"","unique_ID","Season_End_Year","Squad","Comp","Player","Nation","Pos","Age","Born","Mins_Per_90","Tkl_Tackles","TklW_Tackles","Def 3rd_Tackles","Mid 3rd_Tackles","Att 3rd_Tackles","Tkl_Challenges","Att_Challenges","Tkl_percent_Challenges","Lost_Challenges","Blocks_Blocks","Sh_Blocks","Pass_Blocks","Int","Tkl+Int","Clr","Err","Url"
"1","Martin Agirregabiria_2019",2019,"Alavés","La Liga","Martin Agirregabiria","ESP","DF","22",1996,22.6,45,29,32,10,3,28,46,60.9,18,33,11,22,27,72,65,1,"https://fbref.com/en/players/355c883a/Martin-Agirregabiria"
"2","Borja Bastón_2019",2019,"Alavés","La Liga","Borja Bastón","ESP","FW","25",1992,16,16,7,4,9,3,2,24,8.3,22,16,5,11,4,20,10,0,"https://fbref.com/en/players/8c44e37b/Borja-Baston"
"3","Alejandro Blanco_2019",2019,"Alavés","La Liga","Alejandro Blanco","ESP","FW,MF","19",1998,0.2,1,1,1,0,0,1,3,33.3,2,1,0,1,0,1,0,0,"https://fbref.com/en/players/c4dce677/Alejandro-Blanco"
"4","Darko Brašanac_2019",2019,"Alavés","La Liga","Darko Brašanac","SRB","MF","26",1992,17.6,32,16,15,13,4,10,26,38.5,16,17,4,13,13,45,19,0,"https://fbref.com/en/players/4accb7e0/Darko-Brasanac"
"5","Burgui_2019",2019,"Alavés","La Liga","Burgui","ESP","MF,FW","24",1993,6.2,6,6,4,2,0,1,3,33.3,2,4,0,4,0,6,2,1,"https://fbref.com/en/players/45e304c8/Burgui"
"6","Jonathan Calleri_2019",2019,"Alavés","La Liga","Jonathan Calleri","ARG","FW","24",1993,31.9,20,13,3,11,6,1,24,4.2,23,34,7,27,7,27,53,0,"https://fbref.com/en/players/6922f806/Jonathan-Calleri"
"7","Rubén Duarte_2019",2019,"Alavés","La Liga","Rubén Duarte","ESP","DF","22",1995,30.8,72,35,45,20,7,34,64,53.1,30,46,12,34,57,129,130,1,"https://fbref.com/en/players/1fe0492d/Ruben-Duarte"
"8","Rodrigo Ely_2019",2019,"Alavés","La Liga","Rodrigo Ely","BRA","DF","24",1993,4.8,8,5,5,3,0,5,7,71.4,2,9,7,2,7,15,30,0,"https://fbref.com/en/players/fd47b4f2/Rodrigo-Ely"
"9","Manu García_2019",2019,"Alavés","La Liga","Manu García","ESP","MF","32",1986,25.9,83,48,29,40,14,24,77,31.2,53,42,7,35,23,106,67,0,"https://fbref.com/en/players/05a4465d/Manu-Garcia"
"10","Ibai Gómez_2019",2019,"Alavés","La Liga","Ibai Gómez","ESP","MF,FW","28",1989,16.1,14,8,9,3,2,6,19,31.6,13,10,0,10,8,22,17,0,"https://fbref.com/en/players/9d2a3d5f/Ibai-Gomez"
"11","John Guidetti_2019",2019,"Alavés","La Liga","John Guidetti","SWE","FW","26",1992,7,4,1,0,3,1,0,4,0,4,4,0,4,1,5,6,0,"https://fbref.com/en/players/99bebd12/John-Guidetti"
"12","Takashi Inui_2019",2019,"Alavés","La Liga","Takashi Inui","JPN","MF,FW","30",1988,9.2,9,5,6,2,1,5,18,27.8,13,5,0,5,4,13,3,0,"https://fbref.com/en/players/61bd33d0/Takashi-Inui"
"13","Jony_2019",2019,"Alavés","La Liga","Jony","ESP","MF,FW","27",1991,33,20,14,6,7,7,7,37,18.9,30,18,0,18,22,42,12,2,"https://fbref.com/en/players/244f57b9/Jony"
"14","Víctor Laguardia_2019",2019,"Alavés","La Liga","Víctor Laguardia","ESP","DF","28",1989,36,47,34,37,10,0,24,33,72.7,9,42,19,23,53,100,232,0,"https://fbref.com/en/players/b7c99b9b/Victor-Laguardia"
"15","Adrián Marín_2019",2019,"Alavés","La Liga","Adrián Marín","ESP","DF,MF","21",1997,3.2,13,8,8,5,0,4,7,57.1,3,1,0,1,7,20,13,0,"https://fbref.com/en/players/b7f2edff/Adrian-Marin"
"16","Guillermo Maripán_2019",2019,"Alavés","La Liga","Guillermo Maripán","CHI","DF","24",1994,22.3,46,26,34,12,0,26,38,68.4,12,35,19,16,40,86,133,2,"https://fbref.com/en/players/d9764034/Guillermo-Maripan"
"17","Ximo Navarro_2019",2019,"Alavés","La Liga","Ximo Navarro","ESP","DF","28",1990,28.1,57,35,44,12,1,32,45,71.1,13,25,11,14,47,104,143,1,"https://fbref.com/en/players/8db394aa/Ximo-Navarro"
"18","Fernando Pacheco_2019",2019,"Alavés","La Liga","Fernando Pacheco","ESP","GK","26",1992,35,0,0,0,0,0,0,1,0,1,0,0,0,1,1,23,0,"https://fbref.com/en/players/97852360/Fernando-Pacheco"
"19","Tomás Pina Isla_2019",2019,"Alavés","La Liga","Tomás Pina Isla","ESP","MF","30",1987,26,64,41,23,36,5,18,46,39.1,28,15,4,11,41,105,43,1,"https://fbref.com/en/players/e54bd0a2/Tomas-Pina-Isla"
"20","Diego Rolán_2019",2019,"Alavés","La Liga","Diego Rolán","URU","MF,FW","25",1993,3.3,7,4,3,1,3,0,2,0,2,1,0,1,1,8,4,0,"https://fbref.com/en/players/d1491e00/Diego-Rolan"
"21","Antonio Sivera_2019",2019,"Alavés","La Liga","Antonio Sivera","ESP","GK","21",1996,3,0,0,0,0,0,0,0,NA,0,0,0,0,0,0,4,1,"https://fbref.com/en/players/9970da54/Antonio-Sivera"
"22","Rubén Sobrino_2019",2019,"Alavés","La Liga","Rubén Sobrino","ESP","FW,MF","26",1992,10.7,16,11,7,6,3,5,13,38.5,8,16,1,15,2,18,13,0,"https://fbref.com/en/players/19b776e9/Ruben-Sobrino"
"23","Daniel Torres_2019",2019,"Alavés","La Liga","Daniel Torres","COL","MF","28",1989,0.8,2,1,2,0,0,0,3,0,3,0,0,0,2,4,0,0,"https://fbref.com/en/players/87882adc/Daniel-Torres"
"24","Patrick Twumasi_2019",2019,"Alavés","La Liga","Patrick Twumasi","GHA","MF,FW","24",1994,1.9,3,3,2,0,1,0,4,0,4,2,0,2,1,4,1,0,"https://fbref.com/en/players/e3993b65/Patrick-Twumasi"
"25","Carlos Vigaray_2019",2019,"Alavés","La Liga","Carlos Vigaray","ESP","DF","23",1994,7.2,15,8,10,4,1,9,15,60,6,6,1,5,6,21,24,1,"https://fbref.com/en/players/f69d934e/Carlos-Vigaray"
"26","Wakaso_2019",2019,"Alavés","La Liga","Wakaso","GHA","MF","28",1990,18.5,46,30,23,19,4,12,36,33.3,24,37,9,28,16,62,19,2,"https://fbref.com/en/players/999908af/Wakaso"
"27","Khaled Adénon_2019",2019,"Amiens","Ligue 1","Khaled Adénon","BEN","DF","33",1985,22.2,31,22,20,11,0,16,28,57.1,12,26,11,15,31,62,101,0,"https://fbref.com/en/players/16714a62/Khaled-Adenon"
"28","Alexis Blin_2019",2019,"Amiens","Ligue 1","Alexis Blin","FRA","MF","21",1996,22.1,77,45,33,36,8,35,89,39.3,54,39,14,25,33,110,48,1,"https://fbref.com/en/players/c69ef855/Alexis-Blin"
"29","Mathieu Bodmer_2019",2019,"Amiens","Ligue 1","Mathieu Bodmer","FRA","MF,FW","35",1982,11.9,15,11,3,11,1,3,10,30,7,3,0,3,2,17,10,0,"https://fbref.com/en/players/f3642ba8/Mathieu-Bodmer"
"30","Quentin Cornette_2019",2019,"Amiens","Ligue 1","Quentin Cornette","FRA","FW,MF","24",1994,2.3,5,1,2,2,1,3,6,50,3,3,0,3,1,6,5,0,"https://fbref.com/en/players/5d42d487/Quentin-Cornette"
"31","Bakaye Dibassy_2019",2019,"Amiens","Ligue 1","Bakaye Dibassy","MLI","DF","28",1989,32.7,38,26,18,16,4,18,27,66.7,9,40,21,19,44,82,102,0,"https://fbref.com/en/players/247accfd/Bakaye-Dibassy"
"32","Juan Ferney Otero_2019",2019,"Amiens","Ligue 1","Juan Ferney Otero","COL","FW,MF","23",1995,24.2,29,13,11,12,6,13,46,28.3,33,23,3,20,22,51,18,0,"https://fbref.com/en/players/05816e19/Juan-Ferney-Otero"
"33","Guessouma Fofana_2019",2019,"Amiens","Ligue 1","Guessouma Fofana","MTN","MF","25",1992,2.1,6,4,3,3,0,1,3,33.3,2,2,1,1,3,9,0,0,"https://fbref.com/en/players/9dafff2a/Guessouma-Fofana"
"34","Ganso_2019",2019,"Amiens","Ligue 1","Ganso","BRA","MF,FW","28",1989,5.8,12,8,2,8,2,2,15,13.3,13,5,1,4,6,18,0,0,"https://fbref.com/en/players/23593121/Ganso"
"35","Saman Ghoddos_2019",2019,"Amiens","Ligue 1","Saman Ghoddos","IRN","FW,MF","24",1993,20.3,33,17,14,15,4,13,32,40.6,19,15,2,13,7,40,13,0,"https://fbref.com/en/players/f7b1d4e0/Saman-Ghoddos"
"36","Eddy Gnahoré_2019",2019,"Amiens","Ligue 1","Eddy Gnahoré","FRA","MF","24",1993,24.9,39,27,17,17,5,9,39,23.1,30,29,4,25,23,62,23,1,"https://fbref.com/en/players/a0434482/Eddy-Gnahore"
"37","Prince-Désir Gouano_2019",2019,"Amiens","Ligue 1","Prince-Désir Gouano","FRA","DF","24",1993,29.1,31,18,25,5,1,12,22,54.5,10,36,27,9,46,77,127,6,"https://fbref.com/en/players/7c6d6c96/Prince-Desir-Gouano"
"38","Sehrou Guirassy_2019",2019,"Amiens","Ligue 1","Sehrou Guirassy","GUI","FW","22",1996,12.3,7,5,1,5,1,0,4,0,4,7,0,7,4,11,14,0,"https://fbref.com/en/players/923f4dda/Sehrou-Guirassy"
"39","Régis Gurtner_2019",2019,"Amiens","Ligue 1","Régis Gurtner","FRA","GK","31",1986,38,1,1,1,0,0,0,1,0,1,0,0,0,1,2,7,3,"https://fbref.com/en/players/bc270726/Regis-Gurtner"
"40","Oualid El Hajjam_2019",2019,"Amiens","Ligue 1","Oualid El Hajjam","MAR","DF,MF","27",1991,6,14,9,10,3,1,5,15,33.3,10,8,2,6,12,26,26,0,"https://fbref.com/en/players/9f29c204/Oualid-El-Hajjam"
"41","Moussa Konaté_2019",2019,"Amiens","Ligue 1","Moussa Konaté","SEN","FW","25",1993,20.8,10,8,3,3,4,2,12,16.7,10,14,3,11,5,15,15,0,"https://fbref.com/en/players/fcbcbd94/Moussa-Konate"
"42","Emil Krafth_2019",2019,"Amiens","Ligue 1","Emil Krafth","SWE","DF","23",1994,33,55,35,34,14,7,32,65,49.2,33,27,12,15,23,78,94,4,"https://fbref.com/en/players/77cf6852/Emil-Krafth"
"43","Rafał Kurzawa_2019",2019,"Amiens","Ligue 1","Rafał Kurzawa","POL","FW","25",1993,2.7,8,3,6,2,0,2,6,33.3,4,1,0,1,3,11,3,0,"https://fbref.com/en/players/3d3b0206/Rafal-Kurzawa"
"44","Jordan Lefort_2019",2019,"Amiens","Ligue 1","Jordan Lefort","FRA","DF","24",1993,20,33,18,23,6,4,16,25,64,9,11,8,3,46,79,107,0,"https://fbref.com/en/players/c3e4ecbb/Jordan-Lefort"
"45","Stiven Mendoza_2019",2019,"Amiens","Ligue 1","Stiven Mendoza","COL","FW,MF","26",1992,20.9,29,18,10,12,7,14,38,36.8,24,18,0,18,17,46,12,0,"https://fbref.com/en/players/e68f2cb4/Stiven-Mendoza"
"46","Thomas Monconduit_2019",2019,"Amiens","Ligue 1","Thomas Monconduit","FRA","MF","27",1991,31.3,76,47,38,33,5,26,63,41.3,37,46,17,29,36,112,77,1,"https://fbref.com/en/players/84d94b91/Thomas-Monconduit"
"47","Erik Pieters_2019",2019,"Amiens","Ligue 1","Erik Pieters","NED","DF","29",1988,14,49,28,28,18,3,25,33,75.8,8,21,13,8,17,66,56,0,"https://fbref.com/en/players/1ef37668/Erik-Pieters"
"48","Stanley Segarel_2019",2019,"Amiens","Ligue 1","Stanley Segarel","FRA","FW","24",1994,0.2,0,0,0,0,0,0,0,NA,0,0,0,0,0,0,0,0,"https://fbref.com/en/players/b2459674/Stanley-Segarel"
"49","Sanasi Sy_2019",2019,"Amiens","Ligue 1","Sanasi Sy","FRA","MF","19",1999,0,0,0,0,0,0,0,0,NA,0,0,0,0,0,0,0,0,"https://fbref.com/en/players/62a54183/Sanasi-Sy"
"50","Cheick Timite_2019",2019,"Amiens","Ligue 1","Cheick Timite","CIV","FW,MF","20",1997,16.2,18,13,5,7,6,3,16,18.8,13,14,2,12,12,30,13,0,"https://fbref.com/en/players/2c92d3c0/Cheick-Timite"
"51","Gaoussou Traoré_2019",2019,"Amiens","Ligue 1","Gaoussou Traoré","MLI","MF","18",1999,1.2,10,5,6,4,0,4,8,50,4,1,0,1,0,10,0,0,"https://fbref.com/en/players/42e8eba2/Gaoussou-Traore"
"52","Bongani Zungu_2019",2019,"Amiens","Ligue 1","Bongani Zungu","RSA","MF","25",1992,2.6,3,2,0,1,2,2,8,25,6,0,0,0,2,5,5,0,"https://fbref.com/en/players/a8797cf1/Bongani-Zungu"
"53","Rayan Aït Nouri_2019",2019,"Angers","Ligue 1","Rayan Aït Nouri","ALG","DF,MF","17",2001,0.6,2,2,1,1,0,0,1,0,1,0,0,0,0,2,1,0,"https://fbref.com/en/players/9b398aea/Rayan-Ait-Nouri"
"54","Yoann Andreu_2019",2019,"Angers","Ligue 1","Yoann Andreu","FRA","DF","29",1989,0,1,0,1,0,0,0,1,0,1,0,0,0,1,2,0,0,"https://fbref.com/en/players/872cd68c/Yoann-Andreu"
"55","Stéphane Bahoken_2019",2019,"Angers","Ligue 1","Stéphane Bahoken","CMR","FW","26",1992,27.4,15,7,0,10,5,3,21,14.3,18,35,3,32,8,23,5,0,"https://fbref.com/en/players/5046b7d4/Stephane-Bahoken"
"56","Abdoulaye Bamba_2019",2019,"Angers","Ligue 1","Abdoulaye Bamba","CIV","DF","28",1990,28.6,51,29,31,14,6,24,44,54.5,20,20,4,16,37,88,86,0,"https://fbref.com/en/players/7fecbcdb/Abdoulaye-Bamba"
"57","Zacharie Boucher_2019",2019,"Angers","Ligue 1","Zacharie Boucher","FRA","GK","26",1992,2,0,0,0,0,0,0,0,NA,0,1,0,1,0,0,1,0,"https://fbref.com/en/players/249cdcff/Zacharie-Boucher"
"58","Ludovic Butelle_2019",2019,"Angers","Ligue 1","Ludovic Butelle","FRA","GK","35",1983,36,1,0,1,0,0,1,1,100,0,0,0,0,1,2,31,1,"https://fbref.com/en/players/26975a92/Ludovic-Butelle"
"59","Pierrick Capelle_2019",2019,"Angers","Ligue 1","Pierrick Capelle","FRA","DF,MF","31",1987,20.5,51,31,23,22,6,19,54,35.2,35,23,2,21,38,89,49,0,"https://fbref.com/en/players/79b2399c/Pierrick-Capelle"
"60","Angelo Fulgini_2019",2019,"Angers","Ligue 1","Angelo Fulgini","FRA","MF,FW","21",1996,18.2,38,22,18,13,7,12,31,38.7,19,21,3,18,28,66,15,0,"https://fbref.com/en/players/4b96c347/Angelo-Fulgini"
"61","Wilfried Kanga_2019",2019,"Angers","Ligue 1","Wilfried Kanga","CIV","FW","20",1998,5.5,0,0,0,0,0,0,1,0,1,3,0,3,0,0,4,0,"https://fbref.com/en/players/b4c816a9/Wilfried-Kanga"
"62","Cristian López_2019",2019,"Angers","Ligue 1","Cristian López","ESP","FW","29",1989,4.1,6,3,1,2,3,1,8,12.5,7,4,0,4,1,7,2,0,"https://fbref.com/en/players/c76577a0/Cristian-Lopez"
"63","Vincent Manceau_2019",2019,"Angers","Ligue 1","Vincent Manceau","FRA","DF","29",1989,31,98,65,64,23,11,33,62,53.2,29,41,10,31,44,142,87,0,"https://fbref.com/en/players/c26a3918/Vincent-Manceau"
"64","Thomas Mangani_2019",2019,"Angers","Ligue 1","Thomas Mangani","FRA","MF","31",1987,17.8,42,27,13,26,3,19,62,30.6,43,13,2,11,23,65,24,0,"https://fbref.com/en/players/c801616a/Thomas-Mangani"
"65","Harrison Manzala_2019",2019,"Angers","Ligue 1","Harrison Manzala","COD","MF,FW","24",1994,0.8,2,2,1,0,1,0,0,NA,0,0,0,0,0,2,1,0,"https://fbref.com/en/players/392d98fc/Harrison-Manzala"
"66","Farid El Melali_2019",2019,"Angers","Ligue 1","Farid El Melali","ALG","MF,FW","21",1997,3.6,8,4,3,4,1,3,12,25,9,2,0,2,5,13,1,0,"https://fbref.com/en/players/d21e361a/Farid-El-Melali"
"67","Cheikh N'Doye_2019",2019,"Angers","Ligue 1","Cheikh N'Doye","SEN","MF","32",1986,25.9,25,15,14,11,0,10,32,31.3,22,33,8,25,25,50,61,0,"https://fbref.com/en/players/f1b2365a/Cheikh-NDoye"
"68","Vincent Pajot_2019",2019,"Angers","Ligue 1","Vincent Pajot","FRA","MF","27",1990,7.9,18,14,6,8,4,4,14,28.6,10,9,0,9,8,26,6,0,"https://fbref.com/en/players/f86ca403/Vincent-Pajot"
"69","Elhadji Pape Diaw_2019",2019,"Angers","Ligue 1","Elhadji Pape Diaw","SEN","DF","23",1994,0.2,0,0,0,0,0,0,0,NA,0,0,0,0,1,1,0,0,"https://fbref.com/en/players/51450467/Elhadji-Pape-Diaw"
"70","Mateo Pavlović_2019",2019,"Angers","Ligue 1","Mateo Pavlović","BIH","DF","28",1990,27.7,26,18,24,2,0,12,24,50,12,37,29,8,20,46,164,2,"https://fbref.com/en/players/450e277f/Mateo-Pavlovic"
"71","Théo Pellenard_2019",2019,"Angers","Ligue 1","Théo Pellenard","FRA","DF","24",1994,5.5,11,6,7,2,2,5,8,62.5,3,6,2,4,5,16,16,0,"https://fbref.com/en/players/97fb4608/Theo-Pellenard"
"72","Jeff Reine-Adélaïde_2019",2019,"Angers","Ligue 1","Jeff Reine-Adélaïde","FRA","FW,MF","20",1998,28.4,40,22,18,19,3,17,40,42.5,23,20,0,20,19,59,10,0,"https://fbref.com/en/players/d504b3e1/Jeff-Reine-Adelaide"
"73","Baptiste Santamaria_2019",2019,"Angers","Ligue 1","Baptiste Santamaria","FRA","MF","23",1995,36.1,118,60,48,63,7,51,106,48.1,55,41,4,37,57,175,57,2,"https://fbref.com/en/players/5e22e2a4/Baptiste-Santamaria"
"74","Flavien Tait_2019",2019,"Angers","Ligue 1","Flavien Tait","FRA","MF,FW","25",1993,33.2,58,35,33,16,9,23,59,39,36,29,2,27,28,86,15,0,"https://fbref.com/en/players/a0f9b535/Flavien-Tait"
"75","Romain Thomas_2019",2019,"Angers","Ligue 1","Romain Thomas","FRA","DF","30",1988,26.6,35,26,25,10,0,14,19,73.7,5,31,24,7,29,64,133,1,"https://fbref.com/en/players/275e2c51/Romain-Thomas"
"76","Ismaël Traoré_2019",2019,"Angers","Ligue 1","Ismaël Traoré","CIV","DF","31",1986,29.3,27,11,19,8,0,9,24,37.5,15,27,16,11,42,69,120,2,"https://fbref.com/en/players/b666421b/Ismael-Traore"
"77","Pierre-Emerick Aubameyang_2019",2019,"Arsenal","Premier League","Pierre-Emerick Aubameyang","GAB","FW","29",1989,30.3,21,17,6,9,6,8,28,28.6,20,26,0,26,8,29,22,0,"https://fbref.com/en/players/d5dd5f1f/Pierre-Emerick-Aubameyang"
"78","Héctor Bellerín_2019",2019,"Arsenal","Premier League","Héctor Bellerín","ESP","DF","23",1995,17,15,12,8,4,3,6,13,46.2,7,17,5,12,20,35,37,3,"https://fbref.com/en/players/f874dd44/Hector-Bellerin"
"79","Petr Čech_2019",2019,"Arsenal","Premier League","Petr Čech","CZE","GK","36",1982,6.5,1,1,1,0,0,1,1,100,0,0,0,0,0,1,5,2,"https://fbref.com/en/players/71672fa0/Petr-Cech"
"80","Mohamed Elneny_2019",2019,"Arsenal","Premier League","Mohamed Elneny","EGY","MF","26",1992,4.2,13,4,9,1,3,1,2,50,1,7,4,3,2,15,8,0,"https://fbref.com/en/players/47a34c4f/Mohamed-Elneny"
"81","Mattéo Guendouzi_2019",2019,"Arsenal","Premier League","Mattéo Guendouzi","FRA","MF","19",1999,23.9,44,26,18,23,3,17,47,36.2,30,28,5,23,30,74,24,3,"https://fbref.com/en/players/5ea8ef20/Matteo-Guendouzi"
"82","Rob Holding_2019",2019,"Arsenal","Premier League","Rob Holding","ENG","DF","22",1995,9,11,7,9,2,0,2,8,25,6,9,7,2,12,23,40,0,"https://fbref.com/en/players/d79a8c87/Rob-Holding"
"83","Alex Iwobi_2019",2019,"Arsenal","Premier League","Alex Iwobi","NGA","FW,MF","22",1996,21.9,28,14,10,16,2,6,25,24,19,21,1,20,12,40,13,1,"https://fbref.com/en/players/6ca5ec4b/Alex-Iwobi"
"84","Carl Jenkinson_2019",2019,"Arsenal","Premier League","Carl Jenkinson","ENG","DF","26",1992,1.8,3,2,2,0,1,2,3,66.7,1,4,3,1,0,3,2,0,"https://fbref.com/en/players/874125a3/Carl-Jenkinson"
"85","Sead Kolašinac_2019",2019,"Arsenal","Premier League","Sead Kolašinac","BIH","DF,MF","25",1993,21,34,21,21,7,6,20,34,58.8,14,12,3,9,20,54,28,3,"https://fbref.com/en/players/3935e52e/Sead-Kolasinac"
"86","Laurent Koscielny_2019",2019,"Arsenal","Premier League","Laurent Koscielny","FRA","DF","32",1985,14.8,19,11,9,9,1,10,16,62.5,6,20,15,5,30,49,72,0,"https://fbref.com/en/players/f5efb153/Laurent-Koscielny"
"87","Alexandre Lacazette_2019",2019,"Arsenal","Premier League","Alexandre Lacazette","FRA","FW","27",1991,27.8,35,16,6,19,10,5,28,17.9,23,27,1,26,15,50,31,0,"https://fbref.com/en/players/9dbb75ca/Alexandre-Lacazette"
"88","Bernd Leno_2019",2019,"Arsenal","Premier League","Bernd Leno","GER","GK","26",1992,31.5,0,0,0,0,0,0,3,0,3,0,0,0,4,4,16,6,"https://fbref.com/en/players/2628fd2b/Bernd-Leno"
"89","Stephan Lichtsteiner_2019",2019,"Arsenal","Premier League","Stephan Lichtsteiner","SUI","DF","34",1984,10.4,15,9,5,4,6,9,16,56.3,7,11,4,7,9,24,25,1,"https://fbref.com/en/players/99b1d0e6/Stephan-Lichtsteiner"
"90","Ainsley Maitland-Niles_2019",2019,"Arsenal","Premier League","Ainsley Maitland-Niles","ENG","DF","20",1997,11,33,22,19,12,2,14,28,50,14,22,4,18,19,52,15,2,"https://fbref.com/en/players/e3a5814e/Ainsley-Maitland-Niles"
"91","Konstantinos Mavropanos_2019",2019,"Arsenal","Premier League","Konstantinos Mavropanos","GRE","DF","20",1997,1.6,1,0,0,1,0,1,1,100,0,1,1,0,7,8,5,0,"https://fbref.com/en/players/00963611/Konstantinos-Mavropanos"
"92","Henrikh Mkhitaryan_2019",2019,"Arsenal","Premier League","Henrikh Mkhitaryan","ARM","FW,MF","29",1989,18.2,28,22,8,17,3,6,22,27.3,16,34,2,32,16,44,13,0,"https://fbref.com/en/players/dd0daf32/Henrikh-Mkhitaryan"
"93","Nacho Monreal_2019",2019,"Arsenal","Premier League","Nacho Monreal","ESP","DF","32",1986,20.7,35,17,21,9,5,15,25,60,10,28,10,18,31,66,62,0,"https://fbref.com/en/players/d4cb83cc/Nacho-Monreal"
"94","Shkodran Mustafi_2019",2019,"Arsenal","Premier League","Shkodran Mustafi","GER","DF","26",1992,29,62,45,42,17,3,31,40,77.5,9,34,17,17,58,120,168,1,"https://fbref.com/en/players/3f2d59fe/Shkodran-Mustafi"
"95","Eddie Nketiah_2019",2019,"Arsenal","Premier League","Eddie Nketiah","ENG","MF,FW","19",1999,0.7,1,1,0,1,0,0,0,NA,0,0,0,0,0,1,1,0,"https://fbref.com/en/players/a53649b7/Eddie-Nketiah"
"96","Mesut Özil_2019",2019,"Arsenal","Premier League","Mesut Özil","GER","MF,FW","29",1988,19.3,12,5,6,3,3,3,21,14.3,18,10,2,8,4,16,5,0,"https://fbref.com/en/players/16380240/Mesut-Ozil"
"97","Sokratis Papastathopoulos_2019",2019,"Arsenal","Premier League","Sokratis Papastathopoulos","GRE","DF","30",1988,24.4,42,25,30,11,1,15,28,53.6,13,34,17,17,26,68,112,1,"https://fbref.com/en/players/b682dcf6/Sokratis-Papastathopoulos"
"98","Aaron Ramsey_2019",2019,"Arsenal","Premier League","Aaron Ramsey","WAL","MF","27",1990,14.8,34,18,11,15,8,7,25,28,18,7,1,6,9,43,3,0,"https://fbref.com/en/players/ef619b0b/Aaron-Ramsey"
"99","Bukayo Saka_2019",2019,"Arsenal","Premier League","Bukayo Saka","ENG","FW","16",2001,0.1,0,0,0,0,0,0,0,NA,0,0,0,0,0,0,0,0,"https://fbref.com/en/players/bc7dc64d/Bukayo-Saka"
"100","Denis Suárez_2019",2019,"Arsenal","Premier League","Denis Suárez","ESP","MF,FW","24",1994,0.8,1,1,0,1,0,0,5,0,5,0,0,0,1,2,0,0,"https://fbref.com/en/players/12c50af5/Denis-Suarez"
"101","Lucas Torreira_2019",2019,"Arsenal","Premier League","Lucas Torreira","URU","MF","22",1996,26.5,65,39,24,32,9,25,57,43.9,32,34,7,27,41,106,33,2,"https://fbref.com/en/players/52611641/Lucas-Torreira"
"102","Danny Welbeck_2019",2019,"Arsenal","Premier League","Danny Welbeck","ENG","FW,MF","27",1990,1.7,3,2,0,2,1,0,0,NA,0,2,0,2,1,4,2,0,"https://fbref.com/en/players/ce5143da/Danny-Welbeck"
"103","Joe Willock_2019",2019,"Arsenal","Premier League","Joe Willock","ENG","MF,FW","18",1999,0.7,1,0,0,1,0,0,0,NA,0,1,0,1,1,2,0,0,"https://fbref.com/en/players/a3b03921/Joe-Willock"
"104","Granit Xhaka_2019",2019,"Arsenal","Premier League","Granit Xhaka","SUI","MF,DF","25",1992,27.8,52,29,29,20,3,24,59,40.7,35,35,9,26,36,88,56,3,"https://fbref.com/en/players/e61b8aee/Granit-Xhaka"
"105","Ali Adnan Kadhim_2019",2019,"Atalanta","Serie A","Ali Adnan Kadhim","IRQ","DF","24",1993,1.8,1,1,1,0,0,1,2,50,1,1,1,0,3,4,6,0,"https://fbref.com/en/players/06050480/Ali-Adnan-Kadhim"
"106","Musa Barrow_2019",2019,"Atalanta","Serie A","Musa Barrow","GAM","FW","19",1998,6.7,9,5,5,3,1,4,6,66.7,2,4,0,4,0,9,2,0,"https://fbref.com/en/players/e5bf73f3/Musa-Barrow"
"107","Etrit Berisha_2019",2019,"Atalanta","Serie A","Etrit Berisha","ALB","GK","29",1989,18,0,0,0,0,0,0,2,0,2,0,0,0,0,0,5,3,"https://fbref.com/en/players/ee833569/Etrit-Berisha"
"108","Timothy Castagne_2019",2019,"Atalanta","Serie A","Timothy Castagne","BEL","DF","22",1995,22.3,61,39,30,22,9,32,57,56.1,25,32,6,26,28,89,50,0,"https://fbref.com/en/players/197640fd/Timothy-Castagne"
"109","Berat Djimsiti_2019",2019,"Atalanta","Serie A","Berat Djimsiti","ALB","DF","25",1993,20.1,32,22,18,12,2,13,29,44.8,16,21,11,10,34,66,96,0,"https://fbref.com/en/players/6eee05f1/Berat-Djimsiti"
"110","Remo Freuler_2019",2019,"Atalanta","Serie A","Remo Freuler","SUI","MF","26",1992,33.6,84,45,34,34,16,30,70,42.9,40,62,12,50,38,122,45,0,"https://fbref.com/en/players/98d2c2c4/Remo-Freuler"
"111","Pierluigi Gollini_2019",2019,"Atalanta","Serie A","Pierluigi Gollini","ITA","GK","23",1995,20,2,2,2,0,0,1,2,50,1,0,0,0,0,2,3,2,"https://fbref.com/en/players/f0f7f62f/Pierluigi-Gollini"
"112","Papu Gómez_2019",2019,"Atalanta","Serie A","Papu Gómez","ARG","MF,FW","30",1988,32.2,19,14,5,10,4,6,30,20,24,21,0,21,16,35,4,0,"https://fbref.com/en/players/6e4df551/Papu-Gomez"
"113","Robin Gosens_2019",2019,"Atalanta","Serie A","Robin Gosens","GER","DF,MF","24",1994,21.6,63,46,32,26,5,37,54,68.5,17,41,3,38,38,101,60,0,"https://fbref.com/en/players/2d970560/Robin-Gosens"
"114","Hans Hateboer_2019",2019,"Atalanta","Serie A","Hans Hateboer","NED","DF","24",1994,33,43,31,19,19,5,17,34,50,17,29,5,24,23,66,47,1,"https://fbref.com/en/players/3b333ac3/Hans-Hateboer"
"115","Roger Ibanez_2019",2019,"Atalanta","Serie A","Roger Ibanez","BRA","DF,FW","19",1998,0,0,0,0,0,0,0,0,NA,0,0,0,0,0,0,1,0,"https://fbref.com/en/players/82efe6fa/Roger-Ibanez"
"116","Josip Iličić_2019",2019,"Atalanta","Serie A","Josip Iličić","SVN","FW,MF","30",1988,23.8,15,7,2,7,6,5,20,25,15,20,1,19,5,20,2,0,"https://fbref.com/en/players/68252d6d/Josip-Ilicic"
"117","Dejan Kulusevski_2019",2019,"Atalanta","Serie A","Dejan Kulusevski","SWE","MF","18",2000,1.2,3,3,0,2,1,1,3,33.3,2,1,0,1,0,3,0,0,"https://fbref.com/en/players/df3cda47/Dejan-Kulusevski"
"118","José Luis Palomino_2019",2019,"Atalanta","Serie A","José Luis Palomino","ARG","DF","28",1990,25.1,49,31,31,15,3,23,38,60.5,15,34,17,17,68,117,79,0,"https://fbref.com/en/players/921f6058/Jose-Luis-Palomino"
"119","Gianluca Mancini_2019",2019,"Atalanta","Serie A","Gianluca Mancini","ITA","DF","22",1996,25,40,30,22,17,1,16,29,55.2,13,19,4,15,48,88,77,1,"https://fbref.com/en/players/5aa53281/Gianluca-Mancini"
"120","Andrea Masiello_2019",2019,"Atalanta","Serie A","Andrea Masiello","ITA","DF","32",1986,20.4,28,14,13,15,0,17,29,58.6,12,21,6,15,44,72,49,0,"https://fbref.com/en/players/e0314d87/Andrea-Masiello"
"121","Mario Pašalić_2019",2019,"Atalanta","Serie A","Mario Pašalić","CRO","MF","23",1995,18,32,19,9,13,10,7,29,24.1,22,19,4,15,12,44,14,1,"https://fbref.com/en/players/e599253a/Mario-Pasalic"
"122","Matteo Pessina_2019",2019,"Atalanta","Serie A","Matteo Pessina","ITA","MF,FW","21",1997,2.6,4,2,0,4,0,2,3,66.7,1,2,1,1,0,4,4,0,"https://fbref.com/en/players/780e3631/Matteo-Pessina"
"123","Roberto Piccoli_2019",2019,"Atalanta","Serie A","Roberto Piccoli","ITA","FW,MF","17",2001,0.5,2,2,0,1,1,1,1,100,0,1,0,1,0,2,0,0,"https://fbref.com/en/players/1cadaf34/Roberto-Piccoli"
"124","Arkadiusz Reca_2019",2019,"Atalanta","Serie A","Arkadiusz Reca","POL","DF","23",1995,0.5,2,0,1,0,1,0,1,0,1,0,0,0,3,5,0,0,"https://fbref.com/en/players/6213fd82/Arkadiusz-Reca"
"125","Emiliano Rigoni_2019",2019,"Atalanta","Serie A","Emiliano Rigoni","ARG","FW,MF","25",1993,5.8,6,1,2,2,2,2,6,33.3,4,3,0,3,3,9,3,0,"https://fbref.com/en/players/a1216563/Emiliano-Rigoni"
"126","Marten de Roon_2019",2019,"Atalanta","Serie A","Marten de Roon","NED","MF","27",1991,33.1,102,57,32,61,9,34,94,36.2,60,48,9,39,53,155,49,1,"https://fbref.com/en/players/2a1beb34/Marten-de-Roon"
"127","Francesco Rossi_2019",2019,"Atalanta","Serie A","Francesco Rossi","ITA","GK","27",1991,0,0,0,0,0,0,0,0,NA,0,0,0,0,0,0,0,0,"https://fbref.com/en/players/7b5f516f/Francesco-Rossi"
"128","Rafael Tolói_2019",2019,"Atalanta","Serie A","Rafael Tolói","ITA","DF","27",1990,19.4,27,17,15,9,3,16,24,66.7,8,28,10,18,33,60,54,1,"https://fbref.com/en/players/c56dc39e/Rafael-Toloi"
"129","Marco Tumminello_2019",2019,"Atalanta","Serie A","Marco Tumminello","ITA","FW,DF","19",1998,0.1,0,0,0,0,0,0,0,NA,0,0,0,0,0,0,0,0,"https://fbref.com/en/players/5bdd44d8/Marco-Tumminello"
"130","Luca Valzania_2019",2019,"Atalanta","Serie A","Luca Valzania","ITA","MF","22",1996,0.8,5,4,2,3,0,3,5,60,2,0,0,0,1,6,0,0,"https://fbref.com/en/players/2b28ba9f/Luca-Valzania"
"131","Duván Zapata_2019",2019,"Atalanta","Serie A","Duván Zapata","COL","FW","27",1991,32.2,9,5,3,2,4,1,9,11.1,8,26,6,20,4,13,25,0,"https://fbref.com/en/players/d3de9af0/Duvan-Zapata"
"132","Aritz Aduriz_2019",2019,"Athletic Club","La Liga","Aritz Aduriz","ESP","FW","37",1981,10.5,4,2,1,1,2,1,7,14.3,6,2,1,1,0,4,4,0,"https://fbref.com/en/players/293211e1/Aritz-Aduriz"
"133","Yeray Álvarez_2019",2019,"Athletic Club","La Liga","Yeray Álvarez","ESP","DF","23",1995,29,55,30,39,14,2,19,33,57.6,14,35,16,19,63,118,149,1,"https://fbref.com/en/players/3ecc11d8/Yeray-Alvarez"
"134","Mikel Balenziaga_2019",2019,"Athletic Club","La Liga","Mikel Balenziaga","ESP","DF","30",1988,5.8,10,6,7,1,2,5,8,62.5,3,6,2,4,2,12,21,0,"https://fbref.com/en/players/1fe67e86/Mikel-Balenziaga"
"135","Yuri Berchiche_2019",2019,"Athletic Club","La Liga","Yuri Berchiche","ESP","DF,FW","28",1990,34.7,46,31,26,11,9,23,46,50,23,34,9,25,42,88,82,0,"https://fbref.com/en/players/b6e50615/Yuri-Berchiche"
"136","Ander Capa_2019",2019,"Athletic Club","La Liga","Ander Capa","ESP","DF,FW","26",1992,18.2,43,27,32,8,3,13,27,48.1,14,20,2,18,30,73,47,0,"https://fbref.com/en/players/37f1cf47/Ander-Capa"
"137","Iñigo Córdoba_2019",2019,"Athletic Club","La Liga","Iñigo Córdoba","ESP","FW,MF","21",1997,14.7,37,23,15,17,5,14,47,29.8,33,27,0,27,17,54,13,0,"https://fbref.com/en/players/49ea92be/Inigo-Cordoba"
"138","Beñat Etxebarria_2019",2019,"Athletic Club","La Liga","Beñat Etxebarria","ESP","MF","31",1987,22.6,47,24,14,25,8,19,59,32.2,40,18,1,17,24,71,11,0,"https://fbref.com/en/players/b037bd4f/Benat-Etxebarria"
"139","Cristian Ganea_2019",2019,"Athletic Club","La Liga","Cristian Ganea","ROU","DF","26",1992,0.5,0,0,0,0,0,0,3,0,3,1,0,1,1,1,2,0,"https://fbref.com/en/players/baf5665c/Cristian-Ganea"
"140","Dani García_2019",2019,"Athletic Club","La Liga","Dani García","ESP","MF","28",1990,27.5,56,34,21,32,3,24,63,38.1,39,28,8,20,49,105,46,1,"https://fbref.com/en/players/240d3a0b/Dani-Garcia"
"141","Raúl García_2019",2019,"Athletic Club","La Liga","Raúl García","ESP","MF,FW","32",1986,26.3,61,41,13,37,11,22,68,32.4,46,56,1,55,21,82,39,0,"https://fbref.com/en/players/b418dbd4/Raul-Garcia"
"142","Ibai Gómez_2019",2019,"Athletic Club","La Liga","Ibai Gómez","ESP","FW","28",1989,6.4,6,3,3,2,1,4,9,44.4,5,8,1,7,2,8,8,0,"https://fbref.com/en/players/9d2a3d5f/Ibai-Gomez"
"143","Gorka Guruzeta_2019",2019,"Athletic Club","La Liga","Gorka Guruzeta","ESP","MF,FW","21",1996,0.6,1,1,1,0,0,0,2,0,2,1,0,1,2,3,0,0,"https://fbref.com/en/players/6b5ea2f4/Gorka-Guruzeta"
"144","Iago Herrerín_2019",2019,"Athletic Club","La Liga","Iago Herrerín","ESP","GK","30",1988,31,0,0,0,0,0,0,2,0,2,0,0,0,0,0,11,2,"https://fbref.com/en/players/9109185e/Iago-Herrerin"
"145","Ander Iturraspe_2019",2019,"Athletic Club","La Liga","Ander Iturraspe","ESP","MF","29",1989,1.1,2,2,1,1,0,1,1,100,0,0,0,0,6,8,2,0,"https://fbref.com/en/players/6dce77a5/Ander-Iturraspe"
"146","Kenan Kodro_2019",2019,"Athletic Club","La Liga","Kenan Kodro","BIH","FW,MF","24",1993,1.8,3,1,1,1,1,1,3,33.3,2,1,0,1,0,3,0,0,"https://fbref.com/en/players/e82d2807/Kenan-Kodro"
"147","Iñigo Lekue_2019",2019,"Athletic Club","La Liga","Iñigo Lekue","ESP","DF","25",1993,2.3,5,2,3,2,0,2,7,28.6,5,4,0,4,4,9,11,0,"https://fbref.com/en/players/59b7d823/Inigo-Lekue"
"148","Unai López_2019",2019,"Athletic Club","La Liga","Unai López","ESP","MF","22",1995,3.6,7,5,3,2,2,2,12,16.7,10,10,3,7,1,8,2,0,"https://fbref.com/en/players/88050721/Unai-Lopez"
"149","Óscar de Marcos_2019",2019,"Athletic Club","La Liga","Óscar de Marcos","ESP","DF,FW","29",1989,26.9,60,32,34,17,9,29,62,46.8,33,29,4,25,27,87,62,0,"https://fbref.com/en/players/9f323c71/Oscar-de-Marcos"
"150","Iñigo Martínez_2019",2019,"Athletic Club","La Liga","Iñigo Martínez","ESP","DF","27",1991,32.2,53,26,36,16,1,23,37,62.2,14,24,14,10,69,122,144,0,"https://fbref.com/en/players/3fc45c73/Inigo-Martinez"
"151","Iker Muniain_2019",2019,"Athletic Club","La Liga","Iker Muniain","ESP","MF,FW","25",1992,26.5,29,20,10,14,5,6,29,20.7,23,17,3,14,12,41,6,0,"https://fbref.com/en/players/c05dfb74/Iker-Muniain"
"152","Peru Nolaskoain_2019",2019,"Athletic Club","La Liga","Peru Nolaskoain","ESP","DF","19",1998,5.2,11,8,7,4,0,5,9,55.6,4,11,6,5,10,21,18,0,"https://fbref.com/en/players/857cb4f3/Peru-Nolaskoain"
"153","Unai Núñez_2019",2019,"Athletic Club","La Liga","Unai Núñez","ESP","DF","21",1997,11.8,15,11,11,4,0,7,11,63.6,4,20,12,8,28,43,60,2,"https://fbref.com/en/players/be170419/Unai-Nunez"
"154","Mikel Rico_2019",2019,"Athletic Club","La Liga","Mikel Rico","ESP","MF","33",1984,2.7,5,2,1,4,0,2,7,28.6,5,3,2,1,2,7,3,0,"https://fbref.com/en/players/def69cd0/Mikel-Rico"
"155","Mikel San José_2019",2019,"Athletic Club","La Liga","Mikel San José","ESP","MF","29",1989,19.3,43,25,19,19,5,15,48,31.3,33,27,6,21,21,64,35,0,"https://fbref.com/en/players/003a5c72/Mikel-San-Jose"
"156","Unai Simón_2019",2019,"Athletic Club","La Liga","Unai Simón","ESP","GK","21",1997,7,0,0,0,0,0,0,1,0,1,0,0,0,1,1,1,1,"https://fbref.com/en/players/5dcf3e90/Unai-Simon"
"157","Markel Susaeta_2019",2019,"Athletic Club","La Liga","Markel Susaeta","ESP","FW,MF","30",1987,15.3,17,10,4,6,7,3,23,13,20,10,1,9,12,29,5,0,"https://fbref.com/en/players/6fd1ba62/Markel-Susaeta"
"158","Iñaki Williams_2019",2019,"Athletic Club","La Liga","Iñaki Williams","GHA","FW","24",1994,33.6,27,18,9,7,11,5,22,22.7,17,22,1,21,7,34,33,0,"https://fbref.com/en/players/6a99e0b1/Inaki-Williams"
"159","Antonio Adán_2019",2019,"Atlético Madrid","La Liga","Antonio Adán","ESP","GK","31",1987,1,0,0,0,0,0,0,0,NA,0,0,0,0,0,0,0,0,"https://fbref.com/en/players/65d62814/Antonio-Adan"
"160","Santiago Arias_2019",2019,"Atlético Madrid","La Liga","Santiago Arias","COL","DF","26",1992,19.7,48,32,31,16,1,20,31,64.5,11,14,2,12,34,82,43,0,"https://fbref.com/en/players/fdd60087/Santiago-Arias"
"161","Sergio Camello_2019",2019,"Atlético Madrid","La Liga","Sergio Camello","ESP","FW","17",2001,0.5,1,0,1,0,0,1,1,100,0,0,0,0,0,1,0,0,"https://fbref.com/en/players/873619c6/Sergio-Camello"
"162","Ángel Correa_2019",2019,"Atlético Madrid","La Liga","Ángel Correa","ARG","MF,FW","23",1995,21.3,38,19,19,12,7,10,53,18.9,43,28,5,23,17,55,20,0,"https://fbref.com/en/players/01eb744d/Angel-Correa"
"163","Diego Costa_2019",2019,"Atlético Madrid","La Liga","Diego Costa","ESP","FW","29",1988,12.4,4,1,0,4,0,1,8,12.5,7,5,0,5,2,6,6,0,"https://fbref.com/en/players/a190d597/Diego-Costa"
"164","Borja Garcés_2019",2019,"Atlético Madrid","La Liga","Borja Garcés","ESP","FW","18",1999,0.2,0,0,0,0,0,0,0,NA,0,0,0,0,0,0,0,0,"https://fbref.com/en/players/bc39454c/Borja-Garces"
"165","Diego Godín_2019",2019,"Atlético Madrid","La Liga","Diego Godín","URU","DF","32",1986,27.9,52,30,33,19,0,20,42,47.6,22,22,9,13,45,97,141,2,"https://fbref.com/en/players/fc4f85b1/Diego-Godin"
"166","Antoine Griezmann_2019",2019,"Atlético Madrid","La Liga","Antoine Griezmann","FRA","FW,MF","27",1991,35.5,31,19,8,13,10,8,28,28.6,20,18,1,17,12,43,21,0,"https://fbref.com/en/players/df69b544/Antoine-Griezmann"
"167","Lucas Hernández_2019",2019,"Atlético Madrid","La Liga","Lucas Hernández","FRA","DF","22",1996,12.4,35,25,20,14,1,17,20,85,3,17,9,8,14,49,49,0,"https://fbref.com/en/players/c3ee18ef/Lucas-Hernandez"
"168","Carlos Isaac_2019",2019,"Atlético Madrid","La Liga","Carlos Isaac","ESP","DF","20",1998,1,0,0,0,0,0,0,2,0,2,2,0,2,1,1,2,0,"https://fbref.com/en/players/3e5a168c/Carlos-Isaac"
"169","Juanfran_2019",2019,"Atlético Madrid","La Liga","Juanfran","ESP","DF","33",1985,17.9,35,22,27,5,3,24,38,63.2,14,13,5,8,19,54,36,1,"https://fbref.com/en/players/cfd8d664/Juanfran"
"170","Nikola Kalinić_2019",2019,"Atlético Madrid","La Liga","Nikola Kalinić","CRO","FW","30",1988,7.1,6,4,2,4,0,1,3,33.3,2,1,0,1,2,8,2,0,"https://fbref.com/en/players/d4931a5a/Nikola-Kalinic"
"171","Koke_2019",2019,"Atlético Madrid","La Liga","Koke","ESP","MF","26",1992,28.7,84,46,41,32,11,34,86,39.5,52,25,5,20,31,115,37,1,"https://fbref.com/en/players/55126f3b/Koke"
"172","Thomas Lemar_2019",2019,"Atlético Madrid","La Liga","Thomas Lemar","FRA","MF","22",1995,20.2,38,21,23,11,4,19,42,45.2,23,26,1,25,22,60,7,1,"https://fbref.com/en/players/4dbd0916/Thomas-Lemar"
"173","Filipe Luís_2019",2019,"Atlético Madrid","La Liga","Filipe Luís","BRA","DF","32",1985,22.6,66,36,33,25,8,32,58,55.2,26,18,3,15,44,110,47,0,"https://fbref.com/en/players/e4ed2628/Filipe-Luis"
"174","José María Giménez_2019",2019,"Atlético Madrid","La Liga","José María Giménez","URU","DF","23",1995,19.7,26,15,20,6,0,13,26,50,13,27,14,13,44,70,128,2,"https://fbref.com/en/players/f0da930c/Jose-Maria-Gimenez"
"175","Gelson Martins_2019",2019,"Atlético Madrid","La Liga","Gelson Martins","POR","FW,MF","23",1995,2.5,5,3,3,1,1,3,4,75,1,1,0,1,1,6,1,0,"https://fbref.com/en/players/3ef0fa48/Gelson-Martins"
"176","Victor Mollejo_2019",2019,"Atlético Madrid","La Liga","Victor Mollejo","ESP","FW,DF","17",2001,0.7,0,0,0,0,0,0,2,0,2,0,0,0,0,0,0,0,"https://fbref.com/en/players/23fffc06/Victor-Mollejo"
"177","Francisco Montero_2019",2019,"Atlético Madrid","La Liga","Francisco Montero","ESP","DF","19",1999,4.5,8,4,5,3,0,5,6,83.3,1,10,4,6,5,13,18,1,"https://fbref.com/en/players/3e96f3e7/Francisco-Montero"
"178","Álvaro Morata_2019",2019,"Atlético Madrid","La Liga","Álvaro Morata","ESP","FW","25",1992,12,20,14,2,7,11,3,10,30,7,7,0,7,5,25,13,0,"https://fbref.com/en/players/129af0db/Alvaro-Morata"
"179","Toni Moya_2019",2019,"Atlético Madrid","La Liga","Toni Moya","ESP","DF","20",1998,1,2,2,2,0,0,0,1,0,1,0,0,0,0,2,3,0,"https://fbref.com/en/players/9e098912/Toni-Moya"
"180","Joaquín Muñoz_2019",2019,"Atlético Madrid","La Liga","Joaquín Muñoz","ESP","FW","19",1999,0,0,0,0,0,0,0,0,NA,0,0,0,0,0,0,0,0,"https://fbref.com/en/players/e9fbcc21/Joaquin-Munoz"
"181","Saúl Ñíguez_2019",2019,"Atlético Madrid","La Liga","Saúl Ñíguez","ESP","MF,DF","23",1994,32.5,83,56,35,41,7,32,81,39.5,49,57,10,47,42,125,86,1,"https://fbref.com/en/players/c14bc029/Saul-Niguez"
"182","Jan Oblak_2019",2019,"Atlético Madrid","La Liga","Jan Oblak","SVN","GK","25",1993,37,1,0,1,0,0,1,1,100,0,0,0,0,1,2,13,1,"https://fbref.com/en/players/ee8508c0/Jan-Oblak"
"183","Thomas Partey_2019",2019,"Atlético Madrid","La Liga","Thomas Partey","GHA","MF","25",1993,23,66,42,32,25,9,21,49,42.9,28,26,5,21,49,115,22,2,"https://fbref.com/en/players/529f49ab/Thomas-Partey"
"184","Rodri_2019",2019,"Atlético Madrid","La Liga","Rodri","ESP","MF","22",1996,30.4,103,70,45,50,8,39,75,52,36,35,11,24,41,144,68,0,"https://fbref.com/en/players/6434f10d/Rodri"
"185","Stefan Savić_2019",2019,"Atlético Madrid","La Liga","Stefan Savić","MNE","DF","27",1991,15.5,11,10,9,2,0,7,12,58.3,5,13,9,4,22,33,67,0,"https://fbref.com/en/players/f6ac68c1/Stefan-Savic"
"186","Andrés Solano_2019",2019,"Atlético Madrid","La Liga","Andrés Solano","COL","DF","20",1998,0.5,4,3,2,2,0,2,2,100,0,1,0,1,0,4,1,0,"https://fbref.com/en/players/c8764028/Andres-Solano"
"187","Vitolo_2019",2019,"Atlético Madrid","La Liga","Vitolo","ESP","MF,FW","28",1989,8.4,17,13,8,6,3,6,19,31.6,13,8,1,7,10,27,6,0,"https://fbref.com/en/players/db750822/Vitolo"
"188","Simon Asta_2019",2019,"Augsburg","Bundesliga","Simon Asta","GER","DF","17",2001,1,6,3,4,2,0,2,2,100,0,2,1,1,3,9,1,0,"https://fbref.com/en/players/dfc85b89/Simon-Asta"
"189","Daniel Baier_2019",2019,"Augsburg","Bundesliga","Daniel Baier","GER","MF","34",1984,31.3,62,39,21,37,4,24,66,36.4,42,27,8,19,60,122,48,2,"https://fbref.com/en/players/f261abcb/Daniel-Baier"
"190","Caiuby_2019",2019,"Augsburg","Bundesliga","Caiuby","BRA","MF,FW","30",1988,11.2,12,10,5,6,1,3,11,27.3,8,16,1,15,5,17,10,0,"https://fbref.com/en/players/c6637acf/Caiuby"
"191","Jan-Ingwer Callsen-Bracker_2019",2019,"Augsburg","Bundesliga","Jan-Ingwer Callsen-Bracker","GER","DF","33",1984,0.1,0,0,0,0,0,0,0,NA,0,0,0,0,0,0,0,0,"https://fbref.com/en/players/0999a593/Jan-Ingwer-Callsen-Bracker"
"192","Sergio Córdova_2019",2019,"Augsburg","Bundesliga","Sergio Córdova","VEN","FW","20",1997,5.9,9,5,3,4,2,2,6,33.3,4,0,0,0,3,12,5,0,"https://fbref.com/en/players/229cd98a/Sergio-Cordova"
"193","Kevin Danso_2019",2019,"Augsburg","Bundesliga","Kevin Danso","AUT","DF","19",1998,13.9,25,14,21,3,1,11,14,78.6,3,25,17,8,19,44,72,0,"https://fbref.com/en/players/6e33125f/Kevin-Danso"
"194","Ji Dong-won_2019",2019,"Augsburg","Bundesliga","Ji Dong-won","KOR","MF,FW","27",1991,9.9,10,6,5,3,2,6,16,37.5,10,13,2,11,8,18,10,0,"https://fbref.com/en/players/7d841904/Ji-Dong-won"
"195","Alfreð Finnbogason_2019",2019,"Augsburg","Bundesliga","Alfreð Finnbogason","ISL","FW","29",1989,14.8,7,3,2,5,0,1,9,11.1,8,6,1,5,3,10,11,0,"https://fbref.com/en/players/f9e7c4ac/Alfred-Finnbogason"
"196","Raphael Framberger_2019",2019,"Augsburg","Bundesliga","Raphael Framberger","GER","DF,MF","22",1995,6.1,8,6,4,4,0,0,3,0,3,10,3,7,11,19,15,1,"https://fbref.com/en/players/626fab5f/Raphael-Framberger"
"197","Fabian Giefer_2019",2019,"Augsburg","Bundesliga","Fabian Giefer","GER","GK","28",1990,4,0,0,0,0,0,0,2,0,2,0,0,0,0,0,1,2,"https://fbref.com/en/players/fbefefdb/Fabian-Giefer"
"198","Felix Götze_2019",2019,"Augsburg","Bundesliga","Felix Götze","GER","MF","20",1998,1.4,4,2,2,2,0,3,3,100,0,1,0,1,3,7,7,0,"https://fbref.com/en/players/ee7cdd0c/Felix-Gotze"
"199","Jeffrey Gouweleeuw_2019",2019,"Augsburg","Bundesliga","Jeffrey Gouweleeuw","NED","DF","27",1991,23.2,42,31,23,19,0,24,39,61.5,15,44,21,23,56,98,71,1,"https://fbref.com/en/players/1025db8e/Jeffrey-Gouweleeuw"
"200","Michael Gregoritsch_2019",2019,"Augsburg","Bundesliga","Michael Gregoritsch","AUT","MF,FW","24",1994,27.6,22,13,7,9,6,4,28,14.3,24,29,10,19,15,37,58,0,"https://fbref.com/en/players/8e235926/Michael-Gregoritsch"
"201","André Hahn_2019",2019,"Augsburg","Bundesliga","André Hahn","GER","FW,MF","27",1990,22.8,64,38,22,39,3,22,53,41.5,31,28,2,26,27,91,32,0,"https://fbref.com/en/players/cd82452e/Andre-Hahn"
"202","Martin Hinteregger_2019",2019,"Augsburg","Bundesliga","Martin Hinteregger","AUT","DF","25",1992,17.5,48,35,31,16,1,24,35,68.6,11,24,13,11,22,70,68,0,"https://fbref.com/en/players/080440a4/Martin-Hinteregger"
"203","Koo Ja-cheol_2019",2019,"Augsburg","Bundesliga","Koo Ja-cheol","KOR","MF","29",1989,18.2,36,23,10,20,6,12,30,40,18,28,5,23,27,63,21,0,"https://fbref.com/en/players/3c05e082/Koo-Ja-cheol"
"204","Christoph Janker_2019",2019,"Augsburg","Bundesliga","Christoph Janker","GER","MF,FW","33",1985,0.8,2,1,2,0,0,0,0,NA,0,1,0,1,0,2,1,0,"https://fbref.com/en/players/cf01fe3a/Christoph-Janker"
"205","Fredrik Jensen_2019",2019,"Augsburg","Bundesliga","Fredrik Jensen","FIN","FW,MF","20",1997,2.3,5,4,3,1,1,2,4,50,2,6,0,6,2,7,3,0,"https://fbref.com/en/players/3eeb80e0/Fredrik-Jensen"
"206","Rani Khedira_2019",2019,"Augsburg","Bundesliga","Rani Khedira","GER","DF,MF","24",1994,29.2,56,39,22,28,6,18,36,50,18,44,22,22,80,136,95,1,"https://fbref.com/en/players/59e4b92e/Rani-Khedira"
"207","Gregor Kobel_2019",2019,"Augsburg","Bundesliga","Gregor Kobel","SUI","GK","20",1997,15.4,1,1,1,0,0,1,1,100,0,0,0,0,2,3,5,3,"https://fbref.com/en/players/cd59b9df/Gregor-Kobel"
"208","Andreas Luthe_2019",2019,"Augsburg","Bundesliga","Andreas Luthe","GER","GK","31",1987,14.6,0,0,0,0,0,0,0,NA,0,0,0,0,0,0,4,0,"https://fbref.com/en/players/7fe12375/Andreas-Luthe"
"209","Philipp Max_2019",2019,"Augsburg","Bundesliga","Philipp Max","GER","DF,MF","24",1993,28.5,35,24,17,15,3,21,39,53.8,18,16,3,13,22,57,46,1,"https://fbref.com/en/players/826e8b63/Philipp-Max"
"210","Jan Morávek_2019",2019,"Augsburg","Bundesliga","Jan Morávek","CZE","MF","28",1989,8.4,38,21,17,16,5,19,42,45.2,23,21,1,20,9,47,13,0,"https://fbref.com/en/players/e7d22eae/Jan-Moravek"
"211","Reece Oxford_2019",2019,"Augsburg","Bundesliga","Reece Oxford","ENG","DF","19",1998,5.6,12,9,9,3,0,4,6,66.7,2,10,9,1,11,23,39,0,"https://fbref.com/en/players/8b6e0db2/Reece-Oxford"
"212","Marco Richter_2019",2019,"Augsburg","Bundesliga","Marco Richter","GER","MF,FW","20",1997,15.8,13,8,4,5,4,7,20,35,13,16,1,15,13,26,9,1,"https://fbref.com/en/players/f972644c/Marco-Richter"
"213","Julian Schieber_2019",2019,"Augsburg","Bundesliga","Julian Schieber","GER","FW","29",1989,2.9,3,2,1,2,0,0,1,0,1,1,0,1,1,4,3,0,"https://fbref.com/en/players/37c213cf/Julian-Schieber"
"214","Jonathan Schmid_2019",2019,"Augsburg","Bundesliga","Jonathan Schmid","FRA","DF","28",1990,28,44,22,23,19,2,16,28,57.1,12,22,8,14,43,87,70,2,"https://fbref.com/en/players/088ca1bd/Jonathan-Schmid"
"215","Kostas Stafylidis_2019",2019,"Augsburg","Bundesliga","Kostas Stafylidis","GRE","DF","24",1993,10.2,22,14,17,4,1,10,19,52.6,9,13,2,11,15,37,31,0,"https://fbref.com/en/players/861e0116/Kostas-Stafylidis"
"216","Jozo Stanić_2019",2019,"Augsburg","Bundesliga","Jozo Stanić","CRO","MF","19",1999,0,0,0,0,0,0,0,0,NA,0,0,0,0,0,0,0,0,"https://fbref.com/en/players/597ff9d3/Jozo-Stanic"
"217","Georg Teigl_2019",2019,"Augsburg","Bundesliga","Georg Teigl","AUT","MF,FW","27",1991,3.3,5,3,4,0,1,2,2,100,0,1,0,1,7,12,5,1,"https://fbref.com/en/players/c8cfb04d/Georg-Teigl"
"218","Jordi Alba_2019",2019,"Barcelona","La Liga","Jordi Alba","ESP","DF","29",1989,33.2,42,22,20,15,7,20,48,41.7,28,24,6,18,60,102,76,1,"https://fbref.com/en/players/4601e194/Jordi-Alba"
"219","Carles Aleñá_2019",2019,"Barcelona","La Liga","Carles Aleñá","ESP","MF","20",1998,7.1,7,4,0,6,1,2,8,25,6,4,0,4,2,9,0,0,"https://fbref.com/en/players/6c811eb7/Carles-Alena"
"220","Kevin-Prince Boateng_2019",2019,"Barcelona","La Liga","Kevin-Prince Boateng","GHA","FW","31",1987,2.7,3,2,0,1,2,0,1,0,1,1,0,1,1,4,4,0,"https://fbref.com/en/players/f4ec4fd0/Kevin-Prince-Boateng"
"221","Sergio Busquets_2019",2019,"Barcelona","La Liga","Sergio Busquets","ESP","MF","30",1988,30.2,90,60,35,45,10,41,89,46.1,48,43,8,35,54,144,22,1,"https://fbref.com/en/players/5ab0ea87/Sergio-Busquets"
"222","Jasper Cillessen_2019",2019,"Barcelona","La Liga","Jasper Cillessen","NED","GK","29",1989,3,0,0,0,0,0,0,0,NA,0,0,0,0,0,0,3,2,"https://fbref.com/en/players/04ac8285/Jasper-Cillessen"
"223","Álex Collado_2019",2019,"Barcelona","La Liga","Álex Collado","ESP","FW","19",1999,0.9,1,0,0,1,0,0,1,0,1,3,0,3,0,1,2,0,"https://fbref.com/en/players/85dace26/Alex-Collado"
"224","Philippe Coutinho_2019",2019,"Barcelona","La Liga","Philippe Coutinho","BRA","FW,MF","26",1992,22.4,16,11,1,6,9,7,22,31.8,15,21,2,19,12,28,8,0,"https://fbref.com/en/players/0ef89a37/Philippe-Coutinho"
"225","Ousmane Dembélé_2019",2019,"Barcelona","La Liga","Ousmane Dembélé","FRA","FW,MF","21",1997,18.5,23,15,4,13,6,6,18,33.3,12,13,0,13,5,28,4,0,"https://fbref.com/en/players/b19db005/Ousmane-Dembele"
"226","Munir El Haddadi_2019",2019,"Barcelona","La Liga","Munir El Haddadi","MAR","FW","22",1995,1.7,3,3,1,1,1,1,3,33.3,2,1,0,1,0,3,1,0,"https://fbref.com/en/players/8696bc90/Munir-El-Haddadi"
"227","Clément Lenglet_2019",2019,"Barcelona","La Liga","Clément Lenglet","FRA","DF","23",1995,21.5,47,29,26,19,2,22,36,61.1,14,30,20,10,21,68,70,0,"https://fbref.com/en/players/4f28a6ff/Clement-Lenglet"
"228","Malcom_2019",2019,"Barcelona","La Liga","Malcom","BRA","FW,MF","21",1997,6.8,3,2,0,1,2,2,3,66.7,1,7,0,7,1,4,1,0,"https://fbref.com/en/players/6853490f/Malcom"
"229","Arthur Melo_2019",2019,"Barcelona","La Liga","Arthur Melo","BRA","MF","21",1996,15.9,15,10,5,6,4,6,13,46.2,7,8,0,8,9,24,9,1,"https://fbref.com/en/players/48b3dd60/Arthur-Melo"
"230","Lionel Messi_2019",2019,"Barcelona","La Liga","Lionel Messi","ARG","FW","31",1987,30.1,12,7,5,3,4,1,17,5.9,16,10,0,10,3,15,1,0,"https://fbref.com/en/players/d70ce98e/Lionel-Messi"
"231","Jeison Murillo_2019",2019,"Barcelona","La Liga","Jeison Murillo","COL","DF","26",1992,1.3,2,2,1,1,0,0,3,0,3,0,0,0,0,2,5,1,"https://fbref.com/en/players/b233e8e4/Jeison-Murillo"
"232","Carles Pérez_2019",2019,"Barcelona","La Liga","Carles Pérez","ESP","FW","20",1998,0.2,0,0,0,0,0,0,0,NA,0,1,0,1,0,0,0,0,"https://fbref.com/en/players/a8f21b9f/Carles-Perez"
"233","Gerard Piqué_2019",2019,"Barcelona","La Liga","Gerard Piqué","ESP","DF","31",1987,35,42,27,25,17,0,24,37,64.9,13,41,27,14,36,78,154,5,"https://fbref.com/en/players/adfc9123/Gerard-Pique"
"234","Riqui Puig_2019",2019,"Barcelona","La Liga","Riqui Puig","ESP","MF","18",1999,1.7,3,3,0,2,1,2,3,66.7,1,0,0,0,0,3,1,0,"https://fbref.com/en/players/f090a37a/Riqui-Puig"
"235","Rafinha_2019",2019,"Barcelona","La Liga","Rafinha","BRA","FW,MF","25",1993,2.5,8,6,2,3,3,2,2,100,0,5,1,4,1,9,2,0,"https://fbref.com/en/players/0c2ac3cb/Rafinha"
"236","Ivan Rakitić_2019",2019,"Barcelona","La Liga","Ivan Rakitić","CRO","MF","30",1988,29.4,30,24,10,14,6,12,37,32.4,25,32,8,24,51,81,33,0,"https://fbref.com/en/players/89f951b5/Ivan-Rakitic"
"237","Sergi Roberto_2019",2019,"Barcelona","La Liga","Sergi Roberto","ESP","DF,MF","26",1992,23.2,28,20,15,9,4,16,24,66.7,8,18,3,15,43,71,31,0,"https://fbref.com/en/players/335fa267/Sergi-Roberto"
"238","Abel Ruiz_2019",2019,"Barcelona","La Liga","Abel Ruiz","ESP","FW","18",2000,0.2,1,1,1,0,0,1,1,100,0,0,0,0,0,1,0,0,"https://fbref.com/en/players/6cbf8d0d/Abel-Ruiz"
"239","Nélson Semedo_2019",2019,"Barcelona","La Liga","Nélson Semedo","POR","DF","24",1993,17.8,38,27,23,12,3,12,18,66.7,6,23,7,16,22,60,26,0,"https://fbref.com/en/players/d04b94db/Nelson-Semedo"
"240","Denis Suárez_2019",2019,"Barcelona","La Liga","Denis Suárez","ESP","MF,DF","24",1994,0.2,0,0,0,0,0,0,0,NA,0,1,0,1,0,0,0,0,"https://fbref.com/en/players/12c50af5/Denis-Suarez"
"241","Luis Suárez_2019",2019,"Barcelona","La Liga","Luis Suárez","URU","FW","31",1987,31.4,18,11,1,6,11,4,10,40,6,12,4,8,8,26,24,0,"https://fbref.com/en/players/a6154613/Luis-Suarez"
"242","Marc-André ter Stegen_2019",2019,"Barcelona","La Liga","Marc-André ter Stegen","GER","GK","26",1992,35,0,0,0,0,0,0,3,0,3,0,0,0,2,2,5,2,"https://fbref.com/en/players/6f51e382/Marc-Andre-ter-Stegen"
"243","Jean-Clair Todibo_2019",2019,"Barcelona","La Liga","Jean-Clair Todibo","FRA","DF","18",1999,1.7,7,2,4,3,0,5,6,83.3,1,1,0,1,3,10,8,0,"https://fbref.com/en/players/88f130ed/Jean-Clair-Todibo"
"244","Samuel Umtiti_2019",2019,"Barcelona","La Liga","Samuel Umtiti","FRA","DF","24",1993,13.2,8,5,3,4,1,4,6,66.7,2,10,8,2,18,26,28,2,"https://fbref.com/en/players/3eed9821/Samuel-Umtiti"
"245","Thomas Vermaelen_2019",2019,"Barcelona","La Liga","Thomas Vermaelen","BEL","DF","32",1985,6.5,6,4,3,3,0,3,7,42.9,4,4,2,2,6,12,21,0,"https://fbref.com/en/players/d0d79694/Thomas-Vermaelen"
"246","Arturo Vidal_2019",2019,"Barcelona","La Liga","Arturo Vidal","CHI","MF","31",1987,21.4,78,44,32,37,9,30,69,43.5,39,46,5,41,29,107,23,1,"https://fbref.com/en/players/67cdbc0e/Arturo-Vidal"
"247","Moussa Wagué_2019",2019,"Barcelona","La Liga","Moussa Wagué","SEN","DF,FW","19",1998,2.5,6,5,1,4,1,3,7,42.9,4,1,0,1,4,10,3,0,"https://fbref.com/en/players/808df563/Moussa-Wague"
"248","David Alaba_2019",2019,"Bayern Munich","Bundesliga","David Alaba","AUT","DF","26",1992,28.1,34,21,13,13,8,17,26,65.4,9,24,3,21,31,65,40,0,"https://fbref.com/en/players/05439de2/David-Alaba"
"249","Thiago Alcántara_2019",2019,"Bayern Munich","Bundesliga","Thiago Alcántara","ESP","MF","27",1991,26.8,87,65,31,44,12,25,48,52.1,23,23,4,19,44,131,17,1,"https://fbref.com/en/players/77e84962/Thiago-Alcantara"
"250","Jérôme Boateng_2019",2019,"Bayern Munich","Bundesliga","Jérôme Boateng","GER","DF","29",1988,18.8,21,15,12,9,0,10,22,45.5,12,8,3,5,25,46,49,0,"https://fbref.com/en/players/2db2fd7b/Jerome-Boateng"
"251","Kingsley Coman_2019",2019,"Bayern Munich","Bundesliga","Kingsley Coman","FRA","FW,MF","22",1996,15.3,11,6,4,4,3,6,19,31.6,13,20,0,20,5,16,3,0,"https://fbref.com/en/players/042e8a49/Kingsley-Coman"
"252","Alphonso Davies_2019",2019,"Bayern Munich","Bundesliga","Alphonso Davies","CAN","MF,FW","17",2000,0.9,1,1,1,0,0,0,0,NA,0,2,0,2,2,3,1,0,"https://fbref.com/en/players/d781d855/Alphonso-Davies"
"253","Serge Gnabry_2019",2019,"Bayern Munich","Bundesliga","Serge Gnabry","GER","FW,MF","23",1995,19.6,36,20,12,13,11,5,30,16.7,25,18,0,18,11,47,3,0,"https://fbref.com/en/players/88e357ef/Serge-Gnabry"
"254","Leon Goretzka_2019",2019,"Bayern Munich","Bundesliga","Leon Goretzka","GER","MF","23",1995,22.5,41,22,7,27,7,14,38,36.8,24,25,4,21,26,67,14,1,"https://fbref.com/en/players/cc86b9a3/Leon-Goretzka"
"255","Mats Hummels_2019",2019,"Bayern Munich","Bundesliga","Mats Hummels","GER","DF","29",1988,19.7,26,17,19,6,1,9,24,37.5,15,20,8,12,34,60,50,1,"https://fbref.com/en/players/05d548d8/Mats-Hummels"
"256","Joshua Kimmich_2019",2019,"Bayern Munich","Bundesliga","Joshua Kimmich","GER","DF,MF","23",1995,34,46,26,17,22,7,25,54,46.3,29,35,9,26,34,80,41,3,"https://fbref.com/en/players/49296448/Joshua-Kimmich"
"257","Robert Lewandowski_2019",2019,"Bayern Munich","Bundesliga","Robert Lewandowski","POL","FW","29",1988,32.9,12,9,0,8,4,3,11,27.3,8,11,1,10,7,19,15,0,"https://fbref.com/en/players/8d78e732/Robert-Lewandowski"
"258","Javi Martínez_2019",2019,"Bayern Munich","Bundesliga","Javi Martínez","ESP","MF","29",1988,14.5,26,15,7,17,2,5,16,31.3,11,17,5,12,31,57,13,0,"https://fbref.com/en/players/7f97771d/Javi-Martinez"
"259","Thomas Müller_2019",2019,"Bayern Munich","Bundesliga","Thomas Müller","GER","MF,FW","28",1989,26.4,42,23,13,15,14,10,38,26.3,28,46,6,40,9,51,12,0,"https://fbref.com/en/players/3c6089ab/Thomas-Muller"
"260","Manuel Neuer_2019",2019,"Bayern Munich","Bundesliga","Manuel Neuer","GER","GK","32",1986,25.6,1,1,1,0,0,0,1,0,1,1,0,1,0,1,8,3,"https://fbref.com/en/players/8778c910/Manuel-Neuer"
"261","Rafinha_2019",2019,"Bayern Munich","Bundesliga","Rafinha","BRA","DF","32",1985,10,15,7,6,6,3,6,14,42.9,8,8,3,5,19,34,11,0,"https://fbref.com/en/players/d003e213/Rafinha"
"262","Franck Ribéry_2019",2019,"Bayern Munich","Bundesliga","Franck Ribéry","FRA","MF,FW","35",1983,13,15,7,7,6,2,4,10,40,6,9,0,9,7,22,1,0,"https://fbref.com/en/players/f61c7c4e/Franck-Ribery"
"263","Arjen Robben_2019",2019,"Bayern Munich","Bundesliga","Arjen Robben","NED","FW,MF","34",1984,6.3,3,1,0,3,0,0,1,0,1,6,1,5,3,6,0,0,"https://fbref.com/en/players/09586899/Arjen-Robben"
"264","James Rodríguez_2019",2019,"Bayern Munich","Bundesliga","James Rodríguez","COL","MF","27",1991,12.6,12,8,3,4,5,5,19,26.3,14,9,0,9,4,16,1,0,"https://fbref.com/en/players/715bf047/James-Rodriguez"
"265","Renato Sanches_2019",2019,"Bayern Munich","Bundesliga","Renato Sanches","POR","MF","20",1997,6.4,5,5,2,1,2,3,10,30,7,7,0,7,4,9,2,0,"https://fbref.com/en/players/032f894e/Renato-Sanches"
"266","Meritan Shabani_2019",2019,"Bayern Munich","Bundesliga","Meritan Shabani","ALB","MF","19",1999,0,0,0,0,0,0,0,0,NA,0,0,0,0,0,0,0,0,"https://fbref.com/en/players/012c38ec/Meritan-Shabani"
"267","Niklas Süle_2019",2019,"Bayern Munich","Bundesliga","Niklas Süle","GER","DF","22",1995,29.5,28,23,17,10,1,18,25,72,7,23,13,10,40,68,83,0,"https://fbref.com/en/players/e33c06cf/Niklas-Sule"
"268","Corentin Tolisso_2019",2019,"Bayern Munich","Bundesliga","Corentin Tolisso","FRA","MF","23",1994,0.6,0,0,0,0,0,0,2,0,2,1,1,0,0,0,0,0,"https://fbref.com/en/players/652d4c37/Corentin-Tolisso"
"269","Sven Ulreich_2019",2019,"Bayern Munich","Bundesliga","Sven Ulreich","GER","GK","29",1988,8.4,0,0,0,0,0,0,0,NA,0,0,0,0,0,0,2,1,"https://fbref.com/en/players/7d3e7da6/Sven-Ulreich"
"270","Sandro Wagner_2019",2019,"Bayern Munich","Bundesliga","Sandro Wagner","GER","FW","30",1987,1.6,3,2,0,2,1,0,1,0,1,0,0,0,0,3,2,0,"https://fbref.com/en/players/61b0b44d/Sandro-Wagner"
"271","Jeong Woo-yeong_2019",2019,"Bayern Munich","Bundesliga","Jeong Woo-yeong","KOR","FW","18",1999,0.1,0,0,0,0,0,0,1,0,1,0,0,0,0,0,0,0,"https://fbref.com/en/players/6190474d/Jeong-Woo-yeong"
"272","Antonio Barragán_2019",2019,"Betis","La Liga","Antonio Barragán","ESP","DF,FW","31",1987,10.4,14,8,9,4,1,2,12,16.7,10,15,4,11,5,19,30,2,"https://fbref.com/en/players/487d9b09/Antonio-Barragan"
"273","Marc Bartra_2019",2019,"Betis","La Liga","Marc Bartra","ESP","DF","27",1991,32.5,86,55,55,26,5,41,76,53.9,35,46,21,25,60,146,132,2,"https://fbref.com/en/players/b742cc0d/Marc-Bartra"
"274","Ryad Boudebouz_2019",2019,"Betis","La Liga","Ryad Boudebouz","ALG","MF,FW","28",1990,6,8,4,4,1,3,4,10,40,6,5,1,4,5,13,2,0,"https://fbref.com/en/players/1001ae82/Ryad-Boudebouz"
"275","Sergio Canales_2019",2019,"Betis","La Liga","Sergio Canales","ESP","MF","27",1991,29.5,44,30,19,18,7,11,53,20.8,42,34,3,31,9,53,8,1,"https://fbref.com/en/players/a6de370d/Sergio-Canales"
"276","William Carvalho_2019",2019,"Betis","La Liga","William Carvalho","POR","MF","26",1992,26.5,45,27,20,21,4,16,29,55.2,13,8,0,8,12,57,30,0,"https://fbref.com/en/players/dee86451/William-Carvalho"
"277","Emerson_2019",2019,"Betis","La Liga","Emerson","BRA","FW,DF","19",1999,3.5,9,7,6,1,2,3,10,30,7,6,0,6,7,16,12,0,"https://fbref.com/en/players/df8b52a5/Emerson"
"278","Zouhair Feddal_2019",2019,"Betis","La Liga","Zouhair Feddal","MAR","DF","29",1989,18.9,38,23,31,6,1,16,28,57.1,12,19,8,11,31,69,94,2,"https://fbref.com/en/players/89151b16/Zouhair-Feddal"
"279","Junior Firpo_2019",2019,"Betis","La Liga","Junior Firpo","ESP","DF,FW","21",1996,21.5,38,25,16,14,8,10,24,41.7,14,27,2,25,23,61,48,0,"https://fbref.com/en/players/24f59bb2/Junior-Firpo"
"280","Javi García_2019",2019,"Betis","La Liga","Javi García","ESP","DF,MF","31",1987,5.8,3,1,3,0,0,2,3,66.7,1,5,1,4,5,8,27,0,"https://fbref.com/en/players/167c1bb0/Javi-Garcia"
"281","Andrés Guardado_2019",2019,"Betis","La Liga","Andrés Guardado","MEX","MF,DF","31",1986,25.9,24,15,9,12,3,11,47,23.4,36,27,1,26,28,52,28,1,"https://fbref.com/en/players/ef322658/Andres-Guardado"
"282","Francis Guerrero_2019",2019,"Betis","La Liga","Francis Guerrero","ESP","DF,FW","22",1996,19.8,51,28,25,16,10,23,41,56.1,18,15,1,14,21,72,47,4,"https://fbref.com/en/players/59d53e8a/Francis-Guerrero"
"283","Takashi Inui_2019",2019,"Betis","La Liga","Takashi Inui","JPN","MF","30",1988,4.2,4,3,0,4,0,3,7,42.9,4,3,0,3,1,5,1,0,"https://fbref.com/en/players/61bd33d0/Takashi-Inui"
"284","Jesé_2019",2019,"Betis","La Liga","Jesé","ESP","FW,MF","25",1993,8.7,7,4,3,3,1,2,8,25,6,8,0,8,1,8,1,0,"https://fbref.com/en/players/4a537185/Jese"
"285","Joaquín_2019",2019,"Betis","La Liga","Joaquín","ESP","FW,MF","37",1981,18.8,10,4,4,2,4,3,7,42.9,4,13,2,11,14,24,31,1,"https://fbref.com/en/players/4c5b14d2/Joaquin"
"286","Wilfrid Kaptoum_2019",2019,"Betis","La Liga","Wilfrid Kaptoum","CMR","MF","22",1996,8.6,15,6,4,10,1,5,11,45.5,6,9,1,8,10,25,6,2,"https://fbref.com/en/players/d717630e/Wilfrid-Kaptoum"
"287","Diego Lainez_2019",2019,"Betis","La Liga","Diego Lainez","MEX","FW,MF","18",2000,3.9,4,4,0,3,1,1,1,100,0,2,0,2,1,5,2,0,"https://fbref.com/en/players/bf12926c/Diego-Lainez"
"288","Sergio León_2019",2019,"Betis","La Liga","Sergio León","ESP","FW,MF","29",1989,7.1,4,2,2,1,1,2,8,25,6,4,0,4,2,6,6,0,"https://fbref.com/en/players/0a0cc13c/Sergio-Leon"
"289","Giovani Lo Celso_2019",2019,"Betis","La Liga","Giovani Lo Celso","ARG","MF,FW","22",1996,26.6,52,31,16,28,8,9,35,25.7,26,24,1,23,17,69,8,0,"https://fbref.com/en/players/d7553721/Giovani-Lo-Celso"
"290","Pau López_2019",2019,"Betis","La Liga","Pau López","ESP","GK","23",1994,33,0,0,0,0,0,0,2,0,2,1,0,1,2,2,17,2,"https://fbref.com/en/players/20b9f052/Pau-Lopez"
"291","Aïssa Mandi_2019",2019,"Betis","La Liga","Aïssa Mandi","ALG","DF","26",1991,34,52,34,27,20,5,12,29,41.4,17,39,23,16,41,93,71,2,"https://fbref.com/en/players/fbd6378b/Aissa-Mandi"
"292","Loren Morón_2019",2019,"Betis","La Liga","Loren Morón","ESP","FW","24",1993,21.7,18,12,4,11,3,6,27,22.2,21,24,1,23,6,24,18,0,"https://fbref.com/en/players/3aa4a3be/Loren-Moron"
"293","Joel Robles_2019",2019,"Betis","La Liga","Joel Robles","ESP","GK","28",1990,5,1,0,1,0,0,1,1,100,0,0,0,0,0,1,5,1,"https://fbref.com/en/players/cda0b317/Joel-Robles"
"294","Antonio Sanabria_2019",2019,"Betis","La Liga","Antonio Sanabria","PAR","FW","22",1996,9,8,6,0,5,3,1,6,16.7,5,8,2,6,3,11,4,0,"https://fbref.com/en/players/0a447501/Antonio-Sanabria"
"295","Sidnei_2019",2019,"Betis","La Liga","Sidnei","BRA","DF","28",1989,19.4,48,29,33,12,3,18,34,52.9,16,21,8,13,41,89,57,0,"https://fbref.com/en/players/b14d0c5d/Sidnei"
"296","Cristian Tello_2019",2019,"Betis","La Liga","Cristian Tello","ESP","DF,FW","26",1991,17.5,32,20,18,9,5,17,35,48.6,18,19,0,19,16,48,17,1,"https://fbref.com/en/players/72a99e38/Cristian-Tello"
"297","Arturo Calabresi_2019",2019,"Bologna","Serie A","Arturo Calabresi","ITA","DF","22",1996,15.7,46,27,22,17,7,22,40,55,18,18,3,15,34,80,60,0,"https://fbref.com/en/players/34bb6fbd/Arturo-Calabresi"
"298","Gabriele Corbo_2019",2019,"Bologna","Serie A","Gabriele Corbo","ITA","DF","18",2000,0.1,0,0,0,0,0,0,0,NA,0,0,0,0,0,0,0,0,"https://fbref.com/en/players/091795f2/Gabriele-Corbo"
"299","Sebastien De Maio_2019",2019,"Bologna","Serie A","Sebastien De Maio","FRA","DF","31",1987,5.5,5,4,3,2,0,1,2,50,1,8,5,3,1,6,32,0,"https://fbref.com/en/players/952a03fe/Sebastien-De-Maio"
"300","Mattia Destro_2019",2019,"Bologna","Serie A","Mattia Destro","ITA","FW","27",1991,5.5,3,2,2,0,1,0,0,NA,0,4,0,4,0,3,6,0,"https://fbref.com/en/players/d7d32194/Mattia-Destro"
"301","Mitchell Dijks_2019",2019,"Bologna","Serie A","Mitchell Dijks","NED","DF","25",1993,22.5,30,18,19,7,4,13,36,36.1,23,18,1,17,23,53,49,0,"https://fbref.com/en/players/0a3065c8/Mitchell-Dijks"
"302","Godfred Donsah_2019",2019,"Bologna","Serie A","Godfred Donsah","GHA","MF","22",1996,1.7,3,1,3,0,0,3,5,60,2,4,2,2,0,3,7,0,"https://fbref.com/en/players/384dd218/Godfred-Donsah"
"303","Blerim Džemaili_2019",2019,"Bologna","Serie A","Blerim Džemaili","SUI","MF","32",1986,19.4,44,27,22,19,3,19,58,32.8,39,22,1,21,17,61,12,1,"https://fbref.com/en/players/756959aa/Blerim-Dzemaili"
"304","Simone Edera_2019",2019,"Bologna","Serie A","Simone Edera","ITA","FW","21",1997,2.2,4,4,3,0,1,1,3,33.3,2,5,1,4,0,4,1,0,"https://fbref.com/en/players/8697c095/Simone-Edera"
"305","Diego Falcinelli_2019",2019,"Bologna","Serie A","Diego Falcinelli","ITA","FW","27",1991,7.8,8,5,1,3,4,2,3,66.7,1,4,1,3,1,9,5,0,"https://fbref.com/en/players/a39b9ef6/Diego-Falcinelli"
"306","Giancarlo González_2019",2019,"Bologna","Serie A","Giancarlo González","CRC","DF","30",1988,8.3,13,7,12,1,0,5,9,55.6,4,15,11,4,12,25,42,0,"https://fbref.com/en/players/117beb8f/Giancarlo-Gonzalez"
"307","Filip Helander_2019",2019,"Bologna","Serie A","Filip Helander","SWE","DF","25",1993,19,42,26,25,13,4,19,23,82.6,4,27,16,11,14,56,84,0,"https://fbref.com/en/players/27f0ddef/Filip-Helander"
"308","Ladislav Krejčí_2019",2019,"Bologna","Serie A","Ladislav Krejčí","CZE","DF,MF","26",1992,11.8,16,12,6,9,1,7,12,58.3,5,8,2,6,6,22,18,0,"https://fbref.com/en/players/58027adc/Ladislav-Krejci"
"309","Danilo Larangeira_2019",2019,"Bologna","Serie A","Danilo Larangeira","BRA","DF","34",1984,34.2,40,26,29,11,0,20,30,66.7,10,52,39,13,37,77,182,3,"https://fbref.com/en/players/fed5f993/Danilo-Larangeira"
"310","Lyanco_2019",2019,"Bologna","Serie A","Lyanco","BRA","DF","21",1997,12.4,29,18,19,10,0,13,18,72.2,5,24,16,8,22,51,64,0,"https://fbref.com/en/players/b5bf1770/Lyanco"
"311","Juan Manuel Valencia_2019",2019,"Bologna","Serie A","Juan Manuel Valencia","COL","FW","20",1998,0.3,0,0,0,0,0,0,0,NA,0,0,0,0,1,1,0,0,"https://fbref.com/en/players/7f50c23b/Juan-Manuel-Valencia"
"312","Federico Mattiello_2019",2019,"Bologna","Serie A","Federico Mattiello","ITA","DF,FW","23",1995,14.8,33,20,19,9,5,15,23,65.2,8,9,3,6,20,53,43,0,"https://fbref.com/en/players/fba81826/Federico-Mattiello"
"313","Ibrahima Mbaye_2019",2019,"Bologna","Serie A","Ibrahima Mbaye","SEN","DF","23",1994,22.3,48,32,30,16,2,19,32,59.4,13,21,12,9,19,67,66,1,"https://fbref.com/en/players/cfbf9881/Ibrahima-Mbaye"
"314","Ádám Nagy_2019",2019,"Bologna","Serie A","Ádám Nagy","HUN","MF","23",1995,10.8,29,21,15,13,1,11,21,52.4,10,13,5,8,25,54,12,2,"https://fbref.com/en/players/788b31e2/Adam-Nagy"
"315","Orji Okwonkwo_2019",2019,"Bologna","Serie A","Orji Okwonkwo","NGA","FW","20",1998,2.9,4,3,1,2,1,2,2,100,0,0,0,0,1,5,0,0,"https://fbref.com/en/players/905a4f61/Orji-Okwonkwo"
"316","Riccardo Orsolini_2019",2019,"Bologna","Serie A","Riccardo Orsolini","ITA","FW,MF","21",1997,21.8,40,24,16,18,6,9,39,23.1,30,23,2,21,14,54,25,1,"https://fbref.com/en/players/e14ec482/Riccardo-Orsolini"
"317","Rodrigo Palacio_2019",2019,"Bologna","Serie A","Rodrigo Palacio","ARG","FW","36",1982,25.9,24,13,8,12,4,4,34,11.8,30,35,0,35,5,29,13,0,"https://fbref.com/en/players/8d8178ac/Rodrigo-Palacio"
"318","Nehuén Paz_2019",2019,"Bologna","Serie A","Nehuén Paz","ARG","DF","25",1993,1.3,2,1,2,0,0,1,2,50,1,3,1,2,0,2,2,0,"https://fbref.com/en/players/42b1a58a/Nehuen-Paz"
"319","Andrea Poli_2019",2019,"Bologna","Serie A","Andrea Poli","ITA","MF","28",1989,21.5,65,47,30,28,7,24,67,35.8,43,36,5,31,35,100,13,2,"https://fbref.com/en/players/b3fd7075/Andrea-Poli"
"320","Erick Pulgar_2019",2019,"Bologna","Serie A","Erick Pulgar","CHI","MF","24",1994,26.2,65,36,35,23,7,22,73,30.1,51,35,5,30,50,115,54,1,"https://fbref.com/en/players/4611e028/Erick-Pulgar"
"321","Nicola Sansone_2019",2019,"Bologna","Serie A","Nicola Sansone","ITA","FW","26",1991,12.7,29,17,9,14,6,9,27,33.3,18,13,1,12,9,38,4,0,"https://fbref.com/en/players/7eb97a8e/Nicola-Sansone"
"322","Federico Santander_2019",2019,"Bologna","Serie A","Federico Santander","PAR","FW","27",1991,22.9,18,10,6,8,4,2,23,8.7,21,20,2,18,9,27,30,0,"https://fbref.com/en/players/df85d472/Federico-Santander"
"323","Łukasz Skorupski_2019",2019,"Bologna","Serie A","Łukasz Skorupski","POL","GK","27",1991,38,0,0,0,0,0,0,0,NA,0,0,0,0,3,3,12,4,"https://fbref.com/en/players/ab4449d6/Lukasz-Skorupski"
"324","Roberto Soriano_2019",2019,"Bologna","Serie A","Roberto Soriano","ITA","MF","27",1991,16.5,27,18,14,10,3,8,24,33.3,16,21,2,19,3,30,11,0,"https://fbref.com/en/players/9d4c45d6/Roberto-Soriano"
"325","Mattias Svanberg_2019",2019,"Bologna","Serie A","Mattias Svanberg","SWE","MF","19",1999,13.1,22,11,14,7,1,11,25,44,14,25,6,19,11,33,16,2,"https://fbref.com/en/players/92d83c27/Mattias-Svanberg"
"326","Yacine Adli_2019",2019,"Bordeaux","Ligue 1","Yacine Adli","FRA","MF","18",2000,2.4,7,2,2,3,2,3,9,33.3,6,3,0,3,2,9,0,0,"https://fbref.com/en/players/26777636/Yacine-Adli"
"327","Toma Bašić_2019",2019,"Bordeaux","Ligue 1","Toma Bašić","CRO","MF","21",1996,14.8,32,16,5,21,6,11,31,35.5,20,13,1,12,9,41,22,1,"https://fbref.com/en/players/80556f08/Toma-Basic"
"328","Paul Baysse_2019",2019,"Bordeaux","Ligue 1","Paul Baysse","FRA","DF","30",1988,0.8,1,0,1,0,0,0,1,0,1,1,1,0,1,2,6,0,"https://fbref.com/en/players/2515040a/Paul-Baysse"
"329","Yassine Benrahou_2019",2019,"Bordeaux","Ligue 1","Yassine Benrahou","FRA","MF,FW","19",1999,2,9,6,1,7,1,2,5,40,3,4,0,4,2,11,1,0,"https://fbref.com/en/players/fbf76716/Yassine-Benrahou"
"330","Jimmy Briand_2019",2019,"Bordeaux","Ligue 1","Jimmy Briand","FRA","FW","32",1985,27.7,14,8,2,10,2,4,24,16.7,20,14,6,8,4,18,29,0,"https://fbref.com/en/players/f83c8d6c/Jimmy-Briand"
"331","Till Cissokho_2019",2019,"Bordeaux","Ligue 1","Till Cissokho","FRA","DF","18",2000,0.9,1,0,1,0,0,0,0,NA,0,0,0,0,2,3,3,0,"https://fbref.com/en/players/e8b5ad37/Till-Cissokho"
"332","Andreas Cornelius_2019",2019,"Bordeaux","Ligue 1","Andreas Cornelius","DEN","FW","25",1993,8.8,4,1,1,3,0,1,4,25,3,4,1,3,1,5,21,0,"https://fbref.com/en/players/c693347d/Andreas-Cornelius"
"333","Benoît Costil_2019",2019,"Bordeaux","Ligue 1","Benoît Costil","FRA","GK","31",1987,37,2,0,2,0,0,2,2,100,0,0,0,0,0,2,14,3,"https://fbref.com/en/players/2434f24a/Benoit-Costil"
"334","Milan Gajić_2019",2019,"Bordeaux","Ligue 1","Milan Gajić","SRB","DF","22",1996,1,2,1,1,0,1,1,1,100,0,0,0,0,1,3,7,0,"https://fbref.com/en/players/9f6325f9/Milan-Gajic"
"335","Vukašin Jovanović_2019",2019,"Bordeaux","Ligue 1","Vukašin Jovanović","SRB","DF","22",1996,15.3,26,21,21,5,0,13,19,68.4,6,23,12,11,36,62,105,0,"https://fbref.com/en/players/0eb03d5b/Vukasin-Jovanovic"
"336","Samuel Kalu_2019",2019,"Bordeaux","Ligue 1","Samuel Kalu","NGA","FW","20",1997,14.2,27,18,15,7,5,4,11,36.4,7,11,3,8,8,35,4,1,"https://fbref.com/en/players/b8d22478/Samuel-Kalu"
"337","François Kamano_2019",2019,"Bordeaux","Ligue 1","François Kamano","GUI","FW,MF","22",1996,28.5,29,18,6,17,6,11,30,36.7,19,27,0,27,17,46,6,1,"https://fbref.com/en/players/81d3318f/Francois-Kamano"
"338","Yann Karamoh_2019",2019,"Bordeaux","Ligue 1","Yann Karamoh","FRA","FW","20",1998,13.6,7,3,1,4,2,1,13,7.7,12,9,0,9,6,13,3,0,"https://fbref.com/en/players/8b66d9cc/Yann-Karamoh"
"339","Jules Koundé_2019",2019,"Bordeaux","Ligue 1","Jules Koundé","FRA","DF","19",1998,37,48,31,37,11,0,27,41,65.9,14,44,23,21,50,98,193,7,"https://fbref.com/en/players/4d1666ff/Jules-Kounde"
"340","Gaëtan Laborde_2019",2019,"Bordeaux","Ligue 1","Gaëtan Laborde","FRA","FW","24",1994,1,4,3,0,1,3,2,4,50,2,0,0,0,0,4,0,0,"https://fbref.com/en/players/7cdda3bf/Gaetan-Laborde"
"341","Alexandre Lauray_2019",2019,"Bordeaux","Ligue 1","Alexandre Lauray","FRA","DF","21",1997,2.9,11,6,9,2,0,6,8,75,2,2,0,2,4,15,10,0,"https://fbref.com/en/players/ae6941ec/Alexandre-Lauray"
"342","Lukas Lerager_2019",2019,"Bordeaux","Ligue 1","Lukas Lerager","DEN","MF","25",1993,14.4,38,21,14,23,1,18,43,41.9,25,22,10,12,32,70,26,1,"https://fbref.com/en/players/1b82f8df/Lukas-Lerager"
"343","Igor Lewczuk_2019",2019,"Bordeaux","Ligue 1","Igor Lewczuk","POL","DF","33",1985,5,12,7,8,2,2,1,4,25,3,2,2,0,4,16,27,0,"https://fbref.com/en/players/6b9f2f3e/Igor-Lewczuk"
"344","Albert Lottin_2019",2019,"Bordeaux","Ligue 1","Albert Lottin","FRA","MF,FW","16",2001,0.2,1,1,0,1,0,0,1,0,1,1,0,1,0,1,0,0,"https://fbref.com/en/players/934a0957/Albert-Lottin"
"345","Josh Maja_2019",2019,"Bordeaux","Ligue 1","Josh Maja","NGA","FW","19",1998,2.2,2,1,1,1,0,0,1,0,1,1,0,1,0,2,0,0,"https://fbref.com/en/players/bc0bfc64/Josh-Maja"
"346","Otávio_2019",2019,"Bordeaux","Ligue 1","Otávio","BRA","MF","24",1994,31.9,127,74,59,64,4,49,109,45,60,45,11,34,43,170,54,1,"https://fbref.com/en/players/243f4a0b/Otavio"
"347","Pablo_2019",2019,"Bordeaux","Ligue 1","Pablo","BRA","DF","27",1991,21.5,26,15,22,3,1,13,23,56.5,10,28,22,6,32,58,173,2,"https://fbref.com/en/players/29d8ad3f/Pablo"
"348","Sergi Palencia_2019",2019,"Bordeaux","Ligue 1","Sergi Palencia","ESP","DF","22",1996,22.1,74,50,46,20,8,27,55,49.1,28,22,3,19,17,91,70,1,"https://fbref.com/en/players/19f8e480/Sergi-Palencia"
"349","Jaroslav Plašil_2019",2019,"Bordeaux","Ligue 1","Jaroslav Plašil","CZE","MF","36",1982,16,34,26,11,20,3,18,44,40.9,26,21,5,16,19,53,28,1,"https://fbref.com/en/players/516dc25b/Jaroslav-Plasil"
"350","Maxime Poundjé_2019",2019,"Bordeaux","Ligue 1","Maxime Poundjé","FRA","DF","25",1992,28.2,48,35,34,12,2,31,62,50,31,24,5,19,29,77,79,0,"https://fbref.com/en/players/b92edde2/Maxime-Poundje"
"351","Gaëtan Poussin_2019",2019,"Bordeaux","Ligue 1","Gaëtan Poussin","FRA","GK","19",1999,1,0,0,0,0,0,0,0,NA,0,0,0,0,0,0,0,0,"https://fbref.com/en/players/c252c705/Gaetan-Poussin"
"352","Nicolas de Préville_2019",2019,"Bordeaux","Ligue 1","Nicolas de Préville","FRA","FW,MF","27",1991,14.1,28,19,10,15,3,8,29,27.6,21,23,1,22,10,38,21,1,"https://fbref.com/en/players/b0547a87/Nicolas-de-Preville"
"353","Youssouf Sabaly_2019",2019,"Bordeaux","Ligue 1","Youssouf Sabaly","SEN","DF","25",1993,21.2,46,32,32,12,2,25,46,54.3,21,19,2,17,26,72,42,0,"https://fbref.com/en/players/fbbb9269/Youssouf-Sabaly"
"354","Younousse Sankharé_2019",2019,"Bordeaux","Ligue 1","Younousse Sankharé","SEN","MF","28",1989,16.4,25,12,2,19,4,6,19,31.6,13,14,0,14,9,34,4,0,"https://fbref.com/en/players/c650629d/Younousse-Sankhare"
"355","Aurélien Tchouaméni_2019",2019,"Bordeaux","Ligue 1","Aurélien Tchouaméni","FRA","MF","18",2000,7.8,24,12,10,14,0,7,18,38.9,11,11,5,6,21,45,14,0,"https://fbref.com/en/players/4f255115/Aurelien-Tchouameni"
"356","Driss Trichard_2019",2019,"Bordeaux","Ligue 1","Driss Trichard","FRA","DF","23",1995,1,2,2,2,0,0,1,1,100,0,1,0,1,1,3,4,0,"https://fbref.com/en/players/6fea4e00/Driss-Trichard"
"357","Valentín Vada_2019",2019,"Bordeaux","Ligue 1","Valentín Vada","ARG","MF","22",1996,0.4,2,1,0,2,0,1,1,100,0,0,0,0,0,2,0,0,"https://fbref.com/en/players/dcf7cf44/Valentin-Vada"
"358","Zaydou Youssouf_2019",2019,"Bordeaux","Ligue 1","Zaydou Youssouf","FRA","MF,FW","19",1999,4.7,7,5,3,4,0,3,7,42.9,4,5,1,4,5,12,0,0,"https://fbref.com/en/players/e2f9bb5f/Zaydou-Youssouf"
"359","Nathan Aké_2019",2019,"Bournemouth","Premier League","Nathan Aké","NED","DF","23",1995,37.9,66,35,42,21,3,22,35,62.9,13,51,35,16,32,98,241,0,"https://fbref.com/en/players/eaeca114/Nathan-Ake"
"360","Asmir Begović_2019",2019,"Bournemouth","Premier League","Asmir Begović","BIH","GK","31",1987,24,0,0,0,0,0,0,3,0,3,1,0,1,1,1,15,7,"https://fbref.com/en/players/7b4de647/Asmir-Begovic"
"361","Artur Boruc_2019",2019,"Bournemouth","Premier League","Artur Boruc","POL","GK","38",1980,12,1,0,1,0,0,1,3,33.3,2,0,0,0,0,1,1,0,"https://fbref.com/en/players/34ccf6fa/Artur-Boruc"
"362","David Brooks_2019",2019,"Bournemouth","Premier League","David Brooks","WAL","MF,FW","21",1997,25.1,37,26,12,19,6,19,44,43.2,25,36,7,29,24,61,28,0,"https://fbref.com/en/players/dc4cae05/David-Brooks"
"363","Nathaniel Clyne_2019",2019,"Bournemouth","Premier League","Nathaniel Clyne","ENG","DF","27",1991,12.7,33,18,16,14,3,11,23,47.8,12,13,3,10,16,49,33,1,"https://fbref.com/en/players/0442183b/Nathaniel-Clyne"
"364","Lewis Cook_2019",2019,"Bournemouth","Premier League","Lewis Cook","ENG","MF","21",1997,8,13,6,6,7,0,8,19,42.1,11,8,2,6,8,21,7,1,"https://fbref.com/en/players/2afc7272/Lewis-Cook"
"365","Steve Cook_2019",2019,"Bournemouth","Premier League","Steve Cook","ENG","DF","27",1991,31,36,19,31,5,0,20,27,74.1,7,36,21,15,50,86,202,1,"https://fbref.com/en/players/3e5e4e63/Steve-Cook"
"366","Charlie Daniels_2019",2019,"Bournemouth","Premier League","Charlie Daniels","ENG","DF","31",1986,17.6,25,15,18,6,1,13,22,59.1,9,14,4,10,20,45,56,2,"https://fbref.com/en/players/9d107085/Charlie-Daniels"
"367","Jermain Defoe_2019",2019,"Bournemouth","Premier League","Jermain Defoe","ENG","FW","35",1982,0.3,0,0,0,0,0,0,0,NA,0,0,0,0,0,0,0,0,"https://fbref.com/en/players/f1e8372d/Jermain-Defoe"
"368","Simon Francis_2019",2019,"Bournemouth","Premier League","Simon Francis","ENG","DF","33",1985,13.7,25,14,19,5,1,12,24,50,12,15,7,8,19,44,73,1,"https://fbref.com/en/players/1e0b6a73/Simon-Francis"
"369","Ryan Fraser_2019",2019,"Bournemouth","Premier League","Ryan Fraser","SCO","MF,FW","24",1994,35.2,19,11,9,8,2,10,32,31.3,22,23,6,17,22,41,33,0,"https://fbref.com/en/players/d56543a0/Ryan-Fraser"
"370","Dan Gosling_2019",2019,"Bournemouth","Premier League","Dan Gosling","ENG","MF","28",1990,19.3,57,23,27,21,9,28,53,52.8,25,33,11,22,20,77,46,1,"https://fbref.com/en/players/7fec31a0/Dan-Gosling"
"371","Emerson Hyndman_2019",2019,"Bournemouth","Premier League","Emerson Hyndman","USA","MF","22",1996,0.4,6,2,6,0,0,2,3,66.7,1,0,0,0,1,7,0,0,"https://fbref.com/en/players/3be1a627/Emerson-Hyndman"
"372","Jordon Ibe_2019",2019,"Bournemouth","Premier League","Jordon Ibe","ENG","MF,DF","22",1995,8.9,6,5,0,5,1,2,7,28.6,5,2,0,2,4,10,4,0,"https://fbref.com/en/players/9f736ed2/Jordon-Ibe"
"373","Joshua King_2019",2019,"Bournemouth","Premier League","Joshua King","NOR","FW,MF","26",1992,32.9,30,19,7,19,4,8,29,27.6,21,28,4,24,7,37,14,0,"https://fbref.com/en/players/43458538/Joshua-King"
"374","Jefferson Lerma_2019",2019,"Bournemouth","Premier League","Jefferson Lerma","COL","MF","23",1994,27.8,45,31,20,20,5,14,54,25.9,40,35,19,16,54,99,88,1,"https://fbref.com/en/players/9b5ce51a/Jefferson-Lerma"
"375","Chris Mepham_2019",2019,"Bournemouth","Premier League","Chris Mepham","WAL","DF","20",1997,9.4,9,3,9,0,0,7,11,63.6,4,12,5,7,14,23,57,2,"https://fbref.com/en/players/fed96827/Chris-Mepham"
"376","Tyrone Mings_2019",2019,"Bournemouth","Premier League","Tyrone Mings","ENG","DF","25",1993,1.6,4,3,3,1,0,2,3,66.7,1,5,2,3,6,10,8,0,"https://fbref.com/en/players/8397a50c/Tyrone-Mings"
"377","Lys Mousset_2019",2019,"Bournemouth","Premier League","Lys Mousset","FRA","FW","22",1996,4.1,3,1,1,1,1,1,4,25,3,3,0,3,1,4,3,0,"https://fbref.com/en/players/d9cfca3d/Lys-Mousset"
"378","Diego Rico_2019",2019,"Bournemouth","Premier League","Diego Rico","ESP","DF,MF","25",1993,6.8,14,9,8,2,4,4,12,33.3,8,13,2,11,14,28,20,0,"https://fbref.com/en/players/d9ba39fc/Diego-Rico"
"379","Jack Simpson_2019",2019,"Bournemouth","Premier League","Jack Simpson","ENG","DF","21",1996,4.5,9,5,8,1,0,6,9,66.7,3,5,4,1,9,18,25,2,"https://fbref.com/en/players/76fa5f80/Jack-Simpson"
"380","Adam Smith_2019",2019,"Bournemouth","Premier League","Adam Smith","ENG","DF,MF","27",1991,23,46,32,26,14,6,19,41,46.3,22,26,7,19,31,77,68,1,"https://fbref.com/en/players/20b104bc/Adam-Smith"
"381","Dominic Solanke_2019",2019,"Bournemouth","Premier League","Dominic Solanke","ENG","FW,MF","20",1997,3.9,8,3,1,4,3,1,8,12.5,7,4,1,3,2,10,9,0,"https://fbref.com/en/players/e77dc3b2/Dominic-Solanke"
"382","Junior Stanislas_2019",2019,"Bournemouth","Premier League","Junior Stanislas","ENG","MF,FW","28",1989,11.5,12,6,5,4,3,3,7,42.9,4,8,1,7,2,14,15,0,"https://fbref.com/en/players/6992791d/Junior-Stanislas"
"383","Andrew Surman_2019",2019,"Bournemouth","Premier League","Andrew Surman","ENG","MF","31",1986,16,11,6,6,5,0,3,13,23.1,10,20,7,13,10,21,34,1,"https://fbref.com/en/players/7d41b619/Andrew-Surman"
"384","Sam Surridge_2019",2019,"Bournemouth","Premier League","Sam Surridge","ENG","MF,FW","20",1998,0.1,1,0,0,0,1,0,0,NA,0,0,0,0,0,1,0,0,"https://fbref.com/en/players/b017b770/Sam-Surridge"
"385","Mark Travers_2019",2019,"Bournemouth","Premier League","Mark Travers","IRL","GK","19",1999,2,0,0,0,0,0,0,0,NA,0,0,0,0,0,0,2,0,"https://fbref.com/en/players/fe558029/Mark-Travers"
"386","Callum Wilson_2019",2019,"Bournemouth","Premier League","Callum Wilson","ENG","FW","26",1992,28.1,9,7,4,3,2,0,8,0,8,14,4,10,4,13,16,0,"https://fbref.com/en/players/c596fcb0/Callum-Wilson"
"387","Florin Andone_2019",2019,"Brighton","Premier League","Florin Andone","ROU","FW","25",1993,9.8,10,2,3,4,3,1,6,16.7,5,9,1,8,3,13,12,0,"https://fbref.com/en/players/dc008610/Florin-Andone"
"388","Leon Balogun_2019",2019,"Brighton","Premier League","Leon Balogun","NGA","DF","30",1988,6.6,12,6,11,1,0,8,9,88.9,1,5,3,2,17,29,32,1,"https://fbref.com/en/players/78e68b4d/Leon-Balogun"
"389","Bernardo_2019",2019,"Brighton","Premier League","Bernardo","BRA","DF","23",1995,19.5,62,43,43,13,6,31,45,68.9,14,32,13,19,34,96,82,0,"https://fbref.com/en/players/17370b95/Bernardo"
"390","Yves Bissouma_2019",2019,"Brighton","Premier League","Yves Bissouma","MLI","MF","21",1996,19.7,62,30,33,27,2,20,38,52.6,18,21,5,16,33,95,29,2,"https://fbref.com/en/players/6c203af0/Yves-Bissouma"
"391","Gaëtan Bong_2019",2019,"Brighton","Premier League","Gaëtan Bong","CMR","DF","30",1988,20.1,16,10,7,6,3,6,10,60,4,16,6,10,25,41,57,2,"https://fbref.com/en/players/cfd5e123/Gaetan-Bong"
"392","Bruno_2019",2019,"Brighton","Premier League","Bruno","ESP","DF","37",1980,12.6,25,16,20,3,2,14,18,77.8,4,7,2,5,11,36,30,1,"https://fbref.com/en/players/78803d03/Bruno"
"393","David Button_2019",2019,"Brighton","Premier League","David Button","ENG","GK","29",1989,4,0,0,0,0,0,0,0,NA,0,0,0,0,0,0,2,0,"https://fbref.com/en/players/e608ed4c/David-Button"
"394","Shane Duffy_2019",2019,"Brighton","Premier League","Shane Duffy","IRL","DF","26",1992,34.3,35,20,23,7,5,14,25,56,11,57,47,10,36,71,244,3,"https://fbref.com/en/players/7314bba4/Shane-Duffy"
"395","Lewis Dunk_2019",2019,"Brighton","Premier League","Lewis Dunk","ENG","DF","26",1991,35,42,26,31,10,1,17,39,43.6,22,49,38,11,46,88,196,5,"https://fbref.com/en/players/282f75f3/Lewis-Dunk"
"396","Pascal Groß_2019",2019,"Brighton","Premier League","Pascal Groß","GER","MF,FW","27",1991,20.7,27,12,12,12,3,11,36,30.6,25,20,8,12,13,40,23,0,"https://fbref.com/en/players/8aec0537/Pascal-Gross"
"397","José Izquierdo_2019",2019,"Brighton","Premier League","José Izquierdo","COL","MF,FW","26",1992,8.8,15,9,9,4,2,10,20,50,10,7,1,6,5,20,7,0,"https://fbref.com/en/players/ca2bc3df/Jose-Izquierdo"
"398","Alireza Jahanbakhsh_2019",2019,"Brighton","Premier League","Alireza Jahanbakhsh","IRN","FW,MF","24",1993,11.3,32,18,17,11,4,11,30,36.7,19,16,0,16,11,43,4,0,"https://fbref.com/en/players/08452314/Alireza-Jahanbakhsh"
"399","Beram Kayal_2019",2019,"Brighton","Premier League","Beram Kayal","ISR","MF","30",1988,10.4,28,17,16,11,1,5,21,23.8,16,17,10,7,15,43,25,0,"https://fbref.com/en/players/26679cdf/Beram-Kayal"
"400","Anthony Knockaert_2019",2019,"Brighton","Premier League","Anthony Knockaert","FRA","MF,FW","26",1991,20.4,33,21,12,15,6,13,30,43.3,17,13,0,13,29,62,11,0,"https://fbref.com/en/players/6c679c6d/Anthony-Knockaert"
"401","Jürgen Locadia_2019",2019,"Brighton","Premier League","Jürgen Locadia","NED","FW,MF","24",1993,13.7,15,10,5,8,2,3,7,42.9,4,8,0,8,9,24,13,0,"https://fbref.com/en/players/6cc47ae1/Jurgen-Locadia"
"402","Solly March_2019",2019,"Brighton","Premier League","Solly March","ENG","FW,MF","24",1994,27.4,56,24,27,16,13,19,45,42.2,26,34,4,30,27,83,44,0,"https://fbref.com/en/players/bb5fbd2b/Solly-March"
"403","Martín Montoya_2019",2019,"Brighton","Premier League","Martín Montoya","ESP","DF","27",1991,24.1,58,35,29,21,8,32,55,58.2,23,30,10,20,48,106,76,1,"https://fbref.com/en/players/5cec2487/Martin-Montoya"
"404","Glenn Murray_2019",2019,"Brighton","Premier League","Glenn Murray","ENG","FW","34",1983,27.9,17,7,4,7,6,4,20,20,16,20,3,17,2,19,17,1,"https://fbref.com/en/players/f2f29dda/Glenn-Murray"
"405","Davy Pröpper_2019",2019,"Brighton","Premier League","Davy Pröpper","NED","MF","26",1991,28.3,50,28,23,21,6,16,52,30.8,36,21,6,15,53,103,37,0,"https://fbref.com/en/players/fdd85f94/Davy-Propper"
"406","Mathew Ryan_2019",2019,"Brighton","Premier League","Mathew Ryan","AUS","GK","26",1992,34,1,0,1,0,0,1,2,50,1,0,0,0,0,1,13,1,"https://fbref.com/en/players/4535e4bb/Mathew-Ryan"
"407","Dale Stephens_2019",2019,"Brighton","Premier League","Dale Stephens","ENG","MF","29",1989,27.6,83,57,37,41,5,28,74,37.8,46,33,13,20,46,129,47,0,"https://fbref.com/en/players/653ee42d/Dale-Stephens"
"408","Phil Bardsley_2019",2019,"Burnley","Premier League","Phil Bardsley","SCO","DF","33",1985,18.6,32,19,15,14,3,12,21,57.1,9,25,12,13,31,63,68,1,"https://fbref.com/en/players/1ae30132/Phil-Bardsley"
"409","Ashley Barnes_2019",2019,"Burnley","Premier League","Ashley Barnes","ENG","FW","28",1989,26.5,28,17,4,17,7,6,29,20.7,23,29,8,21,2,30,25,0,"https://fbref.com/en/players/2691c772/Ashley-Barnes"
"410","Jóhann Berg Guðmundsson_2019",2019,"Burnley","Premier League","Jóhann Berg Guðmundsson","ISL","MF","27",1990,19.5,27,11,14,10,3,16,34,47.1,18,25,4,21,33,60,34,0,"https://fbref.com/en/players/f72293fc/Johann-Berg-Gudmundsson"
"411","Robbie Brady_2019",2019,"Burnley","Premier League","Robbie Brady","IRL","MF","26",1992,8,15,7,5,5,5,6,17,35.3,11,7,1,6,7,22,18,1,"https://fbref.com/en/players/96bb8cc2/Robbie-Brady"
"412","Jack Cork_2019",2019,"Burnley","Premier League","Jack Cork","ENG","MF","29",1989,36.8,51,27,12,34,5,18,46,39.1,28,39,16,23,29,80,82,2,"https://fbref.com/en/players/74e12f1e/Jack-Cork"
"413","Peter Crouch_2019",2019,"Burnley","Premier League","Peter Crouch","ENG","FW","37",1981,1,1,1,0,1,0,1,1,100,0,0,0,0,0,1,2,0,"https://fbref.com/en/players/73d9bdc7/Peter-Crouch"
"414","Steven Defour_2019",2019,"Burnley","Premier League","Steven Defour","BEL","MF","30",1988,5,8,4,2,4,2,3,14,21.4,11,11,3,8,8,16,7,0,"https://fbref.com/en/players/73489527/Steven-Defour"
"415","Ben Gibson_2019",2019,"Burnley","Premier League","Ben Gibson","ENG","DF","25",1993,0.7,1,1,1,0,0,0,0,NA,0,1,1,0,0,1,2,0,"https://fbref.com/en/players/bcfb0142/Ben-Gibson"
"416","Joe Hart_2019",2019,"Burnley","Premier League","Joe Hart","ENG","GK","31",1987,19,0,0,0,0,0,0,1,0,1,0,0,0,0,0,11,3,"https://fbref.com/en/players/cb4f24c6/Joe-Hart"
"417","Tom Heaton_2019",2019,"Burnley","Premier League","Tom Heaton","ENG","GK","32",1986,19,0,0,0,0,0,0,2,0,2,0,0,0,0,0,8,2,"https://fbref.com/en/players/a6de6361/Tom-Heaton"
"418","Jeff Hendrick_2019",2019,"Burnley","Premier League","Jeff Hendrick","IRL","MF,FW","26",1992,22.9,24,12,13,7,4,9,32,28.1,23,20,5,15,12,36,31,0,"https://fbref.com/en/players/989d5705/Jeff-Hendrick"
"419","Aaron Lennon_2019",2019,"Burnley","Premier League","Aaron Lennon","ENG","MF","31",1987,13.5,26,16,11,12,3,6,14,42.9,8,24,0,24,10,36,18,0,"https://fbref.com/en/players/2ff964a0/Aaron-Lennon"
"420","Kevin Long_2019",2019,"Burnley","Premier League","Kevin Long","IRL","DF","27",1990,5.7,18,10,13,5,0,7,17,41.2,10,7,5,2,7,25,35,1,"https://fbref.com/en/players/5a4280b1/Kevin-Long"
"421","Matthew Lowton_2019",2019,"Burnley","Premier League","Matthew Lowton","ENG","DF","29",1989,19.4,56,35,21,31,4,32,60,53.3,28,29,7,22,30,86,80,1,"https://fbref.com/en/players/9a9c05db/Matthew-Lowton"
"422","Dwight McNeil_2019",2019,"Burnley","Premier League","Dwight McNeil","ENG","MF","18",1999,17.7,36,22,16,17,3,13,44,29.5,31,30,3,27,13,49,35,0,"https://fbref.com/en/players/fc15fb84/Dwight-McNeil"
"423","Ben Mee_2019",2019,"Burnley","Premier League","Ben Mee","ENG","DF","28",1989,38,55,24,38,17,0,35,44,79.5,9,59,50,9,48,103,235,4,"https://fbref.com/en/players/8df7a2fb/Ben-Mee"
"424","James Tarkowski_2019",2019,"Burnley","Premier League","James Tarkowski","ENG","DF","25",1992,34.3,71,36,52,18,1,29,50,58,21,72,56,16,42,113,240,2,"https://fbref.com/en/players/15ea812b/James-Tarkowski"
"425","Charlie Taylor_2019",2019,"Burnley","Premier League","Charlie Taylor","ENG","DF","24",1993,36,55,26,37,15,3,24,50,48,26,74,35,39,40,95,120,0,"https://fbref.com/en/players/cc2d7ad5/Charlie-Taylor"
"426","Sam Vokes_2019",2019,"Burnley","Premier League","Sam Vokes","WAL","FW","28",1989,10.2,4,2,1,2,1,0,0,NA,0,2,1,1,0,4,17,0,"https://fbref.com/en/players/1d6ac165/Sam-Vokes"
"427","Matěj Vydra_2019",2019,"Burnley","Premier League","Matěj Vydra","CZE","FW","26",1992,3.5,2,1,0,1,1,0,3,0,3,4,1,3,1,3,6,0,"https://fbref.com/en/players/0d4ceb32/Matej-Vydra"
"428","Stephen Ward_2019",2019,"Burnley","Premier League","Stephen Ward","IRL","DF","32",1985,2.5,4,2,1,2,1,1,4,25,3,3,1,2,4,8,14,0,"https://fbref.com/en/players/3831b9fe/Stephen-Ward"
"429","Ashley Westwood_2019",2019,"Burnley","Premier League","Ashley Westwood","ENG","MF","28",1990,31.4,58,30,24,27,7,14,39,35.9,25,38,9,29,47,105,42,2,"https://fbref.com/en/players/495945ef/Ashley-Westwood"
"430","Chris Wood_2019",2019,"Burnley","Premier League","Chris Wood","NZL","FW","26",1991,28.8,12,8,0,7,5,5,17,29.4,12,17,4,13,3,15,26,0,"https://fbref.com/en/players/4e9a0555/Chris-Wood"
"431","Yoël Armougom_2019",2019,"Caen","Ligue 1","Yoël Armougom","FRA","DF","20",1998,20.6,31,21,20,9,2,15,29,51.7,14,9,3,6,21,52,66,0,"https://fbref.com/en/players/9dd5da03/Yoel-Armougom"
"432","Yacine Bammou_2019",2019,"Caen","Ligue 1","Yacine Bammou","MAR","FW,MF","26",1991,10.3,14,7,7,4,3,3,8,37.5,5,14,3,11,9,23,17,0,"https://fbref.com/en/players/a1d04509/Yacine-Bammou"
"433","Paul Baysse_2019",2019,"Caen","Ligue 1","Paul Baysse","FRA","DF","30",1988,19.9,25,14,20,5,0,13,18,72.2,5,25,20,5,31,56,113,1,"https://fbref.com/en/players/2515040a/Paul-Baysse"
"434","Claudio Beauvue_2019",2019,"Caen","Ligue 1","Claudio Beauvue","GLP","FW,MF","30",1988,16.7,18,11,7,9,2,1,14,7.1,13,11,2,9,10,28,21,0,"https://fbref.com/en/players/8ca253a3/Claudio-Beauvue"
"435","Enzo Crivelli_2019",2019,"Caen","Ligue 1","Enzo Crivelli","FRA","FW","23",1995,25.1,20,14,10,8,2,8,13,61.5,5,5,0,5,4,24,28,1,"https://fbref.com/en/players/06f33dc8/Enzo-Crivelli"
"436","Jessy Deminguet_2019",2019,"Caen","Ligue 1","Jessy Deminguet","FRA","MF","20",1998,14.1,37,25,18,17,2,15,40,37.5,25,19,3,16,18,55,28,1,"https://fbref.com/en/players/a6138e4a/Jessy-Deminguet"
"437","Ismaël Diomandé_2019",2019,"Caen","Ligue 1","Ismaël Diomandé","CIV","MF,DF","25",1992,14.4,28,15,15,12,1,11,20,55,9,17,7,10,10,38,37,0,"https://fbref.com/en/players/10650926/Ismael-Diomande"
"438","Alexander Djiku_2019",2019,"Caen","Ligue 1","Alexander Djiku","GHA","DF","23",1994,30.6,48,37,33,13,2,23,43,53.5,20,56,31,25,83,131,183,3,"https://fbref.com/en/players/43e7a164/Alexander-Djiku"
"439","Fayçal Fajr_2019",2019,"Caen","Ligue 1","Fayçal Fajr","MAR","MF","29",1988,36,65,32,22,33,10,25,66,37.9,41,27,6,21,29,94,19,2,"https://fbref.com/en/players/79135368/Faycal-Fajr"
"440","Romain Genevois_2019",2019,"Caen","Ligue 1","Romain Genevois","HAI","DF","30",1987,4,10,6,9,1,0,6,11,54.5,5,3,0,3,8,18,13,0,"https://fbref.com/en/players/1040e783/Romain-Genevois"
"441","Jonathan Gradit_2019",2019,"Caen","Ligue 1","Jonathan Gradit","FRA","DF","25",1992,22.3,52,28,30,21,1,28,52,53.8,24,40,15,25,45,97,82,3,"https://fbref.com/en/players/06c48679/Jonathan-Gradit"
"442","Frederic Guilbert_2019",2019,"Caen","Ligue 1","Frederic Guilbert","FRA","DF","23",1994,32.4,98,67,59,29,10,41,83,49.4,42,49,21,28,78,176,121,2,"https://fbref.com/en/players/5d8d7454/Frederic-Guilbert"
"443","Emmanuel Imorou_2019",2019,"Caen","Ligue 1","Emmanuel Imorou","BEN","DF","29",1988,12.4,18,13,10,7,1,11,17,64.7,6,14,4,10,28,46,49,1,"https://fbref.com/en/players/3e87d087/Emmanuel-Imorou"
"444","Evens Joseph_2019",2019,"Caen","Ligue 1","Evens Joseph","FRA","MF,FW","19",1999,3.8,5,2,1,2,2,1,3,33.3,2,3,0,3,2,7,1,0,"https://fbref.com/en/players/acde3581/Evens-Joseph"
"445","Saîf-Eddine Khaoui_2019",2019,"Caen","Ligue 1","Saîf-Eddine Khaoui","TUN","MF,FW","23",1995,15,20,14,5,11,4,8,27,29.6,19,9,1,8,20,40,4,0,"https://fbref.com/en/players/796b1c41/Saif-Eddine-Khaoui"
"446","Adama Mbengue_2019",2019,"Caen","Ligue 1","Adama Mbengue","SEN","DF","24",1993,8.2,48,32,34,12,2,19,26,73.1,7,15,4,11,7,55,22,0,"https://fbref.com/en/players/b931d9d1/Adama-Mbengue"
"447","Herman Moussaki_2019",2019,"Caen","Ligue 1","Herman Moussaki","FRA","MF,FW","19",1999,2.3,3,3,2,1,0,1,4,25,3,2,1,1,0,3,3,0,"https://fbref.com/en/players/63a10528/Herman-Moussaki"
"448","Aly Ndom_2019",2019,"Caen","Ligue 1","Aly Ndom","FRA","MF","22",1996,0.5,0,0,0,0,0,0,0,NA,0,0,0,0,1,1,1,0,"https://fbref.com/en/players/df819670/Aly-Ndom"
"449","Casimir Ninga_2019",2019,"Caen","Ligue 1","Casimir Ninga","CHA","FW,MF","25",1993,27.4,53,30,23,21,9,20,49,40.8,29,22,1,21,22,75,12,0,"https://fbref.com/en/players/91f2da4c/Casimir-Ninga"
"450","Prince Oniangué_2019",2019,"Caen","Ligue 1","Prince Oniangué","CGO","MF","29",1988,26,59,33,22,34,3,24,57,42.1,33,30,10,20,29,88,42,0,"https://fbref.com/en/players/9e27e5de/Prince-Oniangue"
"451","Stef Peeters_2019",2019,"Caen","Ligue 1","Stef Peeters","BEL","MF","26",1992,4.5,15,8,8,4,3,4,11,36.4,7,1,0,1,6,21,1,0,"https://fbref.com/en/players/2f8f43f3/Stef-Peeters"
"452","Brice Samba_2019",2019,"Caen","Ligue 1","Brice Samba","FRA","GK","24",1994,38,1,0,1,0,0,0,1,0,1,0,0,0,1,2,12,4,"https://fbref.com/en/players/60d90c55/Brice-Samba"
"453","Baissama Sankoh_2019",2019,"Caen","Ligue 1","Baissama Sankoh","GUI","MF,FW","26",1992,7.2,4,1,4,0,0,1,4,25,3,8,1,7,5,9,16,0,"https://fbref.com/en/players/a8b4a643/Baissama-Sankoh"
"454","Timo Stavitski_2019",2019,"Caen","Ligue 1","Timo Stavitski","FIN","MF,FW","19",1999,0.2,0,0,0,0,0,0,1,0,1,0,0,0,0,0,0,0,"https://fbref.com/en/players/6fb7edd3/Timo-Stavitski"
"455","Malik Tchokounté_2019",2019,"Caen","Ligue 1","Malik Tchokounté","FRA","FW,MF","29",1988,16.4,21,13,6,12,3,5,10,50,5,11,0,11,6,27,26,0,"https://fbref.com/en/players/ed0c3318/Malik-Tchokounte"
"456","Younn Zahary_2019",2019,"Caen","Ligue 1","Younn Zahary","COM","DF","19",1998,8.2,16,9,7,6,3,8,14,57.1,6,13,8,5,16,32,35,0,"https://fbref.com/en/players/28129034/Younn-Zahary"
"457","Marco Andreolli_2019",2019,"Cagliari","Serie A","Marco Andreolli","ITA","DF","32",1986,1.2,1,1,1,0,0,1,1,100,0,2,1,1,1,2,5,0,"https://fbref.com/en/players/13d820de/Marco-Andreolli"
"458","Nicolò Barella_2019",2019,"Cagliari","Serie A","Nicolò Barella","ITA","MF","21",1997,34.5,99,65,38,41,20,30,82,36.6,52,61,2,59,38,137,27,0,"https://fbref.com/en/players/6928979a/Nicolo-Barella"
"459","Valter Birsa_2019",2019,"Cagliari","Serie A","Valter Birsa","SVN","MF,FW","31",1986,3.9,5,3,1,3,1,4,8,50,4,5,0,5,4,9,3,0,"https://fbref.com/en/players/455a2b79/Valter-Birsa"
"460","Filip Bradarić_2019",2019,"Cagliari","Serie A","Filip Bradarić","CRO","MF","26",1992,16.6,26,21,11,12,3,10,20,50,10,13,3,10,39,65,50,0,"https://fbref.com/en/players/605873e1/Filip-Bradaric"
"461","Fabrizio Cacciatore_2019",2019,"Cagliari","Serie A","Fabrizio Cacciatore","ITA","DF","31",1986,6.4,9,7,7,0,2,1,5,20,4,6,4,2,7,16,17,0,"https://fbref.com/en/players/00b0bb87/Fabrizio-Cacciatore"
"462","Lucas Castro_2019",2019,"Cagliari","Serie A","Lucas Castro","ARG","MF","29",1989,10,18,11,8,8,2,8,23,34.8,15,20,4,16,17,35,6,0,"https://fbref.com/en/players/56b2957b/Lucas-Castro"
"463","Luca Ceppitelli_2019",2019,"Cagliari","Serie A","Luca Ceppitelli","ITA","DF","28",1989,22.8,40,24,28,11,1,13,22,59.1,9,34,24,10,20,60,111,2,"https://fbref.com/en/players/7d50454d/Luca-Ceppitelli"
"464","Alberto Cerri_2019",2019,"Cagliari","Serie A","Alberto Cerri","ITA","FW","22",1996,7.4,3,2,2,1,0,0,7,0,7,7,1,6,2,5,4,0,"https://fbref.com/en/players/1079c685/Alberto-Cerri"
"465","Luca Cigarini_2019",2019,"Cagliari","Serie A","Luca Cigarini","ITA","MF","32",1986,18.7,54,33,27,22,5,28,63,44.4,35,28,5,23,26,80,41,0,"https://fbref.com/en/players/ae64d449/Luca-Cigarini"
"466","Alessio Cragno_2019",2019,"Cagliari","Serie A","Alessio Cragno","ITA","GK","24",1994,38,0,0,0,0,0,0,1,0,1,0,0,0,2,2,19,1,"https://fbref.com/en/players/f554e29b/Alessio-Cragno"
"467","Alessandro Deiola_2019",2019,"Cagliari","Serie A","Alessandro Deiola","ITA","MF","22",1995,5,7,3,1,6,0,3,13,23.1,10,14,0,14,6,13,8,0,"https://fbref.com/en/players/7f267d66/Alessandro-Deiola"
"468","Kiril Despodov_2019",2019,"Cagliari","Serie A","Kiril Despodov","BUL","FW,MF","21",1996,1.2,0,0,0,0,0,0,1,0,1,1,0,1,0,0,0,0,"https://fbref.com/en/players/13c8e5f6/Kiril-Despodov"
"469","Daniele Dessena_2019",2019,"Cagliari","Serie A","Daniele Dessena","ITA","MF","31",1987,3.9,2,2,0,2,0,1,3,33.3,2,3,1,2,3,5,5,0,"https://fbref.com/en/players/02b2937c/Daniele-Dessena"
"470","Riccardo Doratiotto_2019",2019,"Cagliari","Serie A","Riccardo Doratiotto","ITA","FW","19",1999,0.9,1,1,0,0,1,0,0,NA,0,0,0,0,0,1,0,0,"https://fbref.com/en/players/c1bcb2df/Riccardo-Doratiotto"
"471","Paolo Faragò_2019",2019,"Cagliari","Serie A","Paolo Faragò","ITA","MF,DF","25",1993,18.9,46,29,20,16,10,13,43,30.2,30,28,2,26,15,61,38,0,"https://fbref.com/en/players/9085dd7c/Paolo-Farago"
"472","Diego Farias_2019",2019,"Cagliari","Serie A","Diego Farias","BRA","FW","28",1990,7.8,13,9,3,7,3,2,11,18.2,9,7,1,6,1,14,5,0,"https://fbref.com/en/players/157d29b6/Diego-Farias"
"473","Artur Ioniță_2019",2019,"Cagliari","Serie A","Artur Ioniță","MDA","MF","27",1990,33,67,38,23,31,13,16,57,28.1,41,40,5,35,27,94,30,0,"https://fbref.com/en/players/cedb3e36/Artur-Ionita"
"474","Ragnar Klavan_2019",2019,"Cagliari","Serie A","Ragnar Klavan","EST","DF","32",1985,13.7,9,8,5,3,1,5,11,45.5,6,19,13,6,10,19,68,1,"https://fbref.com/en/players/008a6e6d/Ragnar-Klavan"
"475","Charalambos Lykogiannis_2019",2019,"Cagliari","Serie A","Charalambos Lykogiannis","GRE","DF","24",1993,9.2,14,8,8,3,3,6,11,54.5,5,18,3,15,19,33,33,0,"https://fbref.com/en/players/5efc5389/Charalambos-Lykogiannis"
"476","Simone Padoin_2019",2019,"Cagliari","Serie A","Simone Padoin","ITA","DF,MF","34",1984,21.3,34,25,12,18,4,14,33,42.4,19,18,5,13,14,48,54,0,"https://fbref.com/en/players/5eb72339/Simone-Padoin"
"477","Marko Pajač_2019",2019,"Cagliari","Serie A","Marko Pajač","CRO","DF","25",1993,1.1,1,1,0,0,1,0,0,NA,0,1,1,0,1,2,3,0,"https://fbref.com/en/players/5df4ef30/Marko-Pajac"
"478","Leonardo Pavoletti_2019",2019,"Cagliari","Serie A","Leonardo Pavoletti","ITA","FW","29",1988,30.4,32,21,6,17,9,6,16,37.5,10,12,3,9,7,39,26,0,"https://fbref.com/en/players/d37b0350/Leonardo-Pavoletti"
"479","João Pedro_2019",2019,"Cagliari","Serie A","João Pedro","ITA","FW,MF","26",1992,28.4,17,12,4,8,5,4,11,36.4,7,14,5,9,6,23,14,0,"https://fbref.com/en/players/81255c03/Joao-Pedro"
"480","Luca Pellegrini_2019",2019,"Cagliari","Serie A","Luca Pellegrini","ITA","DF","19",1999,10.4,28,19,16,11,1,14,25,56,11,13,3,10,18,46,22,0,"https://fbref.com/en/players/3b61c9ec/Luca-Pellegrini"
"481","Fabio Pisacane_2019",2019,"Cagliari","Serie A","Fabio Pisacane","ITA","DF","32",1986,25.2,33,17,22,8,3,18,31,58.1,13,36,23,13,23,56,108,0,"https://fbref.com/en/players/56400c01/Fabio-Pisacane"
"482","Filippo Romagna_2019",2019,"Cagliari","Serie A","Filippo Romagna","ITA","DF","21",1997,16.4,14,9,10,4,0,4,8,50,4,20,12,8,19,33,68,0,"https://fbref.com/en/players/84594618/Filippo-Romagna"
"483","Marco Sau_2019",2019,"Cagliari","Serie A","Marco Sau","ITA","FW,MF","30",1987,6.2,4,2,0,2,2,0,3,0,3,5,0,5,1,5,4,0,"https://fbref.com/en/players/1ad1f50d/Marco-Sau"
"484","Darijo Srna_2019",2019,"Cagliari","Serie A","Darijo Srna","CRO","DF","36",1982,23.2,24,16,6,13,5,9,14,64.3,5,24,5,19,18,42,66,0,"https://fbref.com/en/players/edd6c8e9/Darijo-Srna"
"485","Cyril Théréau_2019",2019,"Cagliari","Serie A","Cyril Théréau","FRA","FW","35",1983,1.5,1,1,0,1,0,1,1,100,0,0,0,0,0,1,2,0,"https://fbref.com/en/players/4d3ab428/Cyril-Thereau"
"486","Francesco Verde_2019",2019,"Cagliari","Serie A","Francesco Verde","ITA","FW","19",1999,0.1,1,0,0,1,0,0,0,NA,0,0,0,0,0,1,0,0,"https://fbref.com/en/players/0497a545/Francesco-Verde"
"487","Harry Arter_2019",2019,"Cardiff City","Premier League","Harry Arter","IRL","MF","28",1989,22.2,62,37,27,26,9,16,46,34.8,30,33,5,28,21,83,21,2,"https://fbref.com/en/players/2f4c5a52/Harry-Arter"
"488","Leandro Bacuna_2019",2019,"Cardiff City","Premier League","Leandro Bacuna","CUW","MF","26",1991,6.2,15,10,5,7,3,8,22,36.4,14,5,2,3,15,30,9,0,"https://fbref.com/en/players/9dc69d38/Leandro-Bacuna"
"489","Sol Bamba_2019",2019,"Cardiff City","Premier League","Sol Bamba","CIV","DF","33",1985,27.5,74,42,44,30,0,31,55,56.4,24,72,32,40,82,156,181,3,"https://fbref.com/en/players/5534217d/Sol-Bamba"
"490","Joe Bennett_2019",2019,"Cardiff City","Premier League","Joe Bennett","ENG","DF","28",1990,29.3,50,29,34,16,0,22,38,57.9,16,30,8,22,60,110,93,0,"https://fbref.com/en/players/dc936144/Joe-Bennett"
"491","Víctor Camarasa_2019",2019,"Cardiff City","Premier League","Víctor Camarasa","ESP","MF","24",1994,28.5,28,15,8,15,5,6,31,19.4,25,17,2,15,33,61,28,1,"https://fbref.com/en/players/b2d03887/Victor-Camarasa"
"492","Greg Cunningham_2019",2019,"Cardiff City","Premier League","Greg Cunningham","IRL","DF","27",1991,7,18,7,11,4,3,9,16,56.3,7,9,3,6,17,35,16,1,"https://fbref.com/en/players/dc10b26c/Greg-Cunningham"
"493","Loïc Damour_2019",2019,"Cardiff City","Premier League","Loïc Damour","FRA","MF","27",1991,0.3,0,0,0,0,0,0,1,0,1,0,0,0,0,0,0,0,"https://fbref.com/en/players/074d8166/Loic-Damour"
"494","Bruno Ecuele Manga_2019",2019,"Cardiff City","Premier League","Bruno Ecuele Manga","GAB","DF","30",1988,37.5,69,36,48,16,5,29,58,50,29,62,28,34,81,150,179,4,"https://fbref.com/en/players/72a0fb65/Bruno-Ecuele-Manga"
"495","Neil Etheridge_2019",2019,"Cardiff City","Premier League","Neil Etheridge","PHI","GK","28",1990,38,1,1,1,0,0,1,2,50,1,0,0,0,7,8,19,1,"https://fbref.com/en/players/2642bf6c/Neil-Etheridge"
"496","Aron Gunnarsson_2019",2019,"Cardiff City","Premier League","Aron Gunnarsson","ISL","MF","29",1989,25.2,51,29,23,25,3,23,84,27.4,61,40,12,28,38,89,55,1,"https://fbref.com/en/players/e2533c20/Aron-Gunnarsson"
"497","Kadeem Harris_2019",2019,"Cardiff City","Premier League","Kadeem Harris","ENG","MF","25",1993,4.2,12,5,6,4,2,7,8,87.5,1,3,0,3,3,15,5,0,"https://fbref.com/en/players/24396398/Kadeem-Harris"
"498","Rhys Healey_2019",2019,"Cardiff City","Premier League","Rhys Healey","WAL","FW","23",1994,0.6,1,0,0,1,0,0,1,0,1,0,0,0,0,1,0,0,"https://fbref.com/en/players/07ace8c3/Rhys-Healey"
"499","Junior Hoilett_2019",2019,"Cardiff City","Premier League","Junior Hoilett","CAN","MF,FW","28",1990,23.8,40,27,26,11,3,15,53,28.3,38,34,0,34,32,72,30,0,"https://fbref.com/en/players/33af5b9e/Junior-Hoilett"
"500","Gary Madine_2019",2019,"Cardiff City","Premier League","Gary Madine","ENG","FW,MF","27",1990,0.4,1,1,0,1,0,0,0,NA,0,0,0,0,0,1,0,0,"https://fbref.com/en/players/e3e6502a/Gary-Madine"
"501","Nathaniel Mendez-Laing_2019",2019,"Cardiff City","Premier League","Nathaniel Mendez-Laing","GUA","MF,FW","26",1992,10.9,34,25,18,12,4,12,26,46.2,14,17,1,16,13,47,20,0,"https://fbref.com/en/players/b4b2f632/Nathaniel-Mendez-Laing"
"502","Sean Morrison_2019",2019,"Cardiff City","Premier League","Sean Morrison","ENG","DF","27",1991,33.8,35,17,29,4,2,15,28,53.6,13,47,30,17,52,87,204,5,"https://fbref.com/en/players/09fec029/Sean-Morrison"
"503","Josh Murphy_2019",2019,"Cardiff City","Premier League","Josh Murphy","ENG","MF,FW","23",1995,20.2,26,17,15,7,4,9,29,31,20,30,0,30,11,37,17,0,"https://fbref.com/en/players/b30c7426/Josh-Murphy"
"504","Oumar Niasse_2019",2019,"Cardiff City","Premier League","Oumar Niasse","SEN","FW","28",1990,10.3,12,3,1,5,6,4,8,50,4,7,0,7,2,14,7,0,"https://fbref.com/en/players/af721f98/Oumar-Niasse"
"505","Callum Paterson_2019",2019,"Cardiff City","Premier League","Callum Paterson","SCO","FW,MF","23",1994,22.2,21,14,7,7,7,5,26,19.2,21,23,2,21,8,29,29,0,"https://fbref.com/en/players/d2583bce/Callum-Paterson"
"506","Lee Peltier_2019",2019,"Cardiff City","Premier League","Lee Peltier","ENG","DF","31",1986,17.2,39,25,27,11,1,15,27,55.6,12,18,12,6,18,57,60,0,"https://fbref.com/en/players/af341b88/Lee-Peltier"
"507","Joe Ralls_2019",2019,"Cardiff City","Premier League","Joe Ralls","ENG","MF","24",1993,21.8,45,23,21,21,3,10,33,30.3,23,21,6,15,29,74,30,0,"https://fbref.com/en/players/3730fcbc/Joe-Ralls"
"508","Bobby Reid_2019",2019,"Cardiff City","Premier League","Bobby Reid","JAM","FW,MF","25",1993,15.8,16,9,6,7,3,3,8,37.5,5,13,0,13,3,19,12,0,"https://fbref.com/en/players/0f7533cd/Bobby-Reid"
"509","Jazz Richards_2019",2019,"Cardiff City","Premier League","Jazz Richards","WAL","DF,MF","27",1991,1.5,0,0,0,0,0,0,1,0,1,2,1,1,2,2,5,0,"https://fbref.com/en/players/afef14da/Jazz-Richards"
"510","Danny Ward_2019",2019,"Cardiff City","Premier League","Danny Ward","ENG","FW","26",1991,4.9,2,1,0,1,1,0,3,0,3,3,1,2,0,2,9,0,"https://fbref.com/en/players/cfb29823/Danny-Ward"
"511","Kenneth Zohore_2019",2019,"Cardiff City","Premier League","Kenneth Zohore","DEN","FW","24",1994,8.4,3,2,0,3,0,1,3,33.3,2,4,2,2,2,5,5,0,"https://fbref.com/en/players/5e508d0d/Kenneth-Zohore"
"512","Júnior Alonso_2019",2019,"Celta Vigo","La Liga","Júnior Alonso","PAR","DF,MF","25",1993,6,13,9,8,4,1,7,12,58.3,5,8,3,5,5,18,24,1,"https://fbref.com/en/players/b18a3023/Junior-Alonso"
"513","Sergio Álvarez_2019",2019,"Celta Vigo","La Liga","Sergio Álvarez","ESP","GK","31",1986,13,0,0,0,0,0,0,0,NA,0,0,0,0,0,0,4,0,"https://fbref.com/en/players/8875b8c9/Sergio-Alvarez"
"514","Emmanuel Apeh_2019",2019,"Celta Vigo","La Liga","Emmanuel Apeh","NGA","FW,MF","21",1996,0.2,0,0,0,0,0,0,1,0,1,0,0,0,0,0,0,0,"https://fbref.com/en/players/a230ebcc/Emmanuel-Apeh"
"515","Néstor Araujo_2019",2019,"Celta Vigo","La Liga","Néstor Araujo","MEX","DF","26",1991,29.8,42,22,32,9,1,18,22,81.8,4,32,21,11,35,77,153,1,"https://fbref.com/en/players/27a013f7/Nestor-Araujo"
"516","Iago Aspas_2019",2019,"Celta Vigo","La Liga","Iago Aspas","ESP","FW,MF","30",1987,25,16,11,4,8,4,4,20,20,16,14,0,14,16,32,5,0,"https://fbref.com/en/players/7dcf86f6/Iago-Aspas"
"517","Fran Beltrán_2019",2019,"Celta Vigo","La Liga","Fran Beltrán","ESP","MF","19",1999,16.9,23,17,8,12,3,13,31,41.9,18,19,2,17,19,42,15,1,"https://fbref.com/en/players/ed5c5fa3/Fran-Beltran"
"518","Rubén Blanco_2019",2019,"Celta Vigo","La Liga","Rubén Blanco","ESP","GK","23",1995,25,1,0,1,0,0,1,2,50,1,1,0,1,2,3,13,2,"https://fbref.com/en/players/967f34d3/Ruben-Blanco"
"519","Ryad Boudebouz_2019",2019,"Celta Vigo","La Liga","Ryad Boudebouz","ALG","MF,FW","28",1990,8,14,4,4,6,4,3,8,37.5,5,9,1,8,3,17,9,0,"https://fbref.com/en/players/1001ae82/Ryad-Boudebouz"
"520","Sofiane Boufal_2019",2019,"Celta Vigo","La Liga","Sofiane Boufal","MAR","MF,FW","24",1993,23.2,35,21,18,11,6,15,47,31.9,32,24,0,24,10,45,12,0,"https://fbref.com/en/players/b0c71810/Sofiane-Boufal"
"521","Gustavo Cabral_2019",2019,"Celta Vigo","La Liga","Gustavo Cabral","ARG","DF","32",1985,21.1,37,26,28,7,2,17,27,63,10,31,11,20,33,70,102,1,"https://fbref.com/en/players/92b4a127/Gustavo-Cabral"
"522","David Costas_2019",2019,"Celta Vigo","La Liga","David Costas","ESP","DF","23",1995,13,25,13,21,4,0,10,15,66.7,5,12,6,6,18,43,58,1,"https://fbref.com/en/players/545e2f01/David-Costas"
"523","Dennis Eckert_2019",2019,"Celta Vigo","La Liga","Dennis Eckert","GER","FW","21",1997,2.4,3,2,0,1,2,0,2,0,2,1,0,1,2,5,3,0,"https://fbref.com/en/players/7f8fb807/Dennis-Eckert"
"524","Maxi Gómez_2019",2019,"Celta Vigo","La Liga","Maxi Gómez","URU","FW","21",1996,32.9,6,4,1,4,1,1,12,8.3,11,3,0,3,2,8,43,0,"https://fbref.com/en/players/4c2e9442/Maxi-Gomez"
"525","Andrew Hjulsager_2019",2019,"Celta Vigo","La Liga","Andrew Hjulsager","DEN","MF,FW","23",1995,4,16,10,11,2,3,2,18,11.1,16,4,0,4,2,18,1,0,"https://fbref.com/en/players/2ef16f06/Andrew-Hjulsager"
"526","Wesley Hoedt_2019",2019,"Celta Vigo","La Liga","Wesley Hoedt","NED","DF","24",1994,9.9,17,11,15,2,0,12,17,70.6,5,17,11,6,11,28,58,3,"https://fbref.com/en/players/875898c7/Wesley-Hoedt"
"527","Mathias Jensen_2019",2019,"Celta Vigo","La Liga","Mathias Jensen","DEN","MF,FW","22",1996,2.6,4,2,2,2,0,2,9,22.2,7,2,0,2,4,8,1,0,"https://fbref.com/en/players/0f134faf/Mathias-Jensen"
"528","Jozabed_2019",2019,"Celta Vigo","La Liga","Jozabed","ESP","MF","27",1991,12.8,19,10,8,8,3,8,24,33.3,16,8,2,6,9,28,13,2,"https://fbref.com/en/players/9b337c7c/Jozabed"
"529","David Juncà_2019",2019,"Celta Vigo","La Liga","David Juncà","ESP","DF","24",1993,19.5,55,30,40,13,2,28,46,60.9,18,27,6,21,35,90,63,1,"https://fbref.com/en/players/de7d40d6/David-Junca"
"530","Stanislav Lobotka_2019",2019,"Celta Vigo","La Liga","Stanislav Lobotka","SVK","MF","23",1994,27.7,30,19,10,17,3,9,32,28.1,23,15,1,14,26,56,18,1,"https://fbref.com/en/players/e1cbb531/Stanislav-Lobotka"
"531","Hugo Mallo_2019",2019,"Celta Vigo","La Liga","Hugo Mallo","ESP","DF","27",1991,34.4,73,41,41,27,5,27,52,51.9,25,44,13,31,50,123,135,1,"https://fbref.com/en/players/cb574619/Hugo-Mallo"
"532","Róbert Mazáň_2019",2019,"Celta Vigo","La Liga","Róbert Mazáň","SVK","DF","24",1994,1,3,3,3,0,0,2,2,100,0,2,0,2,3,6,0,0,"https://fbref.com/en/players/30672832/Robert-Mazan"
"533","Brais Méndez_2019",2019,"Celta Vigo","La Liga","Brais Méndez","ESP","MF,FW","21",1997,26.1,61,31,23,29,9,14,53,26.4,39,32,3,29,24,85,24,0,"https://fbref.com/en/players/c9e39d91/Brais-Mendez"
"534","Emre Mor_2019",2019,"Celta Vigo","La Liga","Emre Mor","TUR","FW,MF","21",1997,4.1,7,4,1,3,3,2,7,28.6,5,5,0,5,3,10,1,0,"https://fbref.com/en/players/0c3f7197/Emre-Mor"
"535","Lucas Olaza_2019",2019,"Celta Vigo","La Liga","Lucas Olaza","URU","DF","24",1994,10,29,18,19,8,2,14,18,77.8,4,13,6,7,8,37,18,0,"https://fbref.com/en/players/4cee5954/Lucas-Olaza"
"536","Facundo Roncaglia_2019",2019,"Celta Vigo","La Liga","Facundo Roncaglia","ARG","DF","31",1987,11.9,34,22,26,8,0,17,24,70.8,7,12,5,7,20,54,51,2,"https://fbref.com/en/players/51e3954c/Facundo-Roncaglia"
"537","Pione Sisto_2019",2019,"Celta Vigo","La Liga","Pione Sisto","DEN","FW,MF","23",1995,9.4,4,3,4,0,0,0,9,0,9,5,0,5,3,7,3,0,"https://fbref.com/en/players/fd9c4805/Pione-Sisto"
"538","Kevin Vázquez_2019",2019,"Celta Vigo","La Liga","Kevin Vázquez","ESP","DF","25",1993,2.4,6,5,5,0,1,4,7,57.1,3,8,3,5,2,8,9,0,"https://fbref.com/en/players/ee923664/Kevin-Vazquez"
"539","Okay Yokuşlu_2019",2019,"Celta Vigo","La Liga","Okay Yokuşlu","TUR","MF","24",1994,24.4,61,39,31,28,2,28,45,62.2,17,32,11,21,37,98,53,2,"https://fbref.com/en/players/e49ce451/Okay-Yokuslu"
"540","Marcos Alonso_2019",2019,"Chelsea","Premier League","Marcos Alonso","ESP","DF","27",1990,30.7,73,46,44,22,7,33,58,56.9,25,25,2,23,39,112,101,0,"https://fbref.com/en/players/f4290206/Marcos-Alonso"
"541","Kepa Arrizabalaga_2019",2019,"Chelsea","Premier League","Kepa Arrizabalaga","ESP","GK","23",1994,36,1,1,1,0,0,1,2,50,1,1,0,1,0,1,4,2,"https://fbref.com/en/players/28d596a0/Kepa-Arrizabalaga"
"542","César Azpilicueta_2019",2019,"Chelsea","Premier League","César Azpilicueta","ESP","DF","28",1989,37.8,105,60,52,40,13,38,67,56.7,29,63,16,47,43,148,91,3,"https://fbref.com/en/players/53cad200/Cesar-Azpilicueta"
"543","Ross Barkley_2019",2019,"Chelsea","Premier League","Ross Barkley","ENG","MF","24",1993,13.8,15,10,5,7,3,4,14,28.6,10,8,1,7,9,24,17,2,"https://fbref.com/en/players/3a24769f/Ross-Barkley"
"544","Willy Caballero_2019",2019,"Chelsea","Premier League","Willy Caballero","ARG","GK","36",1981,2,0,0,0,0,0,0,0,NA,0,0,0,0,0,0,1,0,"https://fbref.com/en/players/a179d516/Willy-Caballero"
"545","Gary Cahill_2019",2019,"Chelsea","Premier League","Gary Cahill","ENG","DF","32",1985,0.3,0,0,0,0,0,0,0,NA,0,0,0,0,0,0,1,0,"https://fbref.com/en/players/7914b9fe/Gary-Cahill"
"546","Andreas Christensen_2019",2019,"Chelsea","Premier League","Andreas Christensen","DEN","DF","22",1996,6.9,10,4,2,6,2,2,5,40,3,4,2,2,4,14,29,0,"https://fbref.com/en/players/1cb49278/Andreas-Christensen"
"547","Cesc Fàbregas_2019",2019,"Chelsea","Premier League","Cesc Fàbregas","ESP","MF","31",1987,2,6,4,4,2,0,1,5,20,4,2,1,1,1,7,0,0,"https://fbref.com/en/players/33508c78/Cesc-Fabregas"
"548","Olivier Giroud_2019",2019,"Chelsea","Premier League","Olivier Giroud","FRA","FW","31",1986,9.4,3,2,0,1,2,1,4,25,3,6,1,5,3,6,7,0,"https://fbref.com/en/players/16ceb862/Olivier-Giroud"
"549","Eden Hazard_2019",2019,"Chelsea","Premier League","Eden Hazard","BEL","FW","27",1991,32.5,14,9,2,1,11,5,17,29.4,12,10,0,10,13,27,6,1,"https://fbref.com/en/players/a39bb753/Eden-Hazard"
"550","Gonzalo Higuaín_2019",2019,"Chelsea","Premier League","Gonzalo Higuaín","ARG","FW","30",1987,12.1,10,7,2,4,4,2,11,18.2,9,4,0,4,1,11,5,0,"https://fbref.com/en/players/8a08491a/Gonzalo-Higuain"
"551","Callum Hudson-Odoi_2019",2019,"Chelsea","Premier League","Callum Hudson-Odoi","ENG","FW","17",2000,4.4,8,6,8,0,0,2,4,50,2,1,0,1,3,11,0,0,"https://fbref.com/en/players/15f3ec41/Callum-Hudson-Odoi"
"552","Jorginho_2019",2019,"Chelsea","Premier League","Jorginho","ITA","MF","26",1991,35.1,76,38,27,41,8,45,96,46.9,51,46,7,39,64,140,38,1,"https://fbref.com/en/players/45db685d/Jorginho"
"553","N'Golo Kanté_2019",2019,"Chelsea","Premier League","N'Golo Kanté","FRA","MF","27",1991,34.4,75,41,21,41,13,23,67,34.3,44,63,6,57,44,119,32,1,"https://fbref.com/en/players/b9fbae28/NGolo-Kante"
"554","Mateo Kovačić_2019",2019,"Chelsea","Premier League","Mateo Kovačić","CRO","MF","24",1994,19.3,45,29,23,19,3,20,46,43.5,26,19,2,17,8,53,18,1,"https://fbref.com/en/players/79c0821a/Mateo-Kovacic"
"555","Ruben Loftus-Cheek_2019",2019,"Chelsea","Premier League","Ruben Loftus-Cheek","ENG","MF,FW","22",1996,11.1,18,12,7,7,4,3,12,25,9,10,4,6,11,29,5,0,"https://fbref.com/en/players/e97fd090/Ruben-Loftus-Cheek"
"556","David Luiz_2019",2019,"Chelsea","Premier League","David Luiz","BRA","DF","31",1987,36,41,31,27,13,1,21,28,75,7,33,18,15,35,76,149,1,"https://fbref.com/en/players/c0e27d1a/David-Luiz"
"557","Álvaro Morata_2019",2019,"Chelsea","Premier League","Álvaro Morata","ESP","FW","25",1992,10.5,8,5,0,5,3,1,7,14.3,6,6,1,5,0,8,6,0,"https://fbref.com/en/players/129af0db/Alvaro-Morata"
"558","Victor Moses_2019",2019,"Chelsea","Premier League","Victor Moses","NGA","FW","27",1990,0.3,0,0,0,0,0,0,0,NA,0,1,0,1,0,0,0,0,"https://fbref.com/en/players/e726e11e/Victor-Moses"
"559","Emerson Palmieri_2019",2019,"Chelsea","Premier League","Emerson Palmieri","ITA","DF","23",1994,7.4,14,9,6,5,3,6,10,60,4,11,1,10,8,22,14,0,"https://fbref.com/en/players/e0bc6fdc/Emerson-Palmieri"
"560","Pedro_2019",2019,"Chelsea","Premier League","Pedro","ESP","FW","31",1987,19.8,27,14,11,10,6,9,35,25.7,26,13,2,11,18,45,8,1,"https://fbref.com/en/players/3ca7254a/Pedro"
"561","Antonio Rüdiger_2019",2019,"Chelsea","Premier League","Antonio Rüdiger","GER","DF","25",1993,31.9,34,16,27,6,1,15,27,55.6,12,15,8,7,32,66,96,1,"https://fbref.com/en/players/18b896d6/Antonio-Rudiger"
"562","Willian_2019",2019,"Chelsea","Premier League","Willian","BRA","FW","29",1988,23.3,35,21,11,15,9,9,25,36,16,16,1,15,14,49,12,2,"https://fbref.com/en/players/8b9ebd03/Willian"
"563","Davide Zappacosta_2019",2019,"Chelsea","Premier League","Davide Zappacosta","ITA","DF","26",1992,1.4,0,0,0,0,0,0,1,0,1,0,0,0,3,3,5,0,"https://fbref.com/en/players/7fe90ccd/Davide-Zappacosta"
"564","Marco Andreolli_2019",2019,"Chievo","Serie A","Marco Andreolli","ITA","DF","32",1986,7.2,10,6,7,2,1,6,10,60,4,4,2,2,6,16,33,0,"https://fbref.com/en/players/13d820de/Marco-Andreolli"
"565","Mauro Antonio Burruchaga_2019",2019,"Chievo","Serie A","Mauro Antonio Burruchaga","ARG","MF","20",1998,0.6,2,2,1,1,0,0,2,0,2,2,1,1,0,2,3,0,"https://fbref.com/en/players/0830a4f9/Mauro-Antonio-Burruchaga"
"566","Mattia Bani_2019",2019,"Chievo","Serie A","Mattia Bani","ITA","DF","24",1993,29,67,40,46,21,0,27,40,67.5,13,51,35,16,57,124,162,2,"https://fbref.com/en/players/0821331c/Mattia-Bani"
"567","Federico Barba_2019",2019,"Chievo","Serie A","Federico Barba","ITA","DF","24",1993,27.6,30,14,21,9,0,8,21,38.1,13,29,15,14,65,95,129,0,"https://fbref.com/en/players/c010b898/Federico-Barba"
"568","Valter Birsa_2019",2019,"Chievo","Serie A","Valter Birsa","SVN","MF,FW","31",1986,12.2,14,9,4,7,3,4,17,23.5,13,9,1,8,6,20,13,0,"https://fbref.com/en/players/455a2b79/Valter-Birsa"
"569","Fabrizio Cacciatore_2019",2019,"Chievo","Serie A","Fabrizio Cacciatore","ITA","DF","31",1986,5.5,8,4,6,2,0,4,9,44.4,5,8,2,6,5,13,20,0,"https://fbref.com/en/players/00b0bb87/Fabrizio-Cacciatore"
"570","Boštjan Cesar_2019",2019,"Chievo","Serie A","Boštjan Cesar","SVN","DF","36",1982,12,16,10,9,7,0,7,17,41.2,10,14,8,6,14,30,60,2,"https://fbref.com/en/players/c1d18f10/Bostjan-Cesar"
"571","Fabio Depaoli_2019",2019,"Chievo","Serie A","Fabio Depaoli","ITA","DF","21",1997,27.4,74,43,37,32,5,34,67,50.7,33,42,16,26,35,109,99,3,"https://fbref.com/en/players/d97f2e8d/Fabio-Depaoli"
"572","Assane Dioussé_2019",2019,"Chievo","Serie A","Assane Dioussé","SEN","MF","20",1997,9.9,24,16,11,8,5,10,23,43.5,13,14,4,10,19,43,13,2,"https://fbref.com/en/players/7f622eef/Assane-Diousse"
"573","Nicolas Frey_2019",2019,"Chievo","Serie A","Nicolas Frey","FRA","DF","34",1984,2.5,3,1,2,1,0,0,3,0,3,3,3,0,7,10,18,0,"https://fbref.com/en/players/6378443d/Nicolas-Frey"
"574","Emanuele Giaccherini_2019",2019,"Chievo","Serie A","Emanuele Giaccherini","ITA","MF,FW","33",1985,22.3,14,8,5,7,2,6,31,19.4,25,21,2,19,16,30,10,2,"https://fbref.com/en/players/1c50f354/Emanuele-Giaccherini"
"575","Sergej Grubac_2019",2019,"Chievo","Serie A","Sergej Grubac","MNE","FW","18",2000,1.7,2,1,1,0,1,1,1,100,0,1,0,1,0,2,1,0,"https://fbref.com/en/players/a1bedc05/Sergej-Grubac"
"576","Përparim Hetemaj_2019",2019,"Chievo","Serie A","Përparim Hetemaj","FIN","MF","31",1986,24,53,27,27,23,3,20,68,29.4,48,25,1,24,30,83,24,2,"https://fbref.com/en/players/90b70194/Perparim-Hetemaj"
"577","Paweł Jaroszyński_2019",2019,"Chievo","Serie A","Paweł Jaroszyński","POL","DF","23",1994,15,29,18,17,8,4,16,32,50,16,15,4,11,24,53,41,1,"https://fbref.com/en/players/958a601f/Pawel-Jaroszynski"
"578","Musa Juwara_2019",2019,"Chievo","Serie A","Musa Juwara","GAM","FW","16",2001,0.1,0,0,0,0,0,0,0,NA,0,0,0,0,1,1,0,0,"https://fbref.com/en/players/7737dee2/Musa-Juwara"
"579","Ibrahim Karamoko_2019",2019,"Chievo","Serie A","Ibrahim Karamoko","FRA","MF","17",2001,0.7,0,0,0,0,0,0,0,NA,0,1,0,1,0,0,1,0,"https://fbref.com/en/players/550985aa/Ibrahim-Karamoko"
"580","Sofian Kiyine_2019",2019,"Chievo","Serie A","Sofian Kiyine","MAR","MF,DF","20",1997,9.1,28,13,11,14,3,9,18,50,9,10,0,10,10,38,4,0,"https://fbref.com/en/players/ce1806be/Sofian-Kiyine"
"581","Mehdi Léris_2019",2019,"Chievo","Serie A","Mehdi Léris","ALG","MF,DF","20",1998,17.9,53,33,19,24,10,24,54,44.4,30,34,1,33,28,81,24,1,"https://fbref.com/en/players/7d3cbc67/Mehdi-Leris"
"582","Riccardo Meggiorini_2019",2019,"Chievo","Serie A","Riccardo Meggiorini","ITA","FW","32",1985,17.2,17,13,5,9,3,1,10,10,9,20,2,18,8,25,26,0,"https://fbref.com/en/players/2ec0f902/Riccardo-Meggiorini"
"583","Angelo Ndrecka_2019",2019,"Chievo","Serie A","Angelo Ndrecka","ALB","DF","16",2001,1,1,1,1,0,0,1,2,50,1,3,2,1,0,1,1,0,"https://fbref.com/en/players/fcd20025/Angelo-Ndrecka"
"584","Joel Obi_2019",2019,"Chievo","Serie A","Joel Obi","NGA","MF","27",1991,7.3,22,15,9,11,2,7,17,41.2,10,12,1,11,14,36,15,0,"https://fbref.com/en/players/614c38fb/Joel-Obi"
"585","Sergio Pellissier_2019",2019,"Chievo","Serie A","Sergio Pellissier","ITA","FW","39",1979,10.6,4,3,1,1,2,3,4,75,1,8,1,7,2,6,8,0,"https://fbref.com/en/players/878ee034/Sergio-Pellissier"
"586","Lucas Piazon_2019",2019,"Chievo","Serie A","Lucas Piazon","BRA","MF,FW","24",1994,0.9,2,0,1,1,0,0,2,0,2,1,0,1,1,3,0,0,"https://fbref.com/en/players/f201798c/Lucas-Piazon"
"587","Manuel Pucciarelli_2019",2019,"Chievo","Serie A","Manuel Pucciarelli","ITA","FW","27",1991,3.4,4,2,2,1,1,2,5,40,3,5,0,5,3,7,4,0,"https://fbref.com/en/players/a1c7b425/Manuel-Pucciarelli"
"588","Ivan Radovanović_2019",2019,"Chievo","Serie A","Ivan Radovanović","SRB","MF","29",1988,19,27,22,20,7,0,11,31,35.5,20,19,7,12,26,53,36,0,"https://fbref.com/en/players/023937a9/Ivan-Radovanovic"
"589","Nicola Rigoni_2019",2019,"Chievo","Serie A","Nicola Rigoni","ITA","MF","27",1990,21.7,43,25,22,15,6,22,51,43.1,29,20,5,15,23,66,45,1,"https://fbref.com/en/players/e327bd76/Nicola-Rigoni"
"590","Luca Rossettini_2019",2019,"Chievo","Serie A","Luca Rossettini","ITA","DF","33",1985,20.3,26,17,18,8,0,15,20,75,5,23,15,8,35,61,114,0,"https://fbref.com/en/players/47a500ae/Luca-Rossettini"
"591","Ezequiel Schelotto_2019",2019,"Chievo","Serie A","Ezequiel Schelotto","ITA","DF","29",1989,1.6,3,0,3,0,0,2,3,66.7,1,1,0,1,2,5,8,0,"https://fbref.com/en/players/a6e316c1/Ezequiel-Schelotto"
"592","Andrea Seculin_2019",2019,"Chievo","Serie A","Andrea Seculin","ITA","GK","28",1990,1,0,0,0,0,0,0,0,NA,0,0,0,0,0,0,1,0,"https://fbref.com/en/players/c4f573f4/Andrea-Seculin"
"593","Adrian Šemper_2019",2019,"Chievo","Serie A","Adrian Šemper","CRO","GK","20",1998,6,0,0,0,0,0,0,0,NA,0,0,0,0,1,1,3,0,"https://fbref.com/en/players/f02dde20/Adrian-Semper"
"594","Stefano Sorrentino_2019",2019,"Chievo","Serie A","Stefano Sorrentino","ITA","GK","39",1979,31,1,1,1,0,0,1,2,50,1,0,0,0,3,4,10,1,"https://fbref.com/en/players/048877f5/Stefano-Sorrentino"
"595","Mariusz Stępiński_2019",2019,"Chievo","Serie A","Mariusz Stępiński","POL","FW","23",1995,27.5,18,13,1,11,6,1,17,5.9,16,10,2,8,5,23,20,0,"https://fbref.com/en/players/7b536033/Mariusz-Stepinski"
"596","Strahinja Tanasijević_2019",2019,"Chievo","Serie A","Strahinja Tanasijević","SRB","DF,MF","21",1997,0.2,0,0,0,0,0,0,0,NA,0,0,0,0,0,0,0,0,"https://fbref.com/en/players/618ab91f/Strahinja-Tanasijevic"
"597","Nenad Tomović_2019",2019,"Chievo","Serie A","Nenad Tomović","SRB","DF","30",1987,8.2,9,7,5,4,0,7,10,70,3,5,1,4,13,22,34,0,"https://fbref.com/en/players/6aafdc27/Nenad-Tomovic"
"598","Emanuel Vignato_2019",2019,"Chievo","Serie A","Emanuel Vignato","ITA","MF,FW","17",2000,7.3,8,4,4,3,1,0,6,0,6,4,0,4,10,18,0,0,"https://fbref.com/en/players/ec5dae45/Emanuel-Vignato"
"599","Filip Đorđević_2019",2019,"Chievo","Serie A","Filip Đorđević","SRB","FW","30",1987,7,11,6,3,6,2,3,12,25,9,7,1,6,2,13,8,1,"https://fbref.com/en/players/dfb933e0/Filip-Djordjevic"
"600","Patrick van Aanholt_2019",2019,"Crystal Palace","Premier League","Patrick van Aanholt","NED","DF","27",1990,35.5,48,24,35,11,2,24,40,60,16,33,9,24,40,88,91,2,"https://fbref.com/en/players/5f09991f/Patrick-van-Aanholt"
"601","Jordan Ayew_2019",2019,"Crystal Palace","Premier League","Jordan Ayew","GHA","FW","26",1991,13.1,38,23,12,19,7,6,20,30,14,16,0,16,7,45,6,0,"https://fbref.com/en/players/da052c14/Jordan-Ayew"
"602","Michy Batshuayi_2019",2019,"Crystal Palace","Premier League","Michy Batshuayi","BEL","FW","24",1993,8.3,2,1,1,1,0,1,2,50,1,8,3,5,3,5,0,0,"https://fbref.com/en/players/2973d8ff/Michy-Batshuayi"
"603","Christian Benteke_2019",2019,"Crystal Palace","Premier League","Christian Benteke","BEL","FW","27",1990,9,5,1,0,4,1,1,4,25,3,7,2,5,0,5,14,0,"https://fbref.com/en/players/ab070c55/Christian-Benteke"
"604","Scott Dann_2019",2019,"Crystal Palace","Premier League","Scott Dann","ENG","DF","31",1987,7.4,6,2,5,1,0,3,7,42.9,4,16,12,4,5,11,46,0,"https://fbref.com/en/players/52105203/Scott-Dann"
"605","Luke Dreher_2019",2019,"Crystal Palace","Premier League","Luke Dreher","ENG","FW","19",1998,0,0,0,0,0,0,0,0,NA,0,0,0,0,0,0,0,0,"https://fbref.com/en/players/d1c509d9/Luke-Dreher"
"606","Vicente Guaita_2019",2019,"Crystal Palace","Premier League","Vicente Guaita","ESP","GK","31",1987,19.5,0,0,0,0,0,0,0,NA,0,0,0,0,0,0,5,2,"https://fbref.com/en/players/ab13a5aa/Vicente-Guaita"
"607","Wayne Hennessey_2019",2019,"Crystal Palace","Premier League","Wayne Hennessey","WAL","GK","31",1987,17.5,0,0,0,0,0,0,2,0,2,0,0,0,0,0,5,1,"https://fbref.com/en/players/76eca7e2/Wayne-Hennessey"
"608","Martin Kelly_2019",2019,"Crystal Palace","Premier League","Martin Kelly","ENG","DF","28",1990,12.3,21,13,18,2,1,14,19,73.7,5,18,12,6,11,32,88,1,"https://fbref.com/en/players/d7492450/Martin-Kelly"
"609","Cheikhou Kouyaté_2019",2019,"Crystal Palace","Premier League","Cheikhou Kouyaté","SEN","MF","28",1989,21.1,59,33,23,31,5,9,33,27.3,24,29,11,18,16,75,33,0,"https://fbref.com/en/players/8d3c902d/Cheikhou-Kouyate"
"610","James McArthur_2019",2019,"Crystal Palace","Premier League","James McArthur","SCO","MF","30",1987,34,84,51,38,32,14,30,78,38.5,48,64,22,42,39,123,55,0,"https://fbref.com/en/players/cee31595/James-McArthur"
"611","Max Meyer_2019",2019,"Crystal Palace","Premier League","Max Meyer","GER","MF","22",1995,15.7,33,18,14,18,1,11,20,55,9,6,0,6,15,48,19,0,"https://fbref.com/en/players/eba42d2b/Max-Meyer"
"612","Luka Milivojević_2019",2019,"Crystal Palace","Premier League","Luka Milivojević","SRB","MF","27",1991,38,90,69,36,47,7,39,91,42.9,52,47,15,32,72,162,68,3,"https://fbref.com/en/players/2ce2508a/Luka-Milivojevic"
"613","Jason Puncheon_2019",2019,"Crystal Palace","Premier League","Jason Puncheon","ENG","MF","32",1986,0.1,1,1,1,0,0,0,0,NA,0,0,0,0,0,1,0,0,"https://fbref.com/en/players/fd3f57ce/Jason-Puncheon"
"614","Mamadou Sakho_2019",2019,"Crystal Palace","Premier League","Mamadou Sakho","FRA","DF","28",1990,26.8,25,16,22,3,0,11,18,61.1,7,26,16,10,41,66,136,2,"https://fbref.com/en/players/87935cf3/Mamadou-Sakho"
"615","Bakary Sako_2019",2019,"Crystal Palace","Premier League","Bakary Sako","MLI","FW","30",1988,0.3,2,1,2,0,0,1,1,100,0,0,0,0,0,2,0,0,"https://fbref.com/en/players/381d7d54/Bakary-Sako"
"616","Jeffrey Schlupp_2019",2019,"Crystal Palace","Premier League","Jeffrey Schlupp","GHA","MF,FW","25",1992,18.6,41,20,18,18,5,10,27,37,17,30,8,22,19,60,27,1,"https://fbref.com/en/players/3312f911/Jeffrey-Schlupp"
"617","Pape Souaré_2019",2019,"Crystal Palace","Premier League","Pape Souaré","SEN","DF","28",1990,0,0,0,0,0,0,0,0,NA,0,0,0,0,1,1,0,0,"https://fbref.com/en/players/46b5375e/Pape-Souare"
"618","Julián Speroni_2019",2019,"Crystal Palace","Premier League","Julián Speroni","ARG","GK","39",1979,1,0,0,0,0,0,0,0,NA,0,0,0,0,0,0,1,2,"https://fbref.com/en/players/8e65a5e5/Julian-Speroni"
"619","Alexander Sørloth_2019",2019,"Crystal Palace","Premier League","Alexander Sørloth","NOR","FW","22",1995,2.1,2,1,0,0,2,1,2,50,1,0,0,0,0,2,3,0,"https://fbref.com/en/players/e92cd3f7/Alexander-Sorloth"
"620","James Tomkins_2019",2019,"Crystal Palace","Premier League","James Tomkins","ENG","DF","29",1989,28.4,34,20,27,7,0,15,28,53.6,13,23,10,13,34,68,184,3,"https://fbref.com/en/players/e7ca0439/James-Tomkins"
"621","Andros Townsend_2019",2019,"Crystal Palace","Premier League","Andros Townsend","ENG","FW,MF","27",1991,33.4,62,35,38,16,8,35,89,39.3,54,48,5,43,38,100,28,0,"https://fbref.com/en/players/b28bbd58/Andros-Townsend"
"622","Aaron Wan-Bissaka_2019",2019,"Crystal Palace","Premier League","Aaron Wan-Bissaka","ENG","DF","20",1997,34.8,129,90,90,33,6,55,65,84.6,10,49,16,33,84,213,161,0,"https://fbref.com/en/players/9e525177/Aaron-Wan-Bissaka"
"623","Joel Ward_2019",2019,"Crystal Palace","Premier League","Joel Ward","ENG","DF","28",1989,6.1,12,7,7,4,1,3,10,30,7,2,0,2,10,22,35,0,"https://fbref.com/en/players/8a7ff278/Joel-Ward"
"624","Connor Wickham_2019",2019,"Crystal Palace","Premier League","Connor Wickham","ENG","FW,MF","25",1993,0.7,0,0,0,0,0,0,0,NA,0,0,0,0,0,0,2,0,"https://fbref.com/en/players/41cc19c2/Connor-Wickham"
"625","Wilfried Zaha_2019",2019,"Crystal Palace","Premier League","Wilfried Zaha","CIV","FW","25",1992,33.7,39,20,11,23,5,12,34,35.3,22,19,0,19,10,49,4,0,"https://fbref.com/en/players/b2bc3b1f/Wilfried-Zaha"
"626","Mehdi Abeid_2019",2019,"Dijon","Ligue 1","Mehdi Abeid","ALG","MF","25",1992,22.5,51,33,27,16,8,15,45,33.3,30,33,7,26,29,80,23,1,"https://fbref.com/en/players/a4c3f7af/Mehdi-Abeid"
"627","Nayef Aguerd_2019",2019,"Dijon","Ligue 1","Nayef Aguerd","MAR","DF","22",1996,11.7,17,12,8,9,0,8,19,42.1,11,20,11,9,14,31,59,1,"https://fbref.com/en/players/288e1e13/Nayef-Aguerd"
"628","Rúnar Alex Rúnarsson_2019",2019,"Dijon","Ligue 1","Rúnar Alex Rúnarsson","ISL","GK","23",1995,25,2,0,2,0,0,2,6,33.3,4,0,0,0,1,3,7,2,"https://fbref.com/en/players/8fa8f8d2/Runar-Alex-Runarsson"
"629","Bobby Allain_2019",2019,"Dijon","Ligue 1","Bobby Allain","FRA","GK","26",1991,13,0,0,0,0,0,0,1,0,1,1,0,1,0,0,16,1,"https://fbref.com/en/players/8870154f/Bobby-Allain"
"630","Mickaël Alphonse_2019",2019,"Dijon","Ligue 1","Mickaël Alphonse","GLP","DF","29",1989,6.3,10,5,6,1,3,3,4,75,1,3,1,2,9,19,30,0,"https://fbref.com/en/players/0a63446f/Mickael-Alphonse"
"631","Romain Amalfitano_2019",2019,"Dijon","Ligue 1","Romain Amalfitano","FRA","MF,FW","28",1989,28,52,33,20,28,4,25,67,37.3,42,45,13,32,47,99,35,0,"https://fbref.com/en/players/d7bf3d19/Romain-Amalfitano"
"632","Florent Balmont_2019",2019,"Dijon","Ligue 1","Florent Balmont","FRA","MF","38",1980,12,29,16,16,10,3,9,36,25,27,13,2,11,6,35,8,0,"https://fbref.com/en/players/4e7bfc23/Florent-Balmont"
"633","Arnold Bouka Moutou_2019",2019,"Dijon","Ligue 1","Arnold Bouka Moutou","CGO","DF,FW","29",1988,0.7,3,1,2,1,0,0,4,0,4,1,0,1,3,6,1,0,"https://fbref.com/en/players/f3085377/Arnold-Bouka-Moutou"
"634","Fouad Chafik_2019",2019,"Dijon","Ligue 1","Fouad Chafik","MAR","DF","31",1986,20.5,44,31,29,12,3,23,36,63.9,13,17,3,14,25,69,71,0,"https://fbref.com/en/players/edd1466a/Fouad-Chafik"
"635","Kwon Chang-hoon_2019",2019,"Dijon","Ligue 1","Kwon Chang-hoon","KOR","FW,MF","24",1994,10.4,7,4,3,2,2,0,12,0,12,16,0,16,8,15,8,0,"https://fbref.com/en/players/7961f7aa/Kwon-Chang-hoon"
"636","Laurent Ciman_2019",2019,"Dijon","Ligue 1","Laurent Ciman","BEL","DF","32",1985,8,11,6,9,2,0,7,16,43.8,9,13,9,4,7,18,37,0,"https://fbref.com/en/players/5113d9a7/Laurent-Ciman"
"637","Senou Coulibaly_2019",2019,"Dijon","Ligue 1","Senou Coulibaly","MLI","DF","23",1994,4.6,13,7,10,3,0,3,8,37.5,5,8,2,6,11,24,20,0,"https://fbref.com/en/players/67b7357e/Senou-Coulibaly"
"638","Yoann Gourcuff_2019",2019,"Dijon","Ligue 1","Yoann Gourcuff","FRA","MF,FW","32",1986,1.5,0,0,0,0,0,0,2,0,2,1,1,0,0,0,1,0,"https://fbref.com/en/players/3acddfdd/Yoann-Gourcuff"
"639","Oussama Haddadi_2019",2019,"Dijon","Ligue 1","Oussama Haddadi","TUN","DF","26",1992,29.7,51,25,38,11,2,24,43,55.8,19,33,8,25,45,96,93,2,"https://fbref.com/en/players/ec400194/Oussama-Haddadi"
"640","Benjamin Jeannot_2019",2019,"Dijon","Ligue 1","Benjamin Jeannot","FRA","FW,MF","26",1992,16,17,12,5,7,5,6,19,31.6,13,15,3,12,12,29,14,0,"https://fbref.com/en/players/2e52206e/Benjamin-Jeannot"
"641","Sory Kaba_2019",2019,"Dijon","Ligue 1","Sory Kaba","GUI","FW,MF","23",1995,2.6,1,1,1,0,0,1,3,33.3,2,2,0,2,0,1,1,0,"https://fbref.com/en/players/d29202c2/Sory-Kaba"
"642","Jules Keita_2019",2019,"Dijon","Ligue 1","Jules Keita","GUI","FW,MF","20",1998,5.1,10,4,0,3,7,5,12,41.7,7,2,0,2,2,12,1,0,"https://fbref.com/en/players/8c955557/Jules-Keita"
"643","Wesley Lautoa_2019",2019,"Dijon","Ligue 1","Wesley Lautoa","NCL","DF,MF","30",1987,33.6,81,55,46,31,4,34,75,45.3,41,37,14,23,87,168,110,1,"https://fbref.com/en/players/6e5b5a45/Wesley-Lautoa"
"644","Enzo Loiodice_2019",2019,"Dijon","Ligue 1","Enzo Loiodice","FRA","MF","17",2000,9.4,25,14,8,15,2,10,21,47.6,11,7,0,7,11,36,7,0,"https://fbref.com/en/players/6bca20fe/Enzo-Loiodice"
"645","Jordan Marié_2019",2019,"Dijon","Ligue 1","Jordan Marié","FRA","MF","26",1991,20,52,28,15,31,6,21,58,36.2,37,28,5,23,40,92,32,0,"https://fbref.com/en/players/0d2158d5/Jordan-Marie"
"646","Valentin Rosier_2019",2019,"Dijon","Ligue 1","Valentin Rosier","FRA","DF,MF","21",1996,16.2,44,25,22,19,3,16,31,51.6,15,25,4,21,32,76,45,1,"https://fbref.com/en/players/9b6d9b53/Valentin-Rosier"
"647","Wesley Saïd_2019",2019,"Dijon","Ligue 1","Wesley Saïd","FRA","FW,MF","23",1995,25,25,18,6,11,8,5,20,25,15,9,0,9,9,34,9,0,"https://fbref.com/en/players/90fcf472/Wesley-Said"
"648","Frédéric Sammaritano_2019",2019,"Dijon","Ligue 1","Frédéric Sammaritano","FRA","FW,MF","32",1986,6,11,5,5,5,1,5,13,38.5,8,8,1,7,8,19,2,1,"https://fbref.com/en/players/8802c1d5/Frederic-Sammaritano"
"649","Naïm Sliti_2019",2019,"Dijon","Ligue 1","Naïm Sliti","TUN","MF,FW","26",1992,25.4,56,33,24,19,13,15,46,32.6,31,18,0,18,11,67,9,0,"https://fbref.com/en/players/2e0367a6/Naim-Sliti"
"650","Júlio Tavares_2019",2019,"Dijon","Ligue 1","Júlio Tavares","CPV","FW","29",1988,31.2,15,9,1,7,7,3,9,33.3,6,17,3,14,13,28,51,0,"https://fbref.com/en/players/d520120b/Julio-Tavares"
"651","Cédric Yamberé_2019",2019,"Dijon","Ligue 1","Cédric Yamberé","CTA","DF","27",1990,31.2,47,31,36,11,0,21,39,53.8,18,45,32,13,52,99,136,4,"https://fbref.com/en/players/1c344204/Cedric-Yambere"
"652","Manuel Akanji_2019",2019,"Dortmund","Bundesliga","Manuel Akanji","SUI","DF","23",1995,24.5,29,19,14,13,2,14,25,56,11,22,13,9,27,56,92,2,"https://fbref.com/en/players/89ac64a6/Manuel-Akanji"
"653","Paco Alcácer_2019",2019,"Dortmund","Bundesliga","Paco Alcácer","ESP","FW","24",1993,13.5,3,1,2,0,1,0,6,0,6,5,0,5,6,9,7,0,"https://fbref.com/en/players/a7a9d95a/Paco-Alcacer"
"654","Jacob Bruun Larsen_2019",2019,"Dortmund","Bundesliga","Jacob Bruun Larsen","DEN","FW","19",1998,14.1,15,9,8,2,5,7,17,41.2,10,15,1,14,13,28,12,0,"https://fbref.com/en/players/4e204552/Jacob-Bruun-Larsen"
"655","Roman Bürki_2019",2019,"Dortmund","Bundesliga","Roman Bürki","SUI","GK","27",1990,32,1,0,1,0,0,1,2,50,1,1,0,1,2,3,8,4,"https://fbref.com/en/players/9d12e142/Roman-Burki"
"656","Mahmoud Dahoud_2019",2019,"Dortmund","Bundesliga","Mahmoud Dahoud","GER","MF","22",1996,7.7,16,10,4,10,2,3,15,20,12,10,0,10,17,33,8,0,"https://fbref.com/en/players/db4ed67b/Mahmoud-Dahoud"
"657","Thomas Delaney_2019",2019,"Dortmund","Bundesliga","Thomas Delaney","DEN","MF","26",1991,25.4,69,54,28,39,2,19,30,63.3,11,30,9,21,58,127,43,0,"https://fbref.com/en/players/fe641c1a/Thomas-Delaney"
"658","Abdou Diallo_2019",2019,"Dortmund","Bundesliga","Abdou Diallo","SEN","DF","22",1996,26.4,36,20,20,13,3,11,15,73.3,4,28,15,13,26,62,91,1,"https://fbref.com/en/players/fc62f087/Abdou-Diallo"
"659","Mario Götze_2019",2019,"Dortmund","Bundesliga","Mario Götze","GER","FW,MF","26",1992,18.6,26,19,6,11,9,4,25,16,21,10,0,10,8,34,4,1,"https://fbref.com/en/players/9efa1d25/Mario-Gotze"
"660","Raphaël Guerreiro_2019",2019,"Dortmund","Bundesliga","Raphaël Guerreiro","POR","FW,DF","24",1993,17,25,12,11,7,7,12,23,52.2,11,7,1,6,18,43,12,1,"https://fbref.com/en/players/048a1cbc/Raphael-Guerreiro"
"661","Achraf Hakimi_2019",2019,"Dortmund","Bundesliga","Achraf Hakimi","MAR","DF","19",1998,19.3,34,19,25,8,1,17,36,47.2,19,27,4,23,29,63,45,2,"https://fbref.com/en/players/e42d61c7/Achraf-Hakimi"
"662","Marwin Hitz_2019",2019,"Dortmund","Bundesliga","Marwin Hitz","SUI","GK","30",1987,2,0,0,0,0,0,0,0,NA,0,0,0,0,0,0,0,1,"https://fbref.com/en/players/2e7ff968/Marwin-Hitz"
"663","Shinji Kagawa_2019",2019,"Dortmund","Bundesliga","Shinji Kagawa","JPN","MF","29",1989,1.1,0,0,0,0,0,0,0,NA,0,0,0,0,0,0,0,0,"https://fbref.com/en/players/5afafbfe/Shinji-Kagawa"
"664","Maximilian Philipp_2019",2019,"Dortmund","Bundesliga","Maximilian Philipp","GER","FW,MF","24",1994,8.4,7,5,3,4,0,2,9,22.2,7,10,0,10,3,10,6,0,"https://fbref.com/en/players/061e8e23/Maximilian-Philipp"
"665","Łukasz Piszczek_2019",2019,"Dortmund","Bundesliga","Łukasz Piszczek","POL","DF","33",1985,19.5,57,36,34,15,8,18,33,54.5,15,26,3,23,39,96,69,0,"https://fbref.com/en/players/fe2db476/Lukasz-Piszczek"
"666","Christian Pulisic_2019",2019,"Dortmund","Bundesliga","Christian Pulisic","USA","FW","19",1998,10.4,10,6,2,6,2,2,6,33.3,4,12,2,10,6,16,10,0,"https://fbref.com/en/players/1bf33a9a/Christian-Pulisic"
"667","Marco Reus_2019",2019,"Dortmund","Bundesliga","Marco Reus","GER","MF,FW","29",1989,25.7,33,22,11,16,6,6,31,19.4,25,28,1,27,8,41,32,0,"https://fbref.com/en/players/36a3ff67/Marco-Reus"
"668","Jadon Sancho_2019",2019,"Dortmund","Bundesliga","Jadon Sancho","ENG","FW,MF","18",2000,27.3,19,10,7,6,6,10,31,32.3,21,21,1,20,14,33,12,1,"https://fbref.com/en/players/dbf053da/Jadon-Sancho"
"669","Marcel Schmelzer_2019",2019,"Dortmund","Bundesliga","Marcel Schmelzer","GER","DF","30",1988,6.3,10,5,7,2,1,5,9,55.6,4,7,1,6,9,19,14,0,"https://fbref.com/en/players/89565ac5/Marcel-Schmelzer"
"670","Ömer Toprak_2019",2019,"Dortmund","Bundesliga","Ömer Toprak","TUR","DF","29",1989,2.6,1,1,0,1,0,0,1,0,1,1,1,0,0,1,7,0,"https://fbref.com/en/players/c5fd13e9/Omer-Toprak"
"671","Julian Weigl_2019",2019,"Dortmund","Bundesliga","Julian Weigl","GER","DF,MF","22",1995,16.2,32,18,19,12,1,24,41,58.5,17,18,10,8,16,48,56,2,"https://fbref.com/en/players/346d51d9/Julian-Weigl"
"672","Axel Witsel_2019",2019,"Dortmund","Bundesliga","Axel Witsel","BEL","MF","29",1989,31.9,47,33,19,24,4,17,28,60.7,11,33,6,27,47,94,49,0,"https://fbref.com/en/players/5dfc6ad5/Axel-Witsel"
"673","Marius Wolf_2019",2019,"Dortmund","Bundesliga","Marius Wolf","GER","DF,FW","23",1995,9.2,14,10,11,3,0,5,13,38.5,8,6,0,6,13,27,12,0,"https://fbref.com/en/players/fa661778/Marius-Wolf"
"674","Dan-Axel Zagadou_2019",2019,"Dortmund","Bundesliga","Dan-Axel Zagadou","FRA","DF","19",1999,14.1,13,10,10,2,1,4,6,66.7,2,17,11,6,25,38,70,2,"https://fbref.com/en/players/a4effc55/Dan-Axel-Zagadou"
"675","Kaan Ayhan_2019",2019,"Düsseldorf","Bundesliga","Kaan Ayhan","TUR","DF","23",1994,27.2,53,29,38,15,0,23,47,48.9,24,34,16,18,59,112,118,3,"https://fbref.com/en/players/2200181e/Kaan-Ayhan"
"676","Aymen Barkok_2019",2019,"Düsseldorf","Bundesliga","Aymen Barkok","MAR","MF","20",1998,5.7,13,6,4,9,0,4,19,21.1,15,8,1,7,4,17,3,0,"https://fbref.com/en/players/a2a85828/Aymen-Barkok"
"677","Adam Bodzek_2019",2019,"Düsseldorf","Bundesliga","Adam Bodzek","GER","MF,DF","32",1985,17.7,44,27,27,16,1,17,43,39.5,26,15,6,9,26,70,39,0,"https://fbref.com/en/players/bb8a42fa/Adam-Bodzek"
"678","Robin Bormuth_2019",2019,"Düsseldorf","Bundesliga","Robin Bormuth","GER","DF","22",1995,6.8,7,4,7,0,0,5,10,50,5,6,4,2,10,17,49,1,"https://fbref.com/en/players/d728acae/Robin-Bormuth"
"679","Jaroslav Drobný_2019",2019,"Düsseldorf","Bundesliga","Jaroslav Drobný","CZE","GK","38",1979,2,0,0,0,0,0,0,0,NA,0,0,0,0,0,0,1,0,"https://fbref.com/en/players/e4a30d8c/Jaroslav-Drobny"
"680","Marvin Ducksch_2019",2019,"Düsseldorf","Bundesliga","Marvin Ducksch","GER","FW","24",1994,9.1,3,1,0,2,1,1,5,20,4,4,0,4,4,7,11,0,"https://fbref.com/en/players/638a4d71/Marvin-Ducksch"
"681","Oliver Fink_2019",2019,"Düsseldorf","Bundesliga","Oliver Fink","GER","MF","36",1982,11.7,38,22,17,17,4,12,38,31.6,26,20,3,17,13,51,19,0,"https://fbref.com/en/players/316162b6/Oliver-Fink"
"682","Niko Gießelmann_2019",2019,"Düsseldorf","Bundesliga","Niko Gießelmann","GER","DF","26",1991,28.8,57,37,38,14,5,26,59,44.1,33,25,6,19,36,93,85,1,"https://fbref.com/en/players/7242b495/Niko-Giesselmann"
"683","Rouwen Hennings_2019",2019,"Düsseldorf","Bundesliga","Rouwen Hennings","GER","FW","30",1987,20.4,14,10,1,8,5,2,13,15.4,11,16,1,15,4,18,20,0,"https://fbref.com/en/players/17611373/Rouwen-Hennings"
"684","André Hoffmann_2019",2019,"Düsseldorf","Bundesliga","André Hoffmann","GER","DF,MF","25",1993,11.7,22,14,12,10,0,9,25,36,16,17,12,5,21,43,44,0,"https://fbref.com/en/players/34b306a1/Andre-Hoffmann"
"685","Marcin Kamiński_2019",2019,"Düsseldorf","Bundesliga","Marcin Kamiński","POL","DF","26",1992,27,18,13,14,3,1,7,11,63.6,4,21,11,10,39,57,103,2,"https://fbref.com/en/players/463503e2/Marcin-Kaminski"
"686","Kenan Karaman_2019",2019,"Düsseldorf","Bundesliga","Kenan Karaman","TUR","FW,MF","24",1994,10.2,13,9,3,10,0,7,12,58.3,5,5,1,4,2,15,8,0,"https://fbref.com/en/players/8f0f2230/Kenan-Karaman"
"687","Dawid Kownacki_2019",2019,"Düsseldorf","Bundesliga","Dawid Kownacki","POL","MF,FW","21",1997,6.4,13,6,9,3,1,7,16,43.8,9,8,0,8,2,15,8,0,"https://fbref.com/en/players/be5e1c4c/Dawid-Kownacki"
"688","Davor Lovren_2019",2019,"Düsseldorf","Bundesliga","Davor Lovren","CRO","MF","19",1998,0.5,1,1,0,0,1,0,0,NA,0,1,0,1,0,1,0,0,"https://fbref.com/en/players/58007d77/Davor-Lovren"
"689","Dodi Lukebakio_2019",2019,"Düsseldorf","Bundesliga","Dodi Lukebakio","BEL","FW,MF","20",1997,21.9,25,17,11,6,8,8,15,53.3,7,13,0,13,9,34,19,0,"https://fbref.com/en/players/0c61c77c/Dodi-Lukebakio"
"690","Alfredo Morales_2019",2019,"Düsseldorf","Bundesliga","Alfredo Morales","USA","MF","28",1990,17,32,18,16,15,1,6,24,25,18,18,9,9,24,56,31,0,"https://fbref.com/en/players/ff45add5/Alfredo-Morales"
"691","Benito Raman_2019",2019,"Düsseldorf","Bundesliga","Benito Raman","BEL","MF,FW","23",1994,18.7,35,20,14,16,5,11,53,20.8,42,30,2,28,15,50,8,0,"https://fbref.com/en/players/867501bf/Benito-Raman"
"692","Michael Rensing_2019",2019,"Düsseldorf","Bundesliga","Michael Rensing","GER","GK","34",1984,32,2,1,2,0,0,1,5,20,4,1,0,1,2,4,13,2,"https://fbref.com/en/players/c476b0c0/Michael-Rensing"
"693","Marcel Sobottka_2019",2019,"Düsseldorf","Bundesliga","Marcel Sobottka","GER","MF","24",1994,10.5,30,20,12,18,0,10,19,52.6,9,13,5,8,24,54,17,0,"https://fbref.com/en/players/664590fa/Marcel-Sobottka"
"694","Kevin Stöger_2019",2019,"Düsseldorf","Bundesliga","Kevin Stöger","AUT","MF","24",1993,23.5,63,35,28,27,8,30,67,44.8,37,32,5,27,31,94,19,1,"https://fbref.com/en/players/e5649a78/Kevin-Stoger"
"695","Markus Suttner_2019",2019,"Düsseldorf","Bundesliga","Markus Suttner","AUT","DF,MF","31",1987,5.4,10,7,5,4,1,4,8,50,4,8,3,5,8,18,10,0,"https://fbref.com/en/players/7391c2d9/Markus-Suttner"
"696","Takashi Usami_2019",2019,"Düsseldorf","Bundesliga","Takashi Usami","JPN","MF,FW","26",1992,9.8,18,12,7,11,0,9,26,34.6,17,15,2,13,8,26,13,1,"https://fbref.com/en/players/2bed2986/Takashi-Usami"
"697","Jean Zimmer_2019",2019,"Düsseldorf","Bundesliga","Jean Zimmer","GER","DF,FW","24",1993,15.9,17,11,11,5,1,6,16,37.5,10,13,2,11,11,28,32,1,"https://fbref.com/en/players/912e63b5/Jean-Zimmer"
"698","Matthias Zimmermann_2019",2019,"Düsseldorf","Bundesliga","Matthias Zimmermann","GER","DF,MF","26",1992,33.9,97,64,69,24,4,45,90,50,45,51,18,33,67,164,90,2,"https://fbref.com/en/players/e199d5b0/Matthias-Zimmermann"
"699","Sergio Álvarez_2019",2019,"Eibar","La Liga","Sergio Álvarez","ESP","DF,MF","26",1992,11.9,34,25,12,20,2,13,23,56.5,10,9,4,5,17,51,43,0,"https://fbref.com/en/players/88d91621/Sergio-Alvarez"
"700","José Ángel_2019",2019,"Eibar","La Liga","José Ángel","ESP","DF","28",1989,33.6,66,46,36,23,7,31,56,55.4,25,24,5,19,41,107,113,1,"https://fbref.com/en/players/3024e383/Jose-Angel"
"701","Anaitz Arbilla_2019",2019,"Eibar","La Liga","Anaitz Arbilla","ESP","DF","31",1987,21.7,31,24,25,5,1,17,27,63,10,12,5,7,46,77,92,2,"https://fbref.com/en/players/850c0a0d/Anaitz-Arbilla"
"702","Bebé_2019",2019,"Eibar","La Liga","Bebé","CPV","MF","28",1990,0.7,0,0,0,0,0,0,0,NA,0,1,0,1,1,1,0,0,"https://fbref.com/en/players/d8712bf9/Bebe"
"703","Pedro Bigas_2019",2019,"Eibar","La Liga","Pedro Bigas","ESP","DF","27",1990,6.5,4,3,2,0,2,1,5,20,4,6,2,4,8,12,22,0,"https://fbref.com/en/players/697295b1/Pedro-Bigas"
"704","Pablo de Blasis_2019",2019,"Eibar","La Liga","Pablo de Blasis","ARG","DF,MF","30",1988,16.9,32,19,17,8,7,12,32,37.5,20,18,0,18,13,45,20,0,"https://fbref.com/en/players/9ab48bde/Pablo-de-Blasis"
"705","Jordi Calavera_2019",2019,"Eibar","La Liga","Jordi Calavera","ESP","DF","22",1995,0,0,0,0,0,0,0,0,NA,0,0,0,0,0,0,0,0,"https://fbref.com/en/players/bdef8cdb/Jordi-Calavera"
"706","Marc Cardona_2019",2019,"Eibar","La Liga","Marc Cardona","ESP","FW,MF","23",1995,6.7,7,5,2,1,4,2,6,33.3,4,7,0,7,1,8,3,0,"https://fbref.com/en/players/b92b456a/Marc-Cardona"
"707","Charles_2019",2019,"Eibar","La Liga","Charles","BRA","FW","34",1984,19.3,7,5,1,3,3,2,13,15.4,11,14,1,13,4,11,14,0,"https://fbref.com/en/players/c4b8bcf4/Charles"
"708","Marc Cucurella_2019",2019,"Eibar","La Liga","Marc Cucurella","ESP","MF,FW","20",1998,26.2,49,37,13,21,15,10,23,43.5,13,36,3,33,20,69,24,0,"https://fbref.com/en/players/1daec722/Marc-Cucurella"
"709","Papakouli Diop_2019",2019,"Eibar","La Liga","Papakouli Diop","SEN","MF","32",1986,26.1,66,40,14,44,8,14,34,41.2,20,21,1,20,37,103,27,0,"https://fbref.com/en/players/7329018e/Papakouli-Diop"
"710","Marko Dmitrović_2019",2019,"Eibar","La Liga","Marko Dmitrović","SRB","GK","26",1992,24,0,0,0,0,0,0,0,NA,0,0,0,0,2,2,11,3,"https://fbref.com/en/players/ac295d9e/Marko-Dmitrovic"
"711","Sergi Enrich_2019",2019,"Eibar","La Liga","Sergi Enrich","ESP","FW","28",1990,28.7,27,17,3,11,13,7,30,23.3,23,11,1,10,6,33,14,0,"https://fbref.com/en/players/bb4b1242/Sergi-Enrich"
"712","Gonzalo Escalante_2019",2019,"Eibar","La Liga","Gonzalo Escalante","ARG","MF","25",1993,19.9,49,28,11,35,3,19,46,41.3,27,37,2,35,21,70,21,0,"https://fbref.com/en/players/3f79a1c8/Gonzalo-Escalante"
"713","Pablo Hervías_2019",2019,"Eibar","La Liga","Pablo Hervías","ESP","MF","25",1993,2,1,1,0,1,0,0,4,0,4,2,0,2,0,1,0,0,"https://fbref.com/en/players/ba5a9545/Pablo-Hervias"
"714","Joan Jordán_2019",2019,"Eibar","La Liga","Joan Jordán","ESP","MF","24",1994,31.9,63,40,16,38,9,28,80,35,52,38,4,34,32,95,18,1,"https://fbref.com/en/players/2a0c8ba4/Joan-Jordan"
"715","Kike_2019",2019,"Eibar","La Liga","Kike","ESP","FW","28",1989,14.4,7,4,1,2,4,1,5,20,4,18,0,18,4,11,6,0,"https://fbref.com/en/players/e897d8ba/Kike"
"716","Pedro León_2019",2019,"Eibar","La Liga","Pedro León","ESP","MF,FW","31",1986,4.7,7,4,2,2,3,4,7,57.1,3,10,0,10,4,11,2,0,"https://fbref.com/en/players/d66b9872/Pedro-Leon"
"717","Miguel Marí_2019",2019,"Eibar","La Liga","Miguel Marí","ESP","MF","21",1997,0.8,0,0,0,0,0,0,2,0,2,0,0,0,1,1,2,0,"https://fbref.com/en/players/d70a3661/Miguel-Mari"
"718","Pere Milla_2019",2019,"Eibar","La Liga","Pere Milla","ESP","MF,FW","25",1992,3.8,7,6,1,5,1,0,5,0,5,4,1,3,2,9,1,0,"https://fbref.com/en/players/335039a2/Pere-Milla"
"719","Paulo Oliveira_2019",2019,"Eibar","La Liga","Paulo Oliveira","POR","DF","26",1992,24.9,49,39,33,16,0,28,44,63.6,16,25,10,15,36,85,116,0,"https://fbref.com/en/players/a8fbae1d/Paulo-Oliveira"
"720","Fabián Orellana_2019",2019,"Eibar","La Liga","Fabián Orellana","CHI","MF,FW","32",1986,30.4,44,21,14,16,14,9,42,21.4,33,17,0,17,19,63,4,0,"https://fbref.com/en/players/c90977db/Fabian-Orellana"
"721","Rubén Peña_2019",2019,"Eibar","La Liga","Rubén Peña","ESP","DF","27",1991,29.7,63,46,24,27,12,24,53,45.3,29,37,9,28,35,98,57,0,"https://fbref.com/en/players/1f079188/Ruben-Pena"
"722","Iván Ramis_2019",2019,"Eibar","La Liga","Iván Ramis","ESP","DF","33",1984,18.6,23,13,10,11,2,17,23,73.9,6,10,5,5,18,41,65,2,"https://fbref.com/en/players/d2be40f2/Ivan-Ramis"
"723","Asier Riesgo_2019",2019,"Eibar","La Liga","Asier Riesgo","ESP","GK","34",1983,14,1,1,1,0,0,1,3,33.3,2,0,0,0,0,1,8,1,"https://fbref.com/en/players/581c5276/Asier-Riesgo"
"724","David Abraham_2019",2019,"Eint Frankfurt","Bundesliga","David Abraham","ARG","DF","32",1986,15.8,22,14,13,8,1,11,25,44,14,23,12,11,24,46,64,0,"https://fbref.com/en/players/565bf0da/David-Abraham"
"725","Allan_2019",2019,"Eint Frankfurt","Bundesliga","Allan","BRA","MF","21",1997,2,4,4,2,2,0,0,4,0,4,4,2,2,0,4,1,0,"https://fbref.com/en/players/b15e93aa/Allan"
"726","Danny Blum_2019",2019,"Eint Frankfurt","Bundesliga","Danny Blum","GER","MF","27",1991,0,0,0,0,0,0,0,0,NA,0,0,0,0,0,0,5,0,"https://fbref.com/en/players/eb61713c/Danny-Blum"
"727","Timothy Chandler_2019",2019,"Eint Frankfurt","Bundesliga","Timothy Chandler","USA","DF","28",1990,0.2,0,0,0,0,0,0,0,NA,0,0,0,0,0,0,0,0,"https://fbref.com/en/players/b3b7f5a6/Timothy-Chandler"
"728","Danny da Costa_2019",2019,"Eint Frankfurt","Bundesliga","Danny da Costa","GER","DF,FW","25",1993,33.7,61,35,29,25,7,18,42,42.9,24,51,9,42,32,93,67,0,"https://fbref.com/en/players/5ddb8f9f/Danny-da-Costa"
"729","Marco Fabián_2019",2019,"Eint Frankfurt","Bundesliga","Marco Fabián","MEX","FW","29",1989,0.7,3,2,2,1,0,1,1,100,0,0,0,0,3,6,0,0,"https://fbref.com/en/players/e665a2db/Marco-Fabian"
"730","Simon Falette_2019",2019,"Eint Frankfurt","Bundesliga","Simon Falette","GUI","DF","26",1992,6.7,9,6,7,1,1,2,6,33.3,4,11,5,6,14,23,32,0,"https://fbref.com/en/players/b82880c6/Simon-Falette"
"731","Gelson Fernandes_2019",2019,"Eint Frankfurt","Bundesliga","Gelson Fernandes","SUI","MF","31",1986,24.7,74,48,33,38,3,23,65,35.4,42,45,9,36,53,127,16,0,"https://fbref.com/en/players/8e58987d/Gelson-Fernandes"
"732","Mijat Gaćinović_2019",2019,"Eint Frankfurt","Bundesliga","Mijat Gaćinović","SRB","MF","23",1995,18.1,31,20,7,13,11,11,42,26.2,31,26,1,25,24,55,10,0,"https://fbref.com/en/players/16daec92/Mijat-Gacinovic"
"733","Jonathan de Guzmán_2019",2019,"Eint Frankfurt","Bundesliga","Jonathan de Guzmán","NED","MF","30",1987,17.4,34,24,11,20,3,13,28,46.4,15,18,2,16,11,45,16,0,"https://fbref.com/en/players/1bcca8b8/Jonathan-de-Guzman"
"734","Sébastien Haller_2019",2019,"Eint Frankfurt","Bundesliga","Sébastien Haller","CIV","FW","24",1994,24.2,24,11,7,10,7,8,21,38.1,13,21,1,20,15,39,23,0,"https://fbref.com/en/players/ba115a40/Sebastien-Haller"
"735","Makoto Hasebe_2019",2019,"Eint Frankfurt","Bundesliga","Makoto Hasebe","JPN","DF,MF","34",1984,28,52,34,35,17,0,25,42,59.5,17,43,22,21,40,92,101,3,"https://fbref.com/en/players/9ab16552/Makoto-Hasebe"
"736","Martin Hinteregger_2019",2019,"Eint Frankfurt","Bundesliga","Martin Hinteregger","AUT","DF","25",1992,12.7,34,26,19,12,3,13,28,46.4,15,20,7,13,13,47,51,0,"https://fbref.com/en/players/080440a4/Martin-Hinteregger"
"737","Branimir Hrgota_2019",2019,"Eint Frankfurt","Bundesliga","Branimir Hrgota","SWE","FW","25",1993,0.1,0,0,0,0,0,0,0,NA,0,0,0,0,0,0,0,0,"https://fbref.com/en/players/710fbdd1/Branimir-Hrgota"
"738","Luka Jović_2019",2019,"Eint Frankfurt","Bundesliga","Luka Jović","SRB","FW,MF","20",1997,24.9,10,5,1,8,1,1,12,8.3,11,8,0,8,3,13,30,0,"https://fbref.com/en/players/4d8cd038/Luka-Jovic"
"739","Filip Kostić_2019",2019,"Eint Frankfurt","Bundesliga","Filip Kostić","SRB","DF,FW","25",1992,32.8,64,42,35,22,7,23,65,35.4,42,80,6,74,23,87,50,0,"https://fbref.com/en/players/b1cd37e6/Filip-Kostic"
"740","Nicolai Müller_2019",2019,"Eint Frankfurt","Bundesliga","Nicolai Müller","GER","FW,MF","30",1987,2.4,4,2,3,1,0,1,2,50,1,4,1,3,0,4,0,0,"https://fbref.com/en/players/5e1df051/Nicolai-Muller"
"741","Obite N'Dicka_2019",2019,"Eint Frankfurt","Bundesliga","Obite N'Dicka","FRA","DF","18",1999,25.6,43,28,31,10,2,31,52,59.6,21,29,11,18,29,72,123,0,"https://fbref.com/en/players/441197b8/Obite-NDicka"
"742","Gonçalo Paciência_2019",2019,"Eint Frankfurt","Bundesliga","Gonçalo Paciência","POR","FW","23",1994,4.3,3,2,0,2,1,1,2,50,1,8,1,7,0,3,1,0,"https://fbref.com/en/players/962e54cb/Goncalo-Paciencia"
"743","Ante Rebić_2019",2019,"Eint Frankfurt","Bundesliga","Ante Rebić","CRO","FW,MF","24",1993,22,22,9,5,12,5,5,12,41.7,7,18,1,17,8,30,3,0,"https://fbref.com/en/players/536cebe5/Ante-Rebic"
"744","Sebastian Rode_2019",2019,"Eint Frankfurt","Bundesliga","Sebastian Rode","GER","MF","27",1990,10.3,31,19,17,9,5,16,35,45.7,19,17,0,17,19,50,14,0,"https://fbref.com/en/players/e12b0b5b/Sebastian-Rode"
"745","Marco Russ_2019",2019,"Eint Frankfurt","Bundesliga","Marco Russ","GER","DF","32",1985,4.2,7,2,5,2,0,4,6,66.7,2,2,2,0,7,14,8,0,"https://fbref.com/en/players/e26c4233/Marco-Russ"
"746","Frederik Rønnow_2019",2019,"Eint Frankfurt","Bundesliga","Frederik Rønnow","DEN","GK","25",1992,1.4,0,0,0,0,0,0,0,NA,0,0,0,0,0,0,1,0,"https://fbref.com/en/players/a70b8345/Frederik-Ronnow"
"747","Carlos Salcedo_2019",2019,"Eint Frankfurt","Bundesliga","Carlos Salcedo","MEX","DF","24",1993,5.1,7,3,4,3,0,4,7,57.1,3,7,3,4,9,16,22,0,"https://fbref.com/en/players/64c07ae1/Carlos-Salcedo"
"748","Marc Stendera_2019",2019,"Eint Frankfurt","Bundesliga","Marc Stendera","GER","MF","22",1995,1.2,6,1,2,4,0,2,4,50,2,4,1,3,0,6,0,0,"https://fbref.com/en/players/500cd987/Marc-Stendera"
"749","Taleb Tawatha_2019",2019,"Eint Frankfurt","Bundesliga","Taleb Tawatha","ISR","FW,DF","26",1992,1.4,1,1,1,0,0,1,2,50,1,0,0,0,0,1,1,0,"https://fbref.com/en/players/bbb496b5/Taleb-Tawatha"
"750","Lucas Torró_2019",2019,"Eint Frankfurt","Bundesliga","Lucas Torró","ESP","MF","24",1994,6.2,14,7,5,7,2,5,11,45.5,6,12,1,11,14,28,13,0,"https://fbref.com/en/players/0e4fef6e/Lucas-Torro"
"751","Almamy Touré_2019",2019,"Eint Frankfurt","Bundesliga","Almamy Touré","MLI","DF,MF","22",1996,5.8,18,11,7,11,0,5,8,62.5,3,4,1,3,9,27,25,0,"https://fbref.com/en/players/c8c60119/Almamy-Toure"
"752","Kevin Trapp_2019",2019,"Eint Frankfurt","Bundesliga","Kevin Trapp","GER","GK","28",1990,32.6,0,0,0,0,0,0,2,0,2,0,0,0,0,0,17,1,"https://fbref.com/en/players/ce17b5eb/Kevin-Trapp"
"753","Jetro Willems_2019",2019,"Eint Frankfurt","Bundesliga","Jetro Willems","NED","MF,DF","24",1994,8.1,20,15,10,8,2,9,15,60,6,10,4,6,10,30,14,0,"https://fbref.com/en/players/9050ddc4/Jetro-Willems"
"754","Afriyie Acquah_2019",2019,"Empoli","Serie A","Afriyie Acquah","GHA","MF","26",1992,16.8,27,9,9,12,6,4,11,36.4,7,11,1,10,12,39,16,0,"https://fbref.com/en/players/d7403bd5/Afriyie-Acquah"
"755","Luca Antonelli_2019",2019,"Empoli","Serie A","Luca Antonelli","ITA","DF","31",1987,8.4,13,11,4,5,4,7,17,41.2,10,19,4,15,16,29,25,1,"https://fbref.com/en/players/40f0ed6c/Luca-Antonelli"
"756","Ismaël Bennacer_2019",2019,"Empoli","Serie A","Ismaël Bennacer","ALG","MF","20",1997,32.9,94,57,43,41,10,32,75,42.7,43,38,9,29,57,151,34,0,"https://fbref.com/en/players/db092d3b/Ismael-Bennacer"
"757","Matteo Brighi_2019",2019,"Empoli","Serie A","Matteo Brighi","ITA","MF","37",1981,2.6,11,4,2,9,0,2,9,22.2,7,2,0,2,3,14,4,0,"https://fbref.com/en/players/d417b306/Matteo-Brighi"
"758","Leonardo Capezzi_2019",2019,"Empoli","Serie A","Leonardo Capezzi","ITA","MF","23",1995,8.6,14,9,6,8,0,7,13,53.8,6,14,4,10,10,24,13,0,"https://fbref.com/en/players/07ea0ef2/Leonardo-Capezzi"
"759","Francesco Caputo_2019",2019,"Empoli","Serie A","Francesco Caputo","ITA","FW","30",1987,38,13,9,2,4,7,3,10,30,7,11,1,10,2,15,11,0,"https://fbref.com/en/players/5bd72174/Francesco-Caputo"
"760","Cristian Dell'Orco_2019",2019,"Empoli","Serie A","Cristian Dell'Orco","ITA","DF","24",1994,11.5,18,11,11,5,2,4,11,36.4,7,13,7,6,17,35,44,0,"https://fbref.com/en/players/b0243215/Cristian-DellOrco"
"761","Giovanni Di Lorenzo_2019",2019,"Empoli","Serie A","Giovanni Di Lorenzo","ITA","DF,FW","24",1993,37,66,43,38,23,5,24,44,54.5,20,34,13,21,36,102,93,3,"https://fbref.com/en/players/230a2fac/Giovanni-Di-Lorenzo"
"762","Bartłomiej Drągowski_2019",2019,"Empoli","Serie A","Bartłomiej Drągowski","POL","GK","20",1997,14,0,0,0,0,0,0,1,0,1,0,0,0,0,0,7,1,"https://fbref.com/en/players/085e71a7/Bartlomiej-Dragowski"
"763","Diego Farias_2019",2019,"Empoli","Serie A","Diego Farias","BRA","FW","28",1990,13.3,11,4,2,8,1,3,10,30,7,7,1,6,0,11,4,0,"https://fbref.com/en/players/157d29b6/Diego-Farias"
"764","Hamed Junior Traorè_2019",2019,"Empoli","Serie A","Hamed Junior Traorè","CIV","MF","18",2000,25.1,67,38,26,32,9,27,72,37.5,45,29,4,25,30,97,17,0,"https://fbref.com/en/players/570bb4b9/Hamed-Junior-Traore"
"765","Rade Krunić_2019",2019,"Empoli","Serie A","Rade Krunić","BIH","MF","24",1993,30.8,38,23,21,14,3,14,41,34.1,27,35,12,23,24,62,32,0,"https://fbref.com/en/players/817c6964/Rade-Krunic"
"766","Antonino La Gumina_2019",2019,"Empoli","Serie A","Antonino La Gumina","ITA","FW,MF","22",1996,12.1,5,4,1,2,2,2,6,33.3,4,8,2,6,6,11,5,0,"https://fbref.com/en/players/822a7761/Antonino-La-Gumina"
"767","Domenico Maietta_2019",2019,"Empoli","Serie A","Domenico Maietta","ITA","DF","35",1982,19,33,15,22,10,1,16,36,44.4,20,19,14,5,24,57,78,2,"https://fbref.com/en/players/3d936ba9/Domenico-Maietta"
"768","Levan Mchedlidze_2019",2019,"Empoli","Serie A","Levan Mchedlidze","GEO","FW","28",1990,2.3,1,1,0,0,1,0,1,0,1,2,0,2,0,1,5,0,"https://fbref.com/en/players/54ab361e/Levan-Mchedlidze"
"769","Samuel Mráz_2019",2019,"Empoli","Serie A","Samuel Mráz","SVK","FW","21",1997,1.9,0,0,0,0,0,0,0,NA,0,2,0,2,0,0,2,0,"https://fbref.com/en/players/be6c1ccc/Samuel-Mraz"
"770","Dimitris Nikolaou_2019",2019,"Empoli","Serie A","Dimitris Nikolaou","GRE","DF","19",1998,3.9,5,3,3,2,0,1,2,50,1,2,2,0,2,7,14,0,"https://fbref.com/en/players/cf961d8d/Dimitris-Nikolaou"
"771","Dimitri Oberlin_2019",2019,"Empoli","Serie A","Dimitri Oberlin","SUI","FW","20",1997,1.5,1,1,0,0,1,0,3,0,3,1,0,1,0,1,1,0,"https://fbref.com/en/players/af45e954/Dimitri-Oberlin"
"772","Marko Pajač_2019",2019,"Empoli","Serie A","Marko Pajač","CRO","FW,DF","25",1993,8.2,7,7,2,3,2,5,11,45.5,6,3,0,3,7,14,18,0,"https://fbref.com/en/players/5df4ef30/Marko-Pajac"
"773","Manuel Pasqual_2019",2019,"Empoli","Serie A","Manuel Pasqual","ITA","DF","36",1982,14.9,26,19,12,11,3,17,45,37.8,28,7,0,7,11,37,31,0,"https://fbref.com/en/players/548902cc/Manuel-Pasqual"
"774","Ivan Provedel_2019",2019,"Empoli","Serie A","Ivan Provedel","ITA","GK","24",1994,16,0,0,0,0,0,0,1,0,1,0,0,0,0,0,4,0,"https://fbref.com/en/players/277da414/Ivan-Provedel"
"775","Jacob Rasmussen_2019",2019,"Empoli","Serie A","Jacob Rasmussen","DEN","DF,MF","21",1997,11.3,18,12,10,6,2,5,14,35.7,9,18,13,5,12,30,55,1,"https://fbref.com/en/players/283699b4/Jacob-Rasmussen"
"776","Alejandro Rodríguez_2019",2019,"Empoli","Serie A","Alejandro Rodríguez","ESP","MF","27",1991,0.3,0,0,0,0,0,0,0,NA,0,0,0,0,0,0,1,0,"https://fbref.com/en/players/7602ddf6/Alejandro-Rodriguez"
"777","Matías Silvestre_2019",2019,"Empoli","Serie A","Matías Silvestre","ARG","DF","33",1984,34,31,17,22,5,4,17,26,65.4,9,29,24,5,21,52,165,0,"https://fbref.com/en/players/b6ca47a2/Matias-Silvestre"
"778","Pietro Terracciano_2019",2019,"Empoli","Serie A","Pietro Terracciano","ITA","GK","28",1990,8,0,0,0,0,0,0,0,NA,0,0,0,0,1,1,4,0,"https://fbref.com/en/players/e1b0a70d/Pietro-Terracciano"
"779","Salih Uçan_2019",2019,"Empoli","Serie A","Salih Uçan","TUR","MF","24",1994,2.9,10,4,3,5,2,3,10,30,7,4,0,4,6,16,2,0,"https://fbref.com/en/players/fe154b26/Salih-Ucan"
"780","Joel Untersee_2019",2019,"Empoli","Serie A","Joel Untersee","SUI","DF","24",1994,1.4,3,2,1,2,0,2,3,66.7,1,2,1,1,1,4,5,1,"https://fbref.com/en/players/3300c14c/Joel-Untersee"
"781","Freddie Veseli_2019",2019,"Empoli","Serie A","Freddie Veseli","ALB","DF","25",1992,28.2,34,21,16,15,3,19,27,70.4,8,28,17,11,30,64,99,1,"https://fbref.com/en/players/d541e703/Freddie-Veseli"
"782","Miha Zajc_2019",2019,"Empoli","Serie A","Miha Zajc","SVN","MF,FW","24",1994,13,6,4,1,1,4,2,11,18.2,9,15,4,11,5,11,8,0,"https://fbref.com/en/players/83e4643e/Miha-Zajc"
"783","Léo Baptistão_2019",2019,"Espanyol","La Liga","Léo Baptistão","BRA","FW,MF","25",1992,13.7,22,14,11,5,6,8,27,29.6,19,17,0,17,8,30,14,0,"https://fbref.com/en/players/35f6db55/Leo-Baptistao"
"784","Sergi Darder_2019",2019,"Espanyol","La Liga","Sergi Darder","ESP","MF","24",1993,30.1,60,35,23,32,5,25,69,36.2,44,18,3,15,22,82,30,0,"https://fbref.com/en/players/070a3904/Sergi-Darder"
"785","Óscar Duarte_2019",2019,"Espanyol","La Liga","Óscar Duarte","CRC","DF,MF","29",1989,7.3,12,5,7,5,0,4,7,57.1,3,7,7,0,13,25,34,0,"https://fbref.com/en/players/aa0ac32d/Oscar-Duarte"
"786","Facundo Ferreyra_2019",2019,"Espanyol","La Liga","Facundo Ferreyra","ARG","FW","27",1991,2.3,5,2,0,4,1,1,3,33.3,2,3,0,3,0,5,5,0,"https://fbref.com/en/players/b39a793e/Facundo-Ferreyra"
"787","Sergio García_2019",2019,"Espanyol","La Liga","Sergio García","ESP","FW,MF","35",1983,16.5,18,10,4,11,3,3,16,18.8,13,6,1,5,10,28,4,0,"https://fbref.com/en/players/2bee98fd/Sergio-Garcia"
"788","Esteban Granero_2019",2019,"Espanyol","La Liga","Esteban Granero","ESP","MF","31",1987,22.4,50,32,26,18,6,17,50,34,33,42,8,34,26,76,34,2,"https://fbref.com/en/players/1b17ed86/Esteban-Granero"
"789","Mario Hermoso_2019",2019,"Espanyol","La Liga","Mario Hermoso","ESP","DF","23",1995,31.2,38,24,29,7,2,21,39,53.8,18,34,25,9,37,75,175,2,"https://fbref.com/en/players/555f3a0b/Mario-Hermoso"
"790","Borja Iglesias_2019",2019,"Espanyol","La Liga","Borja Iglesias","ESP","FW","25",1993,34.2,23,14,7,8,8,5,24,20.8,19,14,6,8,7,30,41,0,"https://fbref.com/en/players/75645f0e/Borja-Iglesias"
"791","Wu Lei_2019",2019,"Espanyol","La Liga","Wu Lei","CHN","FW,MF","26",1991,11.8,13,6,5,6,2,5,16,31.3,11,9,0,9,7,20,7,0,"https://fbref.com/en/players/e3fabb0a/Wu-Lei"
"792","Alejandro López_2019",2019,"Espanyol","La Liga","Alejandro López","ESP","MF","21",1997,1.2,3,1,1,2,0,2,3,66.7,1,0,0,0,3,6,1,0,"https://fbref.com/en/players/f1887f53/Alejandro-Lopez"
"793","David López_2019",2019,"Espanyol","La Liga","David López","ESP","DF","28",1989,20.2,27,18,15,10,2,10,22,45.5,12,18,12,6,28,55,65,2,"https://fbref.com/en/players/f03f284b/David-Lopez"
"794","Diego López_2019",2019,"Espanyol","La Liga","Diego López","ESP","GK","36",1981,38,0,0,0,0,0,0,0,NA,0,0,0,0,2,2,9,3,"https://fbref.com/en/players/73683fa9/Diego-Lopez"
"795","Javi López_2019",2019,"Espanyol","La Liga","Javi López","ESP","DF","32",1986,21.6,63,40,37,22,4,28,60,46.7,32,27,5,22,40,103,90,0,"https://fbref.com/en/players/ffad706e/Javi-Lopez"
"796","Lluis López_2019",2019,"Espanyol","La Liga","Lluis López","ESP","DF","21",1997,5.8,5,3,4,1,0,3,6,50,3,6,2,4,7,12,21,0,"https://fbref.com/en/players/a685f013/Lluis-Lopez"
"797","Óscar Melendo_2019",2019,"Espanyol","La Liga","Óscar Melendo","ESP","MF,FW","20",1997,22.2,17,8,7,6,4,10,26,38.5,16,17,1,16,13,30,9,0,"https://fbref.com/en/players/379652be/Oscar-Melendo"
"798","Naldo_2019",2019,"Espanyol","La Liga","Naldo","BRA","DF","29",1988,15.1,18,10,9,5,4,6,10,60,4,19,13,6,26,44,112,1,"https://fbref.com/en/players/a2609621/Naldo"
"799","Pedrosa_2019",2019,"Espanyol","La Liga","Pedrosa","ESP","DF","20",1998,8.5,14,9,11,2,1,7,14,50,7,10,4,6,8,22,27,0,"https://fbref.com/en/players/112521d1/Pedrosa"
"800","Hernán Pérez_2019",2019,"Espanyol","La Liga","Hernán Pérez","PAR","FW,MF","29",1989,8.8,13,10,8,3,2,6,27,22.2,21,14,3,11,5,18,13,0,"https://fbref.com/en/players/e1cea3f7/Hernan-Perez"
"801","Pablo Piatti_2019",2019,"Espanyol","La Liga","Pablo Piatti","ARG","FW,MF","29",1989,8.3,21,15,8,10,3,8,16,50,8,15,0,15,2,23,8,0,"https://fbref.com/en/players/48e89655/Pablo-Piatti"
"802","Javi Puado_2019",2019,"Espanyol","La Liga","Javi Puado","ESP","FW,MF","20",1998,4,2,1,0,2,0,0,7,0,7,5,1,4,6,8,4,0,"https://fbref.com/en/players/2683eda7/Javi-Puado"
"803","Marc Roca_2019",2019,"Espanyol","La Liga","Marc Roca","ESP","MF","21",1996,34.6,71,45,36,26,9,28,70,40,42,43,21,22,36,107,60,3,"https://fbref.com/en/players/da27e268/Marc-Roca"
"804","Roberto Rosales_2019",2019,"Espanyol","La Liga","Roberto Rosales","VEN","DF","29",1988,19.4,48,31,22,16,10,21,44,47.7,23,19,7,12,22,70,68,0,"https://fbref.com/en/players/81069528/Roberto-Rosales"
"805","Víctor Sánchez_2019",2019,"Espanyol","La Liga","Víctor Sánchez","ESP","MF","30",1987,14.1,45,30,21,17,7,14,67,20.9,53,17,2,15,25,70,25,0,"https://fbref.com/en/players/ad4d0985/Victor-Sanchez"
"806","Alfa Semedo_2019",2019,"Espanyol","La Liga","Alfa Semedo","GNB","MF","20",1997,0.5,0,0,0,0,0,0,3,0,3,1,1,0,2,2,0,0,"https://fbref.com/en/players/07750704/Alfa-Semedo"
"807","Dídac Vilà_2019",2019,"Espanyol","La Liga","Dídac Vilà","ESP","DF","29",1989,26.2,67,31,33,26,8,31,58,53.4,27,41,12,29,53,120,94,1,"https://fbref.com/en/players/bad38a94/Didac-Vila"
"808","Leighton Baines_2019",2019,"Everton","Premier League","Leighton Baines","ENG","DF","33",1984,4.2,8,6,4,3,1,4,6,66.7,2,2,0,2,2,10,8,0,"https://fbref.com/en/players/b18095b6/Leighton-Baines"
"809","Bernard_2019",2019,"Everton","Premier League","Bernard","BRA","FW,MF","25",1992,23.5,49,30,19,22,8,15,55,27.3,40,37,2,35,27,76,14,1,"https://fbref.com/en/players/ab4b3e35/Bernard"
"810","Dominic Calvert-Lewin_2019",2019,"Everton","Premier League","Dominic Calvert-Lewin","ENG","FW","21",1997,19.8,13,7,3,3,7,7,15,46.7,8,16,3,13,7,20,19,0,"https://fbref.com/en/players/59e6e5bf/Dominic-Calvert-Lewin"
"811","Séamus Coleman_2019",2019,"Everton","Premier League","Séamus Coleman","IRL","DF","29",1988,28.4,44,25,23,18,3,19,30,63.3,11,14,5,9,26,70,86,0,"https://fbref.com/en/players/0420d84f/Seamus-Coleman"
"812","Tom Davies_2019",2019,"Everton","Premier League","Tom Davies","ENG","MF","20",1998,10.9,27,17,9,17,1,7,23,30.4,16,15,1,14,16,43,9,1,"https://fbref.com/en/players/9228b07c/Tom-Davies"
"813","Lucas Digne_2019",2019,"Everton","Premier League","Lucas Digne","FRA","DF","25",1993,32.9,71,46,45,18,8,28,45,62.2,17,43,9,34,60,131,116,0,"https://fbref.com/en/players/1b84dbe1/Lucas-Digne"
"814","Idrissa Gana Gueye_2019",2019,"Everton","Premier League","Idrissa Gana Gueye","SEN","MF","28",1989,31.4,142,89,70,63,9,38,76,50,38,52,8,44,74,216,48,1,"https://fbref.com/en/players/72c812f3/Idrissa-Gana-Gueye"
"815","André Gomes_2019",2019,"Everton","Premier League","André Gomes","POR","MF","25",1993,22,39,23,12,24,3,13,59,22,46,27,4,23,20,59,18,0,"https://fbref.com/en/players/1961b2aa/Andre-Gomes"
"816","Mason Holgate_2019",2019,"Everton","Premier League","Mason Holgate","ENG","DF","21",1996,4.5,5,4,4,1,0,1,1,100,0,3,2,1,3,8,32,0,"https://fbref.com/en/players/d0042ab9/Mason-Holgate"
"817","Phil Jagielka_2019",2019,"Everton","Premier League","Phil Jagielka","ENG","DF","35",1982,3.7,7,5,3,4,0,1,4,25,3,1,0,1,2,9,14,0,"https://fbref.com/en/players/3233eefd/Phil-Jagielka"
"818","Michael Keane_2019",2019,"Everton","Premier League","Michael Keane","ENG","DF","25",1993,33,41,25,22,16,3,19,32,59.4,13,30,22,8,43,84,185,4,"https://fbref.com/en/players/c5b7c315/Michael-Keane"
"819","Jonjoe Kenny_2019",2019,"Everton","Premier League","Jonjoe Kenny","ENG","DF","21",1997,8.8,21,16,16,4,1,10,18,55.6,8,13,2,11,17,38,36,1,"https://fbref.com/en/players/099e666f/Jonjoe-Kenny"
"820","Ademola Lookman_2019",2019,"Everton","Premier League","Ademola Lookman","NGA","FW,MF","20",1997,6.9,15,7,7,5,3,4,6,66.7,2,10,0,10,7,22,2,0,"https://fbref.com/en/players/7c104bb7/Ademola-Lookman"
"821","James McCarthy_2019",2019,"Everton","Premier League","James McCarthy","IRL","MF","27",1990,0.2,2,1,1,1,0,0,0,NA,0,0,0,0,1,3,0,0,"https://fbref.com/en/players/64b08de7/James-McCarthy"
"822","Yerry Mina_2019",2019,"Everton","Premier League","Yerry Mina","COL","DF","23",1994,9.9,14,7,8,6,0,6,9,66.7,3,11,5,6,8,22,54,3,"https://fbref.com/en/players/6d5701f2/Yerry-Mina"
"823","Oumar Niasse_2019",2019,"Everton","Premier League","Oumar Niasse","SEN","FW","28",1990,0.7,0,0,0,0,0,0,1,0,1,0,0,0,0,0,0,0,"https://fbref.com/en/players/af721f98/Oumar-Niasse"
"824","Jordan Pickford_2019",2019,"Everton","Premier League","Jordan Pickford","ENG","GK","24",1994,38,0,0,0,0,0,0,0,NA,0,0,0,0,0,0,20,8,"https://fbref.com/en/players/4806ec67/Jordan-Pickford"
"825","Richarlison_2019",2019,"Everton","Premier League","Richarlison","BRA","FW,MF","21",1997,29.6,49,34,19,20,10,8,24,33.3,16,30,2,28,16,65,39,0,"https://fbref.com/en/players/fa031b34/Richarlison"
"826","Morgan Schneiderlin_2019",2019,"Everton","Premier League","Morgan Schneiderlin","FRA","MF","28",1989,9.3,24,16,11,11,2,6,14,42.9,8,16,3,13,15,39,16,0,"https://fbref.com/en/players/51b41c5c/Morgan-Schneiderlin"
"827","Gylfi Sigurðsson_2019",2019,"Everton","Premier League","Gylfi Sigurðsson","ISL","MF","28",1989,34.6,56,36,20,25,11,16,47,34,31,38,4,34,28,84,24,0,"https://fbref.com/en/players/76dd1480/Gylfi-Sigurdsson"
"828","Cenk Tosun_2019",2019,"Everton","Premier League","Cenk Tosun","TUR","FW","27",1991,11.8,13,9,3,6,4,4,13,30.8,9,12,0,12,5,18,3,0,"https://fbref.com/en/players/9a104dee/Cenk-Tosun"
"829","Theo Walcott_2019",2019,"Everton","Premier League","Theo Walcott","ENG","FW,MF","29",1989,23.5,27,17,11,9,7,10,22,45.5,12,17,1,16,22,49,8,0,"https://fbref.com/en/players/1ecb65be/Theo-Walcott"
"830","Kurt Zouma_2019",2019,"Everton","Premier League","Kurt Zouma","FRA","DF","23",1994,29,32,21,16,14,2,4,11,36.4,7,27,12,15,54,86,126,2,"https://fbref.com/en/players/ce4246f5/Kurt-Zouma"
"831","Marco Benassi_2019",2019,"Fiorentina","Serie A","Marco Benassi","ITA","MF","23",1994,25.4,30,19,8,15,7,14,41,34.1,27,16,3,13,9,39,27,1,"https://fbref.com/en/players/0000acda/Marco-Benassi"
"832","Cristiano Biraghi_2019",2019,"Fiorentina","Serie A","Cristiano Biraghi","ITA","DF","25",1992,35.5,52,33,31,17,4,18,38,47.4,20,40,17,23,44,96,113,0,"https://fbref.com/en/players/9e1577aa/Cristiano-Biraghi"
"833","Federico Ceccherini_2019",2019,"Fiorentina","Serie A","Federico Ceccherini","ITA","DF","26",1992,11,13,10,8,3,2,5,9,55.6,4,12,8,4,21,34,40,0,"https://fbref.com/en/players/d9624b51/Federico-Ceccherini"
"834","Federico Chiesa_2019",2019,"Fiorentina","Serie A","Federico Chiesa","ITA","FW","20",1997,33.7,46,27,8,17,21,10,40,25,30,24,1,23,10,56,12,0,"https://fbref.com/en/players/b0f7e36c/Federico-Chiesa"
"835","Bryan Dabo_2019",2019,"Fiorentina","Serie A","Bryan Dabo","BFA","MF,DF","26",1992,9.2,10,6,1,8,1,1,6,16.7,5,11,6,5,10,20,21,0,"https://fbref.com/en/players/c53083ad/Bryan-Dabo"
"836","Bartłomiej Drągowski_2019",2019,"Fiorentina","Serie A","Bartłomiej Drągowski","POL","GK","20",1997,2.5,0,0,0,0,0,0,0,NA,0,0,0,0,0,0,2,0,"https://fbref.com/en/players/085e71a7/Bartlomiej-Dragowski"
"837","Valentin Eysseric_2019",2019,"Fiorentina","Serie A","Valentin Eysseric","FRA","FW,MF","26",1992,4,6,5,3,2,1,2,4,50,2,6,1,5,4,10,1,0,"https://fbref.com/en/players/ae82fa48/Valentin-Eysseric"
"838","Edimilson Fernandes_2019",2019,"Fiorentina","Serie A","Edimilson Fernandes","SUI","MF","22",1996,21.9,36,24,17,16,3,14,36,38.9,22,31,6,25,26,62,31,0,"https://fbref.com/en/players/3bb625ac/Edimilson-Fernandes"
"839","Gerson_2019",2019,"Fiorentina","Serie A","Gerson","BRA","MF,FW","21",1997,27,42,26,22,15,5,12,38,31.6,26,46,9,37,16,58,32,0,"https://fbref.com/en/players/8827bf46/Gerson"
"840","Dávid Hancko_2019",2019,"Fiorentina","Serie A","Dávid Hancko","SVK","DF","20",1997,3.1,7,6,4,3,0,6,9,66.7,3,3,1,2,3,10,12,0,"https://fbref.com/en/players/4fac8f81/David-Hancko"
"841","Vitor Hugo_2019",2019,"Fiorentina","Serie A","Vitor Hugo","BRA","DF","27",1991,27.4,64,42,38,25,1,17,27,63,10,28,13,15,74,138,141,2,"https://fbref.com/en/players/f2c1300a/Vitor-Hugo"
"842","Alban Lafont_2019",2019,"Fiorentina","Serie A","Alban Lafont","FRA","GK","19",1999,33.5,0,0,0,0,0,0,0,NA,0,0,0,0,1,1,16,4,"https://fbref.com/en/players/4e7db402/Alban-Lafont"
"843","Vincent Laurini_2019",2019,"Fiorentina","Serie A","Vincent Laurini","FRA","DF","29",1989,10.2,13,5,6,5,2,6,10,60,4,11,5,6,13,26,30,0,"https://fbref.com/en/players/3535098b/Vincent-Laurini"
"844","Nicky Medja_2019",2019,"Fiorentina","Serie A","Nicky Medja","SUI","FW,MF","18",2000,0.5,1,0,0,0,1,1,2,50,1,0,0,0,0,1,0,0,"https://fbref.com/en/players/714ffae7/Nicky-Medja"
"845","Nikola Milenković_2019",2019,"Fiorentina","Serie A","Nikola Milenković","SRB","DF","20",1997,33.4,59,40,36,21,2,17,33,51.5,16,39,21,18,48,107,143,0,"https://fbref.com/en/players/bee704fc/Nikola-Milenkovic"
"846","Kevin Mirallas_2019",2019,"Fiorentina","Serie A","Kevin Mirallas","BEL","FW,MF","30",1987,14.4,17,7,8,4,5,6,15,40,9,17,0,17,4,21,10,0,"https://fbref.com/en/players/aa51343f/Kevin-Mirallas"
"847","Cristóbal Montiel_2019",2019,"Fiorentina","Serie A","Cristóbal Montiel","ESP","FW","18",2000,0.1,0,0,0,0,0,0,0,NA,0,0,0,0,0,0,0,0,"https://fbref.com/en/players/dd52d069/Cristobal-Montiel"
"848","Luis Muriel_2019",2019,"Fiorentina","Serie A","Luis Muriel","COL","FW","27",1991,16,19,11,4,13,2,6,18,33.3,12,10,0,10,3,22,1,0,"https://fbref.com/en/players/eb2fe5b6/Luis-Muriel"
"849","Christian Nørgaard_2019",2019,"Fiorentina","Serie A","Christian Nørgaard","DEN","MF","24",1994,3.6,4,2,1,2,1,2,5,40,3,2,0,2,10,14,16,0,"https://fbref.com/en/players/df0a4c90/Christian-Norgaard"
"850","Germán Pezzella_2019",2019,"Fiorentina","Serie A","Germán Pezzella","ARG","DF","27",1991,31.7,56,36,42,13,1,31,51,60.8,20,42,30,12,60,116,159,1,"https://fbref.com/en/players/8c725b43/German-Pezzella"
"851","Marko Pjaca_2019",2019,"Fiorentina","Serie A","Marko Pjaca","CRO","FW,MF","23",1995,8.3,9,4,3,4,2,2,6,33.3,4,2,0,2,7,16,6,0,"https://fbref.com/en/players/2c38b327/Marko-Pjaca"
"852","Giovanni Simeone_2019",2019,"Fiorentina","Serie A","Giovanni Simeone","ARG","FW","23",1995,27.3,43,27,10,23,10,7,29,24.1,22,26,2,24,4,47,14,0,"https://fbref.com/en/players/343c0d52/Giovanni-Simeone"
"853","Riccardo Sottil_2019",2019,"Fiorentina","Serie A","Riccardo Sottil","ITA","FW,MF","19",1999,0.2,1,1,0,1,0,1,1,100,0,0,0,0,0,1,0,0,"https://fbref.com/en/players/94816803/Riccardo-Sottil"
"854","Pietro Terracciano_2019",2019,"Fiorentina","Serie A","Pietro Terracciano","ITA","GK","28",1990,2,0,0,0,0,0,0,0,NA,0,0,0,0,0,0,1,1,"https://fbref.com/en/players/e1b0a70d/Pietro-Terracciano"
"855","Cyril Théréau_2019",2019,"Fiorentina","Serie A","Cyril Théréau","FRA","FW,MF","35",1983,0.3,0,0,0,0,0,0,0,NA,0,0,0,0,0,0,1,0,"https://fbref.com/en/players/4d3ab428/Cyril-Thereau"
"856","Jordan Veretout_2019",2019,"Fiorentina","Serie A","Jordan Veretout","FRA","MF","25",1993,32.7,64,40,22,31,11,21,52,40.4,31,33,7,26,46,110,54,2,"https://fbref.com/en/players/4a56052c/Jordan-Veretout"
"857","Dušan Vlahović_2019",2019,"Fiorentina","Serie A","Dušan Vlahović","SRB","FW","18",2000,1.8,0,0,0,0,0,0,0,NA,0,2,0,2,0,0,4,0,"https://fbref.com/en/players/79443529/Dusan-Vlahovic"
"858","Amir Abrashi_2019",2019,"Freiburg","Bundesliga","Amir Abrashi","ALB","MF","28",1990,8.8,20,11,7,10,3,6,19,31.6,13,11,3,8,14,34,15,0,"https://fbref.com/en/players/1c08a3c8/Amir-Abrashi"
"859","Christoph Daferner_2019",2019,"Freiburg","Bundesliga","Christoph Daferner","GER","FW","20",1998,0.3,1,0,1,0,0,0,0,NA,0,0,0,0,1,2,0,0,"https://fbref.com/en/players/e5be34dd/Christoph-Daferner"
"860","Mark Flekken_2019",2019,"Freiburg","Bundesliga","Mark Flekken","NED","GK","25",1993,1,0,0,0,0,0,0,0,NA,0,0,0,0,0,0,0,0,"https://fbref.com/en/players/a92ab7be/Mark-Flekken"
"861","Mike Frantz_2019",2019,"Freiburg","Bundesliga","Mike Frantz","GER","MF,FW","31",1986,24.6,34,26,15,15,4,6,20,30,14,24,4,20,21,55,32,0,"https://fbref.com/en/players/482b70ad/Mike-Frantz"
"862","Jérôme Gondorf_2019",2019,"Freiburg","Bundesliga","Jérôme Gondorf","GER","MF,FW","30",1988,14.4,33,18,12,19,2,14,28,50,14,29,5,24,19,52,23,1,"https://fbref.com/en/players/49ffe0f2/Jerome-Gondorf"
"863","Vincenzo Grifo_2019",2019,"Freiburg","Bundesliga","Vincenzo Grifo","ITA","MF,FW","25",1993,15.9,26,14,11,8,7,14,27,51.9,13,10,1,9,2,28,10,0,"https://fbref.com/en/players/54e4866f/Vincenzo-Grifo"
"864","Manuel Gulde_2019",2019,"Freiburg","Bundesliga","Manuel Gulde","GER","DF","27",1991,19,24,16,18,5,1,12,16,75,4,25,13,12,26,50,90,0,"https://fbref.com/en/players/25ab9c9c/Manuel-Gulde"
"865","Christian Günter_2019",2019,"Freiburg","Bundesliga","Christian Günter","GER","DF,MF","25",1993,32,38,26,16,16,6,20,43,46.5,23,31,7,24,14,52,55,0,"https://fbref.com/en/players/8593f88c/Christian-Gunter"
"866","Janik Haberer_2019",2019,"Freiburg","Bundesliga","Janik Haberer","GER","MF,FW","24",1994,26,71,47,37,24,10,30,75,40,45,31,4,27,36,107,49,0,"https://fbref.com/en/players/70dcf94d/Janik-Haberer"
"867","Dominique Heintz_2019",2019,"Freiburg","Bundesliga","Dominique Heintz","GER","DF","24",1993,33.9,41,21,34,6,1,18,32,56.3,14,45,22,23,45,86,214,0,"https://fbref.com/en/players/699fb8db/Dominique-Heintz"
"868","Nicolas Höfler_2019",2019,"Freiburg","Bundesliga","Nicolas Höfler","GER","MF","28",1990,17.9,45,22,19,22,4,14,36,38.9,22,21,4,17,32,77,41,0,"https://fbref.com/en/players/5d8e331f/Nicolas-Hofler"
"869","Lucas Höler_2019",2019,"Freiburg","Bundesliga","Lucas Höler","GER","FW","24",1994,11.2,18,13,6,9,3,4,18,22.2,14,10,1,9,3,21,15,2,"https://fbref.com/en/players/ca618d23/Lucas-Holer"
"870","Patrick Kammerbauer_2019",2019,"Freiburg","Bundesliga","Patrick Kammerbauer","GER","FW","21",1997,0,0,0,0,0,0,0,0,NA,0,0,0,0,1,1,1,0,"https://fbref.com/en/players/8bdcb6fd/Patrick-Kammerbauer"
"871","Tim Kleindienst_2019",2019,"Freiburg","Bundesliga","Tim Kleindienst","GER","FW","22",1995,2.2,4,3,1,2,1,1,3,33.3,2,3,0,3,0,4,7,0,"https://fbref.com/en/players/258a6f4d/Tim-Kleindienst"
"872","Robin Koch_2019",2019,"Freiburg","Bundesliga","Robin Koch","GER","MF,DF","22",1996,21.1,25,14,17,7,1,7,24,29.2,17,31,18,13,32,57,77,4,"https://fbref.com/en/players/ea6bc03a/Robin-Koch"
"873","Lukas Kübler_2019",2019,"Freiburg","Bundesliga","Lukas Kübler","GER","DF,MF","25",1992,13.2,35,22,23,12,0,16,26,61.5,10,15,5,10,30,65,50,1,"https://fbref.com/en/players/2a29eb9b/Lukas-Kubler"
"874","Philipp Lienhart_2019",2019,"Freiburg","Bundesliga","Philipp Lienhart","AUT","DF","22",1996,6.8,6,6,4,2,0,3,6,50,3,9,7,2,11,17,42,0,"https://fbref.com/en/players/302527b2/Philipp-Lienhart"
"875","Florian Niederlechner_2019",2019,"Freiburg","Bundesliga","Florian Niederlechner","GER","FW,MF","27",1990,10.8,7,5,1,4,2,0,5,0,5,12,4,8,6,13,10,0,"https://fbref.com/en/players/d6862409/Florian-Niederlechner"
"876","Chima Okoroji_2019",2019,"Freiburg","Bundesliga","Chima Okoroji","NGA","DF,MF","21",1997,1.2,3,0,1,1,1,1,1,100,0,0,0,0,1,4,1,0,"https://fbref.com/en/players/d453346c/Chima-Okoroji"
"877","Nils Petersen_2019",2019,"Freiburg","Bundesliga","Nils Petersen","GER","FW","29",1988,21.4,29,21,10,16,3,4,24,16.7,20,28,2,26,13,42,34,0,"https://fbref.com/en/players/f93e6e94/Nils-Petersen"
"878","Yoric Ravet_2019",2019,"Freiburg","Bundesliga","Yoric Ravet","FRA","FW,MF","28",1989,0.8,2,1,1,0,1,1,2,50,1,2,1,1,0,2,1,0,"https://fbref.com/en/players/4d74201d/Yoric-Ravet"
"879","Roland Sallai_2019",2019,"Freiburg","Bundesliga","Roland Sallai","HUN","MF","21",1997,5.9,12,7,5,5,2,5,13,38.5,8,3,0,3,3,15,8,0,"https://fbref.com/en/players/bf075f6b/Roland-Sallai"
"880","Keven Schlotterbeck_2019",2019,"Freiburg","Bundesliga","Keven Schlotterbeck","GER","DF","21",1997,8.6,22,16,19,2,1,8,12,66.7,4,17,11,6,13,35,26,0,"https://fbref.com/en/players/f6bdc830/Keven-Schlotterbeck"
"881","Nico Schlotterbeck_2019",2019,"Freiburg","Bundesliga","Nico Schlotterbeck","GER","DF","18",1999,2.5,6,6,6,0,0,2,2,100,0,3,1,2,5,11,10,0,"https://fbref.com/en/players/34e12499/Nico-Schlotterbeck"
"882","Alexander Schwolow_2019",2019,"Freiburg","Bundesliga","Alexander Schwolow","GER","GK","26",1992,33,0,0,0,0,0,0,1,0,1,0,0,0,0,0,13,2,"https://fbref.com/en/players/0d55d942/Alexander-Schwolow"
"883","Pascal Stenzel_2019",2019,"Freiburg","Bundesliga","Pascal Stenzel","GER","DF,MF","22",1996,16.1,42,26,26,14,2,24,43,55.8,19,16,3,13,30,72,48,1,"https://fbref.com/en/players/99f7e9aa/Pascal-Stenzel"
"884","Marco Terrazzino_2019",2019,"Freiburg","Bundesliga","Marco Terrazzino","GER","MF,FW","27",1991,5.7,6,3,4,2,0,1,7,14.3,6,5,2,3,3,9,2,0,"https://fbref.com/en/players/7e689867/Marco-Terrazzino"
"885","Luca Waldschmidt_2019",2019,"Freiburg","Bundesliga","Luca Waldschmidt","GER","FW,MF","22",1996,19.1,20,13,7,10,3,2,20,10,18,20,3,17,13,33,8,1,"https://fbref.com/en/players/e5a35ae9/Luca-Waldschmidt"
"886","Joaquín Ardaiz_2019",2019,"Frosinone","Serie A","Joaquín Ardaiz","URU","FW","19",1999,0.2,0,0,0,0,0,0,0,NA,0,0,0,0,0,0,0,0,"https://fbref.com/en/players/eb823875/Joaquin-Ardaiz"
"887","Lorenzo Ariaudo_2019",2019,"Frosinone","Serie A","Lorenzo Ariaudo","ITA","DF","29",1989,18.7,20,14,15,4,1,6,10,60,4,31,20,11,14,34,103,0,"https://fbref.com/en/players/68b78c2a/Lorenzo-Ariaudo"
"888","Francesco Bardi_2019",2019,"Frosinone","Serie A","Francesco Bardi","ITA","GK","26",1992,3,0,0,0,0,0,0,0,NA,0,0,0,0,0,0,2,0,"https://fbref.com/en/players/0acda699/Francesco-Bardi"
"889","Andrea Beghetto_2019",2019,"Frosinone","Serie A","Andrea Beghetto","ITA","DF","23",1994,24.7,26,14,13,10,3,15,25,60,10,20,4,16,17,43,59,0,"https://fbref.com/en/players/438dfc6a/Andrea-Beghetto"
"890","Nicolò Brighenti_2019",2019,"Frosinone","Serie A","Nicolò Brighenti","ITA","DF","28",1989,11,27,17,9,15,3,6,14,42.9,8,17,8,9,31,58,37,0,"https://fbref.com/en/players/54c356b0/Nicolo-Brighenti"
"891","Joel Campbell_2019",2019,"Frosinone","Serie A","Joel Campbell","CRC","FW,MF","26",1992,9.9,15,10,5,8,2,3,17,17.6,14,2,0,2,3,18,2,1,"https://fbref.com/en/players/895ff3ca/Joel-Campbell"
"892","Marco Capuano_2019",2019,"Frosinone","Serie A","Marco Capuano","ITA","DF","26",1991,25.6,53,33,37,15,1,26,46,56.5,20,44,31,13,34,87,101,2,"https://fbref.com/en/players/616aea37/Marco-Capuano"
"893","Francesco Cassata_2019",2019,"Frosinone","Serie A","Francesco Cassata","ITA","MF","21",1997,12.5,20,11,12,4,4,9,23,39.1,14,8,1,7,6,26,15,1,"https://fbref.com/en/players/96960855/Francesco-Cassata"
"894","Raman Chibsah_2019",2019,"Frosinone","Serie A","Raman Chibsah","GHA","MF","25",1993,29.1,46,27,25,19,2,16,54,29.6,38,45,10,35,32,78,28,1,"https://fbref.com/en/players/aa5a409a/Raman-Chibsah"
"895","Camillo Ciano_2019",2019,"Frosinone","Serie A","Camillo Ciano","ITA","FW,MF","28",1990,27.3,33,15,12,10,11,8,50,16,42,28,4,24,8,41,16,0,"https://fbref.com/en/players/2114abf9/Camillo-Ciano"
"896","Daniel Ciofani_2019",2019,"Frosinone","Serie A","Daniel Ciofani","ITA","FW","33",1985,18,8,6,2,5,1,3,7,42.9,4,4,0,4,3,11,9,0,"https://fbref.com/en/players/b09a3ecc/Daniel-Ciofani"
"897","Lorenzo Crisetig_2019",2019,"Frosinone","Serie A","Lorenzo Crisetig","ITA","MF","25",1993,5.6,14,11,4,8,2,6,15,40,9,8,3,5,12,26,12,0,"https://fbref.com/en/players/f54dfca8/Lorenzo-Crisetig"
"898","Federico Dionisi_2019",2019,"Frosinone","Serie A","Federico Dionisi","ITA","FW,MF","31",1987,2.3,3,1,0,2,1,0,2,0,2,0,0,0,0,3,0,0,"https://fbref.com/en/players/a74d2999/Federico-Dionisi"
"899","Paolo Ghiglione_2019",2019,"Frosinone","Serie A","Paolo Ghiglione","ITA","DF","21",1997,5.7,8,4,6,1,1,6,14,42.9,8,2,0,2,4,12,22,0,"https://fbref.com/en/players/71dc23da/Paolo-Ghiglione"
"900","Edoardo Goldaniga_2019",2019,"Frosinone","Serie A","Edoardo Goldaniga","ITA","DF","24",1993,29,43,28,34,7,2,19,32,59.4,13,29,16,13,57,100,119,0,"https://fbref.com/en/players/4b029b31/Edoardo-Goldaniga"
"901","Mirko Gori_2019",2019,"Frosinone","Serie A","Mirko Gori","ITA","MF","25",1993,3.7,16,13,7,9,0,5,16,31.3,11,2,0,2,4,20,9,0,"https://fbref.com/en/players/7d86864c/Mirko-Gori"
"902","Emil Hallfreðsson_2019",2019,"Frosinone","Serie A","Emil Hallfreðsson","ISL","MF","34",1984,4.4,10,6,5,4,1,0,9,0,9,4,1,3,2,12,3,0,"https://fbref.com/en/players/86015b20/Emil-Hallfredsson"
"903","Luka Krajnc_2019",2019,"Frosinone","Serie A","Luka Krajnc","SVN","DF","23",1994,8.8,10,8,6,3,1,5,6,83.3,1,11,3,8,11,21,42,0,"https://fbref.com/en/players/2b71b88a/Luka-Krajnc"
"904","Raffaele Maiello_2019",2019,"Frosinone","Serie A","Raffaele Maiello","ITA","MF","27",1991,22.7,42,27,30,8,4,16,27,59.3,11,23,10,13,30,72,41,0,"https://fbref.com/en/players/02febfdc/Raffaele-Maiello"
"905","Luca Matarese_2019",2019,"Frosinone","Serie A","Luca Matarese","ITA","FW","20",1998,0.2,0,0,0,0,0,0,0,NA,0,0,0,0,0,0,0,0,"https://fbref.com/en/players/a6fc1a22/Luca-Matarese"
"906","Cristian Molinaro_2019",2019,"Frosinone","Serie A","Cristian Molinaro","ITA","DF,MF","35",1983,12.9,15,10,7,7,1,3,9,33.3,6,11,4,7,15,30,43,0,"https://fbref.com/en/players/1c8c5aed/Cristian-Molinaro"
"907","Luca Paganini_2019",2019,"Frosinone","Serie A","Luca Paganini","ITA","DF,MF","25",1993,12.5,25,13,8,13,4,8,23,34.8,15,19,4,15,19,44,17,1,"https://fbref.com/en/players/e5b98a70/Luca-Paganini"
"908","Stipe Perica_2019",2019,"Frosinone","Serie A","Stipe Perica","CRO","FW","23",1995,5.3,5,3,2,2,1,1,3,33.3,2,3,1,2,0,5,4,0,"https://fbref.com/en/players/269b4638/Stipe-Perica"
"909","Andrea Pinamonti_2019",2019,"Frosinone","Serie A","Andrea Pinamonti","ITA","FW","19",1999,18.1,14,6,6,5,3,4,20,20,16,16,3,13,5,19,17,0,"https://fbref.com/en/players/08aa9cd1/Andrea-Pinamonti"
"910","Bartosz Salamon_2019",2019,"Frosinone","Serie A","Bartosz Salamon","POL","DF","27",1991,19.2,17,10,12,5,0,6,14,42.9,8,27,19,8,27,44,143,1,"https://fbref.com/en/players/9b30df1e/Bartosz-Salamon"
"911","Paolo Sammarco_2019",2019,"Frosinone","Serie A","Paolo Sammarco","ITA","MF","35",1983,6.1,16,7,7,6,3,6,9,66.7,3,5,0,5,3,19,1,2,"https://fbref.com/en/players/3c1e4e84/Paolo-Sammarco"
"912","Danilo Soddimo_2019",2019,"Frosinone","Serie A","Danilo Soddimo","ITA","MF,FW","30",1987,2.8,11,9,3,6,2,3,6,50,3,2,1,1,7,18,3,0,"https://fbref.com/en/players/098139eb/Danilo-Soddimo"
"913","Marco Sportiello_2019",2019,"Frosinone","Serie A","Marco Sportiello","ITA","GK","26",1992,35,1,0,1,0,0,1,1,100,0,1,0,1,0,1,8,2,"https://fbref.com/en/players/ac4003af/Marco-Sportiello"
"914","Marcello Trotta_2019",2019,"Frosinone","Serie A","Marcello Trotta","ITA","FW","25",1992,4.4,7,6,2,4,1,1,3,33.3,2,2,1,1,3,10,3,0,"https://fbref.com/en/players/acdad0aa/Marcello-Trotta"
"915","Luca Valzania_2019",2019,"Frosinone","Serie A","Luca Valzania","ITA","MF","22",1996,10,21,12,7,10,4,13,33,39.4,20,18,0,18,16,37,8,1,"https://fbref.com/en/players/2b28ba9f/Luca-Valzania"
"916","Federico Viviani_2019",2019,"Frosinone","Serie A","Federico Viviani","ITA","MF","26",1992,3.7,6,5,2,3,1,3,8,37.5,5,6,3,3,8,14,2,0,"https://fbref.com/en/players/2258c078/Federico-Viviani"
"917","Rai Vloet_2019",2019,"Frosinone","Serie A","Rai Vloet","NED","MF","23",1995,1.4,4,2,1,2,1,0,3,0,3,4,0,4,0,4,1,0,"https://fbref.com/en/players/b32e8c5f/Rai-Vloet"
"918","Francesco Zampano_2019",2019,"Frosinone","Serie A","Francesco Zampano","ITA","DF,MF","24",1993,23.4,35,25,23,9,3,15,31,48.4,16,24,4,20,13,48,48,0,"https://fbref.com/en/players/8e45910b/Francesco-Zampano"
"919","Floyd Ayité_2019",2019,"Fulham","Premier League","Floyd Ayité","TOG","FW,MF","29",1988,5.3,4,4,2,1,1,2,6,33.3,4,8,1,7,7,11,5,0,"https://fbref.com/en/players/fd5888a0/Floyd-Ayite"
"920","Ryan Babel_2019",2019,"Fulham","Premier League","Ryan Babel","NED","FW,MF","31",1986,13.9,8,4,1,5,2,3,9,33.3,6,12,0,12,6,14,13,1,"https://fbref.com/en/players/6438d426/Ryan-Babel"
"921","Marcus Bettinelli_2019",2019,"Fulham","Premier League","Marcus Bettinelli","ENG","GK","26",1992,7,0,0,0,0,0,0,0,NA,0,0,0,0,0,0,5,0,"https://fbref.com/en/players/0d85a4e8/Marcus-Bettinelli"
"922","Joe Bryan_2019",2019,"Fulham","Premier League","Joe Bryan","ENG","DF,MF","24",1993,26.1,61,41,35,21,5,24,42,57.1,18,34,12,22,31,92,82,1,"https://fbref.com/en/players/af69e7f0/Joe-Bryan"
"923","Tom Cairney_2019",2019,"Fulham","Premier League","Tom Cairney","SCO","MF,FW","27",1991,24.4,37,21,9,22,6,12,16,75,4,21,5,16,10,47,13,1,"https://fbref.com/en/players/a8748947/Tom-Cairney"
"924","Calum Chambers_2019",2019,"Fulham","Premier League","Calum Chambers","ENG","MF,DF","23",1995,28.8,64,36,32,27,5,16,48,33.3,32,37,12,25,69,133,113,4,"https://fbref.com/en/players/dc6f5bdd/Calum-Chambers"
"925","Cyrus Christie_2019",2019,"Fulham","Premier League","Cyrus Christie","IRL","DF,MF","25",1992,21.6,43,23,26,13,4,18,41,43.9,23,25,11,14,29,72,96,1,"https://fbref.com/en/players/7eb67dad/Cyrus-Christie"
"926","Ibrahima Cissé_2019",2019,"Fulham","Premier League","Ibrahima Cissé","GUI","MF","24",1994,1,0,0,0,0,0,0,1,0,1,0,0,0,3,3,4,0,"https://fbref.com/en/players/be4fede9/Ibrahima-Cisse"
"927","Harvey Elliott_2019",2019,"Fulham","Premier League","Harvey Elliott","ENG","MF","15",2003,0.2,0,0,0,0,0,0,0,NA,0,1,0,1,0,0,0,0,"https://fbref.com/en/players/c8387671/Harvey-Elliott"
"928","Fabricio_2019",2019,"Fulham","Premier League","Fabricio","ESP","GK","30",1987,2,1,1,1,0,0,0,0,NA,0,0,0,0,0,1,3,2,"https://fbref.com/en/players/af245161/Fabricio"
"929","Timothy Fosu-Mensah_2019",2019,"Fulham","Premier League","Timothy Fosu-Mensah","NED","DF","20",1998,8.8,18,7,12,6,0,8,13,61.5,5,11,5,6,12,30,30,1,"https://fbref.com/en/players/a9142dc3/Timothy-Fosu-Mensah"
"930","Stefan Johansen_2019",2019,"Fulham","Premier League","Stefan Johansen","NOR","MF","27",1991,4.6,11,3,4,7,0,5,8,62.5,3,5,0,5,3,14,6,0,"https://fbref.com/en/players/a48da055/Stefan-Johansen"
"931","Aboubakar Kamara_2019",2019,"Fulham","Premier League","Aboubakar Kamara","MTN","FW","23",1995,7.7,8,4,1,5,2,3,7,42.9,4,6,0,6,1,9,6,0,"https://fbref.com/en/players/4047c976/Aboubakar-Kamara"
"932","Neeskens Kebano_2019",2019,"Fulham","Premier League","Neeskens Kebano","COD","FW,MF","26",1992,1.2,3,1,2,1,0,1,1,100,0,3,0,3,0,3,3,0,"https://fbref.com/en/players/18b999f4/Neeskens-Kebano"
"933","Maxime Le Marchand_2019",2019,"Fulham","Premier League","Maxime Le Marchand","FRA","DF","28",1989,25,56,36,45,11,0,23,47,48.9,24,30,16,14,54,110,129,2,"https://fbref.com/en/players/321a71a7/Maxime-Le-Marchand"
"934","Lazar Marković_2019",2019,"Fulham","Premier League","Lazar Marković","SRB","MF","24",1994,0.5,0,0,0,0,0,0,0,NA,0,0,0,0,0,0,2,0,"https://fbref.com/en/players/723ba189/Lazar-Markovic"
"935","Alfie Mawson_2019",2019,"Fulham","Premier League","Alfie Mawson","ENG","DF","24",1994,12.6,11,7,7,4,0,6,10,60,4,20,17,3,19,30,64,1,"https://fbref.com/en/players/d368feb8/Alfie-Mawson"
"936","Kevin McDonald_2019",2019,"Fulham","Premier League","Kevin McDonald","SCO","MF","29",1988,9.3,15,11,6,8,1,5,13,38.5,8,8,2,6,9,24,22,0,"https://fbref.com/en/players/71a08f97/Kevin-McDonald"
"937","Aleksandar Mitrović_2019",2019,"Fulham","Premier League","Aleksandar Mitrović","SRB","FW","23",1994,36.4,19,9,3,13,3,5,15,33.3,10,22,8,14,6,25,53,0,"https://fbref.com/en/players/3925dbd6/Aleksandar-Mitrovic"
"938","Håvard Nordtveit_2019",2019,"Fulham","Premier League","Håvard Nordtveit","NOR","DF","28",1990,4,9,4,8,1,0,4,5,80,1,3,3,0,8,17,15,1,"https://fbref.com/en/players/6cafd68d/Havard-Nordtveit"
"939","Denis Odoi_2019",2019,"Fulham","Premier League","Denis Odoi","GHA","DF","30",1988,28.8,48,34,29,16,3,21,33,63.6,12,45,24,21,42,90,153,0,"https://fbref.com/en/players/f7750aa0/Denis-Odoi"
"940","Tim Ream_2019",2019,"Fulham","Premier League","Tim Ream","USA","DF","30",1987,22.7,23,14,16,7,0,14,28,50,14,19,10,9,25,48,80,2,"https://fbref.com/en/players/28b40c9c/Tim-Ream"
"941","Sergio Rico_2019",2019,"Fulham","Premier League","Sergio Rico","ESP","GK","24",1993,29,1,1,1,0,0,1,1,100,0,0,0,0,1,2,13,5,"https://fbref.com/en/players/5f0241b2/Sergio-Rico"
"942","André Schürrle_2019",2019,"Fulham","Premier League","André Schürrle","GER","FW,MF","27",1990,18.2,30,19,14,10,6,12,42,28.6,30,16,1,15,8,38,17,1,"https://fbref.com/en/players/ecbb3fdf/Andre-Schurrle"
"943","Jean Seri_2019",2019,"Fulham","Premier League","Jean Seri","CIV","MF","27",1991,24.9,41,28,20,20,1,13,45,28.9,32,40,9,31,32,73,17,4,"https://fbref.com/en/players/10efd0e1/Jean-Seri"
"944","Ryan Sessegnon_2019",2019,"Fulham","Premier League","Ryan Sessegnon","ENG","FW,DF","18",2000,25.6,22,14,8,8,6,6,22,27.3,16,25,2,23,19,41,49,1,"https://fbref.com/en/players/6aa3e78b/Ryan-Sessegnon"
"945","Luciano Vietto_2019",2019,"Fulham","Premier League","Luciano Vietto","ARG","FW,MF","24",1993,11,15,11,5,5,5,4,19,21.1,15,9,0,9,6,21,5,0,"https://fbref.com/en/players/2513a588/Luciano-Vietto"
"946","Andre-Frank Zambo Anguissa_2019",2019,"Fulham","Premier League","Andre-Frank Zambo Anguissa","CMR","MF","22",1995,16.9,48,29,23,20,5,18,52,34.6,34,25,6,19,34,82,32,0,"https://fbref.com/en/players/6bb2c084/Andre-Frank-Zambo-Anguissa"
"947","Daniel Bessa_2019",2019,"Genoa","Serie A","Daniel Bessa","ITA","MF","25",1993,27.1,60,35,28,23,9,11,39,28.2,28,30,4,26,19,79,16,1,"https://fbref.com/en/players/88895312/Daniel-Bessa"
"948","Davide Biraschi_2019",2019,"Genoa","Serie A","Davide Biraschi","ITA","DF","24",1994,31.6,58,38,37,19,2,25,42,59.5,17,32,13,19,64,122,107,1,"https://fbref.com/en/players/64cd167d/Davide-Biraschi"
"949","Domenico Criscito_2019",2019,"Genoa","Serie A","Domenico Criscito","ITA","DF","31",1986,34.1,111,75,64,36,11,57,83,68.7,26,40,11,29,70,181,142,0,"https://fbref.com/en/players/35dd6d80/Domenico-Criscito"
"950","Nicola Dalmonte_2019",2019,"Genoa","Serie A","Nicola Dalmonte","ITA","FW,MF","20",1997,0.5,2,2,0,2,0,0,0,NA,0,0,0,0,0,2,0,0,"https://fbref.com/en/players/59a3efba/Nicola-Dalmonte"
"951","Andrea Favilli_2019",2019,"Genoa","Serie A","Andrea Favilli","ITA","FW,DF","21",1997,1.9,1,1,0,0,1,0,1,0,1,1,0,1,0,1,1,0,"https://fbref.com/en/players/44510fde/Andrea-Favilli"
"952","Koray Günter_2019",2019,"Genoa","Serie A","Koray Günter","GER","DF","23",1994,9.3,18,13,13,3,2,9,16,56.3,7,9,7,2,18,36,34,0,"https://fbref.com/en/players/f1f1f238/Koray-Gunter"
"953","Oscar Hiljemark_2019",2019,"Genoa","Serie A","Oscar Hiljemark","SWE","MF","26",1992,13.3,16,9,8,7,1,5,16,31.3,11,13,3,10,13,29,14,0,"https://fbref.com/en/players/98e958af/Oscar-Hiljemark"
"954","Jandrei_2019",2019,"Genoa","Serie A","Jandrei","BRA","GK","25",1993,1,0,0,0,0,0,0,1,0,1,0,0,0,0,0,0,0,"https://fbref.com/en/players/85ea4399/Jandrei"
"955","Christian Kouamé_2019",2019,"Genoa","Serie A","Christian Kouamé","CIV","FW","20",1997,34.1,31,22,8,16,7,2,13,15.4,11,23,3,20,25,56,28,0,"https://fbref.com/en/players/58e933d2/Christian-Kouame"
"956","Gianluca Lapadula_2019",2019,"Genoa","Serie A","Gianluca Lapadula","PER","FW","28",1990,4.5,2,1,2,0,0,1,5,20,4,2,0,2,1,3,2,0,"https://fbref.com/en/players/2ead2809/Gianluca-Lapadula"
"957","Darko Lazović_2019",2019,"Genoa","Serie A","Darko Lazović","SRB","DF,FW","27",1990,28.2,28,17,13,8,7,14,31,45.2,17,21,6,15,20,48,33,0,"https://fbref.com/en/players/5128bde4/Darko-Lazovic"
"958","Lukas Lerager_2019",2019,"Genoa","Serie A","Lukas Lerager","DEN","MF","25",1993,12.5,34,18,12,20,2,13,42,31,29,11,1,10,18,52,12,0,"https://fbref.com/en/players/1b82f8df/Lukas-Lerager"
"959","Federico Marchetti_2019",2019,"Genoa","Serie A","Federico Marchetti","ITA","GK","35",1983,4,0,0,0,0,0,0,0,NA,0,0,0,0,0,0,1,0,"https://fbref.com/en/players/f794b426/Federico-Marchetti"
"960","Luca Mazzitelli_2019",2019,"Genoa","Serie A","Luca Mazzitelli","ITA","MF","22",1995,3.6,5,2,3,1,1,2,3,66.7,1,4,1,3,6,11,7,0,"https://fbref.com/en/players/dc61b402/Luca-Mazzitelli"
"961","Iuri Medeiros_2019",2019,"Genoa","Serie A","Iuri Medeiros","POR","MF,FW","24",1994,1.2,2,2,0,1,1,1,2,50,1,2,0,2,0,2,1,0,"https://fbref.com/en/players/97e2aa67/Iuri-Medeiros"
"962","Stephane Omeonga_2019",2019,"Genoa","Serie A","Stephane Omeonga","BEL","MF","22",1996,0.6,1,1,1,0,0,0,1,0,1,1,0,1,0,1,2,0,"https://fbref.com/en/players/72c803a0/Stephane-Omeonga"
"963","Goran Pandev_2019",2019,"Genoa","Serie A","Goran Pandev","MKD","FW,MF","35",1983,12.5,14,10,0,10,4,2,8,25,6,7,0,7,1,15,3,0,"https://fbref.com/en/players/d711d04f/Goran-Pandev"
"964","Pedro Pereira_2019",2019,"Genoa","Serie A","Pedro Pereira","POR","DF,FW","20",1998,15.4,20,14,15,2,3,11,19,57.9,8,10,5,5,14,34,55,1,"https://fbref.com/en/players/c77be0cf/Pedro-Pereira"
"965","Giuseppe Pezzella_2019",2019,"Genoa","Serie A","Giuseppe Pezzella","ITA","DF,MF","20",1997,1.2,2,1,1,1,0,0,0,NA,0,1,0,1,1,3,4,0,"https://fbref.com/en/players/149c5f5d/Giuseppe-Pezzella"
"966","Krzysztof Piątek_2019",2019,"Genoa","Serie A","Krzysztof Piątek","POL","FW","23",1995,17.7,9,4,2,5,2,1,15,6.7,14,18,3,15,3,12,19,0,"https://fbref.com/en/players/17f3620a/Krzysztof-Piatek"
"967","Ivan Radovanović_2019",2019,"Genoa","Serie A","Ivan Radovanović","SRB","MF","29",1988,14.2,20,12,11,8,1,8,17,47.1,9,12,4,8,13,33,20,1,"https://fbref.com/en/players/023937a9/Ivan-Radovanovic"
"968","Ionuț Radu_2019",2019,"Genoa","Serie A","Ionuț Radu","ROU","GK","21",1997,33,0,0,0,0,0,0,1,0,1,0,0,0,1,1,11,4,"https://fbref.com/en/players/67f649be/Ionut-Radu"
"969","Esteban Rolón_2019",2019,"Genoa","Serie A","Esteban Rolón","ARG","MF","23",1995,11.6,46,29,14,20,12,20,44,45.5,24,18,2,16,16,62,12,0,"https://fbref.com/en/players/10e25802/Esteban-Rolon"
"970","Cristian Romero_2019",2019,"Genoa","Serie A","Cristian Romero","ARG","DF","20",1998,26,61,35,38,18,5,27,40,67.5,13,49,27,22,37,98,128,1,"https://fbref.com/en/players/a3d94a58/Cristian-Romero"
"971","Rômulo_2019",2019,"Genoa","Serie A","Rômulo","ITA","MF,FW","31",1987,15,26,18,9,10,7,7,17,41.2,10,16,3,13,18,44,20,0,"https://fbref.com/en/players/07abb358/Romulo"
"972","Antonio Sanabria_2019",2019,"Genoa","Serie A","Antonio Sanabria","PAR","FW","22",1996,8.5,6,3,1,1,4,0,1,0,1,8,0,8,4,10,3,0,"https://fbref.com/en/players/0a447501/Antonio-Sanabria"
"973","Sandro_2019",2019,"Genoa","Serie A","Sandro","BRA","MF","29",1989,7.9,27,17,12,11,4,9,17,52.9,8,9,4,5,20,47,25,0,"https://fbref.com/en/players/c1c2c925/Sandro"
"974","Nicolás Spolli_2019",2019,"Genoa","Serie A","Nicolás Spolli","ARG","DF","35",1983,6,7,6,3,4,0,0,2,0,2,8,6,2,7,14,39,1,"https://fbref.com/en/players/9a560ebe/Nicolas-Spolli"
"975","Stefano Sturaro_2019",2019,"Genoa","Serie A","Stefano Sturaro","ITA","MF,FW","25",1993,2.4,4,3,0,3,1,2,9,22.2,7,3,1,2,3,7,2,0,"https://fbref.com/en/players/2334478a/Stefano-Sturaro"
"976","Miguel Veloso_2019",2019,"Genoa","Serie A","Miguel Veloso","POR","MF","32",1986,14,31,20,14,13,4,9,26,34.6,17,12,1,11,13,44,21,0,"https://fbref.com/en/players/ab1ca213/Miguel-Veloso"
"977","Ervin Zukanović_2019",2019,"Genoa","Serie A","Ervin Zukanović","BIH","DF","31",1987,21.8,28,16,20,7,1,17,30,56.7,13,17,9,8,19,47,96,0,"https://fbref.com/en/players/1253a12e/Ervin-Zukanovic"
"978","Iván Alejo_2019",2019,"Getafe","La Liga","Iván Alejo","ESP","MF","23",1995,1.6,2,0,0,2,0,0,4,0,4,2,0,2,0,2,3,0,"https://fbref.com/en/players/3d7e48ce/Ivan-Alejo"
"979","Amath_2019",2019,"Getafe","La Liga","Amath","SEN","MF","22",1996,11.1,20,13,7,11,2,6,27,22.2,21,17,0,17,10,30,12,0,"https://fbref.com/en/players/f3b1d9a2/Amath"
"980","Vitorino Antunes_2019",2019,"Getafe","La Liga","Vitorino Antunes","POR","DF,MF","31",1987,24.2,41,26,22,17,2,27,45,60,18,33,7,26,43,84,75,1,"https://fbref.com/en/players/3e4f735d/Vitorino-Antunes"
"981","Mauro Arambarri_2019",2019,"Getafe","La Liga","Mauro Arambarri","URU","MF","22",1995,29.7,59,33,18,37,4,23,76,30.3,53,44,9,35,30,89,36,0,"https://fbref.com/en/players/58afe001/Mauro-Arambarri"
"982","Markel Bergara_2019",2019,"Getafe","La Liga","Markel Bergara","ESP","MF","32",1986,0.6,2,2,0,1,1,2,3,66.7,1,3,0,3,1,3,2,0,"https://fbref.com/en/players/04a65a8f/Markel-Bergara"
"983","Leandro Cabrera_2019",2019,"Getafe","La Liga","Leandro Cabrera","URU","DF","27",1991,31,47,26,28,17,2,24,41,58.5,17,29,16,13,52,99,216,2,"https://fbref.com/en/players/69cbc8b6/Leandro-Cabrera"
"984","Leandro Chichizola_2019",2019,"Getafe","La Liga","Leandro Chichizola","ARG","GK","28",1990,1,0,0,0,0,0,0,0,NA,0,0,0,0,0,0,1,0,"https://fbref.com/en/players/8d957256/Leandro-Chichizola"
"985","Sebastián Cristóforo_2019",2019,"Getafe","La Liga","Sebastián Cristóforo","URU","MF","24",1993,5,15,8,4,8,3,5,14,35.7,9,13,0,13,8,23,5,0,"https://fbref.com/en/players/3c05c659/Sebastian-Cristoforo"
"986","Djené_2019",2019,"Getafe","La Liga","Djené","TOG","DF","26",1991,33.1,54,34,43,11,0,26,43,60.5,17,27,11,16,74,128,154,3,"https://fbref.com/en/players/a4971d84/Djene"
"987","Hugo Duro_2019",2019,"Getafe","La Liga","Hugo Duro","ESP","MF,FW","18",1999,4.6,6,4,1,2,3,3,6,50,3,6,1,5,3,9,4,0,"https://fbref.com/en/players/37e103f8/Hugo-Duro"
"988","Mathieu Flamini_2019",2019,"Getafe","La Liga","Mathieu Flamini","FRA","MF","34",1984,5,9,4,4,4,1,4,7,57.1,3,3,1,2,5,14,4,0,"https://fbref.com/en/players/148d4105/Mathieu-Flamini"
"989","Dimitri Foulquier_2019",2019,"Getafe","La Liga","Dimitri Foulquier","FRA","MF,DF","25",1993,20,29,12,10,14,5,11,22,50,11,23,2,21,20,49,38,0,"https://fbref.com/en/players/45e17712/Dimitri-Foulquier"
"990","Bruno González_2019",2019,"Getafe","La Liga","Bruno González","ESP","DF","28",1990,18.9,23,10,14,8,1,9,18,50,9,13,6,7,22,45,110,0,"https://fbref.com/en/players/f11fe861/Bruno-Gonzalez"
"991","Sergi Guardiola_2019",2019,"Getafe","La Liga","Sergi Guardiola","ESP","MF,FW","27",1991,0.3,1,1,0,1,0,0,0,NA,0,0,0,0,0,1,0,0,"https://fbref.com/en/players/32974271/Sergi-Guardiola"
"992","Robert Ibáñez_2019",2019,"Getafe","La Liga","Robert Ibáñez","ESP","MF","25",1993,0.8,2,2,1,1,0,0,1,0,1,3,0,3,0,2,0,0,"https://fbref.com/en/players/c7429db3/Robert-Ibanez"
"993","Nemanja Maksimović_2019",2019,"Getafe","La Liga","Nemanja Maksimović","SRB","MF","23",1995,35.7,77,45,21,51,5,21,61,34.4,40,60,15,45,71,148,33,0,"https://fbref.com/en/players/00b28772/Nemanja-Maksimovic"
"994","Jaime Mata_2019",2019,"Getafe","La Liga","Jaime Mata","ESP","FW,MF","29",1988,27,30,21,8,14,8,7,26,26.9,19,14,0,14,17,47,27,0,"https://fbref.com/en/players/02319ad7/Jaime-Mata"
"995","Ignasi Miquel_2019",2019,"Getafe","La Liga","Ignasi Miquel","ESP","DF","25",1992,3.5,1,0,0,1,0,1,2,50,1,4,4,0,5,6,25,0,"https://fbref.com/en/players/174f09a6/Ignasi-Miquel"
"996","Jorge Molina_2019",2019,"Getafe","La Liga","Jorge Molina","ESP","FW","36",1982,29.4,12,9,1,4,7,2,15,13.3,13,22,0,22,7,19,26,1,"https://fbref.com/en/players/43f71e77/Jorge-Molina"
"997","Mathías Olivera_2019",2019,"Getafe","La Liga","Mathías Olivera","URU","DF,MF","20",1997,11.2,24,17,11,8,5,10,18,55.6,8,25,2,23,10,34,22,0,"https://fbref.com/en/players/41c12f75/Mathias-Olivera"
"998","Francisco Portillo_2019",2019,"Getafe","La Liga","Francisco Portillo","ESP","MF","28",1990,22.2,26,16,6,15,5,9,29,31,20,14,0,14,17,43,9,0,"https://fbref.com/en/players/8e010ff4/Francisco-Portillo"
"999","Ángel Rodríguez_2019",2019,"Getafe","La Liga","Ángel Rodríguez","ESP","FW","31",1987,20.2,16,7,1,6,9,6,26,23.1,20,15,1,14,8,24,8,0,"https://fbref.com/en/players/8cfc2f69/Angel-Rodriguez"
"1000","Samuel Sáiz_2019",2019,"Getafe","La Liga","Samuel Sáiz","ESP","MF","27",1991,3.4,4,3,0,3,1,2,5,40,3,1,0,1,0,4,2,0,"https://fbref.com/en/players/13e0eb29/Samuel-Saiz"
"1001","Gaku Shibasaki_2019",2019,"Getafe","La Liga","Gaku Shibasaki","JPN","MF,FW","26",1992,4.3,7,3,2,4,1,3,6,50,3,2,0,2,3,10,4,0,"https://fbref.com/en/players/d2ac648c/Gaku-Shibasaki"
"1002","David Soria_2019",2019,"Getafe","La Liga","David Soria","ESP","GK","25",1993,37,1,0,1,0,0,1,2,50,1,2,0,2,1,2,15,6,"https://fbref.com/en/players/8f8c6934/David-Soria"
"1003","Damián Suárez_2019",2019,"Getafe","La Liga","Damián Suárez","URU","DF","30",1988,36,96,62,43,41,12,53,120,44.2,67,47,6,41,46,142,57,2,"https://fbref.com/en/players/ba5004e1/Damian-Suarez"
"1004","Aday_2019",2019,"Girona","La Liga","Aday","ESP","DF,MF","30",1987,7.2,9,8,2,5,2,6,7,85.7,1,1,0,1,7,16,17,1,"https://fbref.com/en/players/5890cef1/Aday"
"1005","Pedro Alcalá_2019",2019,"Girona","La Liga","Pedro Alcalá","ESP","DF","29",1989,20.8,32,23,23,9,0,15,23,65.2,8,21,18,3,36,68,120,0,"https://fbref.com/en/players/ba71d071/Pedro-Alcala"
"1006","Yassine Bounou_2019",2019,"Girona","La Liga","Yassine Bounou","MAR","GK","27",1991,31.8,0,0,0,0,0,0,2,0,2,0,0,0,1,1,7,2,"https://fbref.com/en/players/f6798fc3/Yassine-Bounou"
"1007","Seydou Doumbia_2019",2019,"Girona","La Liga","Seydou Doumbia","CIV","FW","30",1987,6,5,1,1,2,2,0,2,0,2,2,0,2,3,8,1,0,"https://fbref.com/en/players/c49afee6/Seydou-Doumbia"
"1008","Bernardo Espinosa_2019",2019,"Girona","La Liga","Bernardo Espinosa","COL","DF","29",1989,30.3,20,14,16,4,0,8,17,47.1,9,46,31,15,40,60,197,5,"https://fbref.com/en/players/4242011c/Bernardo-Espinosa"
"1009","Aleix García_2019",2019,"Girona","La Liga","Aleix García","ESP","MF","21",1997,18.5,37,19,17,20,0,13,36,36.1,23,21,6,15,21,58,18,0,"https://fbref.com/en/players/a10361d2/Aleix-Garcia"
"1010","Borja García_2019",2019,"Girona","La Liga","Borja García","ESP","MF,FW","27",1990,29.2,39,27,17,15,7,22,44,50,22,23,2,21,38,77,17,0,"https://fbref.com/en/players/e7f4603c/Borja-Garcia"
"1011","Raúl García_2019",2019,"Girona","La Liga","Raúl García","ESP","DF","29",1989,9.4,21,12,11,7,3,11,16,68.8,5,14,4,10,11,32,35,1,"https://fbref.com/en/players/1a317a1b/Raul-Garcia"
"1012","Álex Granell_2019",2019,"Girona","La Liga","Álex Granell","ESP","MF,DF","29",1988,26.6,64,28,30,31,3,34,83,41,49,34,5,29,35,99,36,1,"https://fbref.com/en/players/a25250f8/Alex-Granell"
"1013","Gorka Iraizoz_2019",2019,"Girona","La Liga","Gorka Iraizoz","ESP","GK","37",1981,6.2,1,0,1,0,0,1,1,100,0,0,0,0,1,2,7,0,"https://fbref.com/en/players/26f2473f/Gorka-Iraizoz"
"1014","Juanpe_2019",2019,"Girona","La Liga","Juanpe","ESP","DF","27",1991,30.7,48,25,32,15,1,24,45,53.3,21,31,15,16,57,105,138,0,"https://fbref.com/en/players/1633fc8a/Juanpe"
"1015","Anthony Lozano_2019",2019,"Girona","La Liga","Anthony Lozano","HON","FW,MF","25",1993,8.1,6,5,3,3,0,0,6,0,6,7,1,6,0,6,6,0,"https://fbref.com/en/players/38699c72/Anthony-Lozano"
"1016","Douglas Luiz_2019",2019,"Girona","La Liga","Douglas Luiz","BRA","MF","20",1998,16.6,34,19,13,20,1,9,38,23.7,29,19,7,12,21,55,26,0,"https://fbref.com/en/players/6f7d826d/Douglas-Luiz"
"1017","Johan Mojica_2019",2019,"Girona","La Liga","Johan Mojica","COL","FW,MF","25",1992,0.2,1,1,1,0,0,0,0,NA,0,0,0,0,0,1,0,0,"https://fbref.com/en/players/608f2092/Johan-Mojica"
"1018","Marc Muniesa_2019",2019,"Girona","La Liga","Marc Muniesa","ESP","DF,MF","26",1992,15.6,49,34,27,17,5,15,28,53.6,13,18,6,12,37,86,49,1,"https://fbref.com/en/players/4db76f57/Marc-Muniesa"
"1019","Carles Planas_2019",2019,"Girona","La Liga","Carles Planas","ESP","DF","27",1991,4.7,12,6,7,5,0,4,11,36.4,7,2,0,2,4,16,15,0,"https://fbref.com/en/players/72b92c4e/Carles-Planas"
"1020","Pere Pons_2019",2019,"Girona","La Liga","Pere Pons","ESP","MF","25",1993,31,83,46,34,38,11,30,82,36.6,52,48,12,36,35,118,39,0,"https://fbref.com/en/players/29b61deb/Pere-Pons"
"1021","Pedro Porro_2019",2019,"Girona","La Liga","Pedro Porro","ESP","DF","18",1999,24.6,51,31,28,16,7,32,80,40,48,36,2,34,39,90,60,1,"https://fbref.com/en/players/27d0a506/Pedro-Porro"
"1022","Portu_2019",2019,"Girona","La Liga","Portu","ESP","FW,MF","26",1992,31.3,33,24,8,15,10,12,43,27.9,31,16,1,15,8,41,5,0,"https://fbref.com/en/players/1bda5842/Portu"
"1023","Jonás Ramalho_2019",2019,"Girona","La Liga","Jonás Ramalho","ESP","DF","25",1993,18,13,6,12,1,0,8,14,57.1,6,24,11,13,16,29,80,1,"https://fbref.com/en/players/be3a0121/Jonas-Ramalho"
"1024","Patrick Roberts_2019",2019,"Girona","La Liga","Patrick Roberts","ENG","MF,FW","21",1997,6.7,7,6,5,2,0,3,15,20,12,5,0,5,3,10,2,1,"https://fbref.com/en/players/59d93937/Patrick-Roberts"
"1025","Paik Seung-ho_2019",2019,"Girona","La Liga","Paik Seung-ho","KOR","FW,MF","21",1997,0.7,0,0,0,0,0,0,1,0,1,1,0,1,3,3,1,0,"https://fbref.com/en/players/1e1bea09/Paik-Seung-ho"
"1026","Kévin Soni_2019",2019,"Girona","La Liga","Kévin Soni","CMR","FW,DF","20",1998,0.9,3,2,0,2,1,2,4,50,2,3,0,3,1,4,0,0,"https://fbref.com/en/players/6435143e/Kevin-Soni"
"1027","Cristhian Stuani_2019",2019,"Girona","La Liga","Cristhian Stuani","URU","FW","31",1986,30.3,23,13,7,13,3,5,20,25,15,13,1,12,4,27,39,0,"https://fbref.com/en/players/220c11f1/Cristhian-Stuani"
"1028","David Timor_2019",2019,"Girona","La Liga","David Timor","ESP","MF","28",1989,1.8,2,2,1,1,0,0,1,0,1,1,1,0,3,5,3,0,"https://fbref.com/en/players/174651c8/David-Timor"
"1029","Valery_2019",2019,"Girona","La Liga","Valery","ESP","DF,FW","18",1999,9.9,20,15,13,6,1,10,17,58.8,7,15,1,14,8,28,10,0,"https://fbref.com/en/players/4acd733a/Valery"
"1030","Nicolas Benezet_2019",2019,"Guingamp","Ligue 1","Nicolas Benezet","FRA","MF,FW","27",1991,18.5,32,19,14,15,3,5,19,26.3,14,12,0,12,19,51,4,0,"https://fbref.com/en/players/30395d3b/Nicolas-Benezet"
"1031","Ludovic Blas_2019",2019,"Guingamp","Ligue 1","Ludovic Blas","FRA","MF,FW","20",1997,26.4,62,38,22,32,8,20,43,46.5,23,44,7,37,26,88,14,0,"https://fbref.com/en/players/6191093d/Ludovic-Blas"
"1032","Marc-Aurèle Caillard_2019",2019,"Guingamp","Ligue 1","Marc-Aurèle Caillard","FRA","GK","24",1994,21,0,0,0,0,0,0,2,0,2,0,0,0,2,2,8,3,"https://fbref.com/en/players/5ee6e943/Marc-Aurele-Caillard"
"1033","Louis Carnot_2019",2019,"Guingamp","Ligue 1","Louis Carnot","FRA","MF","17",2001,0.1,0,0,0,0,0,0,0,NA,0,0,0,0,0,0,0,0,"https://fbref.com/en/players/2384dbed/Louis-Carnot"
"1034","Marcus Coco_2019",2019,"Guingamp","Ligue 1","Marcus Coco","FRA","FW,MF","22",1996,20.4,39,23,20,10,9,16,33,48.5,17,24,0,24,23,62,14,0,"https://fbref.com/en/players/3010aefb/Marcus-Coco"
"1035","Lucas Deaux_2019",2019,"Guingamp","Ligue 1","Lucas Deaux","FRA","MF","29",1988,13.2,41,28,21,18,2,20,41,48.8,21,10,0,10,11,52,7,0,"https://fbref.com/en/players/44f8c299/Lucas-Deaux"
"1036","Étienne Didot_2019",2019,"Guingamp","Ligue 1","Étienne Didot","FRA","MF","35",1983,23.4,41,29,12,27,2,17,44,38.6,27,37,10,27,37,78,35,0,"https://fbref.com/en/players/d2aa8ac0/Etienne-Didot"
"1037","Papy Djilobodji_2019",2019,"Guingamp","Ligue 1","Papy Djilobodji","SEN","DF","29",1988,1.9,1,1,1,0,0,0,0,NA,0,4,2,2,0,1,11,0,"https://fbref.com/en/players/083525e5/Papy-Djilobodji"
"1038","Félix Eboa Eboa_2019",2019,"Guingamp","Ligue 1","Félix Eboa Eboa","CMR","DF","21",1997,27,47,33,26,20,1,16,22,72.7,6,37,24,13,39,86,136,2,"https://fbref.com/en/players/167d5018/Felix-Eboa-Eboa"
"1039","Guessouma Fofana_2019",2019,"Guingamp","Ligue 1","Guessouma Fofana","MTN","MF","25",1992,5.3,14,9,2,10,2,4,10,40,6,3,0,3,6,20,8,0,"https://fbref.com/en/players/9dafff2a/Guessouma-Fofana"
"1040","Didier Ibrahim Ndong_2019",2019,"Guingamp","Ligue 1","Didier Ibrahim Ndong","GAB","MF","24",1994,8.3,16,11,3,13,0,5,13,38.5,8,15,3,12,15,31,6,1,"https://fbref.com/en/players/885b7aa7/Didier-Ibrahim-Ndong"
"1041","Jordan Ikoko_2019",2019,"Guingamp","Ligue 1","Jordan Ikoko","COD","DF","24",1994,19,37,24,22,14,1,16,28,57.1,12,18,5,13,24,61,30,0,"https://fbref.com/en/players/8ff4872e/Jordan-Ikoko"
"1042","Karl-Johan Johnsson_2019",2019,"Guingamp","Ligue 1","Karl-Johan Johnsson","SWE","GK","28",1990,17,0,0,0,0,0,0,1,0,1,0,0,0,0,0,4,1,"https://fbref.com/en/players/a56bd2ee/Karl-Johan-Johnsson"
"1043","Nathaël Julan_2019",2019,"Guingamp","Ligue 1","Nathaël Julan","FRA","FW,MF","22",1996,4.8,1,0,0,0,1,0,3,0,3,6,1,5,0,1,2,0,"https://fbref.com/en/players/39901146/Nathael-Julan"
"1044","Christophe Kerbrat_2019",2019,"Guingamp","Ligue 1","Christophe Kerbrat","FRA","DF","31",1986,23.3,40,24,28,12,0,24,38,63.2,14,19,10,9,50,90,140,5,"https://fbref.com/en/players/0515a4cb/Christophe-Kerbrat"
"1045","Djégui Koita_2019",2019,"Guingamp","Ligue 1","Djégui Koita","FRA","DF","18",1999,1.9,8,6,8,0,0,3,4,75,1,5,3,2,0,8,9,0,"https://fbref.com/en/players/b1adaefa/Djegui-Koita"
"1046","Johan Larsson_2019",2019,"Guingamp","Ligue 1","Johan Larsson","SWE","DF","28",1990,1,1,1,0,1,0,1,2,50,1,0,0,0,1,2,1,1,"https://fbref.com/en/players/fe006f82/Johan-Larsson"
"1047","Alexandre Mendy_2019",2019,"Guingamp","Ligue 1","Alexandre Mendy","GNB","FW","24",1994,8.5,5,3,0,4,1,3,8,37.5,5,3,0,3,1,6,6,0,"https://fbref.com/en/players/e067808c/Alexandre-Mendy"
"1048","Mehdi Merghem_2019",2019,"Guingamp","Ligue 1","Mehdi Merghem","FRA","FW,MF","21",1997,8,25,18,15,7,3,11,21,52.4,10,14,1,13,9,34,6,0,"https://fbref.com/en/players/49000148/Mehdi-Merghem"
"1049","Yeni Ngbakoto_2019",2019,"Guingamp","Ligue 1","Yeni Ngbakoto","COD","MF,FW","26",1992,6.3,9,4,4,3,2,4,8,50,4,7,0,7,4,13,2,0,"https://fbref.com/en/players/813aae2f/Yeni-Ngbakoto"
"1050","Matthias Phaeton_2019",2019,"Guingamp","Ligue 1","Matthias Phaeton","GLP","FW,MF","18",2000,0.6,1,1,0,1,0,0,0,NA,0,0,0,0,0,1,0,0,"https://fbref.com/en/players/42c8ede1/Matthias-Phaeton"
"1051","Lebogang Phiri_2019",2019,"Guingamp","Ligue 1","Lebogang Phiri","RSA","MF","23",1994,21.4,60,38,16,41,3,24,43,55.8,19,26,3,23,29,89,19,0,"https://fbref.com/en/players/b6dac747/Lebogang-Phiri"
"1052","Pedro Rebocho_2019",2019,"Guingamp","Ligue 1","Pedro Rebocho","POR","DF","23",1995,36,61,35,31,22,8,29,54,53.7,25,48,13,35,40,101,92,1,"https://fbref.com/en/players/276cce2e/Pedro-Rebocho"
"1053","Ronny Rodelin_2019",2019,"Guingamp","Ligue 1","Ronny Rodelin","FRA","MF,FW","28",1989,8.8,13,5,2,7,4,3,8,37.5,5,8,1,7,8,21,13,0,"https://fbref.com/en/players/1f8c7aa9/Ronny-Rodelin"
"1054","Nolan Roux_2019",2019,"Guingamp","Ligue 1","Nolan Roux","FRA","FW","30",1988,17.1,11,9,0,6,5,4,14,28.6,10,6,2,4,4,15,21,0,"https://fbref.com/en/players/3071a619/Nolan-Roux"
"1055","Yannis Salibur_2019",2019,"Guingamp","Ligue 1","Yannis Salibur","FRA","MF","27",1991,0.2,0,0,0,0,0,0,0,NA,0,0,0,0,0,0,0,0,"https://fbref.com/en/players/bb4a42be/Yannis-Salibur"
"1056","Jérémy Sorbon_2019",2019,"Guingamp","Ligue 1","Jérémy Sorbon","FRA","DF","34",1983,29.4,33,20,23,10,0,14,22,63.6,8,33,23,10,34,67,105,2,"https://fbref.com/en/players/7768df30/Jeremy-Sorbon"
"1057","Franck Tabanou_2019",2019,"Guingamp","Ligue 1","Franck Tabanou","FRA","DF","29",1989,2,4,3,4,0,0,1,2,50,1,0,0,0,6,10,15,0,"https://fbref.com/en/players/15e1afd5/Franck-Tabanou"
"1058","Marcus Thuram_2019",2019,"Guingamp","Ligue 1","Marcus Thuram","FRA","FW,MF","20",1997,28.6,45,28,23,15,7,20,43,46.5,23,24,1,23,10,55,14,0,"https://fbref.com/en/players/6f8cd6d0/Marcus-Thuram"
"1059","Cheick Traoré_2019",2019,"Guingamp","Ligue 1","Cheick Traoré","MLI","DF","23",1995,16.8,37,21,23,11,3,15,25,60,10,13,3,10,23,60,46,1,"https://fbref.com/en/players/bfcef334/Cheick-Traore"
"1060","Kevin Akpoguma_2019",2019,"Hannover 96","Bundesliga","Kevin Akpoguma","NGA","DF","23",1995,3.5,10,6,5,5,0,6,7,85.7,1,7,2,5,10,20,7,2,"https://fbref.com/en/players/6ec6fde0/Kevin-Akpoguma"
"1061","Miiko Albornoz_2019",2019,"Hannover 96","Bundesliga","Miiko Albornoz","CHI","DF,MF","27",1990,18.4,46,26,31,10,5,21,45,46.7,24,23,3,20,16,62,37,1,"https://fbref.com/en/players/d459281d/Miiko-Albornoz"
"1062","Waldemar Anton_2019",2019,"Hannover 96","Bundesliga","Waldemar Anton","GER","DF","22",1996,34,49,32,33,14,2,22,50,44,28,56,33,23,69,118,169,3,"https://fbref.com/en/players/5e66fa06/Waldemar-Anton"
"1063","Takuma Asano_2019",2019,"Hannover 96","Bundesliga","Takuma Asano","JPN","MF,FW","23",1994,7.8,5,3,1,1,3,1,6,16.7,5,9,0,9,2,7,2,0,"https://fbref.com/en/players/13ddc856/Takuma-Asano"
"1064","Marvin Bakalorz_2019",2019,"Hannover 96","Bundesliga","Marvin Bakalorz","GER","MF","28",1989,16.3,18,11,7,9,2,6,36,16.7,30,29,4,25,28,46,47,0,"https://fbref.com/en/players/04c11885/Marvin-Bakalorz"
"1065","Noah Joel Sarenren Bazee_2019",2019,"Hannover 96","Bundesliga","Noah Joel Sarenren Bazee","NGA","FW,MF","21",1996,1.7,0,0,0,0,0,0,0,NA,0,1,0,1,0,0,3,0,"https://fbref.com/en/players/fbbc8e15/Noah-Joel-Sarenren-Bazee"
"1066","Ihlas Bebou_2019",2019,"Hannover 96","Bundesliga","Ihlas Bebou","TOG","MF,FW","24",1994,11.8,15,9,4,10,1,4,9,44.4,5,18,2,16,9,24,9,0,"https://fbref.com/en/players/a53b661f/Ihlas-Bebou"
"1067","Uffe Bech_2019",2019,"Hannover 96","Bundesliga","Uffe Bech","DEN","FW","25",1993,0.2,0,0,0,0,0,0,1,0,1,0,0,0,0,0,0,0,"https://fbref.com/en/players/f7097e8a/Uffe-Bech"
"1068","Tim Dierßen_2019",2019,"Hannover 96","Bundesliga","Tim Dierßen","GER","MF","22",1996,0.2,0,0,0,0,0,0,0,NA,0,1,0,1,0,0,0,0,"https://fbref.com/en/players/96f8ab0c/Tim-Dierssen"
"1069","Josip Elez_2019",2019,"Hannover 96","Bundesliga","Josip Elez","CRO","DF","24",1994,7.2,8,3,5,3,0,2,11,18.2,9,13,4,9,6,14,27,0,"https://fbref.com/en/players/eafac393/Josip-Elez"
"1070","Michael Esser_2019",2019,"Hannover 96","Bundesliga","Michael Esser","GER","GK","30",1987,32,3,2,3,0,0,2,5,40,3,1,0,1,1,4,15,0,"https://fbref.com/en/players/83e0eeb4/Michael-Esser"
"1071","Felipe_2019",2019,"Hannover 96","Bundesliga","Felipe","BRA","DF","31",1987,12.2,23,15,21,2,0,9,17,52.9,8,17,9,8,35,58,71,0,"https://fbref.com/en/players/de164de6/Felipe"
"1072","Iver Fossum_2019",2019,"Hannover 96","Bundesliga","Iver Fossum","NOR","MF","22",1996,5.1,9,5,1,7,1,4,8,50,4,8,2,6,7,16,10,0,"https://fbref.com/en/players/ce218223/Iver-Fossum"
"1073","Niclas Füllkrug_2019",2019,"Hannover 96","Bundesliga","Niclas Füllkrug","GER","FW","25",1993,12.4,3,0,0,1,2,1,5,20,4,10,4,6,1,4,17,0,"https://fbref.com/en/players/4f16405e/Niclas-Fullkrug"
"1074","Benjamin Hadžić_2019",2019,"Hannover 96","Bundesliga","Benjamin Hadžić","BIH","FW,MF","19",1999,0.3,0,0,0,0,0,0,1,0,1,0,0,0,0,0,0,0,"https://fbref.com/en/players/f765bb88/Benjamin-Hadzic"
"1075","Genki Haraguchi_2019",2019,"Hannover 96","Bundesliga","Genki Haraguchi","JPN","MF,DF","27",1991,23.7,44,26,21,20,3,17,66,25.8,49,34,5,29,21,65,33,0,"https://fbref.com/en/players/f24ea523/Genki-Haraguchi"
"1076","Jonathas_2019",2019,"Hannover 96","Bundesliga","Jonathas","BRA","FW","29",1989,6.7,7,4,3,4,0,3,10,30,7,9,1,8,3,10,4,0,"https://fbref.com/en/players/531807b3/Jonathas"
"1077","Julian Korb_2019",2019,"Hannover 96","Bundesliga","Julian Korb","GER","DF","26",1992,11.2,26,17,16,9,1,10,29,34.5,19,27,4,23,23,49,34,1,"https://fbref.com/en/players/3dffff26/Julian-Korb"
"1078","Linton Maina_2019",2019,"Hannover 96","Bundesliga","Linton Maina","GER","FW,MF","19",1999,15.7,28,14,13,10,5,12,23,52.2,11,20,0,20,14,42,4,0,"https://fbref.com/en/players/e5d85da8/Linton-Maina"
"1079","Nicolai Müller_2019",2019,"Hannover 96","Bundesliga","Nicolai Müller","GER","MF,FW","30",1987,10,18,9,7,7,4,8,27,29.6,19,9,1,8,1,19,7,0,"https://fbref.com/en/players/5e1df051/Nicolai-Muller"
"1080","Florent Muslija_2019",2019,"Hannover 96","Bundesliga","Florent Muslija","KVX","MF,FW","20",1998,7.5,16,10,8,6,2,8,12,66.7,4,4,0,4,3,19,4,0,"https://fbref.com/en/players/ae961785/Florent-Muslija"
"1081","Matthias Ostrzolek_2019",2019,"Hannover 96","Bundesliga","Matthias Ostrzolek","GER","DF","28",1990,16.3,32,18,24,8,0,20,33,60.6,13,20,5,15,26,58,44,2,"https://fbref.com/en/players/1cd87320/Matthias-Ostrzolek"
"1082","Edgar Prib_2019",2019,"Hannover 96","Bundesliga","Edgar Prib","GER","MF","28",1989,2.2,10,9,3,5,2,2,4,50,2,4,0,4,2,12,1,0,"https://fbref.com/en/players/420ff5a3/Edgar-Prib"
"1083","Samuel Şahin-Radlinger_2019",2019,"Hannover 96","Bundesliga","Samuel Şahin-Radlinger","AUT","GK","25",1992,1,0,0,0,0,0,0,0,NA,0,1,0,1,0,0,2,0,"https://fbref.com/en/players/e385200c/Samuel-Sahin-Radlinger"
"1084","Pirmin Schwegler_2019",2019,"Hannover 96","Bundesliga","Pirmin Schwegler","SUI","MF","31",1987,23.1,63,34,30,29,4,34,60,56.7,26,21,5,16,41,104,54,0,"https://fbref.com/en/players/5528407e/Pirmin-Schwegler"
"1085","Oliver Sorg_2019",2019,"Hannover 96","Bundesliga","Oliver Sorg","GER","DF","28",1990,17.6,42,28,26,16,0,20,43,46.5,23,16,9,7,46,88,47,0,"https://fbref.com/en/players/541cdd20/Oliver-Sorg"
"1086","Sebastian Soto_2019",2019,"Hannover 96","Bundesliga","Sebastian Soto","USA","MF,FW","18",2000,0.3,0,0,0,0,0,0,0,NA,0,0,0,0,0,0,0,0,"https://fbref.com/en/players/00c3d4dc/Sebastian-Soto"
"1087","Philipp Tschauner_2019",2019,"Hannover 96","Bundesliga","Philipp Tschauner","GER","GK","32",1985,1,0,0,0,0,0,0,0,NA,0,0,0,0,0,0,0,0,"https://fbref.com/en/players/73e2f6eb/Philipp-Tschauner"
"1088","Walace_2019",2019,"Hannover 96","Bundesliga","Walace","BRA","MF","23",1995,22.2,52,22,17,28,7,27,61,44.3,34,30,4,26,45,97,36,1,"https://fbref.com/en/players/26db8853/Walace"
"1089","Hendrik Weydandt_2019",2019,"Hannover 96","Bundesliga","Hendrik Weydandt","GER","FW","23",1995,19.1,18,12,7,8,3,3,24,12.5,21,14,4,10,5,23,44,0,"https://fbref.com/en/players/773968e4/Hendrik-Weydandt"
"1090","Kevin Wimmer_2019",2019,"Hannover 96","Bundesliga","Kevin Wimmer","AUT","DF","25",1992,18.7,25,17,17,6,2,15,27,55.6,12,30,23,7,41,66,63,0,"https://fbref.com/en/players/faf55ce4/Kevin-Wimmer"
"1091","Bobby Wood_2019",2019,"Hannover 96","Bundesliga","Bobby Wood","USA","FW,MF","25",1992,13.1,13,10,2,10,1,5,8,62.5,3,2,0,2,4,17,6,0,"https://fbref.com/en/players/9853983f/Bobby-Wood"
"1092","Florian Baak_2019",2019,"Hertha BSC","Bundesliga","Florian Baak","GER","MF","19",1999,0,0,0,0,0,0,0,0,NA,0,0,0,0,0,0,0,0,"https://fbref.com/en/players/150d5992/Florian-Baak"
"1093","Per Ciljan Skjelbred_2019",2019,"Hertha BSC","Bundesliga","Per Ciljan Skjelbred","NOR","MF","31",1987,11.1,26,18,13,12,1,5,22,22.7,17,10,1,9,20,46,14,0,"https://fbref.com/en/players/ecab64a0/Per-Ciljan-Skjelbred"
"1094","Palkó Dárdai_2019",2019,"Hertha BSC","Bundesliga","Palkó Dárdai","HUN","FW,MF","19",1999,1.3,1,1,1,0,0,0,0,NA,0,1,0,1,0,1,0,0,"https://fbref.com/en/players/db7161ed/Palko-Dardai"
"1095","Vladimír Darida_2019",2019,"Hertha BSC","Bundesliga","Vladimír Darida","CZE","MF","27",1990,4.2,8,5,3,4,1,2,3,66.7,1,5,0,5,8,16,5,0,"https://fbref.com/en/players/3eb0f2df/Vladimir-Darida"
"1096","Javairô Dilrosun_2019",2019,"Hertha BSC","Bundesliga","Javairô Dilrosun","NED","FW,MF","20",1998,10,14,10,7,5,2,3,7,42.9,4,18,2,16,7,21,9,0,"https://fbref.com/en/players/34a0f5ff/Javairo-Dilrosun"
"1097","Ondrej Duda_2019",2019,"Hertha BSC","Bundesliga","Ondrej Duda","SVK","MF","23",1994,28.5,54,33,13,35,6,15,55,27.3,40,36,4,32,15,69,17,1,"https://fbref.com/en/players/79ca3e23/Ondrej-Duda"
"1098","Marko Grujić_2019",2019,"Hertha BSC","Bundesliga","Marko Grujić","SRB","MF","22",1996,19.8,45,33,17,20,8,13,38,34.2,25,29,6,23,29,74,51,1,"https://fbref.com/en/players/8b8e759d/Marko-Grujic"
"1099","Vedad Ibišević_2019",2019,"Hertha BSC","Bundesliga","Vedad Ibišević","BIH","FW","33",1984,20.1,12,8,2,5,5,0,10,0,10,10,4,6,3,15,20,0,"https://fbref.com/en/players/c3fd9887/Vedad-Ibisevic"
"1100","Rune Jarstein_2019",2019,"Hertha BSC","Bundesliga","Rune Jarstein","NOR","GK","33",1984,30.5,0,0,0,0,0,0,0,NA,0,0,0,0,1,1,8,1,"https://fbref.com/en/players/27d2618c/Rune-Jarstein"
"1101","Dennis Jastrzembski_2019",2019,"Hertha BSC","Bundesliga","Dennis Jastrzembski","POL","FW,DF","18",2000,0.7,0,0,0,0,0,0,3,0,3,0,0,0,1,1,0,0,"https://fbref.com/en/players/6bba916f/Dennis-Jastrzembski"
"1102","Salomon Kalou_2019",2019,"Hertha BSC","Bundesliga","Salomon Kalou","CIV","FW,MF","32",1985,25.7,21,12,5,11,5,6,24,25,18,23,1,22,6,27,25,0,"https://fbref.com/en/players/2042d931/Salomon-Kalou"
"1103","Lukas Klünter_2019",2019,"Hertha BSC","Bundesliga","Lukas Klünter","GER","DF","22",1996,6.6,11,8,6,5,0,4,5,80,1,6,2,4,12,23,20,0,"https://fbref.com/en/players/92948149/Lukas-Klunter"
"1104","Pascal Köpke_2019",2019,"Hertha BSC","Bundesliga","Pascal Köpke","GER","FW,MF","22",1995,0.8,1,0,1,0,0,1,2,50,1,0,0,0,0,1,0,0,"https://fbref.com/en/players/3861d9cc/Pascal-Kopke"
"1105","Thomas Kraft_2019",2019,"Hertha BSC","Bundesliga","Thomas Kraft","GER","GK","30",1988,3.5,0,0,0,0,0,0,0,NA,0,0,0,0,0,0,1,1,"https://fbref.com/en/players/bb25c778/Thomas-Kraft"
"1106","Valentino Lazaro_2019",2019,"Hertha BSC","Bundesliga","Valentino Lazaro","AUT","DF,FW","22",1996,30.5,46,31,23,17,6,21,53,39.6,32,52,12,40,44,90,65,0,"https://fbref.com/en/players/016ff750/Valentino-Lazaro"
"1107","Mathew Leckie_2019",2019,"Hertha BSC","Bundesliga","Mathew Leckie","AUS","FW,MF","27",1991,10.5,20,13,5,10,5,7,16,43.8,9,10,1,9,13,33,16,0,"https://fbref.com/en/players/b93b7882/Mathew-Leckie"
"1108","Derrick Luckassen_2019",2019,"Hertha BSC","Bundesliga","Derrick Luckassen","NED","DF","23",1995,2.8,4,2,4,0,0,1,3,33.3,2,1,0,1,0,4,13,0,"https://fbref.com/en/players/30a09cb5/Derrick-Luckassen"
"1109","Fabian Lustenberger_2019",2019,"Hertha BSC","Bundesliga","Fabian Lustenberger","SUI","DF,MF","30",1988,24.1,45,30,23,21,1,15,33,45.5,18,39,18,21,39,84,108,2,"https://fbref.com/en/players/a63a995f/Fabian-Lustenberger"
"1110","Arne Maier_2019",2019,"Hertha BSC","Bundesliga","Arne Maier","GER","MF","19",1999,22.9,31,16,12,19,0,6,25,24,19,32,9,23,28,59,35,0,"https://fbref.com/en/players/ab700320/Arne-Maier"
"1111","Maximilian Mittelstädt_2019",2019,"Hertha BSC","Bundesliga","Maximilian Mittelstädt","GER","DF,MF","21",1997,20,61,37,33,23,5,23,49,46.9,26,32,4,28,46,107,64,0,"https://fbref.com/en/players/88d4144a/Maximilian-Mittelstadt"
"1112","Peter Pekarík_2019",2019,"Hertha BSC","Bundesliga","Peter Pekarík","SVK","DF","31",1986,2.4,2,1,1,1,0,1,3,33.3,2,2,1,1,1,3,5,0,"https://fbref.com/en/players/c18d22f5/Peter-Pekarik"
"1113","Marvin Plattenhardt_2019",2019,"Hertha BSC","Bundesliga","Marvin Plattenhardt","GER","DF","26",1992,21.4,27,21,12,10,5,14,21,66.7,7,18,3,15,7,34,56,0,"https://fbref.com/en/players/f7aa75bd/Marvin-Plattenhardt"
"1114","Karim Rekik_2019",2019,"Hertha BSC","Bundesliga","Karim Rekik","NED","DF","23",1994,23,36,22,23,12,1,12,18,66.7,6,24,16,8,34,70,88,0,"https://fbref.com/en/players/3376a776/Karim-Rekik"
"1115","Davie Selke_2019",2019,"Hertha BSC","Bundesliga","Davie Selke","GER","FW","23",1995,19.3,5,2,1,4,0,2,9,22.2,7,11,0,11,1,6,7,0,"https://fbref.com/en/players/1238a3f9/Davie-Selke"
"1116","Niklas Stark_2019",2019,"Hertha BSC","Bundesliga","Niklas Stark","GER","DF","23",1995,20.8,34,19,23,11,0,9,24,37.5,15,45,26,19,37,71,141,1,"https://fbref.com/en/players/aad48be9/Niklas-Stark"
"1117","Jordan Torunarigha_2019",2019,"Hertha BSC","Bundesliga","Jordan Torunarigha","GER","DF","20",1997,12.9,34,30,23,10,1,18,28,64.3,10,19,7,12,29,63,55,0,"https://fbref.com/en/players/f86cabbd/Jordan-Torunarigha"
"1118","Kevin Akpoguma_2019",2019,"Hoffenheim","Bundesliga","Kevin Akpoguma","NGA","DF","23",1995,5.5,23,15,13,10,0,11,21,52.4,10,18,5,13,12,35,20,2,"https://fbref.com/en/players/6ec6fde0/Kevin-Akpoguma"
"1119","Alfons Amade_2019",2019,"Hoffenheim","Bundesliga","Alfons Amade","GER","MF","18",1999,0.1,1,1,0,1,0,1,2,50,1,0,0,0,1,2,0,0,"https://fbref.com/en/players/d73a07e2/Alfons-Amade"
"1120","Nadiem Amiri_2019",2019,"Hoffenheim","Bundesliga","Nadiem Amiri","GER","MF","21",1996,8.4,14,9,8,4,2,3,13,23.1,10,11,0,11,7,21,4,0,"https://fbref.com/en/players/555d5edd/Nadiem-Amiri"
"1121","Oliver Baumann_2019",2019,"Hoffenheim","Bundesliga","Oliver Baumann","GER","GK","28",1990,33,0,0,0,0,0,0,0,NA,0,0,0,0,2,2,11,5,"https://fbref.com/en/players/47064058/Oliver-Baumann"
"1122","Christoph Baumgartner_2019",2019,"Hoffenheim","Bundesliga","Christoph Baumgartner","AUT","MF","18",1999,0.9,1,0,0,0,1,1,3,33.3,2,2,0,2,0,1,0,0,"https://fbref.com/en/players/437f2b00/Christoph-Baumgartner"
"1123","Ishak Belfodil_2019",2019,"Hoffenheim","Bundesliga","Ishak Belfodil","ALG","FW,MF","26",1992,20.7,13,10,5,6,2,4,16,25,12,6,0,6,3,16,14,0,"https://fbref.com/en/players/ff182fdc/Ishak-Belfodil"
"1124","Ermin Bičakčić_2019",2019,"Hoffenheim","Bundesliga","Ermin Bičakčić","BIH","DF","28",1990,19.9,32,19,18,11,3,13,22,59.1,9,36,15,21,56,88,79,1,"https://fbref.com/en/players/7aac47fe/Ermin-Bicakcic"
"1125","Leonardo Bittencourt_2019",2019,"Hoffenheim","Bundesliga","Leonardo Bittencourt","GER","MF","24",1993,11.9,37,26,9,22,6,8,32,25,24,22,1,21,13,50,7,0,"https://fbref.com/en/players/dc62fbee/Leonardo-Bittencourt"
"1126","Joshua Brenet_2019",2019,"Hoffenheim","Bundesliga","Joshua Brenet","NED","DF","24",1994,10.1,20,13,12,5,3,7,13,53.8,6,16,1,15,8,28,19,0,"https://fbref.com/en/players/2b5527c4/Joshua-Brenet"
"1127","Kerem Demirbay_2019",2019,"Hoffenheim","Bundesliga","Kerem Demirbay","GER","MF","25",1993,22.4,57,35,20,27,10,11,51,21.6,40,34,10,24,22,79,25,0,"https://fbref.com/en/players/54b4dc4e/Kerem-Demirbay"
"1128","Dennis Geiger_2019",2019,"Hoffenheim","Bundesliga","Dennis Geiger","GER","MF","20",1998,2.7,2,1,1,1,0,1,6,16.7,5,1,0,1,3,5,1,0,"https://fbref.com/en/players/37f606f0/Dennis-Geiger"
"1129","Vincenzo Grifo_2019",2019,"Hoffenheim","Bundesliga","Vincenzo Grifo","ITA","MF,FW","25",1993,3.7,6,3,2,3,1,0,5,0,5,2,1,1,2,8,5,0,"https://fbref.com/en/players/54e4866f/Vincenzo-Grifo"
"1130","Florian Grillitsch_2019",2019,"Hoffenheim","Bundesliga","Florian Grillitsch","AUT","MF","22",1995,26.6,77,49,30,38,9,36,80,45,44,34,8,26,72,149,56,1,"https://fbref.com/en/players/ffbbc83b/Florian-Grillitsch"
"1131","Justin Hoogma_2019",2019,"Hoffenheim","Bundesliga","Justin Hoogma","NED","DF,MF","20",1998,1.2,4,2,2,1,1,2,2,100,0,3,1,2,2,6,1,0,"https://fbref.com/en/players/816192f0/Justin-Hoogma"
"1132","Benjamin Hübner_2019",2019,"Hoffenheim","Bundesliga","Benjamin Hübner","GER","DF","29",1989,9,29,18,18,9,2,14,18,77.8,4,16,7,9,21,50,35,0,"https://fbref.com/en/players/99de6b6f/Benjamin-Hubner"
"1133","Joelinton_2019",2019,"Hoffenheim","Bundesliga","Joelinton","BRA","FW,MF","21",1996,23.7,35,22,9,20,6,10,30,33.3,20,36,3,33,14,49,8,0,"https://fbref.com/en/players/c17bfb65/Joelinton"
"1134","Pavel Kadeřábek_2019",2019,"Hoffenheim","Bundesliga","Pavel Kadeřábek","CZE","DF","26",1992,27.9,30,19,12,13,5,11,24,45.8,13,37,10,27,34,64,71,1,"https://fbref.com/en/players/79c90e45/Pavel-Kaderabek"
"1135","Gregor Kobel_2019",2019,"Hoffenheim","Bundesliga","Gregor Kobel","SUI","GK","20",1997,1,0,0,0,0,0,0,0,NA,0,0,0,0,0,0,0,0,"https://fbref.com/en/players/cd59b9df/Gregor-Kobel"
"1136","Andrej Kramarić_2019",2019,"Hoffenheim","Bundesliga","Andrej Kramarić","CRO","MF,FW","27",1991,26.6,9,4,1,5,3,4,26,15.4,22,15,3,12,8,17,13,0,"https://fbref.com/en/players/603cb947/Andrej-Kramaric"
"1137","Reiss Nelson_2019",2019,"Hoffenheim","Bundesliga","Reiss Nelson","ENG","MF,FW","18",1999,7.1,17,10,8,4,5,2,13,15.4,11,12,1,11,5,22,2,0,"https://fbref.com/en/players/c5bdb6e3/Reiss-Nelson"
"1138","Håvard Nordtveit_2019",2019,"Hoffenheim","Bundesliga","Håvard Nordtveit","NOR","MF,DF","28",1990,5.2,8,5,2,4,2,3,7,42.9,4,8,5,3,4,12,14,0,"https://fbref.com/en/players/6cafd68d/Havard-Nordtveit"
"1139","Kasim Nuhu_2019",2019,"Hoffenheim","Bundesliga","Kasim Nuhu","GHA","DF","23",1995,10,19,11,14,3,2,10,23,43.5,13,11,5,6,23,42,44,0,"https://fbref.com/en/players/93a50d2c/Kasim-Nuhu"
"1140","David Otto_2019",2019,"Hoffenheim","Bundesliga","David Otto","GER","MF,FW","19",1999,0.3,2,1,1,1,0,0,1,0,1,0,0,0,0,2,0,0,"https://fbref.com/en/players/676ff98c/David-Otto"
"1141","Stefan Posch_2019",2019,"Hoffenheim","Bundesliga","Stefan Posch","AUT","DF","21",1997,15.6,45,32,28,15,2,17,28,60.7,11,26,11,15,21,66,58,0,"https://fbref.com/en/players/7f609bfc/Stefan-Posch"
"1142","Lukas Rupp_2019",2019,"Hoffenheim","Bundesliga","Lukas Rupp","GER","MF,DF","27",1991,0.3,1,1,0,0,1,0,0,NA,0,0,0,0,0,1,0,0,"https://fbref.com/en/players/3faa1780/Lukas-Rupp"
"1143","Nico Schulz_2019",2019,"Hoffenheim","Bundesliga","Nico Schulz","GER","DF","25",1993,28.2,34,20,19,12,3,15,36,41.7,21,32,4,28,24,58,36,0,"https://fbref.com/en/players/fa274d97/Nico-Schulz"
"1144","Ádám Szalai_2019",2019,"Hoffenheim","Bundesliga","Ádám Szalai","HUN","FW","30",1987,18.1,19,13,3,12,4,4,11,36.4,7,8,1,7,4,23,8,0,"https://fbref.com/en/players/53e07d0b/Adam-Szalai"
"1145","Kevin Vogt_2019",2019,"Hoffenheim","Bundesliga","Kevin Vogt","GER","DF","26",1991,26.6,24,15,20,4,0,12,32,37.5,20,28,11,17,33,57,103,3,"https://fbref.com/en/players/1d8e9add/Kevin-Vogt"
"1146","Steven Zuber_2019",2019,"Hoffenheim","Bundesliga","Steven Zuber","SUI","MF,FW","26",1991,6.3,12,9,5,6,1,6,13,46.2,7,5,1,4,5,17,4,0,"https://fbref.com/en/players/b6a6e0a7/Steven-Zuber"
"1147","Juninho Bacuna_2019",2019,"Huddersfield","Premier League","Juninho Bacuna","CUW","MF,DF","20",1997,15.7,46,29,22,19,5,22,54,40.7,32,21,1,20,24,70,12,1,"https://fbref.com/en/players/aaf1bf05/Juninho-Bacuna"
"1148","Philip Billing_2019",2019,"Huddersfield","Premier League","Philip Billing","DEN","MF","22",1996,24.3,73,44,26,39,8,19,42,45.2,23,57,16,41,53,126,43,0,"https://fbref.com/en/players/d328a254/Philip-Billing"
"1149","Joel Coleman_2019",2019,"Huddersfield","Premier League","Joel Coleman","ENG","GK","22",1995,1,0,0,0,0,0,0,0,NA,0,0,0,0,0,0,0,0,"https://fbref.com/en/players/b73e459a/Joel-Coleman"
"1150","Matty Daly_2019",2019,"Huddersfield","Premier League","Matty Daly","ENG","MF","17",2001,0.8,0,0,0,0,0,0,0,NA,0,0,0,0,0,0,0,0,"https://fbref.com/en/players/03e48abb/Matty-Daly"
"1151","Laurent Depoitre_2019",2019,"Huddersfield","Premier League","Laurent Depoitre","BEL","FW","29",1988,11.9,6,4,2,3,1,0,3,0,3,9,0,9,2,8,8,0,"https://fbref.com/en/players/aa5859cb/Laurent-Depoitre"
"1152","Adama Diakhaby_2019",2019,"Huddersfield","Premier League","Adama Diakhaby","FRA","FW,MF","22",1996,6.1,6,3,4,1,1,3,11,27.3,8,7,0,7,1,7,2,0,"https://fbref.com/en/players/65585e3a/Adama-Diakhaby"
"1153","Demeaco Duhaney_2019",2019,"Huddersfield","Premier League","Demeaco Duhaney","ENG","DF","19",1998,0.5,1,0,1,0,0,1,3,33.3,2,2,0,2,1,2,1,0,"https://fbref.com/en/players/5ef608f7/Demeaco-Duhaney"
"1154","Erik Durm_2019",2019,"Huddersfield","Premier League","Erik Durm","GER","DF","26",1992,22.8,35,22,24,8,3,14,33,42.4,19,26,6,20,41,76,42,0,"https://fbref.com/en/players/cf623c78/Erik-Durm"
"1155","Jon Gorenc Stanković_2019",2019,"Huddersfield","Premier League","Jon Gorenc Stanković","SVN","MF,DF","22",1996,7.9,26,18,18,7,1,14,26,53.8,12,16,9,7,9,35,20,1,"https://fbref.com/en/players/9c74fa25/Jon-Gorenc-Stankovic"
"1156","Karlan Grant_2019",2019,"Huddersfield","Premier League","Karlan Grant","ENG","FW","20",1997,9.7,5,2,1,2,2,1,3,33.3,2,8,0,8,2,7,1,1,"https://fbref.com/en/players/87f7500e/Karlan-Grant"
"1157","Florent Hadergjonaj_2019",2019,"Huddersfield","Premier League","Florent Hadergjonaj","KVX","DF,MF","24",1994,20.5,30,17,10,18,2,13,37,35.1,24,21,7,14,21,51,37,1,"https://fbref.com/en/players/9aa186b2/Florent-Hadergjonaj"
"1158","Ben Hamer_2019",2019,"Huddersfield","Premier League","Ben Hamer","ENG","GK","30",1987,6.1,0,0,0,0,0,0,3,0,3,0,0,0,1,1,3,2,"https://fbref.com/en/players/d822a850/Ben-Hamer"
"1159","Jonathan Hogg_2019",2019,"Huddersfield","Premier League","Jonathan Hogg","ENG","MF","29",1988,26.3,78,41,18,51,9,27,69,39.1,42,46,7,39,73,151,19,1,"https://fbref.com/en/players/9306d5ea/Jonathan-Hogg"
"1160","Mathias Jørgensen_2019",2019,"Huddersfield","Premier League","Mathias Jørgensen","DEN","DF","28",1990,23.9,49,31,27,21,1,27,46,58.7,19,29,14,15,69,118,83,0,"https://fbref.com/en/players/0db5d2c8/Mathias-Jorgensen"
"1161","Elias Kachunga_2019",2019,"Huddersfield","Premier League","Elias Kachunga","COD","FW,MF","26",1992,13.1,22,9,8,12,2,9,25,36,16,16,1,15,4,26,10,0,"https://fbref.com/en/players/5bddccc9/Elias-Kachunga"
"1162","Terence Kongolo_2019",2019,"Huddersfield","Premier League","Terence Kongolo","NED","DF","24",1994,30.2,74,46,44,26,4,27,47,57.4,20,42,16,26,65,139,106,1,"https://fbref.com/en/players/1f9a3a04/Terence-Kongolo"
"1163","Rajiv van La Parra_2019",2019,"Huddersfield","Premier League","Rajiv van La Parra","NED","FW,MF","27",1991,4.5,8,5,1,7,0,1,6,16.7,5,0,0,0,4,12,3,1,"https://fbref.com/en/players/1931bde9/Rajiv-van-La-Parra"
"1164","Jonas Lössl_2019",2019,"Huddersfield","Premier League","Jonas Lössl","DEN","GK","29",1989,30.9,0,0,0,0,0,0,1,0,1,1,0,1,2,2,12,2,"https://fbref.com/en/players/939bc634/Jonas-Lossl"
"1165","Chris Löwe_2019",2019,"Huddersfield","Premier League","Chris Löwe","GER","DF,MF","29",1989,22.9,34,18,17,15,2,12,33,36.4,21,21,3,18,23,57,56,0,"https://fbref.com/en/players/c6896eab/Chris-Lowe"
"1166","Isaac Mbenza_2019",2019,"Huddersfield","Premier League","Isaac Mbenza","BEL","FW,MF","22",1996,11,10,9,5,5,0,2,4,50,2,4,0,4,5,15,4,0,"https://fbref.com/en/players/aa1a8c7e/Isaac-Mbenza"
"1167","Aaron Mooy_2019",2019,"Huddersfield","Premier League","Aaron Mooy","AUS","MF,FW","27",1990,25.9,62,42,19,27,16,21,52,40.4,31,43,7,36,14,76,22,0,"https://fbref.com/en/players/47b7e3af/Aaron-Mooy"
"1168","Steve Mounié_2019",2019,"Huddersfield","Premier League","Steve Mounié","BEN","FW","23",1994,19.8,9,6,3,4,2,2,12,16.7,10,10,1,9,5,14,15,0,"https://fbref.com/en/players/19ba6c6d/Steve-Mounie"
"1169","Alex Pritchard_2019",2019,"Huddersfield","Premier League","Alex Pritchard","ENG","MF,FW","25",1993,23.1,36,24,10,18,8,10,35,28.6,25,26,2,24,17,53,9,0,"https://fbref.com/en/players/ff9fcd4d/Alex-Pritchard"
"1170","Jason Puncheon_2019",2019,"Huddersfield","Premier League","Jason Puncheon","ENG","MF","32",1986,4.2,7,4,1,5,1,1,7,14.3,6,3,1,2,3,10,8,0,"https://fbref.com/en/players/fd3f57ce/Jason-Puncheon"
"1171","Collin Quaner_2019",2019,"Huddersfield","Premier League","Collin Quaner","GER","FW","27",1991,0.4,0,0,0,0,0,0,1,0,1,0,0,0,0,0,0,0,"https://fbref.com/en/players/19b8b0b9/Collin-Quaner"
"1172","Aaron Rowe_2019",2019,"Huddersfield","Premier League","Aaron Rowe","ENG","FW","17",2000,0.8,1,0,1,0,0,0,0,NA,0,0,0,0,1,2,1,0,"https://fbref.com/en/players/4b6bcb0d/Aaron-Rowe"
"1173","Abdelhamid Sabiri_2019",2019,"Huddersfield","Premier League","Abdelhamid Sabiri","MAR","FW","21",1996,0.5,2,1,1,1,0,0,0,NA,0,1,0,1,1,3,0,0,"https://fbref.com/en/players/4830e0af/Abdelhamid-Sabiri"
"1174","Christopher Schindler_2019",2019,"Huddersfield","Premier League","Christopher Schindler","GER","DF","28",1990,36.2,61,36,46,14,1,27,47,57.4,20,69,34,35,70,131,138,4,"https://fbref.com/en/players/8ae9869d/Christopher-Schindler"
"1175","Tommy Smith_2019",2019,"Huddersfield","Premier League","Tommy Smith","ENG","DF","26",1992,12.7,26,13,14,11,1,10,25,40,15,12,4,8,18,44,25,0,"https://fbref.com/en/players/e9208654/Tommy-Smith"
"1176","Ramadan Sobhi_2019",2019,"Huddersfield","Premier League","Ramadan Sobhi","EGY","FW,MF","21",1997,0.9,1,1,0,1,0,0,0,NA,0,2,0,2,1,2,0,0,"https://fbref.com/en/players/98be0d02/Ramadan-Sobhi"
"1177","Danny Williams_2019",2019,"Huddersfield","Premier League","Danny Williams","USA","MF","29",1989,1.1,0,0,0,0,0,0,0,NA,0,4,1,3,1,1,2,0,"https://fbref.com/en/players/ec9a28ce/Danny-Williams"
"1178","Juan Aguilera_2019",2019,"Huesca","La Liga","Juan Aguilera","ESP","MF","32",1985,3.8,2,2,0,1,1,1,4,25,3,4,2,2,4,6,2,0,"https://fbref.com/en/players/18dc8533/Juan-Aguilera"
"1179","Carlos Akapo_2019",2019,"Huesca","La Liga","Carlos Akapo","EQG","DF","25",1993,11.4,28,15,18,8,2,19,33,57.6,14,12,2,10,23,51,36,0,"https://fbref.com/en/players/f2a68b97/Carlos-Akapo"
"1180","Ezequiel Ávila_2019",2019,"Huesca","La Liga","Ezequiel Ávila","ARG","FW,MF","24",1994,22.2,18,10,7,7,4,4,26,15.4,22,21,2,19,13,31,22,0,"https://fbref.com/en/players/253a06b9/Ezequiel-Avila"
"1181","Rajko Brežančić_2019",2019,"Huesca","La Liga","Rajko Brežančić","SRB","DF","28",1989,0.7,1,0,0,0,1,0,0,NA,0,0,0,0,0,1,0,0,"https://fbref.com/en/players/1519a888/Rajko-Brezancic"
"1182","Juanjo Camacho_2019",2019,"Huesca","La Liga","Juanjo Camacho","ESP","MF,DF","37",1980,0.4,1,1,1,0,0,1,1,100,0,0,0,0,0,1,1,0,"https://fbref.com/en/players/1a1609ab/Juanjo-Camacho"
"1183","Cucho_2019",2019,"Huesca","La Liga","Cucho","COL","FW","19",1999,23.9,22,13,6,10,6,6,18,33.3,12,23,2,21,9,31,21,0,"https://fbref.com/en/players/71b47ab9/Cucho"
"1184","Adrián Diéguez_2019",2019,"Huesca","La Liga","Adrián Diéguez","ESP","DF","22",1996,8.3,16,10,11,4,1,9,16,56.3,7,9,4,5,12,28,46,1,"https://fbref.com/en/players/70438d35/Adrian-Dieguez"
"1185","Xabier Etxeita_2019",2019,"Huesca","La Liga","Xabier Etxeita","ESP","DF","30",1987,29.7,47,23,32,12,3,26,47,55.3,21,38,25,13,39,86,163,3,"https://fbref.com/en/players/4a895384/Xabier-Etxeita"
"1186","David Ferreiro_2019",2019,"Huesca","La Liga","David Ferreiro","ESP","MF,FW","30",1988,25.3,36,22,13,19,4,11,64,17.2,53,27,1,26,24,60,14,2,"https://fbref.com/en/players/8970907e/David-Ferreiro"
"1187","Javi Galán_2019",2019,"Huesca","La Liga","Javi Galán","ESP","DF,FW","23",1994,16,61,39,36,23,2,34,59,57.6,25,22,1,21,19,80,52,1,"https://fbref.com/en/players/a4b00319/Javi-Galan"
"1188","Álex Gallar_2019",2019,"Huesca","La Liga","Álex Gallar","ESP","MF,FW","26",1992,11.2,15,9,6,5,4,8,19,42.1,11,9,1,8,9,24,5,0,"https://fbref.com/en/players/36d5469c/Alex-Gallar"
"1189","Enric Gallego_2019",2019,"Huesca","La Liga","Enric Gallego","ESP","FW","31",1986,17.1,21,15,3,13,5,3,19,15.8,16,17,2,15,8,29,32,0,"https://fbref.com/en/players/82e9b89d/Enric-Gallego"
"1190","Moi Gómez_2019",2019,"Huesca","La Liga","Moi Gómez","ESP","MF","24",1994,33.9,42,28,15,25,2,11,46,23.9,35,27,3,24,28,70,27,0,"https://fbref.com/en/players/5a626448/Moi-Gomez"
"1191","Serdar Gürler_2019",2019,"Huesca","La Liga","Serdar Gürler","TUR","MF,FW","26",1991,5.4,5,5,3,2,0,3,11,27.3,8,8,0,8,1,6,2,0,"https://fbref.com/en/players/8d2ad5c0/Serdar-Gurler"
"1192","Yangel Herrera_2019",2019,"Huesca","La Liga","Yangel Herrera","VEN","MF,DF","20",1998,12.8,48,24,18,25,5,23,43,53.5,20,13,1,12,14,62,32,0,"https://fbref.com/en/players/e778654a/Yangel-Herrera"
"1193","Pablo Insua_2019",2019,"Huesca","La Liga","Pablo Insua","ESP","DF","24",1993,8.6,23,10,14,9,0,8,15,53.3,7,2,0,2,12,35,40,0,"https://fbref.com/en/players/4b5e7e90/Pablo-Insua"
"1194","Aleksandar Jovanović_2019",2019,"Huesca","La Liga","Aleksandar Jovanović","SRB","GK","25",1992,12,0,0,0,0,0,0,0,NA,0,0,0,0,1,1,3,0,"https://fbref.com/en/players/129dd8e7/Aleksandar-Jovanovic"
"1195","Juanpi_2019",2019,"Huesca","La Liga","Juanpi","VEN","MF,FW","24",1994,7.4,16,6,9,5,2,4,12,33.3,8,15,0,15,6,22,3,0,"https://fbref.com/en/players/d79afcfc/Juanpi"
"1196","Samuele Longo_2019",2019,"Huesca","La Liga","Samuele Longo","ITA","FW","26",1992,6.2,4,3,2,2,0,0,6,0,6,4,0,4,1,5,7,0,"https://fbref.com/en/players/1163de29/Samuele-Longo"
"1197","Luisinho_2019",2019,"Huesca","La Liga","Luisinho","POR","DF","33",1985,5.6,14,10,9,5,0,10,17,58.8,7,6,1,5,16,30,17,0,"https://fbref.com/en/players/a7f00c8c/Luisinho"
"1198","Martín Mantovani_2019",2019,"Huesca","La Liga","Martín Mantovani","ARG","DF","34",1984,7.8,15,9,12,3,0,6,11,54.5,5,4,3,1,22,37,48,0,"https://fbref.com/en/players/4ffb647d/Martin-Mantovani"
"1199","Gonzalo Melero_2019",2019,"Huesca","La Liga","Gonzalo Melero","ESP","MF","24",1994,14.9,26,23,5,19,2,11,48,22.9,37,14,4,10,2,28,23,0,"https://fbref.com/en/players/3902e91b/Gonzalo-Melero"
"1200","Jorge Miramón_2019",2019,"Huesca","La Liga","Jorge Miramón","ESP","DF","29",1989,27.7,73,55,49,17,7,34,53,64.2,19,34,11,23,44,117,65,1,"https://fbref.com/en/players/7f4c7c9f/Jorge-Miramon"
"1201","Damián Musto_2019",2019,"Huesca","La Liga","Damián Musto","ARG","MF,DF","31",1987,18.7,52,34,22,27,3,16,33,48.5,17,30,11,19,34,86,54,1,"https://fbref.com/en/players/74e0a984/Damian-Musto"
"1202","Jorge Pulido_2019",2019,"Huesca","La Liga","Jorge Pulido","ESP","DF","27",1991,30.9,63,42,40,19,4,32,51,62.7,19,39,18,21,50,113,158,0,"https://fbref.com/en/players/978cd030/Jorge-Pulido"
"1203","Cristian Rivera_2019",2019,"Huesca","La Liga","Cristian Rivera","ESP","MF","21",1997,18.8,38,25,18,19,1,11,25,44,14,21,4,17,31,69,31,0,"https://fbref.com/en/players/8ef81d2d/Cristian-Rivera"
"1204","Roberto Santamaría_2019",2019,"Huesca","La Liga","Roberto Santamaría","ESP","GK","33",1985,20,0,0,0,0,0,0,0,NA,0,0,0,0,1,1,12,1,"https://fbref.com/en/players/bca21ef3/Roberto-Santamaria"
"1205","Lluís Sastre_2019",2019,"Huesca","La Liga","Lluís Sastre","ESP","MF","32",1986,1.3,5,3,0,5,0,0,1,0,1,0,0,0,1,6,0,0,"https://fbref.com/en/players/5f186f5c/Lluis-Sastre"
"1206","Rúben Semedo_2019",2019,"Huesca","La Liga","Rúben Semedo","POR","DF","24",1994,9.4,20,16,14,6,0,12,16,75,4,15,9,6,16,36,35,2,"https://fbref.com/en/players/c904f3d5/Ruben-Semedo"
"1207","Axel Werner_2019",2019,"Huesca","La Liga","Axel Werner","ARG","GK","22",1996,6,0,0,0,0,0,0,0,NA,0,0,0,0,0,0,2,0,"https://fbref.com/en/players/c0b1a6da/Axel-Werner"
"1208","Kwadwo Asamoah_2019",2019,"Inter","Serie A","Kwadwo Asamoah","GHA","DF","29",1988,29.7,44,26,22,14,8,29,51,56.9,22,21,4,17,40,84,46,1,"https://fbref.com/en/players/089550f5/Kwadwo-Asamoah"
"1209","Keita Baldé_2019",2019,"Inter","Serie A","Keita Baldé","SEN","FW","23",1995,9.9,10,6,4,2,4,2,9,22.2,7,8,0,8,3,13,1,0,"https://fbref.com/en/players/509a4ccb/Keita-Balde"
"1210","Marcelo Brozović_2019",2019,"Inter","Serie A","Marcelo Brozović","CRO","MF","25",1992,29.4,101,70,47,40,14,31,86,36,55,45,8,37,44,145,32,3,"https://fbref.com/en/players/33b8d077/Marcelo-Brozovic"
"1211","Antonio Candreva_2019",2019,"Inter","Serie A","Antonio Candreva","ITA","FW,MF","31",1987,5.6,1,1,0,1,0,1,8,12.5,7,0,0,0,4,5,9,0,"https://fbref.com/en/players/356c9002/Antonio-Candreva"
"1212","Danilo D'Ambrosio_2019",2019,"Inter","Serie A","Danilo D'Ambrosio","ITA","DF","29",1988,28.7,69,40,34,27,8,24,57,42.1,33,25,8,17,27,96,39,0,"https://fbref.com/en/players/44eb9093/Danilo-DAmbrosio"
"1213","Roberto Gagliardini_2019",2019,"Inter","Serie A","Roberto Gagliardini","ITA","MF","24",1994,12.1,23,14,13,8,2,10,27,37,17,21,3,18,16,39,19,0,"https://fbref.com/en/players/ce30bfc8/Roberto-Gagliardini"
"1214","Samir Handanović_2019",2019,"Inter","Serie A","Samir Handanović","SVN","GK","34",1984,38,1,0,1,0,0,1,1,100,0,0,0,0,0,1,12,1,"https://fbref.com/en/players/74419746/Samir-Handanovic"
"1215","Dalbert Henrique_2019",2019,"Inter","Serie A","Dalbert Henrique","BRA","DF","24",1993,8.6,33,24,18,14,1,12,21,57.1,9,9,3,6,8,41,20,0,"https://fbref.com/en/players/f45f9427/Dalbert-Henrique"
"1216","Mauro Icardi_2019",2019,"Inter","Serie A","Mauro Icardi","ARG","FW","25",1993,25.2,9,8,2,2,5,1,6,16.7,5,4,1,3,3,12,20,1,"https://fbref.com/en/players/43b78598/Mauro-Icardi"
"1217","Yann Karamoh_2019",2019,"Inter","Serie A","Yann Karamoh","FRA","FW,MF","20",1998,0.1,0,0,0,0,0,0,0,NA,0,0,0,0,0,0,0,0,"https://fbref.com/en/players/8b66d9cc/Yann-Karamoh"
"1218","João Mário_2019",2019,"Inter","Serie A","João Mário","POR","MF,FW","25",1993,12,28,16,9,15,4,9,31,29,22,14,0,14,6,34,4,1,"https://fbref.com/en/players/f0021247/Joao-Mario"
"1219","Lautaro Martínez_2019",2019,"Inter","Serie A","Lautaro Martínez","ARG","FW,MF","20",1997,14.9,6,5,0,2,4,2,6,33.3,4,16,0,16,3,9,7,0,"https://fbref.com/en/players/f7036e1c/Lautaro-Martinez"
"1220","Miranda_2019",2019,"Inter","Serie A","Miranda","BRA","DF","33",1984,12.9,11,7,7,4,0,4,8,50,4,11,7,4,14,25,48,2,"https://fbref.com/en/players/314f2124/Miranda"
"1221","Radja Nainggolan_2019",2019,"Inter","Serie A","Radja Nainggolan","BEL","MF","30",1988,21.9,35,26,7,20,8,10,24,41.7,14,17,2,15,8,43,5,0,"https://fbref.com/en/players/1f9328da/Radja-Nainggolan"
"1222","Ivan Perišić_2019",2019,"Inter","Serie A","Ivan Perišić","CRO","FW","29",1989,30,34,26,7,20,7,16,51,31.4,35,40,4,36,23,57,55,0,"https://fbref.com/en/players/6fe90922/Ivan-Perisic"
"1223","Matteo Politano_2019",2019,"Inter","Serie A","Matteo Politano","ITA","FW","24",1993,28.3,18,7,9,4,5,8,30,26.7,22,18,0,18,14,32,10,1,"https://fbref.com/en/players/5e861944/Matteo-Politano"
"1224","Andrea Ranocchia_2019",2019,"Inter","Serie A","Andrea Ranocchia","ITA","DF,FW","30",1988,0.7,2,2,1,1,0,0,1,0,1,1,0,1,0,2,3,0,"https://fbref.com/en/players/539230cf/Andrea-Ranocchia"
"1225","Milan Škriniar_2019",2019,"Inter","Serie A","Milan Škriniar","SVK","DF","23",1995,35,64,37,46,17,1,38,60,63.3,22,48,29,19,27,91,138,0,"https://fbref.com/en/players/30f5ffa9/Milan-Skriniar"
"1226","Cédric Soares_2019",2019,"Inter","Serie A","Cédric Soares","POR","DF","26",1991,2.9,8,6,2,4,2,4,7,57.1,3,4,1,3,2,10,3,0,"https://fbref.com/en/players/839c14e1/Cedric-Soares"
"1227","Borja Valero_2019",2019,"Inter","Serie A","Borja Valero","ESP","MF","33",1985,13.7,22,19,9,10,3,8,30,26.7,22,11,1,10,16,38,27,2,"https://fbref.com/en/players/0e21fc3c/Borja-Valero"
"1228","Matías Vecino_2019",2019,"Inter","Serie A","Matías Vecino","URU","MF","26",1991,22.4,50,39,18,23,9,26,53,49.1,27,38,9,29,17,67,22,0,"https://fbref.com/en/players/44ac04e9/Matias-Vecino"
"1229","Stefan de Vrij_2019",2019,"Inter","Serie A","Stefan de Vrij","NED","DF","26",1992,28,25,16,14,10,1,8,15,53.3,7,32,23,9,25,50,95,1,"https://fbref.com/en/players/d0d8dd44/Stefan-de-Vrij"
"1230","Šime Vrsaljko_2019",2019,"Inter","Serie A","Šime Vrsaljko","CRO","DF","26",1992,8.1,20,14,8,6,6,9,14,64.3,5,5,1,4,11,31,27,1,"https://fbref.com/en/players/46a8347f/Sime-Vrsaljko"
"1231","Andrea Barzagli_2019",2019,"Juventus","Serie A","Andrea Barzagli","ITA","DF","37",1981,2.9,1,1,0,1,0,1,2,50,1,2,2,0,4,5,10,0,"https://fbref.com/en/players/7c0000fd/Andrea-Barzagli"
"1232","Medhi Benatia_2019",2019,"Juventus","Serie A","Medhi Benatia","MAR","DF","31",1987,5,7,6,6,1,0,3,5,60,2,10,5,5,16,23,18,0,"https://fbref.com/en/players/3b15ef2d/Medhi-Benatia"
"1233","Rodrigo Bentancur_2019",2019,"Juventus","Serie A","Rodrigo Bentancur","URU","MF","21",1997,22.3,53,34,22,29,2,18,39,46.2,21,20,8,12,43,96,42,1,"https://fbref.com/en/players/3b8674e6/Rodrigo-Bentancur"
"1234","Federico Bernardeschi_2019",2019,"Juventus","Serie A","Federico Bernardeschi","ITA","MF,FW","24",1994,16.4,14,8,5,6,3,7,18,38.9,11,9,0,9,6,20,10,0,"https://fbref.com/en/players/ee93c1a9/Federico-Bernardeschi"
"1235","Leonardo Bonucci_2019",2019,"Juventus","Serie A","Leonardo Bonucci","ITA","DF","31",1987,27.5,18,9,11,6,1,10,13,76.9,3,32,21,11,38,56,88,3,"https://fbref.com/en/players/52ec54d0/Leonardo-Bonucci"
"1236","Martín Cáceres_2019",2019,"Juventus","Serie A","Martín Cáceres","URU","DF","31",1987,7,7,3,6,0,1,4,4,100,0,6,3,3,4,11,14,0,"https://fbref.com/en/players/e94d79e3/Martin-Caceres"
"1237","Emre Can_2019",2019,"Juventus","Serie A","Emre Can","GER","MF","24",1994,20.1,64,38,28,27,9,24,40,60,16,43,13,30,28,92,36,2,"https://fbref.com/en/players/a65ce836/Emre-Can"
"1238","João Cancelo_2019",2019,"Juventus","Serie A","João Cancelo","POR","DF","24",1994,21.9,43,28,18,18,7,27,49,55.1,22,14,4,10,15,58,48,0,"https://fbref.com/en/players/bd6351cd/Joao-Cancelo"
"1239","Giorgio Chiellini_2019",2019,"Juventus","Serie A","Giorgio Chiellini","ITA","DF","33",1984,22.1,24,13,20,2,2,5,8,62.5,3,22,15,7,30,54,96,1,"https://fbref.com/en/players/e85fb9b8/Giorgio-Chiellini"
"1240","Douglas Costa_2019",2019,"Juventus","Serie A","Douglas Costa","BRA","FW,MF","27",1990,6.9,10,8,2,8,0,4,9,44.4,5,8,0,8,4,14,2,0,"https://fbref.com/en/players/4fa7cb9b/Douglas-Costa"
"1241","Juan Cuadrado_2019",2019,"Juventus","Serie A","Juan Cuadrado","COL","MF,DF","30",1988,13.6,20,15,6,9,5,5,23,21.7,18,14,3,11,18,38,11,0,"https://fbref.com/en/players/0ab1f153/Juan-Cuadrado"
"1242","Mattia De Sciglio_2019",2019,"Juventus","Serie A","Mattia De Sciglio","ITA","DF","25",1992,19.4,40,28,24,14,2,17,28,60.7,11,18,6,12,26,66,58,1,"https://fbref.com/en/players/ae4e2852/Mattia-De-Sciglio"
"1243","Paulo Dybala_2019",2019,"Juventus","Serie A","Paulo Dybala","ARG","FW,MF","24",1993,23.7,17,8,3,9,5,7,23,30.4,16,20,2,18,14,31,1,0,"https://fbref.com/en/players/e0921a4f/Paulo-Dybala"
"1244","Paolo Gozzi Iweru_2019",2019,"Juventus","Serie A","Paolo Gozzi Iweru","ITA","DF","17",2001,1,3,2,2,1,0,0,0,NA,0,0,0,0,3,6,3,0,"https://fbref.com/en/players/94230890/Paolo-Gozzi-Iweru"
"1245","Grigoris Kastanos_2019",2019,"Juventus","Serie A","Grigoris Kastanos","CYP","MF","20",1998,0.7,3,1,3,0,0,0,0,NA,0,3,1,2,0,3,0,0,"https://fbref.com/en/players/2a82aa85/Grigoris-Kastanos"
"1246","Moise Kean_2019",2019,"Juventus","Serie A","Moise Kean","ITA","FW","18",2000,6,0,0,0,0,0,0,1,0,1,1,0,1,2,2,1,0,"https://fbref.com/en/players/3d50bcdb/Moise-Kean"
"1247","Sami Khedira_2019",2019,"Juventus","Serie A","Sami Khedira","GER","MF","31",1987,7.8,10,9,6,2,2,5,9,55.6,4,8,3,5,5,15,6,0,"https://fbref.com/en/players/38ac43d3/Sami-Khedira"
"1248","Mario Mandžukić_2019",2019,"Juventus","Serie A","Mario Mandžukić","CRO","FW","32",1986,22.4,34,25,13,15,6,9,18,50,9,17,5,12,13,47,22,0,"https://fbref.com/en/players/afa0d4e0/Mario-Mandzukic"
"1249","Blaise Matuidi_2019",2019,"Juventus","Serie A","Blaise Matuidi","FRA","MF","31",1987,26.9,59,33,25,21,13,20,36,55.6,16,33,8,25,26,85,21,1,"https://fbref.com/en/players/c0cddebe/Blaise-Matuidi"
"1250","Stephy Mavididi_2019",2019,"Juventus","Serie A","Stephy Mavididi","ENG","FW","20",1998,0.2,0,0,0,0,0,0,0,NA,0,1,0,1,0,0,0,0,"https://fbref.com/en/players/30144daa/Stephy-Mavididi"
"1251","Hans Nicolussi Caviglia_2019",2019,"Juventus","Serie A","Hans Nicolussi Caviglia","ITA","MF","18",2000,0.6,2,1,0,2,0,0,2,0,2,2,1,1,0,2,0,0,"https://fbref.com/en/players/b136c945/Hans-Nicolussi-Caviglia"
"1252","Mattia Perin_2019",2019,"Juventus","Serie A","Mattia Perin","ITA","GK","25",1992,9,0,0,0,0,0,0,0,NA,0,0,0,0,0,0,3,2,"https://fbref.com/en/players/4c62d0c8/Mattia-Perin"
"1253","Carlo Pinsoglio_2019",2019,"Juventus","Serie A","Carlo Pinsoglio","ITA","GK","28",1990,1,0,0,0,0,0,0,0,NA,0,0,0,0,0,0,0,0,"https://fbref.com/en/players/f6a06749/Carlo-Pinsoglio"
"1254","Miralem Pjanić_2019",2019,"Juventus","Serie A","Miralem Pjanić","BIH","MF","28",1990,25.3,41,20,15,18,8,16,59,27.1,43,34,6,28,36,77,19,2,"https://fbref.com/en/players/ad6df2d5/Miralem-Pjanic"
"1255","Manolo Portanova_2019",2019,"Juventus","Serie A","Manolo Portanova","ITA","MF","18",2000,0.4,1,1,0,1,0,0,1,0,1,2,0,2,1,2,2,0,"https://fbref.com/en/players/c8c0dccd/Manolo-Portanova"
"1256","Cristiano Ronaldo_2019",2019,"Juventus","Serie A","Cristiano Ronaldo","POR","FW","33",1985,29.9,10,7,5,4,1,1,11,9.1,10,7,2,5,6,16,32,0,"https://fbref.com/en/players/dea698d9/Cristiano-Ronaldo"
"1257","Daniele Rugani_2019",2019,"Juventus","Serie A","Daniele Rugani","ITA","DF","24",1994,15,8,5,5,3,0,2,5,40,3,19,14,5,16,24,51,1,"https://fbref.com/en/players/14b8fcdf/Daniele-Rugani"
"1258","Alex Sandro_2019",2019,"Juventus","Serie A","Alex Sandro","BRA","DF","27",1991,26.5,68,45,28,33,7,21,36,58.3,15,32,8,24,38,106,71,0,"https://fbref.com/en/players/0d82903c/Alex-Sandro"
"1259","Matheus Pereira da Silva_2019",2019,"Juventus","Serie A","Matheus Pereira da Silva","BRA","MF","20",1998,1,3,2,0,2,1,2,4,50,2,1,0,1,0,3,1,0,"https://fbref.com/en/players/bef22bc4/Matheus-Pereira-da-Silva"
"1260","Leonardo Spinazzola_2019",2019,"Juventus","Serie A","Leonardo Spinazzola","ITA","DF","25",1993,6.7,9,4,4,2,3,4,8,50,4,5,0,5,3,12,7,0,"https://fbref.com/en/players/3626daea/Leonardo-Spinazzola"
"1261","Wojciech Szczęsny_2019",2019,"Juventus","Serie A","Wojciech Szczęsny","POL","GK","28",1990,28,2,1,2,0,0,1,1,100,0,0,0,0,1,3,8,2,"https://fbref.com/en/players/01b8a2b2/Wojciech-Szczesny"
"1262","Francesco Acerbi_2019",2019,"Lazio","Serie A","Francesco Acerbi","ITA","DF","30",1988,36.8,40,30,22,13,5,12,16,75,4,50,32,18,61,101,169,1,"https://fbref.com/en/players/b96b595c/Francesco-Acerbi"
"1263","Luis Alberto_2019",2019,"Lazio","Serie A","Luis Alberto","ESP","MF,FW","25",1992,22.1,53,22,15,29,9,21,55,38.2,34,23,3,20,10,63,10,0,"https://fbref.com/en/players/5294a83f/Luis-Alberto"
"1264","Nicolò Armini_2019",2019,"Lazio","Serie A","Nicolò Armini","ITA","DF","17",2001,0.4,1,1,0,1,0,1,2,50,1,1,0,1,0,1,0,0,"https://fbref.com/en/players/2f7407fa/Nicolo-Armini"
"1265","Milan Badelj_2019",2019,"Lazio","Serie A","Milan Badelj","CRO","MF","29",1989,12.7,33,20,10,19,4,16,37,43.2,21,27,9,18,33,66,20,1,"https://fbref.com/en/players/e8c930bb/Milan-Badelj"
"1266","Bastos_2019",2019,"Lazio","Serie A","Bastos","ANG","DF","27",1991,12.7,22,17,16,4,2,17,27,63,10,16,8,8,7,29,49,1,"https://fbref.com/en/players/c01c66d9/Bastos"
"1267","Valon Berisha_2019",2019,"Lazio","Serie A","Valon Berisha","KVX","MF,FW","25",1993,2.2,8,5,1,6,1,4,6,66.7,2,6,0,6,4,12,3,0,"https://fbref.com/en/players/d5575935/Valon-Berisha"
"1268","Martín Cáceres_2019",2019,"Lazio","Serie A","Martín Cáceres","URU","DF","31",1987,3.4,4,2,3,1,0,4,6,66.7,2,4,0,4,0,4,12,1,"https://fbref.com/en/players/e94d79e3/Martin-Caceres"
"1269","Felipe Caicedo_2019",2019,"Lazio","Serie A","Felipe Caicedo","ECU","FW","29",1988,15.2,16,12,4,6,6,1,8,12.5,7,9,2,7,5,21,5,0,"https://fbref.com/en/players/93b891d1/Felipe-Caicedo"
"1270","Luan Capanni_2019",2019,"Lazio","Serie A","Luan Capanni","BRA","FW","18",2000,0.1,1,1,0,0,1,0,0,NA,0,0,0,0,0,1,0,0,"https://fbref.com/en/players/28237d7e/Luan-Capanni"
"1271","Danilo Cataldi_2019",2019,"Lazio","Serie A","Danilo Cataldi","ITA","MF,FW","23",1994,6.4,12,7,4,5,3,2,9,22.2,7,3,0,3,7,19,6,0,"https://fbref.com/en/players/ba3d3bea/Danilo-Cataldi"
"1272","Joaquín Correa_2019",2019,"Lazio","Serie A","Joaquín Correa","ARG","FW,MF","23",1994,21.4,21,13,6,12,3,5,18,27.8,13,14,3,11,2,23,7,0,"https://fbref.com/en/players/45b9b619/Joaquin-Correa"
"1273","Riza Durmisi_2019",2019,"Lazio","Serie A","Riza Durmisi","DEN","DF","24",1994,3.6,4,4,2,0,2,2,3,66.7,1,0,0,0,1,5,9,0,"https://fbref.com/en/players/e5cd9da6/Riza-Durmisi"
"1274","Luiz Felipe_2019",2019,"Lazio","Serie A","Luiz Felipe","ITA","DF","21",1997,14.3,27,18,20,7,0,13,20,65,7,27,15,12,26,53,57,1,"https://fbref.com/en/players/15d0c248/Luiz-Felipe"
"1275","Guido Guerrieri_2019",2019,"Lazio","Serie A","Guido Guerrieri","ITA","GK","22",1996,1,0,0,0,0,0,0,0,NA,0,0,0,0,0,0,2,0,"https://fbref.com/en/players/77e401c7/Guido-Guerrieri"
"1276","Ciro Immobile_2019",2019,"Lazio","Serie A","Ciro Immobile","ITA","FW","28",1990,31.8,12,6,4,3,5,4,9,44.4,5,18,1,17,1,13,8,0,"https://fbref.com/en/players/4431aed2/Ciro-Immobile"
"1277","Bruno Jordão_2019",2019,"Lazio","Serie A","Bruno Jordão","POR","MF,DF","19",1998,1,4,3,2,1,1,1,3,33.3,2,1,0,1,0,4,2,0,"https://fbref.com/en/players/41ff002d/Bruno-Jordao"
"1278","Lucas Leiva_2019",2019,"Lazio","Serie A","Lucas Leiva","BRA","MF","31",1987,22.1,91,54,40,46,5,38,79,48.1,41,27,11,16,52,143,43,3,"https://fbref.com/en/players/4c78b5ed/Lucas-Leiva"
"1279","Jordan Lukaku_2019",2019,"Lazio","Serie A","Jordan Lukaku","BEL","DF,MF","24",1994,1.9,4,3,2,1,1,3,5,60,2,3,0,3,5,9,2,0,"https://fbref.com/en/players/0cd0e21b/Jordan-Lukaku"
"1280","Senad Lulić_2019",2019,"Lazio","Serie A","Senad Lulić","BIH","DF,FW","32",1986,32.5,71,43,37,27,7,32,76,42.1,44,27,3,24,49,120,58,1,"https://fbref.com/en/players/7fd58fe3/Senad-Lulic"
"1281","Adam Marušić_2019",2019,"Lazio","Serie A","Adam Marušić","MNE","DF","25",1992,23.5,32,15,14,14,4,16,25,64,9,25,4,21,24,56,36,0,"https://fbref.com/en/players/d4535821/Adam-Marusic"
"1282","Sergej Milinković-Savić_2019",2019,"Lazio","Serie A","Sergej Milinković-Savić","SRB","MF","23",1995,26.6,44,28,17,21,6,23,60,38.3,37,28,4,24,27,71,48,0,"https://fbref.com/en/players/4e6dbac4/Sergej-Milinkovic-Savic"
"1283","Alessandro Murgia_2019",2019,"Lazio","Serie A","Alessandro Murgia","ITA","MF","21",1996,0.1,0,0,0,0,0,0,0,NA,0,0,0,0,0,0,0,0,"https://fbref.com/en/players/fb2c533b/Alessandro-Murgia"
"1284","Pedro Neto_2019",2019,"Lazio","Serie A","Pedro Neto","POR","FW,DF","18",2000,0.5,0,0,0,0,0,0,0,NA,0,1,0,1,0,0,0,0,"https://fbref.com/en/players/7ba2eaa9/Pedro-Neto"
"1285","Marco Parolo_2019",2019,"Lazio","Serie A","Marco Parolo","ITA","MF","33",1985,28.5,68,45,24,37,7,18,56,32.1,38,48,11,37,28,96,56,0,"https://fbref.com/en/players/ed5886d2/Marco-Parolo"
"1286","Patric_2019",2019,"Lazio","Serie A","Patric","ESP","DF","25",1993,12.1,19,11,8,8,3,8,15,53.3,7,14,7,7,12,31,29,1,"https://fbref.com/en/players/f7223718/Patric"
"1287","Silvio Proto_2019",2019,"Lazio","Serie A","Silvio Proto","BEL","GK","35",1983,2,0,0,0,0,0,0,1,0,1,0,0,0,0,0,1,0,"https://fbref.com/en/players/c8a88acd/Silvio-Proto"
"1288","Ștefan Radu_2019",2019,"Lazio","Serie A","Ștefan Radu","ROU","DF","31",1986,24.9,43,27,24,15,4,25,38,65.8,13,20,14,6,42,85,85,1,"https://fbref.com/en/players/53de807a/Stefan-Radu"
"1289","Rômulo_2019",2019,"Lazio","Serie A","Rômulo","ITA","DF","31",1987,8.6,10,5,8,2,0,5,7,71.4,2,10,2,8,5,15,13,0,"https://fbref.com/en/players/07abb358/Romulo"
"1290","Thomas Strakosha_2019",2019,"Lazio","Serie A","Thomas Strakosha","ALB","GK","23",1995,35,1,1,1,0,0,1,1,100,0,0,0,0,1,2,8,1,"https://fbref.com/en/players/339fe0e8/Thomas-Strakosha"
"1291","Wallace_2019",2019,"Lazio","Serie A","Wallace","BRA","DF","23",1994,13.7,17,13,11,6,0,8,17,47.1,9,13,7,6,30,47,60,2,"https://fbref.com/en/players/d61b3354/Wallace"
"1292","Alexander_2019",2019,"Leganés","La Liga","Alexander","ARG","FW","29",1988,0.1,1,0,1,0,0,1,1,100,0,0,0,0,0,1,0,0,"https://fbref.com/en/players/3e1858af/Alexander"
"1293","José Arnaiz_2019",2019,"Leganés","La Liga","José Arnaiz","ESP","MF,FW","23",1995,1.3,1,1,1,0,0,0,3,0,3,0,0,0,2,3,1,0,"https://fbref.com/en/players/46e07328/Jose-Arnaiz"
"1294","Martin Braithwaite_2019",2019,"Leganés","La Liga","Martin Braithwaite","DEN","FW","27",1991,15.6,5,3,0,0,5,0,4,0,4,9,0,9,3,8,4,0,"https://fbref.com/en/players/fd771f95/Martin-Braithwaite"
"1295","Unai Bustinza_2019",2019,"Leganés","La Liga","Unai Bustinza","ESP","DF","26",1992,22.5,41,31,25,14,2,17,33,51.5,16,31,13,18,53,94,110,2,"https://fbref.com/en/players/f3112790/Unai-Bustinza"
"1296","Guido Carrillo_2019",2019,"Leganés","La Liga","Guido Carrillo","ARG","FW","27",1991,22.1,25,14,4,12,9,6,19,31.6,13,12,1,11,8,33,25,0,"https://fbref.com/en/players/8f898ba8/Guido-Carrillo"
"1297","Iván Cuéllar_2019",2019,"Leganés","La Liga","Iván Cuéllar","ESP","GK","34",1984,33.9,0,0,0,0,0,0,1,0,1,0,0,0,2,2,10,0,"https://fbref.com/en/players/75751c99/Ivan-Cuellar"
"1298","Youssef En-Nesyri_2019",2019,"Leganés","La Liga","Youssef En-Nesyri","MAR","FW","21",1997,23.4,16,8,6,5,5,4,24,16.7,20,18,3,15,6,22,23,0,"https://fbref.com/en/players/04e17fd5/Youssef-En-Nesyri"
"1299","Javier Eraso_2019",2019,"Leganés","La Liga","Javier Eraso","ESP","MF,FW","28",1990,7,6,3,3,2,1,0,6,0,6,3,1,2,7,13,4,0,"https://fbref.com/en/players/aec0fb6f/Javier-Eraso"
"1300","Raúl García_2019",2019,"Leganés","La Liga","Raúl García","ESP","DF","29",1989,4.2,8,6,4,4,0,6,8,75,2,5,2,3,6,14,28,1,"https://fbref.com/en/players/1a317a1b/Raul-Garcia"
"1301","Gerard Gumbau_2019",2019,"Leganés","La Liga","Gerard Gumbau","ESP","MF","23",1994,13.3,22,16,9,13,0,6,25,24,19,15,2,13,13,35,13,0,"https://fbref.com/en/players/ac454a4f/Gerard-Gumbau"
"1302","Juanfran_2019",2019,"Leganés","La Liga","Juanfran","ESP","DF,FW","29",1988,16.2,20,12,13,5,2,9,16,56.3,7,9,4,5,19,39,37,0,"https://fbref.com/en/players/9ba48d64/Juanfran"
"1303","Vasyl Kravets_2019",2019,"Leganés","La Liga","Vasyl Kravets","UKR","DF,FW","20",1997,5.3,16,11,8,6,2,6,13,46.2,7,5,1,4,4,20,10,1,"https://fbref.com/en/players/29e48848/Vasyl-Kravets"
"1304","Andriy Lunin_2019",2019,"Leganés","La Liga","Andriy Lunin","UKR","GK","19",1999,4.1,0,0,0,0,0,0,0,NA,0,0,0,0,0,0,0,0,"https://fbref.com/en/players/3061e1ec/Andriy-Lunin"
"1305","Sabin Merino_2019",2019,"Leganés","La Liga","Sabin Merino","ESP","FW,MF","26",1992,3.3,1,1,0,0,1,1,1,100,0,1,0,1,0,1,4,0,"https://fbref.com/en/players/1d5f96d9/Sabin-Merino"
"1306","Ezequiel Muñoz_2019",2019,"Leganés","La Liga","Ezequiel Muñoz","ARG","DF","27",1990,2.3,3,2,1,2,0,0,0,NA,0,3,1,2,1,4,10,0,"https://fbref.com/en/players/e4b8c5b6/Ezequiel-Munoz"
"1307","Allan Nyom_2019",2019,"Leganés","La Liga","Allan Nyom","CMR","DF,FW","30",1988,19,32,24,20,10,2,12,17,70.6,5,7,2,5,20,52,35,0,"https://fbref.com/en/players/97572117/Allan-Nyom"
"1308","Dani Ojeda_2019",2019,"Leganés","La Liga","Dani Ojeda","ESP","MF,DF","23",1994,2.1,3,2,2,0,1,1,3,33.3,2,2,0,2,2,5,2,0,"https://fbref.com/en/players/375a669e/Dani-Ojeda"
"1309","Kenneth Omeruo_2019",2019,"Leganés","La Liga","Kenneth Omeruo","NGA","DF","24",1993,27,49,27,41,8,0,20,29,69,9,23,11,12,37,86,159,3,"https://fbref.com/en/players/0f0aa5b4/Kenneth-Omeruo"
"1310","Rubén Pérez_2019",2019,"Leganés","La Liga","Rubén Pérez","ESP","MF","29",1989,27.5,71,42,27,40,4,32,80,40,48,35,8,27,40,111,34,1,"https://fbref.com/en/players/3c7bc9bd/Ruben-Perez"
"1311","Recio_2019",2019,"Leganés","La Liga","Recio","ESP","MF","27",1991,14.3,30,21,14,13,3,6,24,25,18,14,2,12,14,44,14,0,"https://fbref.com/en/players/54073b28/Recio"
"1312","Diego Reyes_2019",2019,"Leganés","La Liga","Diego Reyes","MEX","DF","25",1992,3.6,7,4,4,3,0,3,4,75,1,4,4,0,7,14,17,1,"https://fbref.com/en/players/d4f46475/Diego-Reyes"
"1313","Óscar Rodríguez Arnaiz_2019",2019,"Leganés","La Liga","Óscar Rodríguez Arnaiz","ESP","MF","20",1998,27.8,46,25,26,15,5,16,58,27.6,42,12,2,10,16,62,16,0,"https://fbref.com/en/players/19709006/Oscar-Rodriguez-Arnaiz"
"1314","Diego Rolán_2019",2019,"Leganés","La Liga","Diego Rolán","URU","MF,FW","25",1993,2.4,6,4,3,3,0,2,9,22.2,7,2,0,2,3,9,3,0,"https://fbref.com/en/players/d1491e00/Diego-Rolan"
"1315","Michael Santos_2019",2019,"Leganés","La Liga","Michael Santos","URU","FW,MF","25",1993,6.2,12,5,1,7,4,2,7,28.6,5,7,1,6,1,13,1,0,"https://fbref.com/en/players/3cb6f224/Michael-Santos"
"1316","Jonathan Silva_2019",2019,"Leganés","La Liga","Jonathan Silva","ARG","DF,FW","24",1994,30,51,38,30,17,4,23,52,44.2,29,23,2,21,29,80,86,0,"https://fbref.com/en/players/f2308b33/Jonathan-Silva"
"1317","Dimitris Siovas_2019",2019,"Leganés","La Liga","Dimitris Siovas","GRE","DF","29",1988,32.9,57,32,38,18,1,27,47,57.4,20,32,15,17,65,122,155,1,"https://fbref.com/en/players/92d38e6c/Dimitris-Siovas"
"1318","Rodrigo Tarín_2019",2019,"Leganés","La Liga","Rodrigo Tarín","ESP","DF","22",1996,15.9,22,14,15,5,2,7,10,70,3,11,5,6,31,53,79,0,"https://fbref.com/en/players/a03c82b2/Rodrigo-Tarin"
"1319","Mikel Vesga_2019",2019,"Leganés","La Liga","Mikel Vesga","ESP","MF","25",1993,23,50,32,27,15,8,20,82,24.4,62,42,4,38,39,89,26,0,"https://fbref.com/en/players/b0fce72c/Mikel-Vesga"
"1320","Nabil El Zhar_2019",2019,"Leganés","La Liga","Nabil El Zhar","MAR","MF,FW","31",1986,10.7,8,4,2,4,2,0,5,0,5,4,0,4,4,12,1,0,"https://fbref.com/en/players/37f96552/Nabil-El-Zhar"
"1321","Marc Albrighton_2019",2019,"Leicester City","Premier League","Marc Albrighton","ENG","FW,MF","28",1989,18.1,35,22,18,14,3,13,31,41.9,18,26,3,23,23,58,30,0,"https://fbref.com/en/players/b827d5b3/Marc-Albrighton"
"1322","Daniel Amartey_2019",2019,"Leicester City","Premier League","Daniel Amartey","GHA","DF","23",1994,7.1,18,12,11,6,1,10,15,66.7,5,6,4,2,17,35,28,1,"https://fbref.com/en/players/1a4ef233/Daniel-Amartey"
"1323","Harvey Barnes_2019",2019,"Leicester City","Premier League","Harvey Barnes","ENG","MF,FW","20",1997,11.2,10,6,5,4,1,4,6,66.7,2,7,1,6,3,13,7,0,"https://fbref.com/en/players/3ea50f67/Harvey-Barnes"
"1324","Ben Chilwell_2019",2019,"Leicester City","Premier League","Ben Chilwell","ENG","DF","21",1996,36,55,29,34,18,3,24,55,43.6,31,37,7,30,38,93,156,0,"https://fbref.com/en/players/d2424d1b/Ben-Chilwell"
"1325","Hamza Choudhury_2019",2019,"Leicester City","Premier League","Hamza Choudhury","ENG","MF","20",1997,6.6,24,10,13,10,1,9,15,60,6,12,3,9,15,39,13,0,"https://fbref.com/en/players/7d2d3329/Hamza-Choudhury"
"1326","Fousseni Diabaté_2019",2019,"Leicester City","Premier League","Fousseni Diabaté","MLI","FW","22",1995,0.6,2,0,2,0,0,0,1,0,1,2,0,2,0,2,0,0,"https://fbref.com/en/players/d07e3b41/Fousseni-Diabate"
"1327","Jonny Evans_2019",2019,"Leicester City","Premier League","Jonny Evans","NIR","DF","30",1988,22.2,24,13,20,4,0,13,18,72.2,5,28,10,18,33,57,152,3,"https://fbref.com/en/players/f8fcd2a5/Jonny-Evans"
"1328","Christian Fuchs_2019",2019,"Leicester City","Premier League","Christian Fuchs","AUT","DF","32",1986,2.3,4,3,0,4,0,1,2,50,1,0,0,0,4,8,8,0,"https://fbref.com/en/players/a67a09fb/Christian-Fuchs"
"1329","Rachid Ghezzal_2019",2019,"Leicester City","Premier League","Rachid Ghezzal","ALG","FW,MF","26",1992,8.3,14,5,3,7,4,3,18,16.7,15,10,1,9,7,21,4,1,"https://fbref.com/en/players/dc3a9a0d/Rachid-Ghezzal"
"1330","Demarai Gray_2019",2019,"Leicester City","Premier League","Demarai Gray","JAM","FW,MF","22",1996,22.1,25,12,7,14,4,6,16,37.5,10,19,0,19,9,34,15,0,"https://fbref.com/en/players/4468ec10/Demarai-Gray"
"1331","Vicente Iborra_2019",2019,"Leicester City","Premier League","Vicente Iborra","ESP","MF","30",1988,2.5,4,1,1,3,0,0,7,0,7,1,0,1,8,12,4,1,"https://fbref.com/en/players/ad1ffcfd/Vicente-Iborra"
"1332","Kelechi Iheanacho_2019",2019,"Leicester City","Premier League","Kelechi Iheanacho","NGA","FW,MF","21",1996,10.5,6,5,4,1,1,1,5,20,4,5,0,5,2,8,3,0,"https://fbref.com/en/players/c92e1a31/Kelechi-Iheanacho"
"1333","James Maddison_2019",2019,"Leicester City","Premier League","James Maddison","ENG","MF,FW","21",1996,31.5,48,32,20,25,3,14,58,24.1,44,20,4,16,12,60,10,1,"https://fbref.com/en/players/ee38d9c5/James-Maddison"
"1334","Harry Maguire_2019",2019,"Leicester City","Premier League","Harry Maguire","ENG","DF","25",1993,28.8,31,17,21,9,1,11,17,64.7,6,32,18,14,36,67,155,4,"https://fbref.com/en/players/d8931174/Harry-Maguire"
"1335","Nampalys Mendy_2019",2019,"Leicester City","Premier League","Nampalys Mendy","SEN","MF","26",1992,23.2,33,18,16,16,1,6,22,27.3,16,24,8,16,26,59,26,2,"https://fbref.com/en/players/1598599e/Nampalys-Mendy"
"1336","Wes Morgan_2019",2019,"Leicester City","Premier League","Wes Morgan","JAM","DF","34",1984,21.4,27,15,14,12,1,6,7,85.7,1,24,10,14,32,59,109,1,"https://fbref.com/en/players/80c31c97/Wes-Morgan"
"1337","Wilfred Ndidi_2019",2019,"Leicester City","Premier League","Wilfred Ndidi","NGA","MF","21",1996,36.6,142,98,66,67,9,46,95,48.4,49,64,9,55,83,225,85,2,"https://fbref.com/en/players/6b47c5db/Wilfred-Ndidi"
"1338","Shinji Okazaki_2019",2019,"Leicester City","Premier League","Shinji Okazaki","JPN","MF,FW","32",1986,3.2,5,5,2,3,0,0,1,0,1,7,1,6,2,7,1,0,"https://fbref.com/en/players/68796d61/Shinji-Okazaki"
"1339","Ricardo Pereira_2019",2019,"Leicester City","Premier League","Ricardo Pereira","POR","DF,FW","24",1993,34.7,118,66,66,40,12,54,112,48.2,58,60,6,54,60,178,130,1,"https://fbref.com/en/players/75a72a99/Ricardo-Pereira"
"1340","Kasper Schmeichel_2019",2019,"Leicester City","Premier League","Kasper Schmeichel","DEN","GK","31",1986,38,1,1,1,0,0,1,1,100,0,0,0,0,3,4,14,3,"https://fbref.com/en/players/53af52f3/Kasper-Schmeichel"
"1341","Adrien Silva_2019",2019,"Leicester City","Premier League","Adrien Silva","POR","MF","29",1989,1,2,2,0,1,1,0,2,0,2,1,0,1,1,3,1,0,"https://fbref.com/en/players/d6f88a1d/Adrien-Silva"
"1342","Danny Simpson_2019",2019,"Leicester City","Premier League","Danny Simpson","ENG","DF","31",1987,3.2,11,3,8,3,0,3,5,60,2,7,3,4,6,17,20,0,"https://fbref.com/en/players/3201b03d/Danny-Simpson"
"1343","Çağlar Söyüncü_2019",2019,"Leicester City","Premier League","Çağlar Söyüncü","TUR","DF","22",1996,4.1,5,2,4,1,0,3,6,50,3,8,5,3,7,12,22,3,"https://fbref.com/en/players/21166ff4/Caglar-Soyuncu"
"1344","Youri Tielemans_2019",2019,"Leicester City","Premier League","Youri Tielemans","BEL","MF","21",1997,12.1,17,8,5,9,3,5,17,29.4,12,13,2,11,5,22,13,1,"https://fbref.com/en/players/56f7a928/Youri-Tielemans"
"1345","Jamie Vardy_2019",2019,"Leicester City","Premier League","Jamie Vardy","ENG","FW","31",1987,30.3,14,8,3,6,5,4,17,23.5,13,16,1,15,6,20,28,0,"https://fbref.com/en/players/45963054/Jamie-Vardy"
"1346","Enis Bardhi_2019",2019,"Levante","La Liga","Enis Bardhi","MKD","MF","23",1995,31.5,70,43,30,34,6,28,87,32.2,59,35,3,32,31,101,36,1,"https://fbref.com/en/players/cac2537b/Enis-Bardhi"
"1347","Emmanuel Boateng_2019",2019,"Levante","La Liga","Emmanuel Boateng","GHA","FW","22",1996,7.8,4,3,0,0,4,0,3,0,3,5,0,5,1,5,7,0,"https://fbref.com/en/players/2e23c66b/Emmanuel-Boateng"
"1348","Erick Cabaco_2019",2019,"Levante","La Liga","Erick Cabaco","URU","DF","23",1995,18.1,22,13,19,3,0,12,29,41.4,17,29,14,15,29,51,69,0,"https://fbref.com/en/players/e7ab4179/Erick-Cabaco"
"1349","José Campaña_2019",2019,"Levante","La Liga","José Campaña","ESP","MF","25",1993,35.7,65,45,31,29,5,27,86,31.4,59,51,7,44,48,113,46,1,"https://fbref.com/en/players/61220da2/Jose-Campana"
"1350","Chema_2019",2019,"Levante","La Liga","Chema","ESP","DF","26",1992,13.9,27,19,16,9,2,13,19,68.4,6,19,11,8,19,46,83,0,"https://fbref.com/en/players/7f203b54/Chema"
"1351","Coke_2019",2019,"Levante","La Liga","Coke","ESP","DF","31",1987,20.2,44,27,24,17,3,26,56,46.4,30,18,8,10,40,84,54,1,"https://fbref.com/en/players/6d8f8441/Coke"
"1352","Cheick Doukouré_2019",2019,"Levante","La Liga","Cheick Doukouré","CIV","MF","25",1992,3.5,13,7,3,7,3,4,15,26.7,11,10,2,8,3,16,3,1,"https://fbref.com/en/players/e208bcc8/Cheick-Doukoure"
"1353","Raphael Dwamena_2019",2019,"Levante","La Liga","Raphael Dwamena","GHA","FW","22",1995,2.5,0,0,0,0,0,0,0,NA,0,2,1,1,0,0,2,0,"https://fbref.com/en/players/525f9bf4/Raphael-Dwamena"
"1354","Aitor Fernández_2019",2019,"Levante","La Liga","Aitor Fernández","ESP","GK","27",1991,16,1,0,1,0,0,1,1,100,0,0,0,0,1,2,10,1,"https://fbref.com/en/players/a01c3d54/Aitor-Fernandez"
"1355","Jason_2019",2019,"Levante","La Liga","Jason","ESP","DF,FW","24",1994,25.9,44,25,22,11,11,20,71,28.2,51,25,4,21,46,90,27,0,"https://fbref.com/en/players/9038c2a1/Jason"
"1356","Pedro López Muñoz_2019",2019,"Levante","La Liga","Pedro López Muñoz","ESP","DF","34",1983,5.2,5,3,5,0,0,3,7,42.9,4,8,3,5,8,13,7,0,"https://fbref.com/en/players/a60823a4/Pedro-Lopez-Munoz"
"1357","José Luis Morales_2019",2019,"Levante","La Liga","José Luis Morales","ESP","FW,MF","31",1987,35.5,21,15,6,10,5,8,49,16.3,41,22,1,21,12,33,17,0,"https://fbref.com/en/players/4a478107/Jose-Luis-Morales"
"1358","Antonio Luna_2019",2019,"Levante","La Liga","Antonio Luna","ESP","DF,FW","27",1991,14,14,10,6,7,1,6,23,26.1,17,22,7,15,15,29,48,1,"https://fbref.com/en/players/ed239245/Antonio-Luna"
"1359","Fran Manzanara_2019",2019,"Levante","La Liga","Fran Manzanara","ESP","DF,MF","21",1996,1.7,7,5,3,3,1,4,4,100,0,3,2,1,1,8,7,0,"https://fbref.com/en/players/bbfaeda4/Fran-Manzanara"
"1360","Roger Martí_2019",2019,"Levante","La Liga","Roger Martí","ESP","FW","27",1991,21,8,6,1,4,3,1,19,5.3,18,14,1,13,4,12,9,0,"https://fbref.com/en/players/0ae4e09a/Roger-Marti"
"1361","Borja Mayoral_2019",2019,"Levante","La Liga","Borja Mayoral","ESP","FW","21",1997,18,9,4,1,6,2,5,16,31.3,11,10,1,9,5,14,5,0,"https://fbref.com/en/players/64e8ed6d/Borja-Mayoral"
"1362","Oier Olazábal_2019",2019,"Levante","La Liga","Oier Olazábal","ESP","GK","28",1989,21,1,1,1,0,0,1,2,50,1,1,0,1,1,2,15,2,"https://fbref.com/en/players/b5bdf144/Oier-Olazabal"
"1363","Sergio Postigo_2019",2019,"Levante","La Liga","Sergio Postigo","ESP","DF","29",1988,16.1,25,15,22,3,0,15,19,78.9,4,21,12,9,20,45,77,0,"https://fbref.com/en/players/474ecac8/Sergio-Postigo"
"1364","Sanjin Prcić_2019",2019,"Levante","La Liga","Sanjin Prcić","BIH","MF","24",1993,5.9,18,13,7,9,2,5,11,45.5,6,11,7,4,11,29,11,1,"https://fbref.com/en/players/51c30111/Sanjin-Prcic"
"1365","Rober_2019",2019,"Levante","La Liga","Rober","ESP","DF","23",1995,31.7,41,29,33,6,2,24,48,50,24,52,36,16,51,92,129,2,"https://fbref.com/en/players/c00097d2/Rober"
"1366","Rubén Rochina_2019",2019,"Levante","La Liga","Rubén Rochina","ESP","MF","27",1991,20,51,33,26,16,9,23,81,28.4,58,29,0,29,21,72,19,1,"https://fbref.com/en/players/ecd8c01e/Ruben-Rochina"
"1367","Moses Simon_2019",2019,"Levante","La Liga","Moses Simon","NGA","DF,MF","23",1995,8.7,14,8,10,2,2,5,9,55.6,4,10,1,9,12,26,14,0,"https://fbref.com/en/players/5f3eaaf5/Moses-Simon"
"1368","Toño_2019",2019,"Levante","La Liga","Toño","ESP","DF,FW","28",1989,19.6,17,13,12,3,2,10,21,47.6,11,20,5,15,14,31,42,0,"https://fbref.com/en/players/d4ef9ac5/Tono"
"1369","Koke Vegas_2019",2019,"Levante","La Liga","Koke Vegas","ESP","GK","22",1995,1,0,0,0,0,0,0,0,NA,0,0,0,0,0,0,0,0,"https://fbref.com/en/players/bfb15d99/Koke-Vegas"
"1370","Rúben Vezo_2019",2019,"Levante","La Liga","Rúben Vezo","POR","DF","24",1994,14.9,26,17,17,8,1,14,22,63.6,8,23,20,3,19,45,88,0,"https://fbref.com/en/players/c67cd65c/Ruben-Vezo"
"1371","Nikola Vukčević_2019",2019,"Levante","La Liga","Nikola Vukčević","MNE","MF","26",1991,7.4,25,18,12,9,4,9,24,37.5,15,15,5,10,10,35,17,0,"https://fbref.com/en/players/4442fbcd/Nikola-Vukcevic"
"1372","Lucas Alario_2019",2019,"Leverkusen","Bundesliga","Lucas Alario","ARG","FW,MF","25",1992,14.1,15,8,5,6,4,4,14,28.6,10,9,0,9,1,16,16,0,"https://fbref.com/en/players/834d0be5/Lucas-Alario"
"1373","Charles Aránguiz_2019",2019,"Leverkusen","Bundesliga","Charles Aránguiz","CHI","MF","29",1989,21,48,30,21,22,5,21,66,31.8,45,31,2,29,25,73,27,1,"https://fbref.com/en/players/56413b1f/Charles-Aranguiz"
"1374","Leon Bailey_2019",2019,"Leverkusen","Bundesliga","Leon Bailey","JAM","FW","20",1997,21.3,15,11,9,2,4,6,20,30,14,20,0,20,14,29,11,0,"https://fbref.com/en/players/3a233281/Leon-Bailey"
"1375","Julian Baumgartlinger_2019",2019,"Leverkusen","Bundesliga","Julian Baumgartlinger","AUT","MF","30",1988,17.3,52,30,24,20,8,20,45,44.4,25,18,6,12,26,78,21,1,"https://fbref.com/en/players/69374ff5/Julian-Baumgartlinger"
"1376","Karim Bellarabi_2019",2019,"Leverkusen","Bundesliga","Karim Bellarabi","GER","FW","28",1990,11.7,13,6,7,4,2,3,19,15.8,16,13,0,13,10,23,8,0,"https://fbref.com/en/players/bee0bab1/Karim-Bellarabi"
"1377","Lars Bender_2019",2019,"Leverkusen","Bundesliga","Lars Bender","GER","MF,DF","29",1989,15.1,43,29,20,20,3,18,35,51.4,17,26,4,22,21,64,26,0,"https://fbref.com/en/players/c50281a0/Lars-Bender"
"1378","Sven Bender_2019",2019,"Leverkusen","Bundesliga","Sven Bender","GER","DF","29",1989,22.1,40,25,25,15,0,18,30,60,12,31,14,17,52,92,98,0,"https://fbref.com/en/players/070ec0b1/Sven-Bender"
"1379","Julian Brandt_2019",2019,"Leverkusen","Bundesliga","Julian Brandt","GER","MF,FW","22",1996,29.6,27,16,13,10,4,7,43,16.3,36,27,1,26,17,44,12,1,"https://fbref.com/en/players/a167537f/Julian-Brandt"
"1380","Aleksandar Dragović_2019",2019,"Leverkusen","Bundesliga","Aleksandar Dragović","AUT","DF","27",1991,14.8,18,12,14,4,0,9,14,64.3,5,15,8,7,25,43,66,0,"https://fbref.com/en/players/6fd8a334/Aleksandar-Dragovic"
"1381","Kai Havertz_2019",2019,"Leverkusen","Bundesliga","Kai Havertz","GER","MF,FW","19",1999,32.2,26,17,10,11,5,8,32,25,24,31,4,27,16,42,29,0,"https://fbref.com/en/players/fed7cb61/Kai-Havertz"
"1382","Benjamin Henrichs_2019",2019,"Leverkusen","Bundesliga","Benjamin Henrichs","GER","DF","21",1997,0.7,0,0,0,0,0,0,0,NA,0,2,0,2,3,3,0,0,"https://fbref.com/en/players/0a89e877/Benjamin-Henrichs"
"1383","Lukáš Hrádecký_2019",2019,"Leverkusen","Bundesliga","Lukáš Hrádecký","FIN","GK","28",1989,32,0,0,0,0,0,0,1,0,1,0,0,0,1,1,9,1,"https://fbref.com/en/players/ad3389d5/Lukas-Hradecky"
"1384","Tin Jedvaj_2019",2019,"Leverkusen","Bundesliga","Tin Jedvaj","CRO","DF","22",1995,12.5,23,15,9,8,6,10,19,52.6,9,28,2,26,22,45,52,0,"https://fbref.com/en/players/f820504e/Tin-Jedvaj"
"1385","Isaac Kiese Thelin_2019",2019,"Leverkusen","Bundesliga","Isaac Kiese Thelin","SWE","FW,MF","26",1992,2,2,1,0,2,0,1,2,50,1,1,0,1,0,2,4,0,"https://fbref.com/en/players/b956af7d/Isaac-Kiese-Thelin"
"1386","Dominik Kohr_2019",2019,"Leverkusen","Bundesliga","Dominik Kohr","GER","MF","24",1994,10.8,42,29,21,21,0,14,35,40,21,25,12,13,15,57,17,1,"https://fbref.com/en/players/0fbecd11/Dominik-Kohr"
"1387","Ramazan Özcan_2019",2019,"Leverkusen","Bundesliga","Ramazan Özcan","AUT","GK","34",1984,2,0,0,0,0,0,0,0,NA,0,0,0,0,1,1,2,0,"https://fbref.com/en/players/a165a577/Ramazan-Ozcan"
"1388","Paulinho_2019",2019,"Leverkusen","Bundesliga","Paulinho","BRA","FW,MF","18",2000,2,4,4,2,2,0,1,2,50,1,3,0,3,2,6,0,1,"https://fbref.com/en/players/53070b63/Paulinho"
"1389","Jonathan Tah_2019",2019,"Leverkusen","Bundesliga","Jonathan Tah","GER","DF","22",1996,32.6,44,30,30,10,4,17,32,53.1,15,39,26,13,45,89,142,1,"https://fbref.com/en/players/bd142efb/Jonathan-Tah"
"1390","Kevin Volland_2019",2019,"Leverkusen","Bundesliga","Kevin Volland","GER","FW","26",1992,31.3,33,20,7,14,12,13,27,48.1,14,17,1,16,6,39,33,0,"https://fbref.com/en/players/64f69877/Kevin-Volland"
"1391","Mitchell Weiser_2019",2019,"Leverkusen","Bundesliga","Mitchell Weiser","GER","DF","24",1994,23.5,63,37,34,22,7,26,50,52,24,31,3,28,27,90,48,0,"https://fbref.com/en/players/30c220c3/Mitchell-Weiser"
"1392","Wendell_2019",2019,"Leverkusen","Bundesliga","Wendell","BRA","DF","25",1993,25.3,75,48,47,24,4,34,57,59.6,23,49,13,36,29,104,66,0,"https://fbref.com/en/players/f9acca3a/Wendell"
"1393","Luiz Araújo_2019",2019,"Lille","Ligue 1","Luiz Araújo","BRA","FW,MF","22",1996,8.7,23,17,8,9,6,9,24,37.5,15,6,1,5,3,26,4,0,"https://fbref.com/en/players/fa18c72e/Luiz-Araujo"
"1394","Fodé Ballo-Touré_2019",2019,"Lille","Ligue 1","Fodé Ballo-Touré","SEN","DF","21",1997,17.7,47,35,26,19,2,21,32,65.6,11,25,7,18,27,74,42,2,"https://fbref.com/en/players/f449640d/Fode-Ballo-Toure"
"1395","Jonathan Bamba_2019",2019,"Lille","Ligue 1","Jonathan Bamba","CIV","FW,MF","22",1996,33.4,29,19,7,17,5,13,39,33.3,26,24,1,23,41,70,18,0,"https://fbref.com/en/players/b2bd0f6c/Jonathan-Bamba"
"1396","Yassine Benzia_2019",2019,"Lille","Ligue 1","Yassine Benzia","ALG","MF","23",1994,1.8,1,1,0,1,0,1,1,100,0,0,0,0,1,2,1,0,"https://fbref.com/en/players/6fbde63a/Yassine-Benzia"
"1397","Zeki Çelik_2019",2019,"Lille","Ligue 1","Zeki Çelik","TUR","DF","21",1997,33,90,59,40,39,11,36,89,40.4,53,34,5,29,34,124,89,1,"https://fbref.com/en/players/31a62dc7/Zeki-Celik"
"1398","Kouadio-Yves Dabila_2019",2019,"Lille","Ligue 1","Kouadio-Yves Dabila","CIV","DF","21",1997,8.7,11,6,10,1,0,5,6,83.3,1,13,9,4,6,17,44,0,"https://fbref.com/en/players/3067cbef/Kouadio-Yves-Dabila"
"1399","Gabriel Dos Santos_2019",2019,"Lille","Ligue 1","Gabriel Dos Santos","BRA","DF","20",1997,11.8,18,11,13,4,1,4,7,57.1,3,14,6,8,19,37,60,2,"https://fbref.com/en/players/67ac5bb8/Gabriel-Dos-Santos"
"1400","José Fonte_2019",2019,"Lille","Ligue 1","José Fonte","POR","DF","34",1983,34.6,27,15,15,9,3,17,24,70.8,7,33,26,7,37,64,153,1,"https://fbref.com/en/players/90f87966/Jose-Fonte"
"1401","Rui Fonte_2019",2019,"Lille","Ligue 1","Rui Fonte","POR","FW,MF","28",1990,7,25,12,4,16,5,6,11,54.5,5,4,0,4,2,27,8,0,"https://fbref.com/en/players/6ff8ef56/Rui-Fonte"
"1402","Edgar Ié_2019",2019,"Lille","Ligue 1","Edgar Ié","GNB","DF","24",1994,2.7,5,4,3,2,0,3,5,60,2,2,1,1,7,12,17,0,"https://fbref.com/en/players/3767b3b7/Edgar-Ie"
"1403","Jonathan Ikone_2019",2019,"Lille","Ligue 1","Jonathan Ikone","FRA","MF,FW","20",1998,31.1,25,14,7,12,6,8,30,26.7,22,24,2,22,6,31,4,0,"https://fbref.com/en/players/42eaa028/Jonathan-Ikone"
"1404","Youssouf Koné_2019",2019,"Lille","Ligue 1","Youssouf Koné","MLI","DF","23",1995,19,67,38,45,19,3,41,65,63.1,24,31,3,28,39,106,52,1,"https://fbref.com/en/players/e6eadfb8/Youssouf-Kone"
"1405","Rafael Leão_2019",2019,"Lille","Ligue 1","Rafael Leão","POR","FW","19",1999,14.3,5,2,0,4,1,2,15,13.3,13,13,4,9,4,9,12,0,"https://fbref.com/en/players/20730eae/Rafael-Leao"
"1406","Thiago Maia_2019",2019,"Lille","Ligue 1","Thiago Maia","BRA","MF","21",1997,11.3,32,19,17,13,2,13,33,39.4,20,14,5,9,23,55,23,0,"https://fbref.com/en/players/91e58f66/Thiago-Maia"
"1407","Mike Maignan_2019",2019,"Lille","Ligue 1","Mike Maignan","FRA","GK","23",1995,38,0,0,0,0,0,0,0,NA,0,1,0,1,0,0,12,1,"https://fbref.com/en/players/fcb38f57/Mike-Maignan"
"1408","Reinildo Mandava_2019",2019,"Lille","Ligue 1","Reinildo Mandava","MOZ","DF","24",1994,1.1,3,2,1,2,0,2,3,66.7,1,1,0,1,1,4,0,0,"https://fbref.com/en/players/c20bdcd7/Reinildo-Mandava"
"1409","Thiago Mendes_2019",2019,"Lille","Ligue 1","Thiago Mendes","BRA","MF","26",1992,34.2,85,47,42,41,2,39,71,54.9,32,44,11,33,68,153,49,0,"https://fbref.com/en/players/c6e5d20f/Thiago-Mendes"
"1410","Lebo Mothiba_2019",2019,"Lille","Ligue 1","Lebo Mothiba","RSA","FW","22",1996,2.8,1,1,0,1,0,0,0,NA,0,0,0,0,0,1,8,0,"https://fbref.com/en/players/3eaf8817/Lebo-Mothiba"
"1411","Nicolas Pépé_2019",2019,"Lille","Ligue 1","Nicolas Pépé","CIV","FW,MF","23",1995,36.9,27,10,6,15,6,8,35,22.9,27,33,0,33,13,40,11,1,"https://fbref.com/en/players/57e3f0c7/Nicolas-Pepe"
"1412","Jérémy Pied_2019",2019,"Lille","Ligue 1","Jérémy Pied","FRA","DF","29",1989,5.2,12,8,5,6,1,3,9,33.3,6,8,1,7,5,17,13,0,"https://fbref.com/en/players/a634b9d2/Jeremy-Pied"
"1413","Loïc Rémy_2019",2019,"Lille","Ligue 1","Loïc Rémy","FRA","FW","31",1987,13.4,2,1,0,2,0,0,3,0,3,3,1,2,2,4,17,1,"https://fbref.com/en/players/5c2da10f/Loic-Remy"
"1414","Adama Soumaoro_2019",2019,"Lille","Ligue 1","Adama Soumaoro","FRA","DF","26",1992,19.1,14,11,12,2,0,4,6,66.7,2,21,18,3,21,35,92,1,"https://fbref.com/en/players/7b075c75/Adama-Soumaoro"
"1415","Boubakary Soumaré_2019",2019,"Lille","Ligue 1","Boubakary Soumaré","FRA","MF","19",1999,6.3,20,15,9,11,0,10,18,55.6,8,9,3,6,7,27,5,0,"https://fbref.com/en/players/ae59b359/Boubakary-Soumare"
"1416","Xeka_2019",2019,"Lille","Ligue 1","Xeka","POR","MF","23",1994,25.1,59,31,25,27,7,18,57,31.6,39,20,2,18,21,80,30,4,"https://fbref.com/en/players/f3600c02/Xeka"
"1417","Arton Zekaj_2019",2019,"Lille","Ligue 1","Arton Zekaj","KVX","FW","18",2000,0,0,0,0,0,0,0,0,NA,0,0,0,0,0,0,0,0,"https://fbref.com/en/players/0bd57eb0/Arton-Zekaj"
"1418","Trent Alexander-Arnold_2019",2019,"Liverpool","Premier League","Trent Alexander-Arnold","ENG","DF","19",1998,27.4,61,39,31,22,8,36,68,52.9,32,19,3,16,35,96,68,0,"https://fbref.com/en/players/cd1acf9d/Trent-Alexander-Arnold"
"1419","Alisson_2019",2019,"Liverpool","Premier League","Alisson","BRA","GK","25",1992,38,2,1,2,0,0,2,2,100,0,0,0,0,1,3,14,6,"https://fbref.com/en/players/7a2e46a8/Alisson"
"1420","Rafael Camacho_2019",2019,"Liverpool","Premier League","Rafael Camacho","POR","DF","18",2000,0,1,0,1,0,0,1,1,100,0,0,0,0,0,1,0,0,"https://fbref.com/en/players/91b43c98/Rafael-Camacho"
"1421","Nathaniel Clyne_2019",2019,"Liverpool","Premier League","Nathaniel Clyne","ENG","DF","27",1991,1.2,4,3,2,2,0,2,4,50,2,1,0,1,2,6,1,0,"https://fbref.com/en/players/0442183b/Nathaniel-Clyne"
"1422","Fabinho_2019",2019,"Liverpool","Premier League","Fabinho","BRA","MF","24",1993,22.4,59,31,17,38,4,24,59,40.7,35,34,6,28,28,87,27,2,"https://fbref.com/en/players/7f3b388c/Fabinho"
"1423","Roberto Firmino_2019",2019,"Liverpool","Premier League","Roberto Firmino","BRA","FW,MF","26",1991,29,30,20,5,16,9,7,34,20.6,27,35,1,34,6,36,16,0,"https://fbref.com/en/players/4c370d81/Roberto-Firmino"
"1424","Joe Gomez_2019",2019,"Liverpool","Premier League","Joe Gomez","ENG","DF","21",1997,11.8,18,11,10,7,1,9,15,60,6,10,5,5,14,32,42,0,"https://fbref.com/en/players/7a11550b/Joe-Gomez"
"1425","Jordan Henderson_2019",2019,"Liverpool","Premier League","Jordan Henderson","ENG","MF","28",1990,22.1,46,36,20,22,4,16,39,41,23,27,3,24,30,76,17,0,"https://fbref.com/en/players/935e6b8f/Jordan-Henderson"
"1426","Naby Keïta_2019",2019,"Liverpool","Premier League","Naby Keïta","GUI","MF,FW","23",1995,15.4,37,15,13,19,5,14,42,33.3,28,29,4,25,12,49,16,1,"https://fbref.com/en/players/f25c8e3a/Naby-Keita"
"1427","Adam Lallana_2019",2019,"Liverpool","Premier League","Adam Lallana","ENG","MF,FW","30",1988,5.2,16,9,6,7,3,5,12,41.7,7,10,1,9,5,21,4,0,"https://fbref.com/en/players/99813635/Adam-Lallana"
"1428","Dejan Lovren_2019",2019,"Liverpool","Premier League","Dejan Lovren","CRO","DF","29",1989,11,15,9,10,5,0,7,15,46.7,8,11,7,4,11,26,51,2,"https://fbref.com/en/players/1a2935f6/Dejan-Lovren"
"1429","Sadio Mané_2019",2019,"Liverpool","Premier League","Sadio Mané","SEN","FW","26",1992,34.2,35,29,12,17,6,14,43,32.6,29,28,4,24,15,50,10,1,"https://fbref.com/en/players/c691bfe2/Sadio-Mane"
"1430","Joël Matip_2019",2019,"Liverpool","Premier League","Joël Matip","CMR","DF","26",1991,17.1,39,26,23,12,4,13,24,54.2,11,12,7,5,32,71,78,0,"https://fbref.com/en/players/b217ef29/Joel-Matip"
"1431","James Milner_2019",2019,"Liverpool","Premier League","James Milner","ENG","MF,DF","32",1986,19.9,43,23,14,24,5,15,41,36.6,26,40,5,35,18,61,30,0,"https://fbref.com/en/players/2f90f6b8/James-Milner"
"1432","Alberto Moreno_2019",2019,"Liverpool","Premier League","Alberto Moreno","ESP","DF","26",1992,1.7,3,2,1,2,0,1,3,33.3,2,1,0,1,2,5,0,0,"https://fbref.com/en/players/11b9265b/Alberto-Moreno"
"1433","Divock Origi_2019",2019,"Liverpool","Premier League","Divock Origi","BEL","FW","23",1995,4.1,6,1,2,3,1,1,4,25,3,2,0,2,0,6,2,0,"https://fbref.com/en/players/43a166b4/Divock-Origi"
"1434","Alex Oxlade-Chamberlain_2019",2019,"Liverpool","Premier League","Alex Oxlade-Chamberlain","ENG","MF","24",1993,0.2,1,1,0,1,0,1,1,100,0,0,0,0,1,2,0,0,"https://fbref.com/en/players/38c7feef/Alex-Oxlade-Chamberlain"
"1435","Andrew Robertson_2019",2019,"Liverpool","Premier League","Andrew Robertson","SCO","DF","24",1994,35.7,80,49,41,31,8,39,70,55.7,31,33,6,27,29,109,57,3,"https://fbref.com/en/players/2e4f5f03/Andrew-Robertson"
"1436","Mohamed Salah_2019",2019,"Liverpool","Premier League","Mohamed Salah","EGY","FW","26",1992,36.1,21,9,3,11,7,5,16,31.3,11,9,0,9,5,26,6,0,"https://fbref.com/en/players/e342ad68/Mohamed-Salah"
"1437","Xherdan Shaqiri_2019",2019,"Liverpool","Premier League","Xherdan Shaqiri","SUI","FW,MF","26",1991,11.8,14,4,3,9,2,9,19,47.4,10,6,1,5,6,20,6,0,"https://fbref.com/en/players/6421ec64/Xherdan-Shaqiri"
"1438","Daniel Sturridge_2019",2019,"Liverpool","Premier League","Daniel Sturridge","ENG","FW,MF","28",1989,5.7,3,3,1,1,1,2,3,66.7,1,4,0,4,1,4,0,0,"https://fbref.com/en/players/1b7ec703/Daniel-Sturridge"
"1439","Virgil van Dijk_2019",2019,"Liverpool","Premier League","Virgil van Dijk","NED","DF","27",1991,37.6,38,28,26,11,1,14,14,100,0,29,18,11,40,78,201,1,"https://fbref.com/en/players/e06683ca/Virgil-van-Dijk"
"1440","Georginio Wijnaldum_2019",2019,"Liverpool","Premier League","Georginio Wijnaldum","NED","MF","27",1990,30.3,41,28,14,20,7,14,27,51.9,13,21,7,14,21,62,24,0,"https://fbref.com/en/players/eb58eef0/Georginio-Wijnaldum"
"1441","Houssem Aouar_2019",2019,"Lyon","Ligue 1","Houssem Aouar","ALG","MF","20",1998,34,63,38,28,25,10,17,61,27.9,44,33,6,27,32,95,25,3,"https://fbref.com/en/players/a5db0bec/Houssem-Aouar"
"1442","Pape Cheikh Diop_2019",2019,"Lyon","Ligue 1","Pape Cheikh Diop","SEN","MF","20",1997,5,1,0,0,1,0,0,5,0,5,6,2,4,2,3,2,1,"https://fbref.com/en/players/873ce3a2/Pape-Cheikh-Diop"
"1443","Maxwel Cornet_2019",2019,"Lyon","Ligue 1","Maxwel Cornet","CIV","FW","21",1996,14.2,14,11,4,7,3,1,11,9.1,10,10,0,10,5,19,8,0,"https://fbref.com/en/players/beb391dd/Maxwel-Cornet"
"1444","Moussa Dembélé_2019",2019,"Lyon","Ligue 1","Moussa Dembélé","FRA","FW","22",1996,22.4,12,4,0,8,4,4,14,28.6,10,15,2,13,2,14,13,0,"https://fbref.com/en/players/e7986081/Moussa-Dembele"
"1445","Jason Denayer_2019",2019,"Lyon","Ligue 1","Jason Denayer","BEL","DF","23",1995,30.6,33,21,22,11,0,16,24,66.7,8,36,32,4,26,59,122,1,"https://fbref.com/en/players/47af88b8/Jason-Denayer"
"1446","Leo Dubois_2019",2019,"Lyon","Ligue 1","Leo Dubois","FRA","DF","23",1994,22.7,51,22,25,21,5,20,35,57.1,15,30,10,20,22,73,61,1,"https://fbref.com/en/players/ff0ab48c/Leo-Dubois"
"1447","Nabil Fekir_2019",2019,"Lyon","Ligue 1","Nabil Fekir","FRA","MF","25",1993,22.1,51,31,16,19,16,13,38,34.2,25,42,0,42,7,58,3,0,"https://fbref.com/en/players/bece776f/Nabil-Fekir"
"1448","Yassin Fekir_2019",2019,"Lyon","Ligue 1","Yassin Fekir","FRA","FW","21",1997,0.1,0,0,0,0,0,0,1,0,1,0,0,0,0,0,0,0,"https://fbref.com/en/players/6644712a/Yassin-Fekir"
"1449","Jordan Ferri_2019",2019,"Lyon","Ligue 1","Jordan Ferri","FRA","MF","26",1992,1.3,5,3,3,1,1,1,4,25,3,4,2,2,1,6,3,0,"https://fbref.com/en/players/375622c5/Jordan-Ferri"
"1450","Mathieu Gorgelin_2019",2019,"Lyon","Ligue 1","Mathieu Gorgelin","FRA","GK","27",1990,4,0,0,0,0,0,0,0,NA,0,0,0,0,0,0,3,0,"https://fbref.com/en/players/4d3e9033/Mathieu-Gorgelin"
"1451","Anthony Lopes_2019",2019,"Lyon","Ligue 1","Anthony Lopes","POR","GK","27",1990,34,1,0,1,0,0,1,3,33.3,2,3,0,3,2,3,16,3,"https://fbref.com/en/players/f00de885/Anthony-Lopes"
"1452","Fernando Marçal_2019",2019,"Lyon","Ligue 1","Fernando Marçal","BRA","DF","29",1989,9.8,25,16,17,7,1,12,15,80,3,9,3,6,30,55,42,0,"https://fbref.com/en/players/9ae9eaea/Fernando-Marcal"
"1453","Marcelo_2019",2019,"Lyon","Ligue 1","Marcelo","BRA","DF","31",1987,32,48,33,29,17,2,19,24,79.2,5,30,22,8,62,110,152,2,"https://fbref.com/en/players/e3d0b0c4/Marcelo"
"1454","Mariano_2019",2019,"Lyon","Ligue 1","Mariano","DOM","FW","24",1993,1.6,0,0,0,0,0,0,0,NA,0,0,0,0,1,1,0,0,"https://fbref.com/en/players/5c4dc0ff/Mariano"
"1455","Memphis_2019",2019,"Lyon","Ligue 1","Memphis","NED","FW,MF","24",1994,30.4,12,9,0,7,5,5,21,23.8,16,16,2,14,9,21,1,0,"https://fbref.com/en/players/8f696594/Memphis"
"1456","Ferland Mendy_2019",2019,"Lyon","Ligue 1","Ferland Mendy","FRA","DF","23",1995,28.1,44,28,25,14,5,14,17,82.4,3,22,5,17,34,78,53,2,"https://fbref.com/en/players/3cefcaef/Ferland-Mendy"
"1457","Jérémy Morel_2019",2019,"Lyon","Ligue 1","Jérémy Morel","MAD","DF","34",1984,11.8,16,10,11,5,0,9,13,69.2,4,18,14,4,18,34,45,1,"https://fbref.com/en/players/e97150c0/Jeremy-Morel"
"1458","Tanguy Ndombele_2019",2019,"Lyon","Ligue 1","Tanguy Ndombele","FRA","MF","21",1996,29.9,66,43,21,35,10,22,54,40.7,32,29,9,20,30,96,13,3,"https://fbref.com/en/players/5cdddffa/Tanguy-Ndombele"
"1459","Lenny Pintor_2019",2019,"Lyon","Ligue 1","Lenny Pintor","FRA","FW","17",2000,0,0,0,0,0,0,0,0,NA,0,0,0,0,0,0,0,0,"https://fbref.com/en/players/6453830e/Lenny-Pintor"
"1460","Rafael_2019",2019,"Lyon","Ligue 1","Rafael","BRA","DF","28",1990,11.4,31,19,14,12,5,17,24,70.8,7,19,2,17,15,46,30,2,"https://fbref.com/en/players/9a1f2e1c/Rafael"
"1461","Oumar Solet_2019",2019,"Lyon","Ligue 1","Oumar Solet","FRA","DF","18",2000,0.7,1,0,1,0,0,1,1,100,0,1,0,1,0,1,0,0,"https://fbref.com/en/players/0670ee51/Oumar-Solet"
"1462","Martin Terrier_2019",2019,"Lyon","Ligue 1","Martin Terrier","FRA","FW","21",1997,16.5,23,13,5,13,5,9,23,39.1,14,17,2,15,6,29,14,0,"https://fbref.com/en/players/5148dcc5/Martin-Terrier"
"1463","Kenny Tete_2019",2019,"Lyon","Ligue 1","Kenny Tete","NED","DF","22",1995,11.6,30,23,11,16,3,13,19,68.4,6,13,5,8,18,48,29,0,"https://fbref.com/en/players/77d7c96f/Kenny-Tete"
"1464","Lucas Tousart_2019",2019,"Lyon","Ligue 1","Lucas Tousart","FRA","MF","21",1997,19.2,74,38,33,34,7,25,59,42.4,34,30,13,17,26,100,27,0,"https://fbref.com/en/players/71ec39ef/Lucas-Tousart"
"1465","Bertrand Traoré_2019",2019,"Lyon","Ligue 1","Bertrand Traoré","BFA","FW","22",1995,23.5,36,22,19,13,4,12,26,46.2,14,23,5,18,15,51,18,0,"https://fbref.com/en/players/c47541e0/Bertrand-Traore"
"1466","László Bénes_2019",2019,"M'Gladbach","Bundesliga","László Bénes","SVK","MF,FW","20",1997,0.3,3,1,3,0,0,3,3,100,0,1,0,1,0,3,0,0,"https://fbref.com/en/players/fe888e39/Laszlo-Benes"
"1467","Jordan Beyer_2019",2019,"M'Gladbach","Bundesliga","Jordan Beyer","GER","DF","18",2000,8,32,18,21,10,1,17,24,70.8,7,12,6,6,11,43,32,0,"https://fbref.com/en/players/9af1f9ff/Jordan-Beyer"
"1468","Mickaël Cuisance_2019",2019,"M'Gladbach","Bundesliga","Mickaël Cuisance","FRA","MF","18",1999,3.1,11,6,6,3,2,3,8,37.5,5,3,0,3,5,16,4,0,"https://fbref.com/en/players/5722eced/Mickael-Cuisance"
"1469","Josip Drmić_2019",2019,"M'Gladbach","Bundesliga","Josip Drmić","SUI","FW","25",1992,2.5,2,0,0,2,0,1,2,50,1,1,0,1,1,3,0,0,"https://fbref.com/en/players/15ea94de/Josip-Drmic"
"1470","Nico Elvedi_2019",2019,"M'Gladbach","Bundesliga","Nico Elvedi","SUI","DF","21",1996,29.1,41,19,34,7,0,23,33,69.7,10,30,13,17,47,88,135,6,"https://fbref.com/en/players/48035304/Nico-Elvedi"
"1471","Matthias Ginter_2019",2019,"M'Gladbach","Bundesliga","Matthias Ginter","GER","DF","24",1994,26.4,24,14,16,7,1,9,17,52.9,8,31,19,12,17,41,98,1,"https://fbref.com/en/players/f521b80a/Matthias-Ginter"
"1472","Thorgan Hazard_2019",2019,"M'Gladbach","Bundesliga","Thorgan Hazard","BEL","FW,MF","25",1993,31.9,50,33,22,20,8,17,48,35.4,31,35,2,33,27,77,12,0,"https://fbref.com/en/players/50871bcc/Thorgan-Hazard"
"1473","Patrick Herrmann_2019",2019,"M'Gladbach","Bundesliga","Patrick Herrmann","GER","FW,DF","27",1991,12,20,14,8,7,5,6,17,35.3,11,6,3,3,6,26,12,0,"https://fbref.com/en/players/dfb6490a/Patrick-Herrmann"
"1474","Jonas Hofmann_2019",2019,"M'Gladbach","Bundesliga","Jonas Hofmann","GER","MF","26",1992,21.2,37,18,11,19,7,9,37,24.3,28,33,2,31,16,53,14,1,"https://fbref.com/en/players/2903a856/Jonas-Hofmann"
"1475","Tony Jantschke_2019",2019,"M'Gladbach","Bundesliga","Tony Jantschke","GER","DF","28",1990,10.4,15,10,9,5,1,6,8,75,2,10,7,3,27,42,51,1,"https://fbref.com/en/players/34b54da7/Tony-Jantschke"
"1476","Fabian Johnson_2019",2019,"M'Gladbach","Bundesliga","Fabian Johnson","USA","DF,FW","30",1987,11.2,13,5,2,8,3,6,8,75,2,8,3,5,10,23,16,0,"https://fbref.com/en/players/76e5da9d/Fabian-Johnson"
"1477","Christoph Kramer_2019",2019,"M'Gladbach","Bundesliga","Christoph Kramer","GER","MF","27",1991,12.6,41,22,17,23,1,15,40,37.5,25,19,4,15,21,62,23,0,"https://fbref.com/en/players/496aeede/Christoph-Kramer"
"1478","Michael Lang_2019",2019,"M'Gladbach","Bundesliga","Michael Lang","SUI","DF","27",1991,13.9,14,9,7,6,1,6,16,37.5,10,14,3,11,16,30,42,1,"https://fbref.com/en/players/864db10a/Michael-Lang"
"1479","Florian Neuhaus_2019",2019,"M'Gladbach","Bundesliga","Florian Neuhaus","GER","MF","21",1997,22.9,22,15,9,9,4,10,36,27.8,26,20,1,19,10,32,23,0,"https://fbref.com/en/players/36a59ba4/Florian-Neuhaus"
"1480","Alassane Pléa_2019",2019,"M'Gladbach","Bundesliga","Alassane Pléa","FRA","FW","25",1993,27.8,14,10,7,4,3,5,22,22.7,17,17,2,15,3,17,15,2,"https://fbref.com/en/players/bc6bd723/Alassane-Plea"
"1481","Raffael_2019",2019,"M'Gladbach","Bundesliga","Raffael","BRA","FW","33",1985,6,8,4,2,4,2,2,7,28.6,5,5,0,5,1,9,0,0,"https://fbref.com/en/players/791af558/Raffael"
"1482","Yann Sommer_2019",2019,"M'Gladbach","Bundesliga","Yann Sommer","SUI","GK","29",1988,34,2,2,2,0,0,2,2,100,0,1,0,1,1,3,12,5,"https://fbref.com/en/players/420c18a1/Yann-Sommer"
"1483","Lars Stindl_2019",2019,"M'Gladbach","Bundesliga","Lars Stindl","GER","FW,MF","29",1988,16.8,21,14,8,11,2,3,15,20,12,22,2,20,14,35,13,0,"https://fbref.com/en/players/7cd6badb/Lars-Stindl"
"1484","Tobias Strobl_2019",2019,"M'Gladbach","Bundesliga","Tobias Strobl","GER","MF,DF","28",1990,25.5,31,17,17,13,1,9,29,31,20,36,14,22,29,60,35,1,"https://fbref.com/en/players/17780d2b/Tobias-Strobl"
"1485","Ibrahima Traoré_2019",2019,"M'Gladbach","Bundesliga","Ibrahima Traoré","GUI","FW,MF","30",1988,6.1,12,6,8,2,2,3,11,27.3,8,3,1,2,3,15,1,0,"https://fbref.com/en/players/096a77c4/Ibrahima-Traore"
"1486","Oscar Wendt_2019",2019,"M'Gladbach","Bundesliga","Oscar Wendt","SWE","DF","32",1985,30.3,45,34,34,8,3,31,53,58.5,22,37,11,26,19,64,90,0,"https://fbref.com/en/players/b69261a0/Oscar-Wendt"
"1487","Denis Zakaria_2019",2019,"M'Gladbach","Bundesliga","Denis Zakaria","SUI","MF","21",1996,21.8,40,21,15,24,1,12,30,40,18,38,9,29,26,66,20,0,"https://fbref.com/en/players/384d58d9/Denis-Zakaria"
"1488","Issah Abbas_2019",2019,"Mainz 05","Bundesliga","Issah Abbas","GHA","FW","19",1998,0.1,0,0,0,0,0,0,0,NA,0,0,0,0,0,0,0,0,"https://fbref.com/en/players/2590ddf7/Issah-Abbas"
"1489","Ridle Baku_2019",2019,"Mainz 05","Bundesliga","Ridle Baku","GER","MF","20",1998,10.4,18,9,6,9,3,2,7,28.6,5,13,1,12,8,26,9,0,"https://fbref.com/en/players/442b56fa/Ridle-Baku"
"1490","Leandro Barreiro Martins_2019",2019,"Mainz 05","Bundesliga","Leandro Barreiro Martins","LUX","MF","18",2000,1,4,4,2,0,2,1,2,50,1,0,0,0,2,6,1,0,"https://fbref.com/en/players/00242b75/Leandro-Barreiro-Martins"
"1491","Stefan Bell_2019",2019,"Mainz 05","Bundesliga","Stefan Bell","GER","DF","26",1991,25,31,20,18,13,0,15,34,44.1,19,31,11,20,54,85,122,1,"https://fbref.com/en/players/857a5abe/Stefan-Bell"
"1492","Pablo de Blasis_2019",2019,"Mainz 05","Bundesliga","Pablo de Blasis","ARG","FW","30",1988,1,2,0,0,1,1,2,3,66.7,1,0,0,0,1,3,0,0,"https://fbref.com/en/players/9ab48bde/Pablo-de-Blasis"
"1493","Jean-Paul Boëtius_2019",2019,"Mainz 05","Bundesliga","Jean-Paul Boëtius","NED","MF","24",1994,23.6,51,32,21,25,5,16,44,36.4,28,59,2,57,37,88,13,0,"https://fbref.com/en/players/635f2732/Jean-Paul-Boetius"
"1494","Daniel Brosinski_2019",2019,"Mainz 05","Bundesliga","Daniel Brosinski","GER","DF","30",1988,24.5,27,16,16,10,1,18,33,54.5,15,30,9,21,26,53,58,0,"https://fbref.com/en/players/a7813ac4/Daniel-Brosinski"
"1495","Niko Bungert_2019",2019,"Mainz 05","Bundesliga","Niko Bungert","GER","DF","31",1986,3.2,7,5,5,2,0,5,5,100,0,7,6,1,4,11,16,0,"https://fbref.com/en/players/0e0ab524/Niko-Bungert"
"1496","Jonathan Burkardt_2019",2019,"Mainz 05","Bundesliga","Jonathan Burkardt","GER","FW,MF","18",2000,2.9,4,4,2,1,1,1,2,50,1,2,0,2,3,7,5,0,"https://fbref.com/en/players/05f99a4a/Jonathan-Burkardt"
"1497","Gaëtan Bussmann_2019",2019,"Mainz 05","Bundesliga","Gaëtan Bussmann","FRA","DF","27",1991,1,2,1,2,0,0,2,5,40,3,0,0,0,1,3,2,0,"https://fbref.com/en/players/278f6efc/Gaetan-Bussmann"
"1498","Giulio Donati_2019",2019,"Mainz 05","Bundesliga","Giulio Donati","ITA","DF","28",1990,6.9,9,7,6,3,0,8,10,80,2,5,3,2,16,25,24,0,"https://fbref.com/en/players/22051fbe/Giulio-Donati"
"1499","Jean-Philippe Gbamin_2019",2019,"Mainz 05","Bundesliga","Jean-Philippe Gbamin","CIV","MF","22",1995,29.7,51,31,29,15,7,23,51,45.1,28,39,5,34,30,81,32,1,"https://fbref.com/en/players/6bd603db/Jean-Philippe-Gbamin"
"1500","Ahmet Gürleyen_2019",2019,"Mainz 05","Bundesliga","Ahmet Gürleyen","GER","DF","19",1999,0.1,0,0,0,0,0,0,0,NA,0,0,0,0,0,0,1,0,"https://fbref.com/en/players/c58a9db7/Ahmet-Gurleyen"
"1501","Alexander Hack_2019",2019,"Mainz 05","Bundesliga","Alexander Hack","GER","DF","24",1993,11.3,29,13,20,9,0,19,28,67.9,9,26,15,11,41,70,59,2,"https://fbref.com/en/players/a5ec3ede/Alexander-Hack"
"1502","Gerrit Holtmann_2019",2019,"Mainz 05","Bundesliga","Gerrit Holtmann","PHI","FW,MF","23",1995,1.6,2,0,1,0,1,1,2,50,1,3,2,1,4,6,1,0,"https://fbref.com/en/players/2979c05a/Gerrit-Holtmann"
"1503","Pierre Kunde_2019",2019,"Mainz 05","Bundesliga","Pierre Kunde","CMR","MF","23",1995,21.2,48,29,20,26,2,16,27,59.3,11,34,14,20,24,72,49,1,"https://fbref.com/en/players/9ceb7642/Pierre-Kunde"
"1504","Danny Latza_2019",2019,"Mainz 05","Bundesliga","Danny Latza","GER","MF","28",1989,20.7,41,22,16,23,2,20,61,32.8,41,49,10,39,20,61,31,0,"https://fbref.com/en/players/33b554b7/Danny-Latza"
"1505","Aarón Martín_2019",2019,"Mainz 05","Bundesliga","Aarón Martín","ESP","DF","21",1997,32,55,30,29,21,5,20,38,52.6,18,38,11,27,38,93,75,1,"https://fbref.com/en/players/2f3e911a/Aaron-Martin"
"1506","Jean-Philippe Mateta_2019",2019,"Mainz 05","Bundesliga","Jean-Philippe Mateta","FRA","FW","21",1997,27.6,13,9,4,4,5,1,10,10,9,15,2,13,3,16,22,0,"https://fbref.com/en/players/50e6dc35/Jean-Philippe-Mateta"
"1507","Alexandru Maxim_2019",2019,"Mainz 05","Bundesliga","Alexandru Maxim","ROU","MF,FW","28",1990,6.4,16,10,6,9,1,10,19,52.6,9,12,0,12,5,21,7,0,"https://fbref.com/en/players/61fc9685/Alexandru-Maxim"
"1508","Florian Müller_2019",2019,"Mainz 05","Bundesliga","Florian Müller","GER","GK","20",1997,24,1,1,1,0,0,1,2,50,1,0,0,0,3,4,8,5,"https://fbref.com/en/players/cbac6ec9/Florian-Muller"
"1509","Phillipp Mwene_2019",2019,"Mainz 05","Bundesliga","Phillipp Mwene","AUT","DF,MF","24",1994,3,7,2,3,4,0,5,6,83.3,1,6,0,6,6,13,10,0,"https://fbref.com/en/players/2ff76adc/Phillipp-Mwene"
"1510","Moussa Niakhate_2019",2019,"Mainz 05","Bundesliga","Moussa Niakhate","SEN","DF","22",1996,31,49,30,35,12,2,20,33,60.6,13,42,24,18,44,93,143,1,"https://fbref.com/en/players/00242715/Moussa-Niakhate"
"1511","Karim Onisiwo_2019",2019,"Mainz 05","Bundesliga","Karim Onisiwo","AUT","FW,MF","26",1992,12.9,23,15,6,12,5,4,12,33.3,8,14,3,11,9,32,13,0,"https://fbref.com/en/players/f26834c7/Karim-Onisiwo"
"1512","Levin Öztunalı_2019",2019,"Mainz 05","Bundesliga","Levin Öztunalı","GER","MF,FW","22",1996,10.2,17,7,5,9,3,4,18,22.2,14,14,2,12,7,24,10,0,"https://fbref.com/en/players/66385c46/Levin-Oztunali"
"1513","Robin Quaison_2019",2019,"Mainz 05","Bundesliga","Robin Quaison","SWE","FW,MF","24",1993,24.4,19,12,3,10,6,5,12,41.7,7,9,1,8,7,26,4,0,"https://fbref.com/en/players/74c7c2db/Robin-Quaison"
"1514","Anthony Ujah_2019",2019,"Mainz 05","Bundesliga","Anthony Ujah","NGA","FW","27",1990,8.2,2,0,0,1,1,1,2,50,1,7,2,5,1,3,10,0,"https://fbref.com/en/players/99be8fb5/Anthony-Ujah"
"1515","Robin Zentner_2019",2019,"Mainz 05","Bundesliga","Robin Zentner","GER","GK","23",1994,10,0,0,0,0,0,0,1,0,1,0,0,0,1,1,3,0,"https://fbref.com/en/players/5c4bf6ba/Robin-Zentner"
"1516","Sergio Agüero_2019",2019,"Manchester City","Premier League","Sergio Agüero","ARG","FW","30",1988,27.3,17,9,1,10,6,5,9,55.6,4,15,1,14,9,26,3,0,"https://fbref.com/en/players/4d034881/Sergio-Aguero"
"1517","Danilo_2019",2019,"Manchester City","Premier League","Danilo","BRA","DF","27",1991,9,20,16,6,12,2,12,17,70.6,5,5,0,5,15,35,22,1,"https://fbref.com/en/players/94b2001f/Danilo"
"1518","Kevin De Bruyne_2019",2019,"Manchester City","Premier League","Kevin De Bruyne","BEL","MF","27",1991,10.8,22,15,6,12,4,7,21,33.3,14,13,1,12,3,25,2,1,"https://fbref.com/en/players/e46012d4/Kevin-De-Bruyne"
"1519","Fabian Delph_2019",2019,"Manchester City","Premier League","Fabian Delph","ENG","DF","28",1989,8.1,23,14,11,7,5,12,23,52.2,11,3,0,3,13,36,19,1,"https://fbref.com/en/players/111c3236/Fabian-Delph"
"1520","Ederson_2019",2019,"Manchester City","Premier League","Ederson","BRA","GK","24",1993,38,3,3,2,1,0,3,3,100,0,0,0,0,1,4,12,2,"https://fbref.com/en/players/3bb7b8b4/Ederson"
"1521","Fernandinho_2019",2019,"Manchester City","Premier League","Fernandinho","BRA","MF","33",1985,26.4,57,43,19,30,8,26,47,55.3,21,28,4,24,41,98,70,0,"https://fbref.com/en/players/101da2b5/Fernandinho"
"1522","Phil Foden_2019",2019,"Manchester City","Premier League","Phil Foden","ENG","MF","18",2000,3.7,7,6,1,3,3,2,9,22.2,7,1,0,1,4,11,1,0,"https://fbref.com/en/players/ed1e53f3/Phil-Foden"
"1523","İlkay Gündoğan_2019",2019,"Manchester City","Premier League","İlkay Gündoğan","GER","MF","27",1990,23.7,19,12,4,12,3,6,31,19.4,25,12,3,9,28,47,19,1,"https://fbref.com/en/players/819b3158/Ilkay-Gundogan"
"1524","Gabriel Jesus_2019",2019,"Manchester City","Premier League","Gabriel Jesus","BRA","FW","21",1997,11.5,10,3,5,2,3,0,5,0,5,16,2,14,3,13,4,0,"https://fbref.com/en/players/b66315ae/Gabriel-Jesus"
"1525","Vincent Kompany_2019",2019,"Manchester City","Premier League","Vincent Kompany","BEL","DF","32",1986,13.6,16,10,11,3,2,8,9,88.9,1,11,8,3,16,32,55,0,"https://fbref.com/en/players/d2bff301/Vincent-Kompany"
"1526","Aymeric Laporte_2019",2019,"Manchester City","Premier League","Aymeric Laporte","ESP","DF","24",1994,34,42,20,27,14,1,22,34,64.7,12,16,9,7,39,81,98,2,"https://fbref.com/en/players/119b9a8e/Aymeric-Laporte"
"1527","Riyad Mahrez_2019",2019,"Manchester City","Premier League","Riyad Mahrez","ALG","FW,MF","27",1991,14.9,14,7,3,7,4,6,18,33.3,12,18,1,17,9,23,3,1,"https://fbref.com/en/players/892d5bb1/Riyad-Mahrez"
"1528","Benjamin Mendy_2019",2019,"Manchester City","Premier League","Benjamin Mendy","FRA","DF","24",1994,10,16,10,10,5,1,9,17,52.9,8,13,4,9,10,26,18,0,"https://fbref.com/en/players/5271c8f1/Benjamin-Mendy"
"1529","Nicolás Otamendi_2019",2019,"Manchester City","Premier League","Nicolás Otamendi","ARG","DF","30",1988,13.7,24,14,17,6,1,5,9,55.6,4,6,4,2,29,53,56,1,"https://fbref.com/en/players/0d267745/Nicolas-Otamendi"
"1530","Leroy Sané_2019",2019,"Manchester City","Premier League","Leroy Sané","GER","FW","22",1996,20.7,24,15,8,7,9,2,23,8.7,21,21,2,19,8,32,2,0,"https://fbref.com/en/players/2b114be3/Leroy-Sane"
"1531","Bernardo Silva_2019",2019,"Manchester City","Premier League","Bernardo Silva","POR","MF,FW","23",1994,31.7,52,39,18,21,13,16,67,23.9,51,47,3,44,25,77,26,1,"https://fbref.com/en/players/3eb22ec9/Bernardo-Silva"
"1532","David Silva_2019",2019,"Manchester City","Premier League","David Silva","ESP","MF","32",1986,26.7,30,18,12,11,7,1,20,5,19,18,1,17,22,52,15,0,"https://fbref.com/en/players/e2716bd0/David-Silva"
"1533","Raheem Sterling_2019",2019,"Manchester City","Premier League","Raheem Sterling","ENG","FW","23",1994,30.8,32,16,11,12,9,9,25,36,16,28,3,25,17,49,4,0,"https://fbref.com/en/players/b400bde0/Raheem-Sterling"
"1534","John Stones_2019",2019,"Manchester City","Premier League","John Stones","ENG","DF","24",1994,19.6,16,11,9,5,2,4,9,44.4,5,15,9,6,14,30,64,1,"https://fbref.com/en/players/5eecec3d/John-Stones"
"1535","Kyle Walker_2019",2019,"Manchester City","Premier League","Kyle Walker","ENG","DF","28",1990,30.9,40,26,20,20,0,24,38,63.2,14,19,5,14,36,76,58,2,"https://fbref.com/en/players/86dd77d1/Kyle-Walker"
"1536","Oleksandr Zinchenko_2019",2019,"Manchester City","Premier League","Oleksandr Zinchenko","UKR","DF","21",1996,12.8,34,20,13,15,6,14,33,42.4,19,14,3,11,20,54,19,1,"https://fbref.com/en/players/51cf8561/Oleksandr-Zinchenko"
"1537","Eric Bailly_2019",2019,"Manchester Utd","Premier League","Eric Bailly","CIV","DF","24",1994,7.1,15,9,14,1,0,8,10,80,2,9,4,5,13,28,39,1,"https://fbref.com/en/players/a1232f4e/Eric-Bailly"
"1538","Tahith Chong_2019",2019,"Manchester Utd","Premier League","Tahith Chong","NED","FW","18",1999,0.4,0,0,0,0,0,0,0,NA,0,1,0,1,0,0,1,0,"https://fbref.com/en/players/2696b6a9/Tahith-Chong"
"1539","Diogo Dalot_2019",2019,"Manchester Utd","Premier League","Diogo Dalot","POR","DF,FW","19",1999,11.3,24,12,8,14,2,14,19,73.7,5,15,2,13,10,34,35,1,"https://fbref.com/en/players/d9565625/Diogo-Dalot"
"1540","Matteo Darmian_2019",2019,"Manchester Utd","Premier League","Matteo Darmian","ITA","DF","28",1989,4.9,14,8,10,4,0,4,11,36.4,7,9,0,9,7,21,20,0,"https://fbref.com/en/players/96e0490d/Matteo-Darmian"
"1541","Marouane Fellaini_2019",2019,"Manchester Utd","Premier League","Marouane Fellaini","BEL","MF","30",1987,8.4,21,13,11,9,1,9,17,52.9,8,9,5,4,4,25,34,1,"https://fbref.com/en/players/87575fd9/Marouane-Fellaini"
"1542","Fred_2019",2019,"Manchester Utd","Premier League","Fred","BRA","MF","25",1993,11.6,29,17,12,16,1,15,33,45.5,18,26,2,24,16,45,14,2,"https://fbref.com/en/players/b853e0ad/Fred"
"1543","James Garner_2019",2019,"Manchester Utd","Premier League","James Garner","ENG","MF","17",2001,0,0,0,0,0,0,0,0,NA,0,0,0,0,0,0,0,0,"https://fbref.com/en/players/4e015693/James-Garner"
"1544","David de Gea_2019",2019,"Manchester Utd","Premier League","David de Gea","ESP","GK","27",1990,38,0,0,0,0,0,0,2,0,2,1,0,1,0,0,11,4,"https://fbref.com/en/players/7ba6d84e/David-de-Gea"
"1545","Angel Gomes_2019",2019,"Manchester Utd","Premier League","Angel Gomes","ENG","MF,FW","17",2000,0.3,1,0,0,0,1,0,0,NA,0,0,0,0,0,1,0,0,"https://fbref.com/en/players/645a3363/Angel-Gomes"
"1546","Mason Greenwood_2019",2019,"Manchester Utd","Premier League","Mason Greenwood","ENG","FW","16",2001,1.3,3,3,2,0,1,2,3,66.7,1,2,0,2,0,3,1,0,"https://fbref.com/en/players/58eee997/Mason-Greenwood"
"1547","Ander Herrera_2019",2019,"Manchester Utd","Premier League","Ander Herrera","ESP","MF","28",1989,15.6,54,28,24,22,8,21,61,34.4,40,38,6,32,37,91,25,1,"https://fbref.com/en/players/436a9dd0/Ander-Herrera"
"1548","Phil Jones_2019",2019,"Manchester Utd","Premier League","Phil Jones","ENG","DF","26",1992,14,19,13,12,7,0,8,13,61.5,5,16,11,5,23,42,67,3,"https://fbref.com/en/players/def899bd/Phil-Jones"
"1549","Victor Lindelöf_2019",2019,"Manchester Utd","Premier League","Victor Lindelöf","SWE","DF","24",1994,28.9,40,27,28,12,0,13,23,56.5,10,21,12,9,24,64,121,3,"https://fbref.com/en/players/f5deef4c/Victor-Lindelof"
"1550","Jesse Lingard_2019",2019,"Manchester Utd","Premier League","Jesse Lingard","ENG","FW,MF","25",1992,18.5,29,18,8,11,10,7,28,25,21,18,2,16,10,39,9,1,"https://fbref.com/en/players/810e3c74/Jesse-Lingard"
"1551","Romelu Lukaku_2019",2019,"Manchester Utd","Premier League","Romelu Lukaku","BEL","FW","25",1993,23.7,8,4,0,6,2,2,10,20,8,12,1,11,2,10,19,0,"https://fbref.com/en/players/5eae500a/Romelu-Lukaku"
"1552","Anthony Martial_2019",2019,"Manchester Utd","Premier League","Anthony Martial","FRA","FW","22",1995,18,9,7,2,5,2,1,11,9.1,10,12,0,12,3,12,8,0,"https://fbref.com/en/players/8b788c01/Anthony-Martial"
"1553","Juan Mata_2019",2019,"Manchester Utd","Premier League","Juan Mata","ESP","FW,MF","30",1988,14.3,9,4,7,1,1,6,21,28.6,15,8,1,7,6,15,6,0,"https://fbref.com/en/players/29733c72/Juan-Mata"
"1554","Nemanja Matić_2019",2019,"Manchester Utd","Premier League","Nemanja Matić","SRB","MF","29",1988,27.1,50,30,27,19,4,30,59,50.8,29,39,18,21,31,81,53,4,"https://fbref.com/en/players/eb7822d7/Nemanja-Matic"
"1555","Scott McTominay_2019",2019,"Manchester Utd","Premier League","Scott McTominay","SCO","MF,DF","21",1996,9.6,10,9,3,6,1,4,10,40,6,9,4,5,15,25,16,0,"https://fbref.com/en/players/d93c2511/Scott-McTominay"
"1556","Andreas Pereira_2019",2019,"Manchester Utd","Premier League","Andreas Pereira","BRA","MF","22",1996,6.7,8,6,5,2,1,4,15,26.7,11,9,2,7,11,19,8,1,"https://fbref.com/en/players/6639e500/Andreas-Pereira"
"1557","Paul Pogba_2019",2019,"Manchester Utd","Premier League","Paul Pogba","FRA","MF","25",1993,33.4,47,30,21,21,5,17,43,39.5,26,30,9,21,18,65,39,0,"https://fbref.com/en/players/867239d3/Paul-Pogba"
"1558","Marcus Rashford_2019",2019,"Manchester Utd","Premier League","Marcus Rashford","ENG","FW","20",1997,25.9,24,12,4,12,8,7,29,24.1,22,27,0,27,3,27,24,0,"https://fbref.com/en/players/a1d5bd30/Marcus-Rashford"
"1559","Marcos Rojo_2019",2019,"Manchester Utd","Premier League","Marcos Rojo","ARG","DF","28",1990,2.4,5,3,3,2,0,1,6,16.7,5,3,2,1,6,11,9,1,"https://fbref.com/en/players/e0991c04/Marcos-Rojo"
"1560","Alexis Sánchez_2019",2019,"Manchester Utd","Premier League","Alexis Sánchez","CHI","FW,MF","29",1988,9.8,17,10,5,9,3,5,13,38.5,8,7,0,7,9,26,2,0,"https://fbref.com/en/players/2c0f8e9e/Alexis-Sanchez"
"1561","Luke Shaw_2019",2019,"Manchester Utd","Premier League","Luke Shaw","ENG","DF","23",1995,28.8,55,29,17,31,7,28,47,59.6,19,42,12,30,21,76,93,2,"https://fbref.com/en/players/9c94165b/Luke-Shaw"
"1562","Chris Smalling_2019",2019,"Manchester Utd","Premier League","Chris Smalling","ENG","DF","28",1989,23.6,30,17,21,9,0,11,17,64.7,6,37,25,12,26,56,109,1,"https://fbref.com/en/players/b6964eb6/Chris-Smalling"
"1563","Antonio Valencia_2019",2019,"Manchester Utd","Premier League","Antonio Valencia","ECU","DF","32",1985,5.2,8,6,2,4,2,3,4,75,1,9,0,9,5,13,10,0,"https://fbref.com/en/players/08aa17d0/Antonio-Valencia"
"1564","Ashley Young_2019",2019,"Manchester Utd","Premier League","Ashley Young","ENG","DF","33",1985,28.5,52,32,34,16,2,20,39,51.3,19,36,10,26,55,107,74,0,"https://fbref.com/en/players/be927d03/Ashley-Young"
"1565","Jordan Amavi_2019",2019,"Marseille","Ligue 1","Jordan Amavi","FRA","DF","24",1994,24.2,74,50,34,26,14,35,56,62.5,21,24,8,16,46,120,93,4,"https://fbref.com/en/players/22721b88/Jordan-Amavi"
"1566","Mario Balotelli_2019",2019,"Marseille","Ligue 1","Mario Balotelli","ITA","FW","27",1990,10.4,5,3,1,3,1,2,7,28.6,5,8,2,6,3,8,6,0,"https://fbref.com/en/players/8ff07990/Mario-Balotelli"
"1567","Duje Ćaleta-Car_2019",2019,"Marseille","Ligue 1","Duje Ćaleta-Car","CRO","DF","21",1996,17.2,22,16,14,8,0,14,18,77.8,4,15,9,6,20,42,86,2,"https://fbref.com/en/players/94f8d10c/Duje-Caleta-Car"
"1568","Valère Germain_2019",2019,"Marseille","Ligue 1","Valère Germain","FRA","FW","28",1990,24.1,38,25,8,22,8,8,33,24.2,25,20,5,15,6,44,30,0,"https://fbref.com/en/players/ea0ff634/Valere-Germain"
"1569","Luiz Gustavo_2019",2019,"Marseille","Ligue 1","Luiz Gustavo","BRA","MF,DF","31",1987,27.1,72,43,49,18,5,30,66,45.5,36,26,12,14,34,106,61,0,"https://fbref.com/en/players/82671804/Luiz-Gustavo"
"1570","Tomáš Hubočan_2019",2019,"Marseille","Ligue 1","Tomáš Hubočan","SVK","DF","32",1985,0.8,3,2,3,0,0,3,4,75,1,0,0,0,2,5,5,0,"https://fbref.com/en/players/97b87472/Tomas-Hubocan"
"1571","Boubacar Kamara_2019",2019,"Marseille","Ligue 1","Boubacar Kamara","FRA","DF","18",1999,26.8,67,39,38,24,5,32,49,65.3,17,24,13,11,45,112,95,2,"https://fbref.com/en/players/cc77354e/Boubacar-Kamara"
"1572","Maxime Lopez_2019",2019,"Marseille","Ligue 1","Maxime Lopez","FRA","MF","20",1997,24.2,46,24,17,23,6,19,53,35.8,34,10,2,8,20,66,8,0,"https://fbref.com/en/players/20094685/Maxime-Lopez"
"1573","Steve Mandanda_2019",2019,"Marseille","Ligue 1","Steve Mandanda","FRA","GK","33",1985,30.4,0,0,0,0,0,0,3,0,3,0,0,0,1,1,7,4,"https://fbref.com/en/players/1d2d5cc8/Steve-Mandanda"
"1574","Kostas Mitroglou_2019",2019,"Marseille","Ligue 1","Kostas Mitroglou","GRE","FW","30",1988,6.4,0,0,0,0,0,0,3,0,3,0,0,0,0,0,5,0,"https://fbref.com/en/players/c6ac6579/Kostas-Mitroglou"
"1575","Clinton N'Jie_2019",2019,"Marseille","Ligue 1","Clinton N'Jie","CMR","FW","24",1993,4,7,4,2,3,2,3,3,100,0,2,0,2,2,9,0,0,"https://fbref.com/en/players/77f278a0/Clinton-NJie"
"1576","Lucas Ocampos_2019",2019,"Marseille","Ligue 1","Lucas Ocampos","ARG","FW,MF","24",1994,30.1,80,54,37,33,10,34,80,42.5,46,40,5,35,29,109,30,0,"https://fbref.com/en/players/a08b974a/Lucas-Ocampos"
"1577","Dimitri Payet_2019",2019,"Marseille","Ligue 1","Dimitri Payet","FRA","MF,FW","31",1987,21.2,11,9,2,8,1,5,22,22.7,17,14,0,14,8,19,8,0,"https://fbref.com/en/players/58ae47b2/Dimitri-Payet"
"1578","Yohann Pelé_2019",2019,"Marseille","Ligue 1","Yohann Pelé","FRA","GK","35",1982,7.6,0,0,0,0,0,0,2,0,2,0,0,0,0,0,1,1,"https://fbref.com/en/players/76806215/Yohann-Pele"
"1579","Nemanja Radonjić_2019",2019,"Marseille","Ligue 1","Nemanja Radonjić","SRB","FW,MF","22",1996,7.6,8,5,1,5,2,5,16,31.3,11,3,0,3,5,13,4,0,"https://fbref.com/en/players/0630eb63/Nemanja-Radonjic"
"1580","Adil Rami_2019",2019,"Marseille","Ligue 1","Adil Rami","FRA","DF","32",1985,15.7,14,9,12,2,0,8,12,66.7,4,14,14,0,18,32,52,3,"https://fbref.com/en/players/8dbff17c/Adil-Rami"
"1581","Christopher Rocchia_2019",2019,"Marseille","Ligue 1","Christopher Rocchia","FRA","DF","20",1998,0,0,0,0,0,0,0,0,NA,0,0,0,0,0,0,1,0,"https://fbref.com/en/players/aa21406e/Christopher-Rocchia"
"1582","Rolando_2019",2019,"Marseille","Ligue 1","Rolando","POR","DF","32",1985,8.9,18,7,15,3,0,8,10,80,2,8,6,2,11,29,25,0,"https://fbref.com/en/players/0eeafda5/Rolando"
"1583","Hiroki Sakai_2019",2019,"Marseille","Ligue 1","Hiroki Sakai","JPN","DF","28",1990,26.4,59,41,30,23,6,29,54,53.7,25,25,10,15,37,96,77,0,"https://fbref.com/en/players/d63e2912/Hiroki-Sakai"
"1584","Morgan Sanson_2019",2019,"Marseille","Ligue 1","Morgan Sanson","FRA","MF","23",1994,26.7,70,47,27,35,8,21,77,27.3,56,40,1,39,42,112,8,1,"https://fbref.com/en/players/6e7f1353/Morgan-Sanson"
"1585","Bouna Sarr_2019",2019,"Marseille","Ligue 1","Bouna Sarr","SEN","DF,MF","26",1992,24.9,67,48,27,27,13,26,42,61.9,16,28,3,25,39,106,56,1,"https://fbref.com/en/players/1a4b9094/Bouna-Sarr"
"1586","Grégory Sertic_2019",2019,"Marseille","Ligue 1","Grégory Sertic","FRA","MF","28",1989,1.2,2,0,1,1,0,0,1,0,1,2,1,1,1,3,2,0,"https://fbref.com/en/players/c4527123/Gregory-Sertic"
"1587","Kevin Strootman_2019",2019,"Marseille","Ligue 1","Kevin Strootman","NED","MF","28",1990,21.6,76,40,21,47,8,20,52,38.5,32,24,6,18,24,100,26,0,"https://fbref.com/en/players/ef2e5e1a/Kevin-Strootman"
"1588","Florian Thauvin_2019",2019,"Marseille","Ligue 1","Florian Thauvin","FRA","FW,MF","25",1993,29,42,23,10,21,11,16,35,45.7,19,19,1,18,8,50,4,0,"https://fbref.com/en/players/2b9fdeea/Florian-Thauvin"
"1589","Ignazio Abate_2019",2019,"Milan","Serie A","Ignazio Abate","ITA","DF","31",1986,14.5,34,19,16,13,5,14,22,63.6,8,19,6,13,18,52,50,0,"https://fbref.com/en/players/1c529186/Ignazio-Abate"
"1590","Tiemoué Bakayoko_2019",2019,"Milan","Serie A","Tiemoué Bakayoko","FRA","MF","23",1994,25.6,69,43,22,40,7,26,62,41.9,36,34,5,29,50,119,42,2,"https://fbref.com/en/players/59bf127b/Tiemoue-Bakayoko"
"1591","Lucas Biglia_2019",2019,"Milan","Serie A","Lucas Biglia","ARG","MF","32",1986,12.4,60,33,31,25,4,20,45,44.4,25,19,3,16,22,82,21,1,"https://fbref.com/en/players/5710a281/Lucas-Biglia"
"1592","Giacomo Bonaventura_2019",2019,"Milan","Serie A","Giacomo Bonaventura","ITA","MF","28",1989,7.2,6,2,2,4,0,2,7,28.6,5,3,0,3,7,13,8,0,"https://fbref.com/en/players/d995ed27/Giacomo-Bonaventura"
"1593","Fabio Borini_2019",2019,"Milan","Serie A","Fabio Borini","ITA","FW,DF","27",1991,11.7,14,10,7,7,0,3,9,33.3,6,17,0,17,12,26,28,0,"https://fbref.com/en/players/ef5b337e/Fabio-Borini"
"1594","Davide Calabria_2019",2019,"Milan","Serie A","Davide Calabria","ITA","DF","21",1996,21.7,79,51,58,16,5,37,67,55.2,30,33,1,32,32,111,78,1,"https://fbref.com/en/players/2146785a/Davide-Calabria"
"1595","Hakan Çalhanoğlu_2019",2019,"Milan","Serie A","Hakan Çalhanoğlu","TUR","MF,FW","24",1994,32,52,31,27,16,9,23,46,50,23,27,5,22,28,80,19,0,"https://fbref.com/en/players/cd0fa27b/Hakan-Calhanoglu"
"1596","Samu Castillejo_2019",2019,"Milan","Serie A","Samu Castillejo","ESP","FW,MF","23",1995,11.4,15,10,10,2,3,4,25,16,21,16,0,16,8,23,11,0,"https://fbref.com/en/players/130a7a3f/Samu-Castillejo"
"1597","Andrea Conti_2019",2019,"Milan","Serie A","Andrea Conti","ITA","DF","24",1994,5.6,9,5,3,4,2,2,9,22.2,7,4,0,4,15,24,12,1,"https://fbref.com/en/players/8fef5412/Andrea-Conti"
"1598","Patrick Cutrone_2019",2019,"Milan","Serie A","Patrick Cutrone","ITA","FW","20",1998,16.2,9,5,0,3,6,2,16,12.5,14,13,2,11,7,16,13,0,"https://fbref.com/en/players/a4fe8cda/Patrick-Cutrone"
"1599","Gianluigi Donnarumma_2019",2019,"Milan","Serie A","Gianluigi Donnarumma","ITA","GK","19",1999,34.3,1,1,1,0,0,1,2,50,1,0,0,0,1,2,13,3,"https://fbref.com/en/players/08f5afaa/Gianluigi-Donnarumma"
"1600","Gonzalo Higuaín_2019",2019,"Milan","Serie A","Gonzalo Higuaín","ARG","FW","30",1987,14.2,8,6,1,5,2,5,13,38.5,8,3,0,3,0,8,11,1,"https://fbref.com/en/players/8a08491a/Gonzalo-Higuain"
"1601","Franck Kessié_2019",2019,"Milan","Serie A","Franck Kessié","CIV","MF","21",1996,33.5,42,27,16,20,6,18,38,47.4,20,35,10,25,27,69,53,2,"https://fbref.com/en/players/05e19d6a/Franck-Kessie"
"1602","Diego Laxalt_2019",2019,"Milan","Serie A","Diego Laxalt","URU","DF,MF","25",1993,7.2,26,13,14,7,5,13,22,59.1,9,23,3,20,8,34,12,0,"https://fbref.com/en/players/f26e3c59/Diego-Laxalt"
"1603","José Mauri_2019",2019,"Milan","Serie A","José Mauri","ITA","MF","22",1996,2.3,8,4,2,6,0,2,6,33.3,4,0,0,0,5,13,0,0,"https://fbref.com/en/players/644faf10/Jose-Mauri"
"1604","Mateo Musacchio_2019",2019,"Milan","Serie A","Mateo Musacchio","ARG","DF","27",1990,29,41,22,30,8,3,19,27,70.4,8,26,19,7,29,70,114,0,"https://fbref.com/en/players/91899ca8/Mateo-Musacchio"
"1605","Lucas Paquetá_2019",2019,"Milan","Serie A","Lucas Paquetá","BRA","MF","20",1997,9.4,18,9,9,8,1,7,24,29.2,17,12,0,12,4,22,11,2,"https://fbref.com/en/players/9b6f7fd5/Lucas-Paqueta"
"1606","Krzysztof Piątek_2019",2019,"Milan","Serie A","Krzysztof Piątek","POL","FW","23",1995,15.3,8,6,2,1,5,3,10,30,7,7,2,5,1,9,15,0,"https://fbref.com/en/players/17f3620a/Krzysztof-Piatek"
"1607","Pepe Reina_2019",2019,"Milan","Serie A","Pepe Reina","ESP","GK","35",1982,3.7,0,0,0,0,0,0,0,NA,0,0,0,0,0,0,1,0,"https://fbref.com/en/players/e358587b/Pepe-Reina"
"1608","Ricardo Rodríguez_2019",2019,"Milan","Serie A","Ricardo Rodríguez","SUI","DF","25",1992,33.9,57,32,34,21,2,32,39,82.1,7,25,5,20,38,95,98,0,"https://fbref.com/en/players/7f78ad23/Ricardo-Rodriguez"
"1609","Alessio Romagnoli_2019",2019,"Milan","Serie A","Alessio Romagnoli","ITA","DF","23",1995,31.6,34,19,26,6,2,16,19,84.2,3,48,32,16,37,71,173,1,"https://fbref.com/en/players/3ead85f9/Alessio-Romagnoli"
"1610","Suso_2019",2019,"Milan","Serie A","Suso","ESP","FW,MF","24",1993,33.5,28,18,10,14,4,10,41,24.4,31,26,1,25,16,44,3,0,"https://fbref.com/en/players/4e219ad2/Suso"
"1611","Cristián Zapata_2019",2019,"Milan","Serie A","Cristián Zapata","COL","DF","31",1986,11.4,23,16,15,7,1,9,10,90,1,18,15,3,8,31,59,0,"https://fbref.com/en/players/b1deecf8/Cristian-Zapata"
"1612","Jean-Eudes Aholou_2019",2019,"Monaco","Ligue 1","Jean-Eudes Aholou","CIV","MF","24",1994,11.9,20,11,6,11,3,8,16,50,8,7,0,7,17,37,12,0,"https://fbref.com/en/players/48b28bfd/Jean-Eudes-Aholou"
"1613","Youssef Aït Bennasser_2019",2019,"Monaco","Ligue 1","Youssef Aït Bennasser","MAR","MF","22",1996,11.9,33,16,14,18,1,13,29,44.8,16,15,5,10,15,48,19,0,"https://fbref.com/en/players/c46fa34c/Youssef-Ait-Bennasser"
"1614","Benoît Badiashile_2019",2019,"Monaco","Ligue 1","Benoît Badiashile","FRA","DF","17",2001,19.6,25,18,18,7,0,17,25,68,8,12,5,7,21,46,79,2,"https://fbref.com/en/players/06df8256/Benoit-Badiashile"
"1615","Fodé Ballo-Touré_2019",2019,"Monaco","Ligue 1","Fodé Ballo-Touré","SEN","DF","21",1997,17.7,46,31,26,16,4,20,40,50,20,20,2,18,28,74,38,2,"https://fbref.com/en/players/f449640d/Fode-Ballo-Toure"
"1616","Antonio Barreca_2019",2019,"Monaco","Ligue 1","Antonio Barreca","ITA","DF","23",1995,6.6,11,8,8,3,0,7,11,63.6,4,3,2,1,7,18,18,0,"https://fbref.com/en/players/6a189491/Antonio-Barreca"
"1617","Diego Benaglio_2019",2019,"Monaco","Ligue 1","Diego Benaglio","SUI","GK","34",1983,22.9,1,0,1,0,0,1,1,100,0,0,0,0,0,1,16,0,"https://fbref.com/en/players/b7e7937d/Diego-Benaglio"
"1618","Giulian Biancone_2019",2019,"Monaco","Ligue 1","Giulian Biancone","FRA","DF","18",2000,1,4,3,4,0,0,1,3,33.3,2,0,0,0,3,7,2,0,"https://fbref.com/en/players/de40e38c/Giulian-Biancone"
"1619","Nacer Chadli_2019",2019,"Monaco","Ligue 1","Nacer Chadli","BEL","MF,DF","28",1989,7.7,11,5,4,4,3,3,8,37.5,5,7,1,6,3,14,7,0,"https://fbref.com/en/players/5b54bf3b/Nacer-Chadli"
"1620","Sofiane Diop_2019",2019,"Monaco","Ligue 1","Sofiane Diop","FRA","MF,FW","18",2000,8.2,12,7,3,6,3,1,15,6.7,14,6,0,6,8,20,6,0,"https://fbref.com/en/players/19053e31/Sofiane-Diop"
"1621","Cesc Fàbregas_2019",2019,"Monaco","Ligue 1","Cesc Fàbregas","ESP","MF","31",1987,10.7,14,10,5,5,4,8,28,28.6,20,12,3,9,9,23,5,1,"https://fbref.com/en/players/33508c78/Cesc-Fabregas"
"1622","Romain Faivre_2019",2019,"Monaco","Ligue 1","Romain Faivre","FRA","MF","20",1998,1,1,0,0,1,0,0,1,0,1,0,0,0,1,2,1,1,"https://fbref.com/en/players/745ca0a3/Romain-Faivre"
"1623","Radamel Falcao_2019",2019,"Monaco","Ligue 1","Radamel Falcao","COL","FW","32",1986,28.4,34,15,6,16,12,8,27,29.6,19,11,6,5,3,37,23,2,"https://fbref.com/en/players/66116290/Radamel-Falcao"
"1624","Willem Geubbels_2019",2019,"Monaco","Ligue 1","Willem Geubbels","FRA","MF","16",2001,0.1,0,0,0,0,0,0,0,NA,0,0,0,0,0,0,0,0,"https://fbref.com/en/players/9836e892/Willem-Geubbels"
"1625","Kamil Glik_2019",2019,"Monaco","Ligue 1","Kamil Glik","POL","DF","30",1988,33,32,23,26,5,1,16,32,50,16,25,17,8,61,93,200,1,"https://fbref.com/en/players/c6056d58/Kamil-Glik"
"1626","Aleksandr Golovin_2019",2019,"Monaco","Ligue 1","Aleksandr Golovin","RUS","MF,FW","22",1996,25.4,36,17,3,20,13,10,44,22.7,34,34,3,31,22,58,12,0,"https://fbref.com/en/players/3708e9fa/Aleksandr-Golovin"
"1627","Samuel Grandsir_2019",2019,"Monaco","Ligue 1","Samuel Grandsir","FRA","FW,MF","21",1996,5.2,12,7,4,5,3,2,10,20,8,11,0,11,1,13,5,1,"https://fbref.com/en/players/d2448564/Samuel-Grandsir"
"1628","Benjamin Henrichs_2019",2019,"Monaco","Ligue 1","Benjamin Henrichs","GER","DF,MF","21",1997,20.3,58,39,32,22,4,16,38,42.1,22,18,0,18,35,93,45,0,"https://fbref.com/en/players/0a89e877/Benjamin-Henrichs"
"1629","Wilson Isidor_2019",2019,"Monaco","Ligue 1","Wilson Isidor","FRA","FW","17",2000,0.5,0,0,0,0,0,0,0,NA,0,1,1,0,0,0,1,0,"https://fbref.com/en/players/a671316d/Wilson-Isidor"
"1630","Jemerson_2019",2019,"Monaco","Ligue 1","Jemerson","BRA","DF,MF","25",1992,24.7,54,38,34,19,1,29,46,63,17,29,17,12,25,79,121,1,"https://fbref.com/en/players/7cab69b5/Jemerson"
"1631","Stevan Jovetić_2019",2019,"Monaco","Ligue 1","Stevan Jovetić","MNE","MF,FW","28",1989,4.4,2,1,1,1,0,1,3,33.3,2,1,0,1,1,3,3,0,"https://fbref.com/en/players/f36c432f/Stevan-Jovetic"
"1632","Rony Lopes_2019",2019,"Monaco","Ligue 1","Rony Lopes","POR","FW,MF","22",1995,20.5,33,22,10,17,6,9,22,40.9,13,17,1,16,8,41,10,0,"https://fbref.com/en/players/7c2965bb/Rony-Lopes"
"1633","Gelson Martins_2019",2019,"Monaco","Ligue 1","Gelson Martins","POR","FW,MF","23",1995,15.4,20,12,8,7,5,13,32,40.6,19,9,1,8,8,28,7,0,"https://fbref.com/en/players/3ef0fa48/Gelson-Martins"
"1634","Han-Noah Massengo_2019",2019,"Monaco","Ligue 1","Han-Noah Massengo","FRA","MF","17",2001,0.7,2,2,2,0,0,2,5,40,3,0,0,0,2,4,1,0,"https://fbref.com/en/players/eba1e557/Han-Noah-Massengo"
"1635","Jordi Mboula_2019",2019,"Monaco","Ligue 1","Jordi Mboula","ESP","FW,MF","19",1999,3.1,3,0,0,1,2,3,6,50,3,1,0,1,1,4,5,0,"https://fbref.com/en/players/4887118d/Jordi-Mboula"
"1636","Kévin N'Doram_2019",2019,"Monaco","Ligue 1","Kévin N'Doram","FRA","DF,MF","22",1996,2.2,5,4,1,4,0,3,5,60,2,1,1,0,5,10,8,1,"https://fbref.com/en/players/e50623a0/Kevin-NDoram"
"1637","Georges-Kévin N'Koudou_2019",2019,"Monaco","Ligue 1","Georges-Kévin N'Koudou","CMR","FW","23",1995,0.3,2,1,0,0,2,1,1,100,0,2,0,2,0,2,0,0,"https://fbref.com/en/players/76c131da/Georges-Kevin-NKoudou"
"1638","Naldo_2019",2019,"Monaco","Ligue 1","Naldo","BRA","DF","35",1982,3.3,5,3,4,1,0,2,4,50,2,5,2,3,5,10,23,0,"https://fbref.com/en/players/03bd0bf4/Naldo"
"1639","Pelé_2019",2019,"Monaco","Ligue 1","Pelé","GNB","MF","26",1991,5.2,8,7,3,5,0,2,6,33.3,4,2,1,1,3,11,10,0,"https://fbref.com/en/players/743fdcd3/Pele"
"1640","Pietro Pellegri_2019",2019,"Monaco","Ligue 1","Pietro Pellegri","ITA","FW,MF","17",2001,0.9,1,1,0,0,1,0,0,NA,0,0,0,0,0,1,0,0,"https://fbref.com/en/players/a44d3a3c/Pietro-Pellegri"
"1641","Ronaël Pierre-Gabriel_2019",2019,"Monaco","Ligue 1","Ronaël Pierre-Gabriel","FRA","DF","20",1998,3.9,13,8,10,2,1,9,10,90,1,3,1,2,3,16,18,0,"https://fbref.com/en/players/64ba07c0/Ronael-Pierre-Gabriel"
"1642","Andrea Raggi_2019",2019,"Monaco","Ligue 1","Andrea Raggi","ITA","DF","34",1984,5.5,7,5,7,0,0,6,6,100,0,1,0,1,7,14,21,0,"https://fbref.com/en/players/bd4f5f94/Andrea-Raggi"
"1643","Julien Serrano_2019",2019,"Monaco","Ligue 1","Julien Serrano","FRA","MF,DF","20",1998,1.3,5,4,3,2,0,3,6,50,3,1,0,1,3,8,3,0,"https://fbref.com/en/players/7fb301af/Julien-Serrano"
"1644","Djibril Sidibé_2019",2019,"Monaco","Ligue 1","Djibril Sidibé","FRA","DF,MF","26",1992,23.1,50,34,27,12,11,26,48,54.2,22,25,9,16,30,80,51,0,"https://fbref.com/en/players/4c5b714f/Djibril-Sidibe"
"1645","Adrien Silva_2019",2019,"Monaco","Ligue 1","Adrien Silva","POR","MF","29",1989,13.2,50,31,19,26,5,30,62,48.4,32,15,2,13,16,66,23,0,"https://fbref.com/en/players/d6f88a1d/Adrien-Silva"
"1646","Danijel Subašić_2019",2019,"Monaco","Ligue 1","Danijel Subašić","CRO","GK","33",1984,12.6,0,0,0,0,0,0,1,0,1,0,0,0,0,0,6,2,"https://fbref.com/en/players/f6db3bd5/Danijel-Subasic"
"1647","Seydou Sy_2019",2019,"Monaco","Ligue 1","Seydou Sy","SEN","GK","22",1995,2.5,0,0,0,0,0,0,0,NA,0,0,0,0,0,0,0,1,"https://fbref.com/en/players/8417953b/Seydou-Sy"
"1648","Moussa Sylla_2019",2019,"Monaco","Ligue 1","Moussa Sylla","FRA","FW,MF","18",1999,8.5,6,4,4,1,1,2,6,33.3,4,5,2,3,2,8,5,0,"https://fbref.com/en/players/d8b97bb3/Moussa-Sylla"
"1649","Youri Tielemans_2019",2019,"Monaco","Ligue 1","Youri Tielemans","BEL","MF","21",1997,18.7,45,24,17,23,5,24,47,51.1,23,20,3,17,18,63,22,0,"https://fbref.com/en/players/56f7a928/Youri-Tielemans"
"1650","Almamy Touré_2019",2019,"Monaco","Ligue 1","Almamy Touré","MLI","DF","22",1996,3.8,13,6,6,7,0,3,10,30,7,3,1,2,11,24,12,0,"https://fbref.com/en/players/c8c60119/Almamy-Toure"
"1651","Adama Traoré_2019",2019,"Monaco","Ligue 1","Adama Traoré","MLI","MF","23",1995,2.7,2,1,1,0,1,1,4,25,3,4,0,4,3,5,1,0,"https://fbref.com/en/players/1a6f2a66/Adama-Traore"
"1652","William Vainqueur_2019",2019,"Monaco","Ligue 1","William Vainqueur","FRA","MF","29",1988,0.9,6,3,4,2,0,1,1,100,0,1,0,1,0,6,0,0,"https://fbref.com/en/players/92cd4bef/William-Vainqueur"
"1653","Carlos Vinícius_2019",2019,"Monaco","Ligue 1","Carlos Vinícius","BRA","FW,MF","23",1995,5.8,4,1,1,2,1,0,1,0,1,7,0,7,1,5,2,0,"https://fbref.com/en/players/8b529245/Carlos-Vinicius"
"1654","Ruben Aguilar_2019",2019,"Montpellier","Ligue 1","Ruben Aguilar","FRA","DF","25",1993,28.1,88,51,40,33,15,39,69,56.5,30,23,3,20,37,125,50,1,"https://fbref.com/en/players/3dd738a1/Ruben-Aguilar"
"1655","Yanis Ammour_2019",2019,"Montpellier","Ligue 1","Yanis Ammour","FRA","MF","19",1999,0,0,0,0,0,0,0,0,NA,0,0,0,0,0,0,0,0,"https://fbref.com/en/players/aeed036d/Yanis-Ammour"
"1656","Dimitry Bertaud_2019",2019,"Montpellier","Ligue 1","Dimitry Bertaud","FRA","GK","20",1998,1,0,0,0,0,0,0,0,NA,0,0,0,0,0,0,0,0,"https://fbref.com/en/players/380a15e2/Dimitry-Bertaud"
"1657","Bilal Boutobba_2019",2019,"Montpellier","Ligue 1","Bilal Boutobba","FRA","FW,MF","19",1998,0.4,0,0,0,0,0,0,2,0,2,0,0,0,0,0,0,0,"https://fbref.com/en/players/e8a65bc8/Bilal-Boutobba"
"1658","Souleymane Camara_2019",2019,"Montpellier","Ligue 1","Souleymane Camara","SEN","FW,MF","35",1982,1.5,0,0,0,0,0,0,2,0,2,0,0,0,0,0,3,0,"https://fbref.com/en/players/c58270f8/Souleymane-Camara"
"1659","Daniel Congré_2019",2019,"Montpellier","Ligue 1","Daniel Congré","FRA","DF","33",1985,36.6,75,45,46,26,3,38,65,58.5,27,35,15,20,67,142,106,1,"https://fbref.com/en/players/3f5b4635/Daniel-Congre"
"1660","Nicolas Cozza_2019",2019,"Montpellier","Ligue 1","Nicolas Cozza","FRA","DF","19",1999,10.9,19,15,14,5,0,4,10,40,6,13,10,3,23,42,37,1,"https://fbref.com/en/players/8f325097/Nicolas-Cozza"
"1661","Andy Delort_2019",2019,"Montpellier","Ligue 1","Andy Delort","ALG","FW","26",1991,34.6,34,20,7,20,7,8,34,23.5,26,28,7,21,4,38,7,0,"https://fbref.com/en/players/d33c706e/Andy-Delort"
"1662","Keagan Dolly_2019",2019,"Montpellier","Ligue 1","Keagan Dolly","RSA","FW","25",1993,1,1,1,0,1,0,0,3,0,3,0,0,0,0,1,0,0,"https://fbref.com/en/players/ccb1c3af/Keagan-Dolly"
"1663","Vitorino Hilton_2019",2019,"Montpellier","Ligue 1","Vitorino Hilton","BRA","DF","40",1977,35.9,33,13,28,5,0,12,30,40,18,31,15,16,66,99,198,2,"https://fbref.com/en/players/c4bbea9f/Vitorino-Hilton"
"1664","Gaëtan Laborde_2019",2019,"Montpellier","Ligue 1","Gaëtan Laborde","FRA","FW,MF","24",1994,32.2,36,15,6,15,15,11,27,40.7,16,18,2,16,6,42,27,0,"https://fbref.com/en/players/7cdda3bf/Gaetan-Laborde"
"1665","Paul Lasne_2019",2019,"Montpellier","Ligue 1","Paul Lasne","FRA","MF,DF","29",1989,19.9,53,33,32,16,5,24,43,55.8,19,22,2,20,22,75,23,1,"https://fbref.com/en/players/542cc80f/Paul-Lasne"
"1666","Damien Le Tallec_2019",2019,"Montpellier","Ligue 1","Damien Le Tallec","FRA","MF","28",1990,31.2,95,58,42,43,10,33,89,37.1,56,35,8,27,59,154,50,0,"https://fbref.com/en/players/8f4d116f/Damien-Le-Tallec"
"1667","Benjamin Lecomte_2019",2019,"Montpellier","Ligue 1","Benjamin Lecomte","FRA","GK","27",1991,37,1,0,1,0,0,1,3,33.3,2,0,0,0,5,6,24,3,"https://fbref.com/en/players/2fa2a875/Benjamin-Lecomte"
"1668","Pedro Mendes_2019",2019,"Montpellier","Ligue 1","Pedro Mendes","POR","DF","27",1990,29.6,71,42,56,13,2,31,47,66,16,42,22,20,48,119,73,1,"https://fbref.com/en/players/6690ef25/Pedro-Mendes"
"1669","Florent Mollet_2019",2019,"Montpellier","Ligue 1","Florent Mollet","FRA","MF","26",1991,28.5,36,20,8,20,8,13,51,25.5,38,32,1,31,23,59,7,0,"https://fbref.com/en/players/7e82a78f/Florent-Mollet"
"1670","Ambroise Oyongo_2019",2019,"Montpellier","Ligue 1","Ambroise Oyongo","CMR","DF","27",1991,23.7,44,21,23,16,5,20,38,52.6,18,26,6,20,38,82,60,0,"https://fbref.com/en/players/e3e05edf/Ambroise-Oyongo"
"1671","Facundo Píriz_2019",2019,"Montpellier","Ligue 1","Facundo Píriz","URU","MF,FW","28",1990,1.3,9,6,3,4,2,4,9,44.4,5,2,1,1,0,9,2,0,"https://fbref.com/en/players/fca455cc/Facundo-Piriz"
"1672","Morgan Poaty_2019",2019,"Montpellier","Ligue 1","Morgan Poaty","CGO","MF","21",1997,1,1,1,1,0,0,0,0,NA,0,1,0,1,0,1,2,0,"https://fbref.com/en/players/7add56e1/Morgan-Poaty"
"1673","Mihailo Ristić_2019",2019,"Montpellier","Ligue 1","Mihailo Ristić","SRB","DF,MF","22",1995,3.6,14,9,8,5,1,6,10,60,4,11,3,8,9,23,6,0,"https://fbref.com/en/players/ea0aa7e0/Mihailo-Ristic"
"1674","Junior Sambia_2019",2019,"Montpellier","Ligue 1","Junior Sambia","FRA","MF,FW","21",1996,10.3,15,7,7,7,1,6,15,40,9,14,2,12,5,20,3,0,"https://fbref.com/en/players/24eb7ed6/Junior-Sambia"
"1675","Giovanni Sio_2019",2019,"Montpellier","Ligue 1","Giovanni Sio","CIV","FW","29",1989,0.7,0,0,0,0,0,0,0,NA,0,0,0,0,0,0,0,0,"https://fbref.com/en/players/0fe7f7bc/Giovanni-Sio"
"1676","Ellyes Skhiri_2019",2019,"Montpellier","Ligue 1","Ellyes Skhiri","TUN","MF","23",1995,34.3,105,58,31,64,10,43,91,47.3,48,60,7,53,60,165,41,0,"https://fbref.com/en/players/c2211709/Ellyes-Skhiri"
"1677","Petar Škuletić_2019",2019,"Montpellier","Ligue 1","Petar Škuletić","SRB","FW","28",1990,6.7,9,5,4,2,3,1,15,6.7,14,7,1,6,3,12,14,1,"https://fbref.com/en/players/d9a66c60/Petar-Skuletic"
"1678","Mathías Suárez_2019",2019,"Montpellier","Ligue 1","Mathías Suárez","URU","DF","22",1996,6.1,20,11,7,10,3,10,23,43.5,13,11,0,11,9,29,18,0,"https://fbref.com/en/players/0c291a1a/Mathias-Suarez"
"1679","Alexis Alegue_2019",2019,"Nantes","Ligue 1","Alexis Alegue","FRA","FW","21",1996,0.1,1,0,0,1,0,0,0,NA,0,0,0,0,0,1,0,0,"https://fbref.com/en/players/0f4c0bad/Alexis-Alegue"
"1680","Thomas Basila_2019",2019,"Nantes","Ligue 1","Thomas Basila","FRA","DF","19",1999,1,2,1,1,1,0,0,0,NA,0,2,1,1,0,2,8,0,"https://fbref.com/en/players/65391fa7/Thomas-Basila"
"1681","Gabriel Boschilia_2019",2019,"Nantes","Ligue 1","Gabriel Boschilia","BRA","FW,MF","22",1996,14.7,33,23,11,9,13,8,33,24.2,25,14,2,12,8,41,7,0,"https://fbref.com/en/players/e90af77c/Gabriel-Boschilia"
"1682","Diego Carlos_2019",2019,"Nantes","Ligue 1","Diego Carlos","BRA","DF","25",1993,35,58,34,43,14,1,26,33,78.8,7,44,31,13,50,108,186,1,"https://fbref.com/en/players/b4a014b1/Diego-Carlos"
"1683","Kalifa Coulibaly_2019",2019,"Nantes","Ligue 1","Kalifa Coulibaly","MLI","FW","26",1991,19.5,15,7,1,10,4,4,11,36.4,7,8,1,7,4,19,22,0,"https://fbref.com/en/players/9980269a/Kalifa-Coulibaly"
"1684","Abdoulaye Dabo_2019",2019,"Nantes","Ligue 1","Abdoulaye Dabo","FRA","FW","17",2001,1.3,3,1,1,0,2,0,0,NA,0,0,0,0,0,3,0,0,"https://fbref.com/en/players/797f6070/Abdoulaye-Dabo"
"1685","Koffi Djidji_2019",2019,"Nantes","Ligue 1","Koffi Djidji","CIV","DF","25",1992,1,1,1,1,0,0,0,0,NA,0,1,1,0,1,2,3,0,"https://fbref.com/en/players/933d3b51/Koffi-Djidji"
"1686","Maxime Dupé_2019",2019,"Nantes","Ligue 1","Maxime Dupé","FRA","GK","25",1993,10.4,0,0,0,0,0,0,0,NA,0,0,0,0,0,0,3,1,"https://fbref.com/en/players/0e12089d/Maxime-Dupe"
"1687","Lucas Evangelista_2019",2019,"Nantes","Ligue 1","Lucas Evangelista","BRA","FW,MF","23",1995,8,30,17,11,12,7,14,25,56,11,10,0,10,9,39,6,0,"https://fbref.com/en/players/5f4ce4b6/Lucas-Evangelista"
"1688","Valentin Eysseric_2019",2019,"Nantes","Ligue 1","Valentin Eysseric","FRA","MF,FW","26",1992,2.3,1,1,0,1,0,0,2,0,2,2,0,2,0,1,0,0,"https://fbref.com/en/players/ae82fa48/Valentin-Eysseric"
"1689","Fábio_2019",2019,"Nantes","Ligue 1","Fábio","BRA","DF,FW","28",1990,14.2,53,34,25,27,1,26,53,49.1,27,18,4,14,18,71,27,0,"https://fbref.com/en/players/bc7b4580/Fabio"
"1690","Andrei Girotto_2019",2019,"Nantes","Ligue 1","Andrei Girotto","BRA","MF","26",1992,16.4,57,40,18,36,3,20,44,45.5,24,22,6,16,29,86,43,1,"https://fbref.com/en/players/3befc2b6/Andrei-Girotto"
"1691","Edgar Ié_2019",2019,"Nantes","Ligue 1","Edgar Ié","GNB","DF","24",1994,8.6,20,13,12,6,2,9,16,56.3,7,10,3,7,8,28,23,0,"https://fbref.com/en/players/3767b3b7/Edgar-Ie"
"1692","Randal Kolo Muani_2019",2019,"Nantes","Ligue 1","Randal Kolo Muani","FRA","FW","19",1998,1.4,2,0,1,1,0,0,1,0,1,2,0,2,0,2,2,0,"https://fbref.com/en/players/c0b3669f/Randal-Kolo-Muani"
"1693","Rene Krhin_2019",2019,"Nantes","Ligue 1","Rene Krhin","SVN","MF","28",1990,11.7,22,14,7,12,3,11,19,57.9,8,7,4,3,21,43,32,0,"https://fbref.com/en/players/9a506145/Rene-Krhin"
"1694","Enock Kwateng_2019",2019,"Nantes","Ligue 1","Enock Kwateng","FRA","DF","21",1997,22.7,65,41,34,27,4,33,70,47.1,37,28,4,24,78,143,56,0,"https://fbref.com/en/players/4bf69118/Enock-Kwateng"
"1695","Lucas Lima_2019",2019,"Nantes","Ligue 1","Lucas Lima","BRA","DF,FW","26",1991,27.7,49,28,26,15,8,20,53,37.7,33,39,3,36,29,78,62,1,"https://fbref.com/en/players/0f52f925/Lucas-Lima"
"1696","Anthony Limbombe_2019",2019,"Nantes","Ligue 1","Anthony Limbombe","BEL","FW","24",1994,13.7,12,10,4,6,2,7,16,43.8,9,5,0,5,8,20,10,0,"https://fbref.com/en/players/ccee698e/Anthony-Limbombe"
"1697","Imran Louza_2019",2019,"Nantes","Ligue 1","Imran Louza","MAR","MF","19",1999,1,2,0,1,1,0,1,1,100,0,1,0,1,0,2,1,0,"https://fbref.com/en/players/e1df6989/Imran-Louza"
"1698","Abdul Majeed Waris_2019",2019,"Nantes","Ligue 1","Abdul Majeed Waris","GHA","FW,MF","26",1991,25,22,13,6,13,3,7,28,25,21,9,0,9,7,29,7,0,"https://fbref.com/en/players/46907171/Abdul-Majeed-Waris"
"1699","Antonio Mance_2019",2019,"Nantes","Ligue 1","Antonio Mance","CRO","FW","22",1995,0.6,1,1,0,0,1,1,2,50,1,0,0,0,0,1,0,0,"https://fbref.com/en/players/171bf11d/Antonio-Mance"
"1700","Kara Mbodji_2019",2019,"Nantes","Ligue 1","Kara Mbodji","SEN","DF","28",1989,5.6,12,10,10,1,1,6,8,75,2,4,1,3,6,18,25,0,"https://fbref.com/en/players/8325870c/Kara-Mbodji"
"1701","Matt Miazga_2019",2019,"Nantes","Ligue 1","Matt Miazga","USA","DF","23",1995,8,12,11,11,1,0,7,9,77.8,2,11,7,4,12,24,41,1,"https://fbref.com/en/players/9fc0f253/Matt-Miazga"
"1702","Samuel Moutoussamy_2019",2019,"Nantes","Ligue 1","Samuel Moutoussamy","COD","MF,FW","21",1996,18.3,35,20,16,11,8,12,34,35.3,22,17,2,15,9,44,17,0,"https://fbref.com/en/players/af0c835b/Samuel-Moutoussamy"
"1703","Alexandre Olliero_2019",2019,"Nantes","Ligue 1","Alexandre Olliero","FRA","GK","22",1996,1,0,0,0,0,0,0,0,NA,0,0,0,0,0,0,0,0,"https://fbref.com/en/players/c977ef13/Alexandre-Olliero"
"1704","Nicolas Pallois_2019",2019,"Nantes","Ligue 1","Nicolas Pallois","FRA","DF","30",1987,24,77,48,60,17,0,40,69,58,29,30,14,16,34,111,114,0,"https://fbref.com/en/players/779847d6/Nicolas-Pallois"
"1705","Valentin Rongier_2019",2019,"Nantes","Ligue 1","Valentin Rongier","FRA","MF","23",1994,35.8,86,54,24,46,16,26,65,40,39,46,6,40,33,119,19,0,"https://fbref.com/en/players/ed45c4a5/Valentin-Rongier"
"1706","Emiliano Sala_2019",2019,"Nantes","Ligue 1","Emiliano Sala","ARG","FW","27",1990,15.2,7,5,0,2,5,1,8,12.5,7,8,1,7,2,9,20,0,"https://fbref.com/en/players/5d59e0df/Emiliano-Sala"
"1707","Ciprian Tătărușanu_2019",2019,"Nantes","Ligue 1","Ciprian Tătărușanu","ROU","GK","32",1986,26.6,0,0,0,0,0,0,0,NA,0,0,0,0,2,2,20,0,"https://fbref.com/en/players/b056e3da/Ciprian-Tatarusanu"
"1708","Abdoulaye Touré_2019",2019,"Nantes","Ligue 1","Abdoulaye Touré","FRA","MF","24",1994,30.5,48,31,14,28,6,19,56,33.9,37,25,10,15,47,95,29,1,"https://fbref.com/en/players/ef7cd87a/Abdoulaye-Toure"
"1709","Charles Traore_2019",2019,"Nantes","Ligue 1","Charles Traore","MLI","DF,FW","26",1992,12.9,40,20,22,16,2,23,34,67.6,11,16,3,13,19,59,46,0,"https://fbref.com/en/players/de488e56/Charles-Traore"
"1710","Anthony Walongwa_2019",2019,"Nantes","Ligue 1","Anthony Walongwa","COD","DF","24",1993,1,0,0,0,0,0,0,0,NA,0,3,2,1,1,1,2,0,"https://fbref.com/en/players/eb78322b/Anthony-Walongwa"
"1711","Elie Youan_2019",2019,"Nantes","Ligue 1","Elie Youan","FRA","FW","19",1999,0.2,1,0,0,1,0,0,0,NA,0,0,0,0,0,1,0,0,"https://fbref.com/en/players/698b37b8/Elie-Youan"
"1712","Raúl Albiol_2019",2019,"Napoli","Serie A","Raúl Albiol","ESP","DF","32",1985,19,16,8,12,4,0,8,15,53.3,7,19,16,3,20,36,90,1,"https://fbref.com/en/players/4bd414c1/Raul-Albiol"
"1713","Allan_2019",2019,"Napoli","Serie A","Allan","BRA","MF","27",1991,29.1,106,70,39,55,12,36,107,33.6,71,55,13,42,36,142,28,0,"https://fbref.com/en/players/cc700722/Allan"
"1714","José Callejón_2019",2019,"Napoli","Serie A","José Callejón","ESP","MF,FW","31",1987,29.4,34,18,12,14,8,18,57,31.6,39,34,5,29,22,56,11,0,"https://fbref.com/en/players/78841da9/Jose-Callejon"
"1715","Vlad Chiricheș_2019",2019,"Napoli","Serie A","Vlad Chiricheș","ROU","DF","28",1989,1.6,2,1,1,1,0,0,2,0,2,2,2,0,1,3,2,0,"https://fbref.com/en/players/c316607a/Vlad-Chiriches"
"1716","Amadou Diawara_2019",2019,"Napoli","Serie A","Amadou Diawara","GUI","MF","21",1997,7.3,12,4,1,9,2,4,5,80,1,6,0,6,11,23,12,0,"https://fbref.com/en/players/bf309d24/Amadou-Diawara"
"1717","Gianluca Gaetano_2019",2019,"Napoli","Serie A","Gianluca Gaetano","ITA","MF,FW","18",2000,0.1,0,0,0,0,0,0,0,NA,0,0,0,0,0,0,0,0,"https://fbref.com/en/players/3b387cc7/Gianluca-Gaetano"
"1718","Faouzi Ghoulam_2019",2019,"Napoli","Serie A","Faouzi Ghoulam","ALG","DF","27",1991,12.8,9,7,3,5,1,8,9,88.9,1,6,2,4,8,17,17,0,"https://fbref.com/en/players/c5adc293/Faouzi-Ghoulam"
"1719","Marek Hamšík_2019",2019,"Napoli","Serie A","Marek Hamšík","SVK","MF","31",1987,10.2,7,5,2,4,1,0,11,0,11,8,1,7,12,19,14,1,"https://fbref.com/en/players/e6ad16b2/Marek-Hamsik"
"1720","Elseid Hysaj_2019",2019,"Napoli","Serie A","Elseid Hysaj","ALB","DF","24",1994,23.4,40,28,22,15,3,25,49,51,24,11,3,8,24,64,51,0,"https://fbref.com/en/players/2f3452eb/Elseid-Hysaj"
"1721","Lorenzo Insigne_2019",2019,"Napoli","Serie A","Lorenzo Insigne","ITA","FW,MF","27",1991,23,14,4,5,6,3,6,18,33.3,12,7,0,7,8,22,3,0,"https://fbref.com/en/players/2f557579/Lorenzo-Insigne"
"1722","Orestis Karnezis_2019",2019,"Napoli","Serie A","Orestis Karnezis","GRE","GK","33",1985,9,0,0,0,0,0,0,0,NA,0,0,0,0,0,0,3,0,"https://fbref.com/en/players/85b011bb/Orestis-Karnezis"
"1723","Kalidou Koulibaly_2019",2019,"Napoli","Serie A","Kalidou Koulibaly","SEN","DF","27",1991,34.8,61,40,37,22,2,19,36,52.8,17,55,33,22,40,101,144,0,"https://fbref.com/en/players/da974c7b/Kalidou-Koulibaly"
"1724","Sebastiano Luperto_2019",2019,"Napoli","Serie A","Sebastiano Luperto","ITA","DF","21",1996,8.1,8,6,5,2,1,2,5,40,3,7,3,4,13,21,30,0,"https://fbref.com/en/players/997fff07/Sebastiano-Luperto"
"1725","Nikola Maksimović_2019",2019,"Napoli","Serie A","Nikola Maksimović","SRB","DF","26",1991,15.3,20,13,14,6,0,6,12,50,6,16,10,6,28,48,56,1,"https://fbref.com/en/players/16b9d5cf/Nikola-Maksimovic"
"1726","Kévin Malcuit_2019",2019,"Napoli","Serie A","Kévin Malcuit","MAR","DF","27",1991,20.1,43,31,23,14,6,23,36,63.9,13,18,4,14,44,87,67,0,"https://fbref.com/en/players/d6a889ea/Kevin-Malcuit"
"1727","Alex Meret_2019",2019,"Napoli","Serie A","Alex Meret","ITA","GK","21",1997,12.8,0,0,0,0,0,0,0,NA,0,0,0,0,0,0,3,1,"https://fbref.com/en/players/9413b19f/Alex-Meret"
"1728","Dries Mertens_2019",2019,"Napoli","Serie A","Dries Mertens","BEL","FW","31",1987,25,19,11,2,7,10,1,21,4.8,20,7,0,7,13,32,3,0,"https://fbref.com/en/players/89b2c8a9/Dries-Mertens"
"1729","Arkadiusz Milik_2019",2019,"Napoli","Serie A","Arkadiusz Milik","POL","FW","24",1994,26.6,19,9,1,8,10,1,20,5,19,7,2,5,3,22,15,0,"https://fbref.com/en/players/85613cf0/Arkadiusz-Milik"
"1730","David Ospina_2019",2019,"Napoli","Serie A","David Ospina","COL","GK","29",1988,16.2,1,0,1,0,0,1,1,100,0,0,0,0,0,1,7,1,"https://fbref.com/en/players/82b1198a/David-Ospina"
"1731","Adam Ounas_2019",2019,"Napoli","Serie A","Adam Ounas","ALG","MF,FW","21",1996,6,5,2,0,3,2,2,11,18.2,9,6,0,6,2,7,0,1,"https://fbref.com/en/players/ed90babd/Adam-Ounas"
"1732","Marko Rog_2019",2019,"Napoli","Serie A","Marko Rog","CRO","MF","23",1995,3.7,12,9,3,7,2,5,11,45.5,6,8,2,6,5,17,1,0,"https://fbref.com/en/players/b6b2b820/Marko-Rog"
"1733","Mário Rui_2019",2019,"Napoli","Serie A","Mário Rui","POR","DF","27",1991,15.7,24,18,9,12,3,14,25,56,11,15,3,12,21,45,38,0,"https://fbref.com/en/players/0b5a292a/Mario-Rui"
"1734","Fabián Ruiz Peña_2019",2019,"Napoli","Serie A","Fabián Ruiz Peña","ESP","MF","22",1996,22.1,54,33,22,25,7,20,46,43.5,26,23,4,19,21,75,29,2,"https://fbref.com/en/players/c0c7ff58/Fabian-Ruiz-Pena"
"1735","Simone Verdi_2019",2019,"Napoli","Serie A","Simone Verdi","ITA","MF,FW","26",1992,7.8,16,11,5,9,2,8,16,50,8,6,0,6,4,20,3,0,"https://fbref.com/en/players/0375723e/Simone-Verdi"
"1736","Amin Younes_2019",2019,"Napoli","Serie A","Amin Younes","GER","MF,FW","24",1993,5.5,11,6,3,6,2,3,6,50,3,7,0,7,2,13,0,0,"https://fbref.com/en/players/228f73ae/Amin-Younes"
"1737","Piotr Zieliński_2019",2019,"Napoli","Serie A","Piotr Zieliński","POL","MF","24",1994,31.9,41,25,11,20,10,13,34,38.2,21,30,4,26,20,61,18,0,"https://fbref.com/en/players/a5296e55/Piotr-Zielinski"
"1738","Miguel Almirón_2019",2019,"Newcastle Utd","Premier League","Miguel Almirón","PAR","MF","24",1994,8.4,20,12,7,10,3,4,10,40,6,14,1,13,8,28,5,0,"https://fbref.com/en/players/862a1c15/Miguel-Almiron"
"1739","Christian Atsu_2019",2019,"Newcastle Utd","Premier League","Christian Atsu","GHA","MF","26",1992,16.6,24,15,9,11,4,5,16,31.3,11,13,3,10,7,31,16,0,"https://fbref.com/en/players/8816329f/Christian-Atsu"
"1740","Antonio Barreca_2019",2019,"Newcastle Utd","Premier League","Antonio Barreca","ITA","DF","23",1995,0.1,0,0,0,0,0,0,0,NA,0,0,0,0,0,0,0,0,"https://fbref.com/en/players/6a189491/Antonio-Barreca"
"1741","Ciaran Clark_2019",2019,"Newcastle Utd","Premier League","Ciaran Clark","IRL","DF","28",1989,9.5,20,17,15,5,0,9,12,75,3,11,7,4,12,32,58,0,"https://fbref.com/en/players/2b91cf8e/Ciaran-Clark"
"1742","Mohamed Diamé_2019",2019,"Newcastle Utd","Premier League","Mohamed Diamé","SEN","MF","31",1987,24.1,76,46,35,36,5,16,54,29.6,38,42,9,33,30,106,39,1,"https://fbref.com/en/players/b7d082af/Mohamed-Diame"
"1743","Martin Dúbravka_2019",2019,"Newcastle Utd","Premier League","Martin Dúbravka","SVK","GK","29",1989,38,2,0,2,0,0,1,3,33.3,2,0,0,0,0,2,20,5,"https://fbref.com/en/players/3a949a25/Martin-Dubravka"
"1744","Paul Dummett_2019",2019,"Newcastle Utd","Premier League","Paul Dummett","WAL","DF","26",1991,22.1,34,22,24,9,1,19,32,59.4,13,25,11,14,37,71,133,0,"https://fbref.com/en/players/3fe6bd8c/Paul-Dummett"
"1745","Federico Fernández_2019",2019,"Newcastle Utd","Premier League","Federico Fernández","ARG","DF","29",1989,16.5,16,12,12,4,0,10,18,55.6,8,19,12,7,25,41,106,1,"https://fbref.com/en/players/f25b010f/Federico-Fernandez"
"1746","Isaac Hayden_2019",2019,"Newcastle Utd","Premier League","Isaac Hayden","ENG","MF","23",1995,20.7,73,43,19,45,9,23,41,56.1,18,32,4,28,40,113,30,0,"https://fbref.com/en/players/c951a6df/Isaac-Hayden"
"1747","Joselu_2019",2019,"Newcastle Utd","Premier League","Joselu","ESP","FW","28",1990,6.6,14,8,4,5,5,4,9,44.4,5,5,0,5,3,17,15,0,"https://fbref.com/en/players/6265208f/Joselu"
"1748","Kenedy_2019",2019,"Newcastle Utd","Premier League","Kenedy","BRA","MF,DF","22",1996,15,30,22,11,16,3,12,29,41.4,17,10,0,10,32,62,24,1,"https://fbref.com/en/players/5eebbfdf/Kenedy"
"1749","Jamaal Lascelles_2019",2019,"Newcastle Utd","Premier League","Jamaal Lascelles","ENG","DF","24",1993,30.5,32,21,25,5,2,11,14,78.6,3,43,28,15,39,71,218,3,"https://fbref.com/en/players/450ab6fc/Jamaal-Lascelles"
"1750","Florian Lejeune_2019",2019,"Newcastle Utd","Premier League","Florian Lejeune","FRA","DF","27",1991,11.7,25,15,17,7,1,11,24,45.8,13,16,5,11,21,46,49,0,"https://fbref.com/en/players/6eaed4eb/Florian-Lejeune"
"1751","Sean Longstaff_2019",2019,"Newcastle Utd","Premier League","Sean Longstaff","ENG","MF","20",1997,7.6,17,13,6,11,0,9,24,37.5,15,19,4,15,10,27,7,0,"https://fbref.com/en/players/a2b105e0/Sean-Longstaff"
"1752","Javier Manquillo_2019",2019,"Newcastle Utd","Premier League","Javier Manquillo","ESP","DF","24",1994,12.2,27,19,14,11,2,9,14,64.3,5,9,1,8,17,44,58,0,"https://fbref.com/en/players/758dd7f0/Javier-Manquillo"
"1753","Jacob Murphy_2019",2019,"Newcastle Utd","Premier League","Jacob Murphy","ENG","MF,DF","23",1995,3.4,6,2,4,2,0,2,4,50,2,5,2,3,1,7,7,0,"https://fbref.com/en/players/de112b84/Jacob-Murphy"
"1754","Yoshinori Mutō_2019",2019,"Newcastle Utd","Premier League","Yoshinori Mutō","JPN","FW,MF","26",1992,5.8,8,4,3,5,0,2,7,28.6,5,9,0,9,5,13,3,1,"https://fbref.com/en/players/5343eb4e/Yoshinori-Muto"
"1755","Ayoze Pérez_2019",2019,"Newcastle Utd","Premier League","Ayoze Pérez","ESP","MF,FW","25",1993,32.4,59,22,24,28,7,17,63,27,46,55,4,51,42,101,33,1,"https://fbref.com/en/players/819aa8e7/Ayoze-Perez"
"1756","Matt Ritchie_2019",2019,"Newcastle Utd","Premier League","Matt Ritchie","SCO","DF,MF","28",1989,32.5,70,44,35,27,8,19,47,40.4,28,34,11,23,51,121,76,1,"https://fbref.com/en/players/71ef519e/Matt-Ritchie"
"1757","Salomón Rondón_2019",2019,"Newcastle Utd","Premier League","Salomón Rondón","VEN","FW","28",1989,28.9,8,3,2,4,2,4,24,16.7,20,14,3,11,5,13,39,0,"https://fbref.com/en/players/b318a643/Salomon-Rondon"
"1758","Fabian Schär_2019",2019,"Newcastle Utd","Premier League","Fabian Schär","SUI","DF","26",1991,22.2,60,39,37,19,4,24,50,48,26,40,16,24,67,127,145,2,"https://fbref.com/en/players/c8aa95da/Fabian-Schar"
"1759","Jonjo Shelvey_2019",2019,"Newcastle Utd","Premier League","Jonjo Shelvey","ENG","MF","26",1992,10.5,22,12,10,9,3,8,17,47.1,9,10,3,7,7,29,15,0,"https://fbref.com/en/players/3727dd3c/Jonjo-Shelvey"
"1760","Ki Sung-yueng_2019",2019,"Newcastle Utd","Premier League","Ki Sung-yueng","KOR","MF","29",1989,14.5,14,10,5,8,1,3,12,25,9,11,1,10,19,33,20,0,"https://fbref.com/en/players/1d8c99b0/Ki-Sung-yueng"
"1761","DeAndre Yedlin_2019",2019,"Newcastle Utd","Premier League","DeAndre Yedlin","USA","DF","25",1993,27.5,54,32,36,14,4,19,41,46.3,22,36,10,26,28,82,88,0,"https://fbref.com/en/players/ae0a7ddf/DeAndre-Yedlin"
"1762","Youcef Atal_2019",2019,"Nice","Ligue 1","Youcef Atal","ALG","DF,FW","22",1996,25.1,68,44,34,25,9,34,67,50.7,33,38,8,30,56,124,42,0,"https://fbref.com/en/players/6a827d8e/Youcef-Atal"
"1763","Mario Balotelli_2019",2019,"Nice","Ligue 1","Mario Balotelli","ITA","FW","27",1990,8.4,1,0,0,1,0,1,4,25,3,9,1,8,1,2,8,0,"https://fbref.com/en/players/8ff07990/Mario-Balotelli"
"1764","Danilo Barbosa_2019",2019,"Nice","Ligue 1","Danilo Barbosa","BRA","MF","22",1996,17.2,29,20,13,13,3,6,17,35.3,11,17,2,15,15,44,25,1,"https://fbref.com/en/players/0557ff4f/Danilo-Barbosa"
"1765","Walter Benítez_2019",2019,"Nice","Ligue 1","Walter Benítez","ARG","GK","25",1993,35,1,0,1,0,0,1,2,50,1,0,0,0,2,3,6,2,"https://fbref.com/en/players/8a2248b4/Walter-Benitez"
"1766","Olivier Boscagli_2019",2019,"Nice","Ligue 1","Olivier Boscagli","FRA","DF","20",1997,9.6,20,12,14,4,2,9,20,45,11,12,1,11,17,37,37,0,"https://fbref.com/en/players/403f5d20/Olivier-Boscagli"
"1767","Pedro Brazão_2019",2019,"Nice","Ligue 1","Pedro Brazão","POR","MF,FW","15",2002,0.2,0,0,0,0,0,0,1,0,1,0,0,0,0,0,0,0,"https://fbref.com/en/players/0589c701/Pedro-Brazao"
"1768","Patrick Burner_2019",2019,"Nice","Ligue 1","Patrick Burner","MTQ","DF","22",1996,15,36,23,22,10,4,16,34,47.1,18,15,5,10,31,67,40,0,"https://fbref.com/en/players/8746d5d0/Patrick-Burner"
"1769","Yoan Cardinale_2019",2019,"Nice","Ligue 1","Yoan Cardinale","FRA","GK","24",1994,3,1,0,1,0,0,1,1,100,0,0,0,0,0,1,1,0,"https://fbref.com/en/players/950ff24d/Yoan-Cardinale"
"1770","Racine Coly_2019",2019,"Nice","Ligue 1","Racine Coly","SEN","DF,MF","22",1995,5.6,7,2,1,5,1,4,11,36.4,7,6,1,5,9,16,11,1,"https://fbref.com/en/players/166a981d/Racine-Coly"
"1771","Wylan Cyprien_2019",2019,"Nice","Ligue 1","Wylan Cyprien","FRA","MF","23",1995,26.2,40,20,16,21,3,15,43,34.9,28,20,5,15,11,51,15,0,"https://fbref.com/en/players/3e092724/Wylan-Cyprien"
"1772","Dante_2019",2019,"Nice","Ligue 1","Dante","BRA","DF","34",1983,35.8,54,40,36,16,2,24,41,58.5,17,56,30,26,38,92,156,2,"https://fbref.com/en/players/fd2bc67d/Dante"
"1773","Ignatius Ganago_2019",2019,"Nice","Ligue 1","Ignatius Ganago","CMR","FW","19",1999,11.5,3,1,0,2,1,0,7,0,7,2,0,2,1,4,7,0,"https://fbref.com/en/players/23c63b7f/Ignatius-Ganago"
"1774","Christophe Hérelle_2019",2019,"Nice","Ligue 1","Christophe Hérelle","MTQ","DF","25",1992,32.6,72,52,51,19,2,40,50,80,10,39,16,23,61,133,158,2,"https://fbref.com/en/players/3681cfff/Christophe-Herelle"
"1775","Christophe Jallet_2019",2019,"Nice","Ligue 1","Christophe Jallet","FRA","DF","34",1983,9.8,29,21,12,13,4,16,27,59.3,11,21,5,16,14,43,32,0,"https://fbref.com/en/players/46d50339/Christophe-Jallet"
"1776","Assil Jaziri_2019",2019,"Nice","Ligue 1","Assil Jaziri","TUN","FW","18",1999,0.4,2,2,0,2,0,1,2,50,1,1,0,1,1,3,0,0,"https://fbref.com/en/players/dd73120f/Assil-Jaziri"
"1777","Mohamed Lamine Diaby_2019",2019,"Nice","Ligue 1","Mohamed Lamine Diaby","FRA","FW","17",2001,1.8,1,1,0,1,0,1,1,100,0,2,0,2,2,3,0,0,"https://fbref.com/en/players/15e99107/Mohamed-Lamine-Diaby"
"1778","Mickaël Le Bihan_2019",2019,"Nice","Ligue 1","Mickaël Le Bihan","FRA","FW","28",1990,2.3,1,1,0,1,0,1,2,50,1,1,0,1,1,2,1,0,"https://fbref.com/en/players/d512db65/Mickael-Le-Bihan"
"1779","Pierre Lees-Melou_2019",2019,"Nice","Ligue 1","Pierre Lees-Melou","FRA","MF","25",1993,26.6,74,46,31,36,7,25,62,40.3,37,44,8,36,36,110,37,0,"https://fbref.com/en/players/f5044e54/Pierre-Lees-Melou"
"1780","Jean-Victor Makengo_2019",2019,"Nice","Ligue 1","Jean-Victor Makengo","FRA","MF,FW","20",1998,11.4,10,8,3,6,1,1,5,20,4,5,1,4,9,19,5,0,"https://fbref.com/en/players/22bfb57e/Jean-Victor-Makengo"
"1781","Myziane Maolida_2019",2019,"Nice","Ligue 1","Myziane Maolida","FRA","FW","19",1999,10.6,12,8,5,5,2,2,4,50,2,5,0,5,1,13,5,0,"https://fbref.com/en/players/706a60e1/Myziane-Maolida"
"1782","Maxime Pélican_2019",2019,"Nice","Ligue 1","Maxime Pélican","FRA","FW,MF","20",1998,1,1,1,0,1,0,0,0,NA,0,1,0,1,0,1,0,0,"https://fbref.com/en/players/09f24df6/Maxime-Pelican"
"1783","Andy Pelmard_2019",2019,"Nice","Ligue 1","Andy Pelmard","FRA","DF","18",2000,3.1,5,5,3,2,0,1,4,25,3,0,0,0,3,8,3,0,"https://fbref.com/en/players/f18d7ab2/Andy-Pelmard"
"1784","Ihsan Sacko_2019",2019,"Nice","Ligue 1","Ihsan Sacko","FRA","FW","21",1997,4.9,7,2,2,5,0,2,5,40,3,5,0,5,2,9,2,0,"https://fbref.com/en/players/68a87d66/Ihsan-Sacko"
"1785","Allan Saint-Maximin_2019",2019,"Nice","Ligue 1","Allan Saint-Maximin","FRA","FW","21",1997,32.2,12,6,1,7,4,2,14,14.3,12,11,0,11,4,16,3,0,"https://fbref.com/en/players/2b16cb1a/Allan-Saint-Maximin"
"1786","Malang Sarr_2019",2019,"Nice","Ligue 1","Malang Sarr","FRA","DF","19",1999,33.3,59,36,38,17,4,31,57,54.4,26,29,12,17,68,127,107,2,"https://fbref.com/en/players/4315f30d/Malang-Sarr"
"1787","Bassem Srarfi_2019",2019,"Nice","Ligue 1","Bassem Srarfi","TUN","FW,MF","21",1997,9.1,20,11,8,8,4,6,17,35.3,11,8,0,8,5,25,5,0,"https://fbref.com/en/players/84549a07/Bassem-Srarfi"
"1788","Eddy Sylvestre_2019",2019,"Nice","Ligue 1","Eddy Sylvestre","FRA","FW,MF","18",1999,3,3,2,0,3,0,3,9,33.3,6,1,0,1,0,3,0,0,"https://fbref.com/en/players/ff3a6a60/Eddy-Sylvestre"
"1789","Adrien Tameze_2019",2019,"Nice","Ligue 1","Adrien Tameze","CMR","MF","24",1994,32.7,74,44,32,31,11,39,92,42.4,53,53,12,41,56,130,59,1,"https://fbref.com/en/players/8da74c05/Adrien-Tameze"
"1790","Paul Wade_2019",2019,"Nice","Ligue 1","Paul Wade","FRA","MF","18",2000,0.1,0,0,0,0,0,0,3,0,3,0,0,0,0,0,1,0,"https://fbref.com/en/players/cfd41fad/Paul-Wade"
"1791","Rémi Walter_2019",2019,"Nice","Ligue 1","Rémi Walter","FRA","MF","23",1995,9.3,20,12,7,10,3,5,15,33.3,10,9,1,8,6,26,11,0,"https://fbref.com/en/players/0984c5d5/Remi-Walter"
"1792","Sofiane Alakouch_2019",2019,"Nîmes","Ligue 1","Sofiane Alakouch","MAR","DF","20",1998,21.1,81,44,44,31,6,36,63,57.1,27,15,4,11,46,127,57,0,"https://fbref.com/en/players/5314e067/Sofiane-Alakouch"
"1793","Rachid Alioui_2019",2019,"Nîmes","Ligue 1","Rachid Alioui","MAR","FW","26",1992,13.9,15,5,3,9,3,4,9,44.4,5,8,1,7,10,25,11,0,"https://fbref.com/en/players/bdedd861/Rachid-Alioui"
"1794","Paul Bernardoni_2019",2019,"Nîmes","Ligue 1","Paul Bernardoni","FRA","GK","21",1997,38,1,1,1,0,0,1,2,50,1,0,0,0,1,2,20,1,"https://fbref.com/en/players/28dabd43/Paul-Bernardoni"
"1795","Antonin Bobichon_2019",2019,"Nîmes","Ligue 1","Antonin Bobichon","FRA","MF","22",1995,23.9,34,16,17,12,5,16,58,27.6,42,15,3,12,15,49,13,0,"https://fbref.com/en/players/7d937aa1/Antonin-Bobichon"
"1796","Denis Bouanga_2019",2019,"Nîmes","Ligue 1","Denis Bouanga","GAB","MF,FW","23",1994,29.3,52,32,21,22,9,13,61,21.3,48,24,3,21,20,72,16,0,"https://fbref.com/en/players/0b0cbe5b/Denis-Bouanga"
"1797","Umut Bozok_2019",2019,"Nîmes","Ligue 1","Umut Bozok","TUR","FW","21",1996,13.7,9,6,0,3,6,2,4,50,2,3,0,3,5,14,1,0,"https://fbref.com/en/players/6e2c94ad/Umut-Bozok"
"1798","Anthony Briançon_2019",2019,"Nîmes","Ligue 1","Anthony Briançon","FRA","DF","23",1994,32.5,46,27,36,10,0,27,50,54,23,51,38,13,70,116,184,1,"https://fbref.com/en/players/16324e1d/Anthony-Briancon"
"1799","Clément Depres_2019",2019,"Nîmes","Ligue 1","Clément Depres","FRA","FW","23",1994,4.9,2,2,1,1,0,1,4,25,3,3,0,3,0,2,6,0,"https://fbref.com/en/players/e53ab10b/Clement-Depres"
"1800","Mustapha Diallo_2019",2019,"Nîmes","Ligue 1","Mustapha Diallo","SEN","MF","32",1986,5.1,16,11,6,9,1,5,13,38.5,8,7,1,6,10,26,14,1,"https://fbref.com/en/players/6c6ecdd4/Mustapha-Diallo"
"1801","Jordan Ferri_2019",2019,"Nîmes","Ligue 1","Jordan Ferri","FRA","MF","26",1992,20.8,52,31,22,23,7,26,62,41.9,36,27,2,25,15,67,9,1,"https://fbref.com/en/players/375622c5/Jordan-Ferri"
"1802","Baptiste Guillaume_2019",2019,"Nîmes","Ligue 1","Baptiste Guillaume","BEL","FW","23",1995,13.1,12,6,1,8,3,2,9,22.2,7,6,0,6,2,14,6,0,"https://fbref.com/en/players/9453d2f4/Baptiste-Guillaume"
"1803","Féthi Harek_2019",2019,"Nîmes","Ligue 1","Féthi Harek","ALG","DF","35",1982,2,4,4,2,2,0,3,4,75,1,1,0,1,1,5,6,0,"https://fbref.com/en/players/d880dc16/Fethi-Harek"
"1804","Loïck Landre_2019",2019,"Nîmes","Ligue 1","Loïck Landre","FRA","DF","26",1992,17.7,31,21,23,8,0,14,22,63.6,8,16,11,5,38,69,83,1,"https://fbref.com/en/players/08082af0/Loick-Landre"
"1805","Hervé Lybohy_2019",2019,"Nîmes","Ligue 1","Hervé Lybohy","NIG","DF","35",1983,16.4,22,13,13,9,0,11,16,68.8,5,17,11,6,14,36,70,0,"https://fbref.com/en/players/dc709ab5/Herve-Lybohy"
"1806","Faitout Maouassa_2019",2019,"Nîmes","Ligue 1","Faitout Maouassa","FRA","DF","20",1998,23.7,55,30,35,15,5,23,39,59,16,24,5,19,23,78,81,1,"https://fbref.com/en/players/e54a9890/Faitout-Maouassa"
"1807","Florian Miguel_2019",2019,"Nîmes","Ligue 1","Florian Miguel","FRA","DF","21",1996,12.4,19,16,13,6,0,7,11,63.6,4,15,7,8,21,40,47,0,"https://fbref.com/en/players/b66d1d8a/Florian-Miguel"
"1808","Gaëtan Paquiez_2019",2019,"Nîmes","Ligue 1","Gaëtan Paquiez","FRA","DF","24",1994,14.8,43,29,30,10,3,23,48,47.9,25,24,6,18,22,65,50,0,"https://fbref.com/en/players/475583ff/Gaetan-Paquiez"
"1809","Renaud Ripart_2019",2019,"Nîmes","Ligue 1","Renaud Ripart","FRA","FW,DF","25",1993,33.4,76,49,41,22,13,32,76,42.1,44,43,7,36,27,103,79,0,"https://fbref.com/en/players/beae3a73/Renaud-Ripart"
"1810","Théo Sainte-Luce_2019",2019,"Nîmes","Ligue 1","Théo Sainte-Luce","FRA","MF","19",1998,0,0,0,0,0,0,0,0,NA,0,0,0,0,0,0,0,0,"https://fbref.com/en/players/93c942fb/Theo-Sainte-Luce"
"1811","Téji Savanier_2019",2019,"Nîmes","Ligue 1","Téji Savanier","FRA","MF","26",1991,31.8,95,58,35,52,8,43,116,37.1,73,32,15,17,64,159,53,2,"https://fbref.com/en/players/6bde367b/Teji-Savanier"
"1812","Sada Thioub_2019",2019,"Nîmes","Ligue 1","Sada Thioub","SEN","MF,FW","23",1995,27.5,30,19,13,10,7,20,45,44.4,25,29,1,28,16,46,11,0,"https://fbref.com/en/players/f4bc42b1/Sada-Thioub"
"1813","Pierrick Valdivia_2019",2019,"Nîmes","Ligue 1","Pierrick Valdivia","FRA","MF","30",1988,0.3,1,1,0,1,0,1,2,50,1,1,0,1,1,2,0,0,"https://fbref.com/en/players/e562a02e/Pierrick-Valdivia"
"1814","Theo Valls_2019",2019,"Nîmes","Ligue 1","Theo Valls","FRA","MF","22",1995,19.7,37,21,16,19,2,15,43,34.9,28,17,4,13,22,59,15,0,"https://fbref.com/en/players/c8090cb3/Theo-Valls"
"1815","Robert Bauer_2019",2019,"Nürnberg","Bundesliga","Robert Bauer","GER","DF","23",1995,19.1,48,29,32,13,3,20,39,51.3,19,19,5,14,28,76,80,0,"https://fbref.com/en/players/9b88e120/Robert-Bauer"
"1816","Hanno Behrens_2019",2019,"Nürnberg","Bundesliga","Hanno Behrens","GER","MF","28",1990,29.3,46,26,29,17,0,21,47,44.7,26,43,13,30,33,79,49,0,"https://fbref.com/en/players/77b41ac0/Hanno-Behrens"
"1817","Fabian Bredlow_2019",2019,"Nürnberg","Bundesliga","Fabian Bredlow","GER","GK","23",1995,12.5,1,1,1,0,0,1,1,100,0,0,0,0,1,2,3,4,"https://fbref.com/en/players/d28339cb/Fabian-Bredlow"
"1818","Patrick Erras_2019",2019,"Nürnberg","Bundesliga","Patrick Erras","GER","MF","23",1995,13.6,15,10,7,7,1,7,19,36.8,12,24,13,11,23,38,45,0,"https://fbref.com/en/players/e3f6253d/Patrick-Erras"
"1819","Ewerton_2019",2019,"Nürnberg","Bundesliga","Ewerton","BRA","DF","29",1989,14.9,24,20,21,3,0,8,14,57.1,6,23,16,7,25,49,108,1,"https://fbref.com/en/players/78cd577c/Ewerton"
"1820","Alexander Fuchs_2019",2019,"Nürnberg","Bundesliga","Alexander Fuchs","GER","MF,FW","21",1997,7.3,14,12,5,7,2,5,15,33.3,10,9,1,8,5,19,10,0,"https://fbref.com/en/players/9c9bd01f/Alexander-Fuchs"
"1821","Kevin Goden_2019",2019,"Nürnberg","Bundesliga","Kevin Goden","GER","DF,MF","19",1999,3,4,3,3,1,0,2,7,28.6,5,4,1,3,4,8,11,0,"https://fbref.com/en/players/25c633b0/Kevin-Goden"
"1822","Ivo Iličević_2019",2019,"Nürnberg","Bundesliga","Ivo Iličević","CRO","MF","31",1986,0.4,1,0,0,1,0,1,2,50,1,1,0,1,0,1,0,0,"https://fbref.com/en/players/4e3e4138/Ivo-Ilicevic"
"1823","Mikael Ishak_2019",2019,"Nürnberg","Bundesliga","Mikael Ishak","SWE","FW","25",1993,21.3,9,6,3,6,0,3,16,18.8,13,8,3,5,3,12,10,0,"https://fbref.com/en/players/0c3057a9/Mikael-Ishak"
"1824","Lukas Jäger_2019",2019,"Nürnberg","Bundesliga","Lukas Jäger","AUT","FW,MF","24",1994,0.3,0,0,0,0,0,0,2,0,2,0,0,0,0,0,0,0,"https://fbref.com/en/players/6be813ab/Lukas-Jager"
"1825","Sebastian Kerk_2019",2019,"Nürnberg","Bundesliga","Sebastian Kerk","GER","MF,FW","24",1994,13.1,16,9,8,5,3,7,23,30.4,16,14,5,9,3,19,22,1,"https://fbref.com/en/players/87fdfb9b/Sebastian-Kerk"
"1826","Törles Knöll_2019",2019,"Nürnberg","Bundesliga","Törles Knöll","GER","FW,MF","20",1997,4.1,3,2,1,1,1,0,4,0,4,5,1,4,0,3,2,0,"https://fbref.com/en/players/b883006f/Torles-Knoll"
"1827","Yuya Kubo_2019",2019,"Nürnberg","Bundesliga","Yuya Kubo","JPN","FW,MF","24",1993,15.1,21,11,6,10,5,12,33,36.4,21,11,0,11,10,31,6,0,"https://fbref.com/en/players/cba16a46/Yuya-Kubo"
"1828","Tim Leibold_2019",2019,"Nürnberg","Bundesliga","Tim Leibold","GER","DF","24",1993,30.7,62,42,45,16,1,33,71,46.5,38,23,3,20,38,100,57,0,"https://fbref.com/en/players/f2571c91/Tim-Leibold"
"1829","Eduard Löwen_2019",2019,"Nürnberg","Bundesliga","Eduard Löwen","GER","MF,FW","21",1997,18,30,22,14,13,3,11,34,32.4,23,15,2,13,8,38,23,0,"https://fbref.com/en/players/70678132/Eduard-Lowen"
"1830","Georg Margreitter_2019",2019,"Nürnberg","Bundesliga","Georg Margreitter","AUT","DF","29",1988,22.9,39,24,28,8,3,31,38,81.6,7,29,26,3,26,65,141,0,"https://fbref.com/en/players/b5114f85/Georg-Margreitter"
"1831","Christian Mathenia_2019",2019,"Nürnberg","Bundesliga","Christian Mathenia","GER","GK","26",1992,21.5,0,0,0,0,0,0,0,NA,0,1,0,1,1,1,18,2,"https://fbref.com/en/players/4a15e95b/Christian-Mathenia"
"1832","Virgil Misidjan_2019",2019,"Nürnberg","Bundesliga","Virgil Misidjan","NED","MF,FW","25",1993,17.1,21,13,10,5,6,4,25,16,21,17,0,17,9,30,5,0,"https://fbref.com/en/players/09bcc566/Virgil-Misidjan"
"1833","Lukas Mühl_2019",2019,"Nürnberg","Bundesliga","Lukas Mühl","GER","DF","21",1997,31,57,34,49,6,2,32,51,62.7,19,53,18,35,48,105,139,2,"https://fbref.com/en/players/6b32d0a6/Lukas-Muhl"
"1834","Federico Palacios Martínez_2019",2019,"Nürnberg","Bundesliga","Federico Palacios Martínez","GER","MF,FW","23",1995,10.5,21,10,11,8,2,10,20,50,10,10,0,10,9,30,4,0,"https://fbref.com/en/players/434cf5b7/Federico-Palacios-Martinez"
"1835","Matheus Pereira_2019",2019,"Nürnberg","Bundesliga","Matheus Pereira","POR","MF,FW","22",1996,13.7,16,11,4,8,4,2,13,15.4,11,15,2,13,14,30,7,0,"https://fbref.com/en/players/b04ee927/Matheus-Pereira"
"1836","Ondřej Petrák_2019",2019,"Nürnberg","Bundesliga","Ondřej Petrák","CZE","MF","26",1992,18,36,24,17,18,1,14,25,56,11,18,4,14,40,76,22,0,"https://fbref.com/en/players/3e81a228/Ondrej-Petrak"
"1837","Simon Rhein_2019",2019,"Nürnberg","Bundesliga","Simon Rhein","GER","MF","20",1998,5.5,7,4,7,0,0,2,7,28.6,5,6,1,5,7,14,6,0,"https://fbref.com/en/players/8f6bfe11/Simon-Rhein"
"1838","Edgar Salli_2019",2019,"Nürnberg","Bundesliga","Edgar Salli","CMR","FW,MF","25",1992,1.3,2,1,1,1,0,0,1,0,1,0,0,0,1,3,1,0,"https://fbref.com/en/players/41d1fbc6/Edgar-Salli"
"1839","Timothy Tillman_2019",2019,"Nürnberg","Bundesliga","Timothy Tillman","GER","FW,MF","19",1999,2.3,0,0,0,0,0,0,4,0,4,3,0,3,3,3,0,2,"https://fbref.com/en/players/a5bea1fb/Timothy-Tillman"
"1840","Enrico Valentini_2019",2019,"Nürnberg","Bundesliga","Enrico Valentini","ITA","DF","29",1989,14.4,44,27,31,10,3,22,40,55,18,17,3,14,13,57,58,0,"https://fbref.com/en/players/5c4d9be7/Enrico-Valentini"
"1841","Adam Zreľák_2019",2019,"Nürnberg","Bundesliga","Adam Zreľák","SVK","FW","24",1994,10.5,14,9,2,11,1,5,9,55.6,4,14,2,12,2,16,13,0,"https://fbref.com/en/players/8c8b4a01/Adam-Zrelak"
"1842","Dani Alves_2019",2019,"Paris S-G","Ligue 1","Dani Alves","BRA","MF,DF","35",1983,18,42,22,16,23,3,13,38,34.2,25,18,5,13,8,50,11,0,"https://fbref.com/en/players/c9e99e49/Dani-Alves"
"1843","Alphonse Areola_2019",2019,"Paris S-G","Ligue 1","Alphonse Areola","FRA","GK","25",1993,21,1,1,1,0,0,1,1,100,0,0,0,0,0,1,4,1,"https://fbref.com/en/players/2f965a72/Alphonse-Areola"
"1844","Juan Bernat_2019",2019,"Paris S-G","Ligue 1","Juan Bernat","ESP","DF,MF","25",1993,20.4,47,32,22,19,6,22,46,47.8,24,19,5,14,20,67,41,1,"https://fbref.com/en/players/433dc9a2/Juan-Bernat"
"1845","Antoine Bernede_2019",2019,"Paris S-G","Ligue 1","Antoine Bernede","FRA","MF","19",1999,1.9,13,7,3,8,2,5,9,55.6,4,3,1,2,3,16,1,1,"https://fbref.com/en/players/07a821e4/Antoine-Bernede"
"1846","Gianluigi Buffon_2019",2019,"Paris S-G","Ligue 1","Gianluigi Buffon","ITA","GK","40",1978,17,0,0,0,0,0,0,1,0,1,0,0,0,0,0,5,0,"https://fbref.com/en/players/e40d028b/Gianluigi-Buffon"
"1847","Edinson Cavani_2019",2019,"Paris S-G","Ligue 1","Edinson Cavani","URU","FW","31",1987,18.6,11,8,1,4,6,3,13,23.1,10,11,2,9,6,17,16,0,"https://fbref.com/en/players/527f063d/Edinson-Cavani"
"1848","Colin Dagba_2019",2019,"Paris S-G","Ligue 1","Colin Dagba","FRA","DF,MF","19",1998,10.2,24,12,10,12,2,13,19,68.4,6,10,0,10,9,33,10,1,"https://fbref.com/en/players/29c02c9f/Colin-Dagba"
"1849","Ángel Di María_2019",2019,"Paris S-G","Ligue 1","Ángel Di María","ARG","FW,MF","30",1988,25.8,29,17,12,10,7,10,42,23.8,32,24,1,23,16,45,4,0,"https://fbref.com/en/players/19cda00b/Angel-Di-Maria"
"1850","Moussa Diaby_2019",2019,"Paris S-G","Ligue 1","Moussa Diaby","FRA","MF,DF","19",1999,12.7,14,8,7,2,5,2,11,18.2,9,7,1,6,12,26,6,0,"https://fbref.com/en/players/aeed5c06/Moussa-Diaby"
"1851","Lassana Diarra_2019",2019,"Paris S-G","Ligue 1","Lassana Diarra","FRA","MF","33",1985,1.8,2,1,0,2,0,0,1,0,1,0,0,0,2,4,3,0,"https://fbref.com/en/players/79584585/Lassana-Diarra"
"1852","Julian Draxler_2019",2019,"Paris S-G","Ligue 1","Julian Draxler","GER","MF,FW","24",1993,22.7,41,22,11,19,11,16,43,37.2,27,20,1,19,15,56,2,1,"https://fbref.com/en/players/1a992676/Julian-Draxler"
"1853","Metehan Güçlü_2019",2019,"Paris S-G","Ligue 1","Metehan Güçlü","TUR","MF","19",1999,0.2,0,0,0,0,0,0,0,NA,0,0,0,0,0,0,0,0,"https://fbref.com/en/players/0ee664db/Metehan-Guclu"
"1854","Thilo Kehrer_2019",2019,"Paris S-G","Ligue 1","Thilo Kehrer","GER","DF","21",1996,21.1,64,43,27,31,6,31,55,56.4,24,32,17,15,31,95,69,1,"https://fbref.com/en/players/51dbeea9/Thilo-Kehrer"
"1855","Presnel Kimpembe_2019",2019,"Paris S-G","Ligue 1","Presnel Kimpembe","FRA","DF","22",1995,22.3,55,34,26,25,4,24,40,60,16,17,10,7,30,85,48,5,"https://fbref.com/en/players/aef6e670/Presnel-Kimpembe"
"1856","Layvin Kurzawa_2019",2019,"Paris S-G","Ligue 1","Layvin Kurzawa","FRA","DF,MF","25",1992,11.2,19,11,6,5,8,6,16,37.5,10,10,2,8,10,29,16,0,"https://fbref.com/en/players/41e7ef1c/Layvin-Kurzawa"
"1857","Giovani Lo Celso_2019",2019,"Paris S-G","Ligue 1","Giovani Lo Celso","ARG","MF","22",1996,0.1,1,1,0,0,1,0,1,0,1,0,0,0,0,1,0,0,"https://fbref.com/en/players/d7553721/Giovani-Lo-Celso"
"1858","Marquinhos_2019",2019,"Paris S-G","Ligue 1","Marquinhos","BRA","DF,MF","24",1994,29.9,65,41,34,28,3,31,52,59.6,21,30,13,17,44,109,84,1,"https://fbref.com/en/players/d5f2f82b/Marquinhos"
"1859","Eric Maxim Choupo-Moting_2019",2019,"Paris S-G","Ligue 1","Eric Maxim Choupo-Moting","CMR","FW","29",1989,8.9,9,4,3,2,4,2,9,22.2,7,7,0,7,3,12,4,0,"https://fbref.com/en/players/0e6bc38c/Eric-Maxim-Choupo-Moting"
"1860","Kylian Mbappé_2019",2019,"Paris S-G","Ligue 1","Kylian Mbappé","FRA","FW","19",1998,26,8,4,2,1,5,1,6,16.7,5,2,0,2,5,13,2,0,"https://fbref.com/en/players/42fd9c7f/Kylian-Mbappe"
"1861","Loïc Mbe Soh_2019",2019,"Paris S-G","Ligue 1","Loïc Mbe Soh","FRA","DF","17",2001,2,0,0,0,0,0,0,3,0,3,2,2,0,3,3,5,0,"https://fbref.com/en/players/8f534f8e/Loic-Mbe-Soh"
"1862","Thomas Meunier_2019",2019,"Paris S-G","Ligue 1","Thomas Meunier","BEL","DF","26",1991,17.9,44,33,25,15,4,21,35,60,14,13,2,11,19,63,29,0,"https://fbref.com/en/players/e162b013/Thomas-Meunier"
"1863","Stanley N'Soki_2019",2019,"Paris S-G","Ligue 1","Stanley N'Soki","FRA","DF","19",1999,7.8,20,14,8,10,2,6,13,46.2,7,10,1,9,18,38,20,1,"https://fbref.com/en/players/61590953/Stanley-NSoki"
"1864","Neymar_2019",2019,"Paris S-G","Ligue 1","Neymar","BRA","MF,FW","26",1992,16,14,9,3,10,1,4,21,19,17,8,0,8,5,19,1,1,"https://fbref.com/en/players/69384e5d/Neymar"
"1865","Christopher Nkunku_2019",2019,"Paris S-G","Ligue 1","Christopher Nkunku","FRA","MF,FW","20",1997,12.8,21,16,8,10,3,7,16,43.8,9,12,2,10,9,30,7,1,"https://fbref.com/en/players/7c56da38/Christopher-Nkunku"
"1866","Leandro Paredes_2019",2019,"Paris S-G","Ligue 1","Leandro Paredes","ARG","MF","24",1994,13.9,34,19,16,15,3,13,30,43.3,17,17,5,12,14,48,20,2,"https://fbref.com/en/players/dff153a4/Leandro-Paredes"
"1867","Adrien Rabiot_2019",2019,"Paris S-G","Ligue 1","Adrien Rabiot","FRA","MF","23",1995,11.8,35,20,13,17,5,9,12,75,3,9,2,7,10,45,20,0,"https://fbref.com/en/players/8794e251/Adrien-Rabiot"
"1868","Kévin Rimane_2019",2019,"Paris S-G","Ligue 1","Kévin Rimane","GUF","MF","27",1991,0.1,0,0,0,0,0,0,0,NA,0,0,0,0,0,0,0,0,"https://fbref.com/en/players/7a137df4/Kevin-Rimane"
"1869","Thiago Silva_2019",2019,"Paris S-G","Ligue 1","Thiago Silva","BRA","DF","33",1984,23.1,16,13,7,8,1,6,11,54.5,5,28,20,8,32,48,99,1,"https://fbref.com/en/players/86e7deaf/Thiago-Silva"
"1870","Marco Verratti_2019",2019,"Paris S-G","Ligue 1","Marco Verratti","ITA","MF","25",1992,20.9,72,42,25,39,8,36,81,44.4,45,26,1,25,18,90,8,2,"https://fbref.com/en/players/1467af0d/Marco-Verratti"
"1871","Timothy Weah_2019",2019,"Paris S-G","Ligue 1","Timothy Weah","USA","FW","18",2000,0.6,0,0,0,0,0,0,0,NA,0,0,0,0,0,0,0,0,"https://fbref.com/en/players/8eec784d/Timothy-Weah"
"1872","Bruno Alves_2019",2019,"Parma","Serie A","Bruno Alves","POR","DF","36",1981,32.5,15,8,11,4,0,4,7,57.1,3,36,28,8,29,44,210,0,"https://fbref.com/en/players/585a73a8/Bruno-Alves"
"1873","Antonino Barillà_2019",2019,"Parma","Serie A","Antonino Barillà","ITA","MF","30",1988,29.1,64,36,40,17,7,19,53,35.8,34,40,13,27,36,100,50,1,"https://fbref.com/en/players/a64cbd35/Antonino-Barilla"
"1874","Alessandro Bastoni_2019",2019,"Parma","Serie A","Alessandro Bastoni","ITA","DF","19",1999,18.8,25,12,20,5,0,6,15,40,9,26,18,8,22,47,96,0,"https://fbref.com/en/players/75b86fb3/Alessandro-Bastoni"
"1875","Jonathan Biabiany_2019",2019,"Parma","Serie A","Jonathan Biabiany","FRA","FW","30",1988,11.9,30,22,18,10,2,9,17,52.9,8,8,1,7,11,41,11,1,"https://fbref.com/en/players/6b99d135/Jonathan-Biabiany"
"1876","Fabio Ceravolo_2019",2019,"Parma","Serie A","Fabio Ceravolo","ITA","FW","31",1987,13.2,5,1,2,1,2,1,11,9.1,10,9,1,8,2,7,19,0,"https://fbref.com/en/players/4cc93246/Fabio-Ceravolo"
"1877","Amato Ciciretti_2019",2019,"Parma","Serie A","Amato Ciciretti","ITA","FW,MF","24",1993,1.5,1,0,1,0,0,0,0,NA,0,3,0,3,3,4,0,0,"https://fbref.com/en/players/1ab0b878/Amato-Ciciretti"
"1878","Alessio da Cruz_2019",2019,"Parma","Serie A","Alessio da Cruz","","FW,MF","21",1997,1.6,2,1,0,2,0,0,1,0,1,0,0,0,0,2,0,0,"https://fbref.com/en/players/b6667741/Alessio-da-Cruz"
"1879","Alessandro Deiola_2019",2019,"Parma","Serie A","Alessandro Deiola","ITA","MF,FW","22",1995,6.1,12,8,4,7,1,4,10,40,6,15,4,11,11,23,10,0,"https://fbref.com/en/players/7f267d66/Alessandro-Deiola"
"1880","Jacopo Dezi_2019",2019,"Parma","Serie A","Jacopo Dezi","ITA","MF","26",1992,1,1,1,1,0,0,0,1,0,1,1,0,1,3,4,2,0,"https://fbref.com/en/players/e921b9db/Jacopo-Dezi"
"1881","Antonio Di Gaudio_2019",2019,"Parma","Serie A","Antonio Di Gaudio","ITA","FW","28",1989,7.8,2,0,0,1,1,1,5,20,4,6,1,5,3,5,5,0,"https://fbref.com/en/players/434b8c73/Antonio-Di-Gaudio"
"1882","Federico Dimarco_2019",2019,"Parma","Serie A","Federico Dimarco","ITA","DF,MF","20",1997,9.9,22,7,10,8,4,10,20,50,10,13,6,7,15,37,27,0,"https://fbref.com/en/players/970b8574/Federico-Dimarco"
"1883","Pierluigi Frattali_2019",2019,"Parma","Serie A","Pierluigi Frattali","ITA","GK","32",1985,1,0,0,0,0,0,0,0,NA,0,0,0,0,0,0,1,0,"https://fbref.com/en/players/71dac2c2/Pierluigi-Frattali"
"1884","Riccardo Gagliolo_2019",2019,"Parma","Serie A","Riccardo Gagliolo","SWE","DF","28",1990,33.8,69,45,52,15,2,33,68,48.5,35,60,33,27,66,135,213,2,"https://fbref.com/en/players/173061c0/Riccardo-Gagliolo"
"1885","Marcello Gazzola_2019",2019,"Parma","Serie A","Marcello Gazzola","ITA","DF,MF","33",1985,10.2,9,4,2,5,2,5,9,55.6,4,6,3,3,4,13,33,0,"https://fbref.com/en/players/93390969/Marcello-Gazzola"
"1886","Gervinho_2019",2019,"Parma","Serie A","Gervinho","CIV","FW","31",1987,25.6,19,12,11,5,3,5,13,38.5,8,7,0,7,10,29,2,0,"https://fbref.com/en/players/e468c053/Gervinho"
"1887","Massimo Gobbi_2019",2019,"Parma","Serie A","Massimo Gobbi","ITA","DF","37",1980,13.1,14,7,5,5,4,8,25,32,17,16,8,8,9,23,48,0,"https://fbref.com/en/players/635b0bae/Massimo-Gobbi"
"1888","Alberto Grassi_2019",2019,"Parma","Serie A","Alberto Grassi","ITA","MF","23",1995,5.1,20,12,7,10,3,2,10,20,8,8,2,6,8,28,10,0,"https://fbref.com/en/players/6cc97b6a/Alberto-Grassi"
"1889","Simone Iacoponi_2019",2019,"Parma","Serie A","Simone Iacoponi","ITA","DF","31",1987,37.2,62,43,50,11,1,27,47,57.4,20,40,26,14,37,99,178,3,"https://fbref.com/en/players/63071a3f/Simone-Iacoponi"
"1890","Roberto Inglese_2019",2019,"Parma","Serie A","Roberto Inglese","ITA","FW","26",1991,21.8,20,14,7,7,6,1,13,7.7,12,26,2,24,6,26,27,0,"https://fbref.com/en/players/6c1f7328/Roberto-Inglese"
"1891","Juraj Kucka_2019",2019,"Parma","Serie A","Juraj Kucka","SVK","MF","31",1987,17.1,51,32,17,29,5,19,53,35.8,34,27,7,20,17,68,37,1,"https://fbref.com/en/players/5aaef9ef/Juraj-Kucka"
"1892","Abdou Lahat Diakhate_2019",2019,"Parma","Serie A","Abdou Lahat Diakhate","SEN","MF","19",1998,0,0,0,0,0,0,0,0,NA,0,0,0,0,0,0,0,0,"https://fbref.com/en/players/8e809937/Abdou-Lahat-Diakhate"
"1893","Gianni Munari_2019",2019,"Parma","Serie A","Gianni Munari","ITA","MF","35",1983,0,0,0,0,0,0,0,0,NA,0,0,0,0,0,0,0,0,"https://fbref.com/en/players/e50613bd/Gianni-Munari"
"1894","Pepín_2019",2019,"Parma","Serie A","Pepín","EQG","MF","21",1996,0.9,4,2,3,1,0,1,4,25,3,0,0,0,3,7,0,0,"https://fbref.com/en/players/7afb1573/Pepin"
"1895","Luca Rigoni_2019",2019,"Parma","Serie A","Luca Rigoni","ITA","MF","33",1984,19.6,42,25,25,15,2,9,26,34.6,17,19,2,17,18,60,39,0,"https://fbref.com/en/players/4dba2a97/Luca-Rigoni"
"1896","Nicolás Schiappacasse_2019",2019,"Parma","Serie A","Nicolás Schiappacasse","URU","FW,MF","19",1999,0.9,0,0,0,0,0,0,0,NA,0,2,0,2,0,0,0,0,"https://fbref.com/en/players/afe31d55/Nicolas-Schiappacasse"
"1897","Matteo Scozzarella_2019",2019,"Parma","Serie A","Matteo Scozzarella","ITA","MF","30",1988,16.2,18,13,9,8,1,9,33,27.3,24,22,10,12,23,41,33,0,"https://fbref.com/en/players/ea164f99/Matteo-Scozzarella"
"1898","Luigi Sepe_2019",2019,"Parma","Serie A","Luigi Sepe","ITA","GK","27",1991,37,1,1,1,0,0,1,2,50,1,0,0,0,3,4,21,3,"https://fbref.com/en/players/343f753a/Luigi-Sepe"
"1899","Francisco Sierralta_2019",2019,"Parma","Serie A","Francisco Sierralta","CHI","DF","21",1997,3,11,8,8,3,0,4,6,66.7,2,1,1,0,4,15,27,0,"https://fbref.com/en/players/0f933743/Francisco-Sierralta"
"1900","Luca Siligardi_2019",2019,"Parma","Serie A","Luca Siligardi","ITA","FW","30",1988,18.2,30,20,10,13,7,8,23,34.8,15,19,3,16,15,45,11,0,"https://fbref.com/en/players/1cac99dc/Luca-Siligardi"
"1901","Mattia Sprocati_2019",2019,"Parma","Serie A","Mattia Sprocati","ITA","FW,MF","25",1993,7.2,10,4,5,5,0,5,11,45.5,6,6,0,6,7,17,6,0,"https://fbref.com/en/players/bdd0692f/Mattia-Sprocati"
"1902","Leo Štulac_2019",2019,"Parma","Serie A","Leo Štulac","SVN","MF","23",1994,16.1,21,13,10,10,1,4,17,23.5,13,29,13,16,34,55,31,1,"https://fbref.com/en/players/92948398/Leo-Stulac"
"1903","Tyler Adams_2019",2019,"RB Leipzig","Bundesliga","Tyler Adams","USA","MF","19",1999,8,29,17,12,16,1,11,26,42.3,15,17,1,16,16,45,8,0,"https://fbref.com/en/players/2b09d998/Tyler-Adams"
"1904","Jean-Kévin Augustin_2019",2019,"RB Leipzig","Bundesliga","Jean-Kévin Augustin","FRA","FW","21",1997,5.1,2,0,0,0,2,0,1,0,1,6,0,6,3,5,0,0,"https://fbref.com/en/players/97bfa797/Jean-Kevin-Augustin"
"1905","Bruma_2019",2019,"RB Leipzig","Bundesliga","Bruma","POR","MF","23",1994,6.1,5,2,3,1,1,1,5,20,4,4,0,4,4,9,2,0,"https://fbref.com/en/players/5caa62a7/Bruma"
"1906","Matheus Cunha_2019",2019,"RB Leipzig","Bundesliga","Matheus Cunha","BRA","FW,MF","19",1999,9.5,10,6,3,5,2,3,13,23.1,10,13,1,12,4,14,8,0,"https://fbref.com/en/players/dc62b55d/Matheus-Cunha"
"1907","Diego Demme_2019",2019,"RB Leipzig","Bundesliga","Diego Demme","GER","MF","26",1991,22.8,75,47,24,43,8,33,67,49.3,34,36,3,33,26,101,15,0,"https://fbref.com/en/players/dc3fa3b5/Diego-Demme"
"1908","Emil Forsberg_2019",2019,"RB Leipzig","Bundesliga","Emil Forsberg","SWE","MF,FW","26",1991,13.9,12,7,0,12,0,5,16,31.3,11,16,1,15,3,15,6,0,"https://fbref.com/en/players/9a2e0ccc/Emil-Forsberg"
"1909","Péter Gulácsi_2019",2019,"RB Leipzig","Bundesliga","Péter Gulácsi","HUN","GK","28",1990,32.5,0,0,0,0,0,0,0,NA,0,0,0,0,0,0,11,0,"https://fbref.com/en/players/bcb2ccd8/Peter-Gulacsi"
"1910","Amadou Haidara_2019",2019,"RB Leipzig","Bundesliga","Amadou Haidara","MLI","MF","20",1998,4.2,13,11,4,8,1,8,14,57.1,6,9,1,8,4,17,7,0,"https://fbref.com/en/players/92432bc6/Amadou-Haidara"
"1911","Marcel Halstenberg_2019",2019,"RB Leipzig","Bundesliga","Marcel Halstenberg","GER","DF,FW","26",1991,26.8,68,44,31,24,13,42,65,64.6,23,27,4,23,38,106,69,0,"https://fbref.com/en/players/8ff2354e/Marcel-Halstenberg"
"1912","Stefan Ilsanker_2019",2019,"RB Leipzig","Bundesliga","Stefan Ilsanker","AUT","DF,MF","29",1989,10.4,26,17,15,10,1,14,23,60.9,9,9,2,7,18,44,43,1,"https://fbref.com/en/players/8494acc4/Stefan-Ilsanker"
"1913","Kevin Kampl_2019",2019,"RB Leipzig","Bundesliga","Kevin Kampl","SVN","MF","27",1990,23.5,41,24,16,21,4,8,28,28.6,20,32,2,30,33,74,22,0,"https://fbref.com/en/players/b825a650/Kevin-Kampl"
"1914","Lukas Klostermann_2019",2019,"RB Leipzig","Bundesliga","Lukas Klostermann","GER","DF","22",1996,22.3,50,29,33,12,5,29,45,64.4,16,37,5,32,29,79,74,0,"https://fbref.com/en/players/ca8033cb/Lukas-Klostermann"
"1915","Ibrahima Konaté_2019",2019,"RB Leipzig","Bundesliga","Ibrahima Konaté","FRA","DF","19",1999,27,44,32,30,14,0,17,27,63,10,29,18,11,58,102,126,0,"https://fbref.com/en/players/5ed9b537/Ibrahima-Konate"
"1916","Konrad Laimer_2019",2019,"RB Leipzig","Bundesliga","Konrad Laimer","AUT","MF,DF","21",1997,20.8,72,38,21,34,17,20,71,28.2,51,67,2,65,32,104,23,0,"https://fbref.com/en/players/c1b7847c/Konrad-Laimer"
"1917","Nordi Mukiele_2019",2019,"RB Leipzig","Bundesliga","Nordi Mukiele","FRA","DF","20",1997,13.6,38,21,23,12,3,19,22,86.4,3,17,3,14,24,62,35,0,"https://fbref.com/en/players/ac73ec79/Nordi-Mukiele"
"1918","Yvon Mvogo_2019",2019,"RB Leipzig","Bundesliga","Yvon Mvogo","SUI","GK","24",1994,1.5,0,0,0,0,0,0,0,NA,0,0,0,0,0,0,1,0,"https://fbref.com/en/players/dc29b608/Yvon-Mvogo"
"1919","Willi Orban_2019",2019,"RB Leipzig","Bundesliga","Willi Orban","HUN","DF","25",1992,22.8,49,26,31,15,3,24,38,63.2,14,33,15,18,36,85,140,0,"https://fbref.com/en/players/20030c06/Willi-Orban"
"1920","Yussuf Poulsen_2019",2019,"RB Leipzig","Bundesliga","Yussuf Poulsen","DEN","FW","24",1994,27.2,20,10,5,10,5,3,25,12,22,33,2,31,7,27,28,0,"https://fbref.com/en/players/d2416c2e/Yussuf-Poulsen"
"1921","Marcel Sabitzer_2019",2019,"RB Leipzig","Bundesliga","Marcel Sabitzer","AUT","MF","24",1994,26.1,45,28,17,21,7,18,46,39.1,28,21,2,19,33,78,31,0,"https://fbref.com/en/players/e280527c/Marcel-Sabitzer"
"1922","Marcelo Saracchi_2019",2019,"RB Leipzig","Bundesliga","Marcelo Saracchi","URU","DF","20",1998,7.3,17,11,12,4,1,8,13,61.5,5,12,1,11,11,28,14,0,"https://fbref.com/en/players/1c96ad85/Marcelo-Saracchi"
"1923","Emile Smith Rowe_2019",2019,"RB Leipzig","Bundesliga","Emile Smith Rowe","ENG","MF","18",2000,0.3,1,0,0,1,0,1,1,100,0,0,0,0,1,2,0,0,"https://fbref.com/en/players/17695062/Emile-Smith-Rowe"
"1924","Dayot Upamecano_2019",2019,"RB Leipzig","Bundesliga","Dayot Upamecano","FRA","DF","19",1998,14.4,22,16,14,8,0,15,18,83.3,3,19,5,14,33,55,47,0,"https://fbref.com/en/players/d248cd8f/Dayot-Upamecano"
"1925","Timo Werner_2019",2019,"RB Leipzig","Bundesliga","Timo Werner","GER","FW","22",1996,27.9,18,12,6,8,4,3,16,18.8,13,18,2,16,3,21,7,0,"https://fbref.com/en/players/49fe9070/Timo-Werner"
"1926","Luis Advíncula_2019",2019,"Rayo Vallecano","La Liga","Luis Advíncula","PER","DF","28",1990,26.5,52,38,38,12,2,21,31,67.7,10,22,2,20,19,71,60,1,"https://fbref.com/en/players/cacadf4f/Luis-Advincula"
"1927","Sergio Akieme_2019",2019,"Rayo Vallecano","La Liga","Sergio Akieme","ESP","DF","20",1997,2,3,3,3,0,0,2,2,100,0,0,0,0,1,4,5,0,"https://fbref.com/en/players/06efa9dc/Sergio-Akieme"
"1928","Álex Alegría_2019",2019,"Rayo Vallecano","La Liga","Álex Alegría","ESP","FW,MF","25",1992,1.6,1,1,0,1,0,0,3,0,3,1,0,1,0,1,0,0,"https://fbref.com/en/players/46166b49/Alex-Alegria"
"1929","Jordi Amat_2019",2019,"Rayo Vallecano","La Liga","Jordi Amat","IDN","DF","26",1992,30.7,54,31,34,19,1,24,42,57.1,18,31,10,21,43,97,133,1,"https://fbref.com/en/players/d70a2141/Jordi-Amat"
"1930","Abdoulaye Ba_2019",2019,"Rayo Vallecano","La Liga","Abdoulaye Ba","SEN","DF","27",1991,23.4,46,33,37,8,1,29,39,74.4,10,32,18,14,29,75,165,4,"https://fbref.com/en/players/1f54ed90/Abdoulaye-Ba"
"1931","Bebé_2019",2019,"Rayo Vallecano","La Liga","Bebé","CPV","FW,MF","28",1990,14.5,19,9,10,4,5,9,19,47.4,10,16,1,15,9,28,16,1,"https://fbref.com/en/players/d8712bf9/Bebe"
"1932","Catena_2019",2019,"Rayo Vallecano","La Liga","Catena","ESP","DF","23",1994,2,4,4,3,1,0,2,2,100,0,4,2,2,8,12,8,0,"https://fbref.com/en/players/274ab13c/Catena"
"1933","Chechu_2019",2019,"Rayo Vallecano","La Liga","Chechu","ESP","DF","36",1982,1,0,0,0,0,0,0,2,0,2,0,0,0,2,2,5,0,"https://fbref.com/en/players/e98f3a6a/Chechu"
"1934","Santi Comesaña_2019",2019,"Rayo Vallecano","La Liga","Santi Comesaña","ESP","MF","21",1996,22.6,56,35,29,25,2,22,61,36.1,39,30,5,25,30,86,45,2,"https://fbref.com/en/players/5ae499d0/Santi-Comesana"
"1935","Franco Di Santo_2019",2019,"Rayo Vallecano","La Liga","Franco Di Santo","ARG","FW","29",1989,1.9,2,2,1,0,1,1,2,50,1,0,0,0,0,2,2,0,"https://fbref.com/en/players/549c6ba7/Franco-Di-Santo"
"1936","Stole Dimitrievski_2019",2019,"Rayo Vallecano","La Liga","Stole Dimitrievski","MKD","GK","24",1993,21,0,0,0,0,0,0,1,0,1,0,0,0,0,0,8,1,"https://fbref.com/en/players/fc70e345/Stole-Dimitrievski"
"1937","Gorka Elustondo_2019",2019,"Rayo Vallecano","La Liga","Gorka Elustondo","ESP","MF,DF","31",1987,3.2,7,5,4,3,0,5,8,62.5,3,6,1,5,6,13,10,0,"https://fbref.com/en/players/7b309e55/Gorka-Elustondo"
"1938","Adri Embarba_2019",2019,"Rayo Vallecano","La Liga","Adri Embarba","ESP","MF,FW","26",1992,25.4,54,26,20,24,10,22,61,36.1,39,38,2,36,29,83,22,0,"https://fbref.com/en/players/db8f0eba/Adri-Embarba"
"1939","Álex Gálvez_2019",2019,"Rayo Vallecano","La Liga","Álex Gálvez","ESP","DF","29",1989,15.7,38,28,25,13,0,14,28,50,14,7,2,5,45,83,69,1,"https://fbref.com/en/players/960fb42d/Alex-Galvez"
"1940","Alberto García_2019",2019,"Rayo Vallecano","La Liga","Alberto García","ESP","GK","33",1985,17,1,1,1,0,0,1,3,33.3,2,1,0,1,2,3,1,2,"https://fbref.com/en/players/17d9e354/Alberto-Garcia"
"1941","Álvaro García_2019",2019,"Rayo Vallecano","La Liga","Álvaro García","ESP","FW,MF","25",1992,19.6,22,19,11,7,4,4,25,16,21,24,0,24,19,41,30,0,"https://fbref.com/en/players/90bbd822/Alvaro-Garcia"
"1942","Javi Guerra_2019",2019,"Rayo Vallecano","La Liga","Javi Guerra","ESP","FW,MF","36",1982,2.6,3,3,1,1,1,0,3,0,3,2,0,2,1,4,0,0,"https://fbref.com/en/players/aa386464/Javi-Guerra"
"1943","Uche Henry Agbo_2019",2019,"Rayo Vallecano","La Liga","Uche Henry Agbo","NGA","MF","22",1995,4.1,7,4,3,4,0,5,10,50,5,3,1,2,6,13,1,0,"https://fbref.com/en/players/98554bfd/Uche-Henry-Agbo"
"1944","Giannelli Imbula_2019",2019,"Rayo Vallecano","La Liga","Giannelli Imbula","COD","MF","25",1992,19.2,14,7,6,7,1,5,12,41.7,7,12,3,9,8,22,6,0,"https://fbref.com/en/players/b86fe156/Giannelli-Imbula"
"1945","Gaël Kakuta_2019",2019,"Rayo Vallecano","La Liga","Gaël Kakuta","COD","MF,FW","27",1991,8,12,7,5,5,2,2,10,20,8,4,1,3,9,21,9,0,"https://fbref.com/en/players/5b1bf5e3/Gael-Kakuta"
"1946","Álvaro Medrán_2019",2019,"Rayo Vallecano","La Liga","Álvaro Medrán","ESP","MF","24",1994,12.8,15,8,5,6,4,6,21,28.6,15,10,1,9,17,32,9,0,"https://fbref.com/en/players/31223bcf/Alvaro-Medran"
"1947","Álex Moreno_2019",2019,"Rayo Vallecano","La Liga","Álex Moreno","ESP","DF","25",1993,34.8,63,40,41,18,4,29,53,54.7,24,35,9,26,41,104,97,0,"https://fbref.com/en/players/16e9d0ea/Alex-Moreno"
"1948","Sergio Moreno_2019",2019,"Rayo Vallecano","La Liga","Sergio Moreno","ESP","FW","19",1999,0.2,0,0,0,0,0,0,0,NA,0,0,0,0,0,0,0,0,"https://fbref.com/en/players/014b57f5/Sergio-Moreno"
"1949","José Pozo_2019",2019,"Rayo Vallecano","La Liga","José Pozo","ESP","MF","22",1996,18,13,10,4,5,4,4,25,16,21,7,1,6,4,17,6,0,"https://fbref.com/en/players/fc8b614b/Jose-Pozo"
"1950","Mario Suárez_2019",2019,"Rayo Vallecano","La Liga","Mario Suárez","ESP","MF","31",1987,11.4,37,23,17,17,3,15,28,53.6,13,10,3,7,14,51,17,2,"https://fbref.com/en/players/7106f0a0/Mario-Suarez"
"1951","Tito_2019",2019,"Rayo Vallecano","La Liga","Tito","ESP","DF","33",1985,12.2,14,9,12,2,0,7,22,31.8,15,22,2,20,17,31,41,0,"https://fbref.com/en/players/7cefa219/Tito"
"1952","Raúl de Tomás_2019",2019,"Rayo Vallecano","La Liga","Raúl de Tomás","ESP","FW","23",1994,31.3,8,3,0,7,1,0,12,0,12,18,4,14,9,17,45,0,"https://fbref.com/en/players/02ef8778/Raul-de-Tomas"
"1953","Óscar Trejo_2019",2019,"Rayo Vallecano","La Liga","Óscar Trejo","ARG","MF,FW","30",1988,19.6,57,41,21,25,11,8,33,24.2,25,24,2,22,18,75,15,0,"https://fbref.com/en/players/fc647b34/Oscar-Trejo"
"1954","Emiliano Velázquez_2019",2019,"Rayo Vallecano","La Liga","Emiliano Velázquez","URU","DF","24",1994,14.2,49,32,38,9,2,20,34,58.8,14,29,7,22,47,96,106,1,"https://fbref.com/en/players/5efb80d5/Emiliano-Velazquez"
"1955","Marco Asensio_2019",2019,"Real Madrid","La Liga","Marco Asensio","ESP","FW","22",1996,19.8,12,8,3,5,4,2,24,8.3,22,16,1,15,14,26,7,0,"https://fbref.com/en/players/45af8a54/Marco-Asensio"
"1956","Gareth Bale_2019",2019,"Real Madrid","La Liga","Gareth Bale","WAL","FW","29",1989,19.8,16,8,5,7,4,6,20,30,14,19,3,16,11,27,13,0,"https://fbref.com/en/players/a58bb1e1/Gareth-Bale"
"1957","Karim Benzema_2019",2019,"Real Madrid","La Liga","Karim Benzema","FRA","FW","30",1987,32.8,24,11,2,11,11,2,17,11.8,15,16,1,15,8,32,25,0,"https://fbref.com/en/players/70d74ece/Karim-Benzema"
"1958","Dani Carvajal_2019",2019,"Real Madrid","La Liga","Dani Carvajal","ESP","DF","26",1992,23.4,40,24,17,15,8,18,41,43.9,23,31,7,24,26,66,35,0,"https://fbref.com/en/players/4958bfb2/Dani-Carvajal"
"1959","Casemiro_2019",2019,"Real Madrid","La Liga","Casemiro","BRA","MF","26",1992,25.7,86,52,44,35,7,38,94,40.4,56,52,12,40,41,127,56,3,"https://fbref.com/en/players/4d224fe8/Casemiro"
"1960","Dani Ceballos_2019",2019,"Real Madrid","La Liga","Dani Ceballos","ESP","MF,FW","21",1996,13.9,32,21,9,16,7,11,31,35.5,20,26,1,25,15,47,6,0,"https://fbref.com/en/players/c0617e2b/Dani-Ceballos"
"1961","Thibaut Courtois_2019",2019,"Real Madrid","La Liga","Thibaut Courtois","BEL","GK","26",1992,27,0,0,0,0,0,0,2,0,2,0,0,0,2,2,5,0,"https://fbref.com/en/players/1840e36d/Thibaut-Courtois"
"1962","Brahim Díaz_2019",2019,"Real Madrid","La Liga","Brahim Díaz","ESP","FW","18",1999,4.2,9,7,5,4,0,3,8,37.5,5,2,0,2,0,9,0,0,"https://fbref.com/en/players/407feb71/Brahim-Diaz"
"1963","Cristo González_2019",2019,"Real Madrid","La Liga","Cristo González","ESP","FW","20",1997,0.5,1,0,0,1,0,0,0,NA,0,0,0,0,1,2,0,0,"https://fbref.com/en/players/896b5df2/Cristo-Gonzalez"
"1964","Isco_2019",2019,"Real Madrid","La Liga","Isco","ESP","MF,FW","26",1992,13.2,29,14,14,8,7,14,34,41.2,20,9,1,8,6,35,3,0,"https://fbref.com/en/players/a0b4bb3e/Isco"
"1965","Vinicius Júnior_2019",2019,"Real Madrid","La Liga","Vinicius Júnior","BRA","FW,MF","18",2000,9.7,10,6,3,6,1,3,16,18.8,13,6,1,5,7,17,1,0,"https://fbref.com/en/players/7111d552/Vinicius-Junior"
"1966","Toni Kroos_2019",2019,"Real Madrid","La Liga","Toni Kroos","GER","MF","28",1990,24.7,51,35,18,24,9,14,57,24.6,43,25,4,21,14,65,13,1,"https://fbref.com/en/players/6ce1f46f/Toni-Kroos"
"1967","Marcos Llorente_2019",2019,"Real Madrid","La Liga","Marcos Llorente","ESP","MF","23",1995,6,16,12,7,7,2,8,18,44.4,10,8,0,8,7,23,12,0,"https://fbref.com/en/players/02c15616/Marcos-Llorente"
"1968","Marcelo_2019",2019,"Real Madrid","La Liga","Marcelo","BRA","DF","30",1988,20.6,34,19,17,12,5,15,39,38.5,24,19,2,17,17,51,21,0,"https://fbref.com/en/players/603116a7/Marcelo"
"1969","Mariano_2019",2019,"Real Madrid","La Liga","Mariano","DOM","FW","24",1993,5,2,1,1,1,0,0,3,0,3,2,0,2,0,2,2,0,"https://fbref.com/en/players/5c4dc0ff/Mariano"
"1970","Luka Modrić_2019",2019,"Real Madrid","La Liga","Luka Modrić","CRO","MF","32",1985,29,49,30,11,25,13,14,48,29.2,34,20,3,17,31,80,7,1,"https://fbref.com/en/players/6025fab1/Luka-Modric"
"1971","Nacho_2019",2019,"Real Madrid","La Liga","Nacho","ESP","DF","28",1990,18.9,26,19,14,7,5,11,22,50,11,19,7,12,32,58,65,1,"https://fbref.com/en/players/2946f9a1/Nacho"
"1972","Keylor Navas_2019",2019,"Real Madrid","La Liga","Keylor Navas","CRC","GK","31",1986,10,0,0,0,0,0,0,0,NA,0,0,0,0,1,1,5,0,"https://fbref.com/en/players/ecada4fc/Keylor-Navas"
"1973","Álvaro Odriozola_2019",2019,"Real Madrid","La Liga","Álvaro Odriozola","ESP","DF","22",1995,13.1,28,25,13,11,4,14,18,77.8,4,11,1,10,11,39,17,1,"https://fbref.com/en/players/1d1691ad/Alvaro-Odriozola"
"1974","Sergio Ramos_2019",2019,"Real Madrid","La Liga","Sergio Ramos","ESP","DF","32",1986,27.5,41,32,25,12,4,22,39,56.4,17,29,15,14,37,78,90,2,"https://fbref.com/en/players/08511d65/Sergio-Ramos"
"1975","Sergio Reguilón_2019",2019,"Real Madrid","La Liga","Sergio Reguilón","ESP","DF","21",1996,12.4,25,14,15,9,1,10,21,47.6,11,13,3,10,20,45,41,1,"https://fbref.com/en/players/3353737a/Sergio-Reguilon"
"1976","Javi Sánchez_2019",2019,"Real Madrid","La Liga","Javi Sánchez","ESP","DF","21",1997,0.5,1,0,1,0,0,0,0,NA,0,0,0,0,0,1,4,0,"https://fbref.com/en/players/60359288/Javi-Sanchez"
"1977","Jesús Vallejo_2019",2019,"Real Madrid","La Liga","Jesús Vallejo","ESP","DF","21",1997,3.5,6,5,4,2,0,5,6,83.3,1,4,4,0,7,13,12,0,"https://fbref.com/en/players/c2111b45/Jesus-Vallejo"
"1978","Federico Valverde_2019",2019,"Real Madrid","La Liga","Federico Valverde","URU","MF","20",1998,7.3,12,8,3,7,2,5,11,45.5,6,10,2,8,21,33,10,0,"https://fbref.com/en/players/0959c2a2/Federico-Valverde"
"1979","Raphaël Varane_2019",2019,"Real Madrid","La Liga","Raphaël Varane","FRA","DF","25",1993,30.6,33,18,25,7,1,15,19,78.9,4,21,9,12,32,65,141,1,"https://fbref.com/en/players/9f8e9423/Raphael-Varane"
"1980","Lucas Vázquez_2019",2019,"Real Madrid","La Liga","Lucas Vázquez","ESP","FW,MF","27",1991,16.8,43,26,11,21,11,15,41,36.6,26,16,1,15,12,55,11,0,"https://fbref.com/en/players/fd51b456/Lucas-Vazquez"
"1981","Luca Zidane_2019",2019,"Real Madrid","La Liga","Luca Zidane","FRA","GK","20",1998,1,0,0,0,0,0,0,0,NA,0,0,0,0,0,0,0,0,"https://fbref.com/en/players/c818c4d9/Luca-Zidane"
"1982","Miguel Ángel Moyá_2019",2019,"Real Sociedad","La Liga","Miguel Ángel Moyá","ESP","GK","34",1984,11,1,1,1,0,0,1,2,50,1,0,0,0,1,2,9,2,"https://fbref.com/en/players/011d8c56/Miguel-Angel-Moya"
"1983","Ander Barrenetxea_2019",2019,"Real Sociedad","La Liga","Ander Barrenetxea","ESP","FW,MF","16",2001,4.4,7,2,2,0,5,2,8,25,6,8,0,8,4,11,1,0,"https://fbref.com/en/players/200e89e1/Ander-Barrenetxea"
"1984","Jon Bautista_2019",2019,"Real Sociedad","La Liga","Jon Bautista","ESP","FW","23",1995,6.6,5,3,0,3,2,0,3,0,3,8,1,7,5,10,4,0,"https://fbref.com/en/players/debc6b55/Jon-Bautista"
"1985","Aritz Elustondo_2019",2019,"Real Sociedad","La Liga","Aritz Elustondo","ESP","DF","24",1994,25,47,29,31,14,2,26,41,63.4,15,23,7,16,39,86,150,0,"https://fbref.com/en/players/f7dc2ae5/Aritz-Elustondo"
"1986","Andoni Gorosabel_2019",2019,"Real Sociedad","La Liga","Andoni Gorosabel","ESP","DF","21",1996,5.1,16,9,10,5,1,8,13,61.5,5,5,1,4,4,20,20,1,"https://fbref.com/en/players/6f5f82c0/Andoni-Gorosabel"
"1987","Ander Guevara_2019",2019,"Real Sociedad","La Liga","Ander Guevara","ESP","MF","21",1997,1,3,1,0,3,0,2,6,33.3,4,1,0,1,1,4,0,0,"https://fbref.com/en/players/8e48dc61/Ander-Guevara"
"1988","Theo Hernández_2019",2019,"Real Sociedad","La Liga","Theo Hernández","FRA","DF","20",1997,22,54,33,30,15,9,28,44,63.6,16,21,5,16,33,87,42,3,"https://fbref.com/en/players/d4c9725f/Theo-Hernandez"
"1989","Asier Illarramendi_2019",2019,"Real Sociedad","La Liga","Asier Illarramendi","ESP","MF","28",1990,20.2,39,24,22,14,3,21,51,41.2,30,36,9,27,31,70,46,1,"https://fbref.com/en/players/5ce0b5ba/Asier-Illarramendi"
"1990","Adnan Januzaj_2019",2019,"Real Sociedad","La Liga","Adnan Januzaj","BEL","FW,MF","23",1995,13.9,11,8,5,2,4,3,13,23.1,10,7,0,7,6,17,6,0,"https://fbref.com/en/players/4737cebe/Adnan-Januzaj"
"1991","Willian José_2019",2019,"Real Sociedad","La Liga","Willian José","BRA","FW","26",1991,26.3,5,3,1,3,1,2,7,28.6,5,11,5,6,1,6,27,0,"https://fbref.com/en/players/d87e2cae/Willian-Jose"
"1992","Juanmi_2019",2019,"Real Sociedad","La Liga","Juanmi","ESP","FW,MF","25",1993,16.9,21,12,7,11,3,8,22,36.4,14,12,0,12,16,37,13,0,"https://fbref.com/en/players/84399660/Juanmi"
"1993","Robin Le Normand_2019",2019,"Real Sociedad","La Liga","Robin Le Normand","ESP","DF","21",1996,3.2,5,2,2,3,0,1,3,33.3,2,3,0,3,4,9,13,1,"https://fbref.com/en/players/9a64e67e/Robin-Le-Normand"
"1994","Diego Llorente_2019",2019,"Real Sociedad","La Liga","Diego Llorente","ESP","DF","24",1993,19.5,26,15,16,8,2,17,29,58.6,12,27,15,12,26,52,83,2,"https://fbref.com/en/players/bba30585/Diego-Llorente"
"1995","Roberto López_2019",2019,"Real Sociedad","La Liga","Roberto López","ESP","MF","18",2000,0.3,0,0,0,0,0,0,1,0,1,1,0,1,1,1,2,0,"https://fbref.com/en/players/2a8c9f98/Roberto-Lopez"
"1996","Mikel Merino_2019",2019,"Real Sociedad","La Liga","Mikel Merino","ESP","MF","22",1996,22.8,50,28,19,25,6,14,52,26.9,38,37,2,35,29,79,37,1,"https://fbref.com/en/players/d080ed5e/Mikel-Merino"
"1997","Martín Merquelanz_2019",2019,"Real Sociedad","La Liga","Martín Merquelanz","ESP","MF","23",1995,0.1,0,0,0,0,0,0,0,NA,0,0,0,0,0,0,0,0,"https://fbref.com/en/players/ddd5348b/Martin-Merquelanz"
"1998","Héctor Moreno_2019",2019,"Real Sociedad","La Liga","Héctor Moreno","MEX","DF","30",1988,21.5,16,9,12,4,0,9,17,52.9,8,34,19,15,31,47,73,0,"https://fbref.com/en/players/5d311e8d/Hector-Moreno"
"1999","Aihen Muñoz_2019",2019,"Real Sociedad","La Liga","Aihen Muñoz","ESP","DF","20",1997,10.6,13,8,11,2,0,10,19,52.6,9,19,9,10,7,20,26,0,"https://fbref.com/en/players/228b0d9d/Aihen-Munoz"
"2000","Raúl Navas_2019",2019,"Real Sociedad","La Liga","Raúl Navas","ESP","DF","30",1988,14.6,23,14,20,3,0,13,21,61.9,8,20,9,11,20,43,60,1,"https://fbref.com/en/players/ad178594/Raul-Navas"
"2001","Mikel Oyarzabal_2019",2019,"Real Sociedad","La Liga","Mikel Oyarzabal","ESP","FW,MF","21",1997,35,36,20,15,15,6,12,49,24.5,37,54,3,51,14,50,26,0,"https://fbref.com/en/players/8c3c640c/Mikel-Oyarzabal"
"2002","Rubén Pardo_2019",2019,"Real Sociedad","La Liga","Rubén Pardo","ESP","MF,FW","25",1992,15.2,11,7,2,9,0,4,17,23.5,13,14,6,8,21,32,9,0,"https://fbref.com/en/players/2306bfde/Ruben-Pardo"
"2003","Sandro Ramírez_2019",2019,"Real Sociedad","La Liga","Sandro Ramírez","ESP","FW,MF","23",1995,11.7,19,10,7,10,2,4,11,36.4,7,12,1,11,9,28,3,0,"https://fbref.com/en/players/833fb62e/Sandro-Ramirez"
"2004","Kévin Rodrigues_2019",2019,"Real Sociedad","La Liga","Kévin Rodrigues","POR","DF","24",1994,5.4,21,11,14,6,1,9,17,52.9,8,13,3,10,8,29,15,0,"https://fbref.com/en/players/f1bed920/Kevin-Rodrigues"
"2005","Gerónimo Rulli_2019",2019,"Real Sociedad","La Liga","Gerónimo Rulli","ARG","GK","26",1992,27,2,1,2,0,0,1,3,33.3,2,1,0,1,1,3,12,6,"https://fbref.com/en/players/625c144a/Geronimo-Rulli"
"2006","Luca Sangalli_2019",2019,"Real Sociedad","La Liga","Luca Sangalli","ESP","MF,FW","23",1995,11.1,19,13,6,11,2,5,22,22.7,17,9,1,8,5,24,5,0,"https://fbref.com/en/players/7958dc65/Luca-Sangalli"
"2007","Alex Sola_2019",2019,"Real Sociedad","La Liga","Alex Sola","ESP","DF","19",1999,1,4,3,0,3,1,3,4,75,1,0,0,0,1,5,2,0,"https://fbref.com/en/players/5fa714d5/Alex-Sola"
"2008","Joseba Zaldúa_2019",2019,"Real Sociedad","La Liga","Joseba Zaldúa","ESP","DF","26",1992,23.8,36,27,23,10,3,15,32,46.9,17,19,3,16,38,74,72,0,"https://fbref.com/en/players/5ca20b7a/Joseba-Zaldua"
"2009","Igor Zubeldia_2019",2019,"Real Sociedad","La Liga","Igor Zubeldia","ESP","MF","21",1997,28.3,61,35,32,24,5,22,54,40.7,32,30,6,24,45,106,60,0,"https://fbref.com/en/players/5c7845f6/Igor-Zubeldia"
"2010","Martín Zubimendi_2019",2019,"Real Sociedad","La Liga","Martín Zubimendi","ESP","MF","19",1999,0.1,1,0,0,1,0,0,1,0,1,0,0,0,0,1,0,0,"https://fbref.com/en/players/3ee0dd59/Martin-Zubimendi"
"2011","David Zurutuza_2019",2019,"Real Sociedad","La Liga","David Zurutuza","ESP","MF","32",1986,13.6,27,16,9,15,3,8,22,36.4,14,19,4,15,24,51,26,1,"https://fbref.com/en/players/d9bda115/David-Zurutuza"
"2012","Yunis Abdelhamid_2019",2019,"Reims","Ligue 1","Yunis Abdelhamid","MAR","DF","30",1987,38,60,33,48,11,1,30,40,75,10,44,24,20,65,125,196,0,"https://fbref.com/en/players/32c2d95f/Yunis-Abdelhamid"
"2013","Mathieu Cafaro_2019",2019,"Reims","Ligue 1","Mathieu Cafaro","FRA","FW,MF","21",1997,23.3,59,28,29,24,6,18,63,28.6,45,28,0,28,20,79,14,0,"https://fbref.com/en/players/2a657da0/Mathieu-Cafaro"
"2014","Moreto Cassamã_2019",2019,"Reims","Ligue 1","Moreto Cassamã","GNB","MF","20",1998,0.7,3,3,1,2,0,1,7,14.3,6,1,0,1,1,4,2,0,"https://fbref.com/en/players/f54d2149/Moreto-Cassama"
"2015","Xavier Chavalerin_2019",2019,"Reims","Ligue 1","Xavier Chavalerin","FRA","MF","27",1991,36,106,61,56,39,11,28,72,38.9,44,44,12,32,72,178,39,1,"https://fbref.com/en/players/279ddf6a/Xavier-Chavalerin"
"2016","Pablo Chavarría_2019",2019,"Reims","Ligue 1","Pablo Chavarría","ARG","FW","30",1988,21.9,20,12,8,6,6,3,15,20,12,11,0,11,4,24,19,0,"https://fbref.com/en/players/4207e578/Pablo-Chavarria"
"2017","Boulaye Dia_2019",2019,"Reims","Ligue 1","Boulaye Dia","SEN","FW","21",1996,8.3,12,6,3,8,1,5,11,45.5,6,4,2,2,4,16,9,0,"https://fbref.com/en/players/244bc2c8/Boulaye-Dia"
"2018","Tristan Dingomé_2019",2019,"Reims","Ligue 1","Tristan Dingomé","CMR","MF","27",1991,14.9,27,15,11,10,6,7,24,29.2,17,16,3,13,11,38,5,0,"https://fbref.com/en/players/92b56413/Tristan-Dingome"
"2019","Axel Disasi_2019",2019,"Reims","Ligue 1","Axel Disasi","FRA","DF","20",1998,1.8,2,1,1,1,0,1,2,50,1,2,1,1,2,4,16,0,"https://fbref.com/en/players/ad82197c/Axel-Disasi"
"2020","Moussa Doumbia_2019",2019,"Reims","Ligue 1","Moussa Doumbia","MLI","FW,MF","23",1994,17.8,28,13,13,13,2,11,39,28.2,28,7,2,5,7,35,13,0,"https://fbref.com/en/players/6481421d/Moussa-Doumbia"
"2021","Björn Engels_2019",2019,"Reims","Ligue 1","Björn Engels","BEL","DF","23",1994,33,11,8,6,5,0,6,16,37.5,10,30,24,6,44,55,181,3,"https://fbref.com/en/players/4fdf1fd9/Bjorn-Engels"
"2022","Thomas Foket_2019",2019,"Reims","Ligue 1","Thomas Foket","BEL","DF","23",1994,32,91,52,55,23,13,42,69,60.9,27,30,4,26,49,140,80,1,"https://fbref.com/en/players/90eb507d/Thomas-Foket"
"2023","Thomas Fontaine_2019",2019,"Reims","Ligue 1","Thomas Fontaine","MAD","DF,MF","27",1991,4.7,6,3,5,0,1,2,5,40,3,6,2,4,7,13,28,1,"https://fbref.com/en/players/9f90c06b/Thomas-Fontaine"
"2024","Suk Hyun-jun_2019",2019,"Reims","Ligue 1","Suk Hyun-jun","KOR","FW","27",1991,8.8,11,8,1,6,4,0,8,0,8,2,1,1,2,13,4,1,"https://fbref.com/en/players/7ffaf233/Suk-Hyun-jun"
"2025","Hassane Kamara_2019",2019,"Reims","Ligue 1","Hassane Kamara","CIV","DF,FW","24",1994,10.3,29,21,22,5,2,16,19,84.2,3,6,1,5,14,43,41,0,"https://fbref.com/en/players/19a12bed/Hassane-Kamara"
"2026","Ghislain Konan_2019",2019,"Reims","Ligue 1","Ghislain Konan","CIV","DF","22",1995,20,45,28,31,10,4,24,40,60,16,18,4,14,40,85,55,1,"https://fbref.com/en/players/6b2c894b/Ghislain-Konan"
"2027","Grejohn Kyei_2019",2019,"Reims","Ligue 1","Grejohn Kyei","FRA","FW","22",1995,0,0,0,0,0,0,0,1,0,1,0,0,0,0,0,0,0,"https://fbref.com/en/players/397ba086/Grejohn-Kyei"
"2028","Marvin Martin_2019",2019,"Reims","Ligue 1","Marvin Martin","FRA","MF","30",1988,6.9,2,1,0,2,0,0,6,0,6,2,1,1,2,4,1,0,"https://fbref.com/en/players/f4319ee8/Marvin-Martin"
"2029","Nolan Mbemba_2019",2019,"Reims","Ligue 1","Nolan Mbemba","CGO","MF,DF","23",1995,4,14,8,10,4,0,6,9,66.7,3,4,1,3,10,24,4,2,"https://fbref.com/en/players/6c9642ae/Nolan-Mbemba"
"2030","Edouard Mendy_2019",2019,"Reims","Ligue 1","Edouard Mendy","SEN","GK","26",1992,38,0,0,0,0,0,0,1,0,1,1,0,1,2,2,16,3,"https://fbref.com/en/players/33887998/Edouard-Mendy"
"2031","Romain Métanire_2019",2019,"Reims","Ligue 1","Romain Métanire","MAD","DF","28",1990,3.5,12,9,10,1,1,5,7,71.4,2,4,3,1,6,18,13,0,"https://fbref.com/en/players/0fb21da9/Romain-Metanire"
"2032","Aly Ndom_2019",2019,"Reims","Ligue 1","Aly Ndom","FRA","MF","22",1996,4,11,9,5,5,1,3,7,42.9,4,6,2,4,3,14,9,1,"https://fbref.com/en/players/df819670/Aly-Ndom"
"2033","Sheyi Ojo_2019",2019,"Reims","Ligue 1","Sheyi Ojo","ENG","FW,MF","21",1997,5.2,8,6,2,4,2,2,8,25,6,1,0,1,3,11,2,0,"https://fbref.com/en/players/7b9a86e6/Sheyi-Ojo"
"2034","Remi Oudin_2019",2019,"Reims","Ligue 1","Remi Oudin","FRA","FW,MF","21",1996,29,51,32,25,18,8,20,45,44.4,25,29,5,24,42,93,34,0,"https://fbref.com/en/players/ea02beaf/Remi-Oudin"
"2035","Virgile Pinson_2019",2019,"Reims","Ligue 1","Virgile Pinson","FRA","MF","22",1996,0.1,0,0,0,0,0,0,0,NA,0,0,0,0,0,0,0,0,"https://fbref.com/en/players/43af5b1b/Virgile-Pinson"
"2036","Baba Rahman_2019",2019,"Reims","Ligue 1","Baba Rahman","GHA","DF","24",1994,10.7,26,20,17,8,1,18,21,85.7,3,21,3,18,16,42,37,2,"https://fbref.com/en/players/e4086af3/Baba-Rahman"
"2037","Alaixys Romao_2019",2019,"Reims","Ligue 1","Alaixys Romao","TOG","MF","34",1984,35.1,118,71,61,50,7,43,102,42.2,59,44,16,28,58,176,65,1,"https://fbref.com/en/players/0aa874f4/Alaixys-Romao"
"2038","Arber Zeneli_2019",2019,"Reims","Ligue 1","Arber Zeneli","KVX","FW","23",1995,9,8,6,3,2,3,0,10,0,10,3,0,3,2,10,3,1,"https://fbref.com/en/players/095e4199/Arber-Zeneli"
"2039","Benjamin André_2019",2019,"Rennes","Ligue 1","Benjamin André","FRA","MF","27",1990,27.7,101,60,39,50,12,33,85,38.8,52,40,6,34,54,155,58,0,"https://fbref.com/en/players/ef9c1c95/Benjamin-Andre"
"2040","Ludovic Baal_2019",2019,"Rennes","Ligue 1","Ludovic Baal","GUF","DF","32",1986,1.4,4,3,3,1,0,0,0,NA,0,1,0,1,2,6,1,0,"https://fbref.com/en/players/d3ce9f1f/Ludovic-Baal"
"2041","Hatem Ben Arfa_2019",2019,"Rennes","Ligue 1","Hatem Ben Arfa","FRA","FW,MF","31",1987,22.6,15,7,4,8,3,7,16,43.8,9,9,0,9,4,19,0,0,"https://fbref.com/en/players/74dc806c/Hatem-Ben-Arfa"
"2042","Ramy Bensebaini_2019",2019,"Rennes","Ligue 1","Ramy Bensebaini","ALG","DF","23",1995,23.9,69,48,42,19,8,40,58,69,18,24,10,14,41,110,98,0,"https://fbref.com/en/players/378825c7/Ramy-Bensebaini"
"2043","Sacha Boey_2019",2019,"Rennes","Ligue 1","Sacha Boey","FRA","DF","17",2000,0.2,0,0,0,0,0,0,0,NA,0,0,0,0,0,0,0,0,"https://fbref.com/en/players/6c8ddd52/Sacha-Boey"
"2044","Benjamin Bourigeaud_2019",2019,"Rennes","Ligue 1","Benjamin Bourigeaud","FRA","MF,FW","24",1994,26.9,55,35,23,21,11,20,67,29.9,47,44,5,39,32,87,34,1,"https://fbref.com/en/players/20e73fac/Benjamin-Bourigeaud"
"2045","Eduardo Camavinga_2019",2019,"Rennes","Ligue 1","Eduardo Camavinga","FRA","MF","15",2002,4,23,15,8,12,3,8,18,44.4,10,13,2,11,4,27,4,0,"https://fbref.com/en/players/7b9c2d84/Eduardo-Camavinga"
"2046","Damien Da Silva_2019",2019,"Rennes","Ligue 1","Damien Da Silva","FRA","DF","30",1988,31.9,41,25,31,9,1,18,24,75,6,42,36,6,39,80,152,0,"https://fbref.com/en/players/1ec7e1c5/Damien-Da-Silva"
"2047","Romain Del Castillo_2019",2019,"Rennes","Ligue 1","Romain Del Castillo","FRA","MF,FW","22",1996,14.9,36,20,15,13,8,13,37,35.1,24,19,0,19,20,56,7,1,"https://fbref.com/en/players/0be95d34/Romain-Del-Castillo"
"2048","Abdoulaye Diallo_2019",2019,"Rennes","Ligue 1","Abdoulaye Diallo","SEN","GK","26",1992,5.5,1,1,1,0,0,1,1,100,0,0,0,0,0,1,1,0,"https://fbref.com/en/players/26383ea5/Abdoulaye-Diallo"
"2049","Souleyman Doumbia_2019",2019,"Rennes","Ligue 1","Souleyman Doumbia","CIV","DF","21",1996,6.7,11,7,9,2,0,6,10,60,4,6,1,5,4,15,20,0,"https://fbref.com/en/players/9daeac61/Souleyman-Doumbia"
"2050","Jérémy Gélin_2019",2019,"Rennes","Ligue 1","Jérémy Gélin","FRA","DF,MF","21",1997,14.2,30,16,18,10,2,18,34,52.9,16,14,6,8,19,49,29,0,"https://fbref.com/en/players/4c700f46/Jeremy-Gelin"
"2051","Clément Grenier_2019",2019,"Rennes","Ligue 1","Clément Grenier","FRA","MF","27",1991,29.6,44,27,7,33,4,21,61,34.4,40,28,4,24,29,73,34,1,"https://fbref.com/en/players/8b298f56/Clement-Grenier"
"2052","Adrien Hunou_2019",2019,"Rennes","Ligue 1","Adrien Hunou","FRA","FW,MF","24",1994,13.8,11,7,3,5,3,2,9,22.2,7,14,0,14,5,16,8,0,"https://fbref.com/en/players/d14229f3/Adrien-Hunou"
"2053","Nicolas Janvier_2019",2019,"Rennes","Ligue 1","Nicolas Janvier","FRA","MF","19",1998,0,0,0,0,0,0,0,0,NA,0,0,0,0,0,0,0,0,"https://fbref.com/en/players/22a62523/Nicolas-Janvier"
"2054","Jakob Johansson_2019",2019,"Rennes","Ligue 1","Jakob Johansson","SWE","MF","28",1990,7.9,17,9,5,12,0,10,20,50,10,7,3,4,3,20,17,1,"https://fbref.com/en/players/e4a26a91/Jakob-Johansson"
"2055","Tomáš Koubek_2019",2019,"Rennes","Ligue 1","Tomáš Koubek","CZE","GK","25",1992,32.5,0,0,0,0,0,0,1,0,1,0,0,0,0,0,26,4,"https://fbref.com/en/players/dc366c36/Tomas-Koubek"
"2056","Armand Lauriente_2019",2019,"Rennes","Ligue 1","Armand Lauriente","FRA","MF","19",1998,0,0,0,0,0,0,0,0,NA,0,0,0,0,0,0,0,0,"https://fbref.com/en/players/2d22cea7/Armand-Lauriente"
"2057","James Lea Siliki_2019",2019,"Rennes","Ligue 1","James Lea Siliki","CMR","MF,FW","22",1996,13.6,26,17,13,10,3,12,35,34.3,23,14,1,13,10,36,7,1,"https://fbref.com/en/players/7cf431a5/James-Lea-Siliki"
"2058","Mexer_2019",2019,"Rennes","Ligue 1","Mexer","MOZ","DF","29",1988,27.4,23,12,18,5,0,12,18,66.7,6,26,18,8,30,53,125,0,"https://fbref.com/en/players/ce492295/Mexer"
"2059","M'Baye Niang_2019",2019,"Rennes","Ligue 1","M'Baye Niang","SEN","FW,MF","23",1994,19.9,16,10,3,8,5,2,11,18.2,9,19,3,16,8,24,14,0,"https://fbref.com/en/players/2054d037/MBaye-Niang"
"2060","Gerzino Nyamsi_2019",2019,"Rennes","Ligue 1","Gerzino Nyamsi","FRA","DF","21",1997,6,6,3,5,1,0,4,9,44.4,5,8,4,4,4,10,17,0,"https://fbref.com/en/players/6043997c/Gerzino-Nyamsi"
"2061","Jordan Pefok_2019",2019,"Rennes","Ligue 1","Jordan Pefok","USA","FW","22",1996,6.8,6,2,0,3,3,2,4,50,2,7,2,5,4,10,5,0,"https://fbref.com/en/players/b684a484/Jordan-Pefok"
"2062","Denis-Will Poha_2019",2019,"Rennes","Ligue 1","Denis-Will Poha","FRA","MF","21",1997,0.3,0,0,0,0,0,0,1,0,1,0,0,0,1,1,1,0,"https://fbref.com/en/players/854a2041/Denis-Will-Poha"
"2063","Diafra Sakho_2019",2019,"Rennes","Ligue 1","Diafra Sakho","SEN","FW","28",1989,1.6,2,1,0,0,2,0,0,NA,0,0,0,0,0,2,0,0,"https://fbref.com/en/players/57c433c8/Diafra-Sakho"
"2064","Ismaila Sarr_2019",2019,"Rennes","Ligue 1","Ismaila Sarr","SEN","FW,MF","20",1998,31,35,24,16,15,4,17,34,50,17,17,2,15,14,49,4,0,"https://fbref.com/en/players/bfdb33aa/Ismaila-Sarr"
"2065","Hamari Traoré_2019",2019,"Rennes","Ligue 1","Hamari Traoré","MLI","DF","26",1992,33,61,33,32,27,2,36,71,50.7,35,39,11,28,44,105,82,0,"https://fbref.com/en/players/a4b1028a/Hamari-Traore"
"2066","Mehdi Zeffane_2019",2019,"Rennes","Ligue 1","Mehdi Zeffane","ALG","DF,MF","26",1992,13.5,19,13,12,7,0,10,26,38.5,16,14,5,9,18,37,35,1,"https://fbref.com/en/players/c8c02ac7/Mehdi-Zeffane"
"2067","Žan Celar_2019",2019,"Roma","Serie A","Žan Celar","SVN","FW","19",1999,0.1,0,0,0,0,0,0,0,NA,0,0,0,0,0,0,0,0,"https://fbref.com/en/players/868c6958/Zan-Celar"
"2068","Ante Ćorić_2019",2019,"Roma","Serie A","Ante Ćorić","CRO","MF","21",1997,0.3,0,0,0,0,0,0,0,NA,0,0,0,0,0,0,0,0,"https://fbref.com/en/players/2d3f7367/Ante-Coric"
"2069","Bryan Cristante_2019",2019,"Roma","Serie A","Bryan Cristante","ITA","MF","23",1995,26.9,63,34,21,35,7,19,49,38.8,30,37,5,32,29,92,48,0,"https://fbref.com/en/players/16657b95/Bryan-Cristante"
"2070","Daniele De Rossi_2019",2019,"Roma","Serie A","Daniele De Rossi","ITA","MF","35",1983,14.1,16,10,6,7,3,3,14,21.4,11,18,12,6,26,42,33,0,"https://fbref.com/en/players/532d2690/Daniele-De-Rossi"
"2071","Edin Džeko_2019",2019,"Roma","Serie A","Edin Džeko","BIH","FW","32",1986,28.7,13,7,3,5,5,4,16,25,12,10,1,9,0,13,36,1,"https://fbref.com/en/players/3bb7f478/Edin-Dzeko"
"2072","Federico Fazio_2019",2019,"Roma","Serie A","Federico Fazio","ARG","DF","31",1987,31.2,28,20,14,11,3,12,25,48,13,45,33,12,53,81,171,2,"https://fbref.com/en/players/4e358a2d/Federico-Fazio"
"2073","Alessandro Florenzi_2019",2019,"Roma","Serie A","Alessandro Florenzi","ITA","DF,FW","27",1991,24.2,38,21,22,11,5,17,37,45.9,20,27,5,22,46,84,58,0,"https://fbref.com/en/players/e288d4b3/Alessandro-Florenzi"
"2074","Juan Jesus_2019",2019,"Roma","Serie A","Juan Jesus","BRA","DF","27",1991,15.6,37,29,30,5,2,17,30,56.7,13,20,12,8,16,53,41,0,"https://fbref.com/en/players/79083382/Juan-Jesus"
"2075","Rick Karsdorp_2019",2019,"Roma","Serie A","Rick Karsdorp","NED","DF","23",1995,6.6,9,6,3,5,1,5,11,45.5,6,4,2,2,12,21,12,1,"https://fbref.com/en/players/9f84febe/Rick-Karsdorp"
"2076","Justin Kluivert_2019",2019,"Roma","Serie A","Justin Kluivert","NED","FW","19",1999,14.9,28,27,12,9,7,10,23,43.5,13,17,0,17,7,35,12,0,"https://fbref.com/en/players/4c3a6744/Justin-Kluivert"
"2077","Aleksandar Kolarov_2019",2019,"Roma","Serie A","Aleksandar Kolarov","SRB","DF","32",1985,32.3,38,26,22,10,6,21,34,61.8,13,23,15,8,41,79,82,2,"https://fbref.com/en/players/eda40760/Aleksandar-Kolarov"
"2078","Kostas Manolas_2019",2019,"Roma","Serie A","Kostas Manolas","GRE","DF","27",1991,25.8,32,24,23,8,1,17,26,65.4,9,34,25,9,50,82,117,2,"https://fbref.com/en/players/c707411f/Kostas-Manolas"
"2079","Iván Marcano_2019",2019,"Roma","Serie A","Iván Marcano","ESP","DF","31",1987,9,8,4,4,4,0,5,8,62.5,3,13,6,7,24,32,45,0,"https://fbref.com/en/players/7a20d90a/Ivan-Marcano"
"2080","Antonio Mirante_2019",2019,"Roma","Serie A","Antonio Mirante","ITA","GK","35",1983,11,0,0,0,0,0,0,0,NA,0,0,0,0,0,0,6,1,"https://fbref.com/en/players/30223b33/Antonio-Mirante"
"2081","Steven Nzonzi_2019",2019,"Roma","Serie A","Steven Nzonzi","FRA","MF","29",1988,29.1,66,45,24,36,6,21,34,61.8,13,40,24,16,27,93,55,2,"https://fbref.com/en/players/c7526c18/Steven-Nzonzi"
"2082","Robin Olsen_2019",2019,"Roma","Serie A","Robin Olsen","SWE","GK","28",1990,27,0,0,0,0,0,0,1,0,1,1,0,1,0,0,10,4,"https://fbref.com/en/players/e7ee38c3/Robin-Olsen"
"2083","Javier Pastore_2019",2019,"Roma","Serie A","Javier Pastore","ARG","MF,FW","29",1989,6.6,10,4,4,3,3,4,16,25,12,7,0,7,3,13,5,0,"https://fbref.com/en/players/881ef58c/Javier-Pastore"
"2084","Lorenzo Pellegrini_2019",2019,"Roma","Serie A","Lorenzo Pellegrini","ITA","MF","22",1996,20.2,39,23,16,18,5,10,30,33.3,20,20,2,18,12,51,21,0,"https://fbref.com/en/players/4a5a45c7/Lorenzo-Pellegrini"
"2085","Luca Pellegrini_2019",2019,"Roma","Serie A","Luca Pellegrini","ITA","DF","19",1999,1.8,1,1,1,0,0,1,2,50,1,2,1,1,3,4,2,0,"https://fbref.com/en/players/3b61c9ec/Luca-Pellegrini"
"2086","Diego Perotti_2019",2019,"Roma","Serie A","Diego Perotti","ARG","FW,MF","30",1988,7.4,14,12,5,5,4,6,19,31.6,13,4,0,4,4,18,2,0,"https://fbref.com/en/players/a40d5a0c/Diego-Perotti"
"2087","Davide Santon_2019",2019,"Roma","Serie A","Davide Santon","ITA","DF","27",1991,11.2,14,6,8,6,0,8,12,66.7,4,11,7,4,15,29,27,0,"https://fbref.com/en/players/88c89891/Davide-Santon"
"2088","Patrik Schick_2019",2019,"Roma","Serie A","Patrik Schick","CZE","FW,MF","22",1996,14.6,11,5,3,5,3,1,19,5.3,18,19,2,17,3,14,15,1,"https://fbref.com/en/players/5d4f7d61/Patrik-Schick"
"2089","Stephan El Shaarawy_2019",2019,"Roma","Serie A","Stephan El Shaarawy","ITA","FW,MF","25",1992,23.4,27,14,14,8,5,9,24,37.5,15,11,2,9,20,47,9,0,"https://fbref.com/en/players/d3aaad90/Stephan-El-Shaarawy"
"2090","Kevin Strootman_2019",2019,"Roma","Serie A","Kevin Strootman","NED","MF","28",1990,1,2,2,1,0,1,0,1,0,1,5,0,5,2,4,2,0,"https://fbref.com/en/players/ef2e5e1a/Kevin-Strootman"
"2091","Cengiz Ünder_2019",2019,"Roma","Serie A","Cengiz Ünder","TUR","FW","21",1997,15.3,6,3,3,3,0,2,11,18.2,9,7,0,7,13,19,5,0,"https://fbref.com/en/players/1880614f/Cengiz-Under"
"2092","Nicolò Zaniolo_2019",2019,"Roma","Serie A","Nicolò Zaniolo","ITA","MF,FW","19",1999,19.6,35,21,7,18,10,7,37,18.9,30,14,0,14,13,48,8,0,"https://fbref.com/en/players/9907b1c8/Nicolo-Zaniolo"
"2093","Mirco Antenucci_2019",2019,"SPAL","Serie A","Mirco Antenucci","ITA","FW","33",1984,23.7,11,9,5,1,5,1,10,10,9,14,0,14,5,16,5,0,"https://fbref.com/en/players/43a2e16c/Mirco-Antenucci"
"2094","Kevin Bonifazi_2019",2019,"SPAL","Serie A","Kevin Bonifazi","ITA","DF","22",1996,25.6,40,24,31,8,1,15,33,45.5,18,38,21,17,36,76,79,0,"https://fbref.com/en/players/fb77bfef/Kevin-Bonifazi"
"2095","Thiago Cionek_2019",2019,"SPAL","Serie A","Thiago Cionek","POL","DF","32",1986,28.2,75,44,46,25,4,29,56,51.8,27,34,22,12,55,130,144,0,"https://fbref.com/en/players/46f5c54d/Thiago-Cionek"
"2096","Filippo Costa_2019",2019,"SPAL","Serie A","Filippo Costa","ITA","DF,FW","23",1995,6.3,15,13,6,6,3,4,9,44.4,5,10,3,7,8,23,31,1,"https://fbref.com/en/players/00528660/Filippo-Costa"
"2097","Felipe dal Belo_2019",2019,"SPAL","Serie A","Felipe dal Belo","BRA","DF","34",1984,26.2,36,25,21,13,2,16,32,50,16,29,18,11,17,53,88,1,"https://fbref.com/en/players/8cea6319/Felipe-dal-Belo"
"2098","Lorenzo Dickmann_2019",2019,"SPAL","Serie A","Lorenzo Dickmann","ITA","DF,MF","21",1996,1.9,5,4,4,1,0,5,7,71.4,2,0,0,0,1,6,5,0,"https://fbref.com/en/players/12851227/Lorenzo-Dickmann"
"2099","Johan Djourou_2019",2019,"SPAL","Serie A","Johan Djourou","SUI","DF","31",1987,3.1,3,1,3,0,0,2,2,100,0,5,3,2,4,7,20,0,"https://fbref.com/en/players/b8673e18/Johan-Djourou"
"2100","Mohamed Fares_2019",2019,"SPAL","Serie A","Mohamed Fares","ALG","DF","22",1996,32.8,63,43,37,18,8,25,54,46.3,29,48,4,44,54,117,83,2,"https://fbref.com/en/players/b7a5bc86/Mohamed-Fares"
"2101","Sergio Floccari_2019",2019,"SPAL","Serie A","Sergio Floccari","ITA","FW","36",1981,10.8,13,5,1,5,7,1,7,14.3,6,6,2,4,2,15,6,0,"https://fbref.com/en/players/df301450/Sergio-Floccari"
"2102","Alfred Gomis_2019",2019,"SPAL","Serie A","Alfred Gomis","SEN","GK","24",1993,19.2,0,0,0,0,0,0,1,0,1,0,0,0,1,1,14,1,"https://fbref.com/en/players/cecbce23/Alfred-Gomis"
"2103","Marko Janković_2019",2019,"SPAL","Serie A","Marko Janković","MNE","DF,MF","23",1995,0.6,3,1,2,1,0,0,2,0,2,0,0,0,0,3,0,0,"https://fbref.com/en/players/9866afec/Marko-Jankovic"
"2104","Jasmin Kurtić_2019",2019,"SPAL","Serie A","Jasmin Kurtić","SVN","MF","29",1989,28.4,35,20,19,13,3,13,41,31.7,28,30,3,27,20,55,52,0,"https://fbref.com/en/players/144607cc/Jasmin-Kurtic"
"2105","Manuel Lazzari_2019",2019,"SPAL","Serie A","Manuel Lazzari","ITA","DF","24",1993,31.5,29,17,16,10,3,13,24,54.2,11,26,5,21,20,49,51,1,"https://fbref.com/en/players/02caf6e0/Manuel-Lazzari"
"2106","Everton Luiz_2019",2019,"SPAL","Serie A","Everton Luiz","BRA","MF","30",1988,3.5,11,6,5,5,1,4,7,57.1,3,9,1,8,3,14,7,2,"https://fbref.com/en/players/3799e138/Everton-Luiz"
"2107","Vanja Milinković-Savić_2019",2019,"SPAL","Serie A","Vanja Milinković-Savić","SRB","GK","21",1997,1.8,0,0,0,0,0,0,0,NA,0,0,0,0,0,0,1,0,"https://fbref.com/en/players/9fa26bc2/Vanja-Milinkovic-Savic"
"2108","Simone Missiroli_2019",2019,"SPAL","Serie A","Simone Missiroli","ITA","MF","32",1986,30.5,58,43,31,22,5,25,49,51,24,44,11,33,46,104,46,0,"https://fbref.com/en/players/331c0a43/Simone-Missiroli"
"2109","Gabriele Moncini_2019",2019,"SPAL","Serie A","Gabriele Moncini","ITA","MF","22",1996,0.1,1,1,1,0,0,0,0,NA,0,0,0,0,0,1,0,0,"https://fbref.com/en/players/c4efe2b4/Gabriele-Moncini"
"2110","Alessandro Murgia_2019",2019,"SPAL","Serie A","Alessandro Murgia","ITA","MF","21",1996,11.9,22,15,9,12,1,7,32,21.9,25,14,2,12,19,41,12,1,"https://fbref.com/en/players/fb2c533b/Alessandro-Murgia"
"2111","Alberto Paloschi_2019",2019,"SPAL","Serie A","Alberto Paloschi","ITA","FW","28",1990,9.6,13,9,3,5,5,1,2,50,1,2,0,2,1,14,0,0,"https://fbref.com/en/players/b5cae4e6/Alberto-Paloschi"
"2112","Andrea Petagna_2019",2019,"SPAL","Serie A","Andrea Petagna","ITA","FW","23",1995,33.7,15,6,5,5,5,2,9,22.2,7,23,8,15,4,19,15,0,"https://fbref.com/en/players/03f946ed/Andrea-Petagna"
"2113","Giacomo Poluzzi_2019",2019,"SPAL","Serie A","Giacomo Poluzzi","ITA","GK","30",1988,0.1,0,0,0,0,0,0,0,NA,0,0,0,0,0,0,0,0,"https://fbref.com/en/players/07f55871/Giacomo-Poluzzi"
"2114","Vasco Regini_2019",2019,"SPAL","Serie A","Vasco Regini","ITA","DF,FW","27",1990,0.9,1,0,0,1,0,1,3,33.3,2,2,1,1,0,1,4,0,"https://fbref.com/en/players/339c6ed4/Vasco-Regini"
"2115","Pasquale Schiattarella_2019",2019,"SPAL","Serie A","Pasquale Schiattarella","ITA","MF","31",1987,20.5,43,27,18,21,4,13,38,34.2,25,17,5,12,22,65,25,1,"https://fbref.com/en/players/bd84fc61/Pasquale-Schiattarella"
"2116","Lorenco Šimić_2019",2019,"SPAL","Serie A","Lorenco Šimić","CRO","DF","22",1996,2.6,6,3,5,1,0,2,4,50,2,2,1,1,12,18,19,1,"https://fbref.com/en/players/65e4dede/Lorenco-Simic"
"2117","Mirko Valdifiori_2019",2019,"SPAL","Serie A","Mirko Valdifiori","ITA","MF","32",1986,7.4,20,15,12,7,1,8,14,57.1,6,4,2,2,5,25,9,0,"https://fbref.com/en/players/c710f7d5/Mirko-Valdifiori"
"2118","Mattia Valoti_2019",2019,"SPAL","Serie A","Mattia Valoti","ITA","MF","24",1993,13.6,33,19,13,14,6,13,29,44.8,16,23,0,23,19,52,17,1,"https://fbref.com/en/players/c414df9d/Mattia-Valoti"
"2119","Francesco Vicari_2019",2019,"SPAL","Serie A","Francesco Vicari","ITA","DF","23",1994,25.9,28,24,21,7,0,18,28,64.3,10,31,24,7,34,62,139,1,"https://fbref.com/en/players/de045b15/Francesco-Vicari"
"2120","Emiliano Viviano_2019",2019,"SPAL","Serie A","Emiliano Viviano","ITA","GK","32",1985,16.9,0,0,0,0,0,0,0,NA,0,0,0,0,0,0,5,2,"https://fbref.com/en/players/03760df0/Emiliano-Viviano"
"2121","Charles Abi_2019",2019,"Saint-Étienne","Ligue 1","Charles Abi","FRA","DF,FW","18",2000,0.4,4,4,2,1,1,2,2,100,0,1,0,1,0,4,1,0,"https://fbref.com/en/players/469d3d84/Charles-Abi"
"2122","Youssef Aït Bennasser_2019",2019,"Saint-Étienne","Ligue 1","Youssef Aït Bennasser","MAR","MF","22",1996,10.4,25,13,9,12,4,13,28,46.4,15,15,2,13,19,44,6,2,"https://fbref.com/en/players/c46fa34c/Youssef-Ait-Bennasser"
"2123","Robert Berić_2019",2019,"Saint-Étienne","Ligue 1","Robert Berić","SVN","FW","27",1991,13.1,12,5,1,9,2,1,11,9.1,10,8,2,6,4,16,3,0,"https://fbref.com/en/players/9001138b/Robert-Beric"
"2124","Rémy Cabella_2019",2019,"Saint-Étienne","Ligue 1","Rémy Cabella","FRA","MF,FW","28",1990,33.3,88,51,31,38,19,30,87,34.5,57,39,1,38,19,107,5,3,"https://fbref.com/en/players/148e136f/Remy-Cabella"
"2125","Mahdi Camara_2019",2019,"Saint-Étienne","Ligue 1","Mahdi Camara","FRA","FW","20",1998,0.1,0,0,0,0,0,0,0,NA,0,0,0,0,0,0,2,0,"https://fbref.com/en/players/8577e60a/Mahdi-Camara"
"2126","Mathieu Debuchy_2019",2019,"Saint-Étienne","Ligue 1","Mathieu Debuchy","FRA","DF","33",1985,21.6,43,26,25,13,5,22,37,59.5,15,17,7,10,47,90,64,0,"https://fbref.com/en/players/92232aad/Mathieu-Debuchy"
"2127","Lois Diony_2019",2019,"Saint-Étienne","Ligue 1","Lois Diony","FRA","FW","25",1992,17.7,17,12,3,9,5,4,10,40,6,14,0,14,1,18,9,0,"https://fbref.com/en/players/4be0b467/Lois-Diony"
"2128","Assane Dioussé_2019",2019,"Saint-Étienne","Ligue 1","Assane Dioussé","SEN","MF","20",1997,2.4,6,4,3,3,0,2,4,50,2,2,0,2,1,7,7,1,"https://fbref.com/en/players/7f622eef/Assane-Diousse"
"2129","Wesley Fofana_2019",2019,"Saint-Étienne","Ligue 1","Wesley Fofana","FRA","DF","17",2000,1.8,7,6,5,2,0,6,13,46.2,7,1,0,1,4,11,9,0,"https://fbref.com/en/players/132a82f1/Wesley-Fofana"
"2130","Lamine Ghezali_2019",2019,"Saint-Étienne","Ligue 1","Lamine Ghezali","FRA","FW,MF","19",1999,0.5,1,1,0,1,0,1,2,50,1,0,0,0,0,1,2,0,"https://fbref.com/en/players/ce84946a/Lamine-Ghezali"
"2131","Makhtar Gueye_2019",2019,"Saint-Étienne","Ligue 1","Makhtar Gueye","SEN","FW,MF","20",1997,0.6,2,1,2,0,0,2,2,100,0,2,0,2,0,2,0,0,"https://fbref.com/en/players/92b1763b/Makhtar-Gueye"
"2132","Romain Hamouma_2019",2019,"Saint-Étienne","Ligue 1","Romain Hamouma","FRA","FW,MF","31",1987,17.6,30,19,6,18,6,12,32,37.5,20,12,1,11,9,39,7,0,"https://fbref.com/en/players/0b4d8274/Romain-Hamouma"
"2133","Wahbi Khazri_2019",2019,"Saint-Étienne","Ligue 1","Wahbi Khazri","TUN","FW,MF","27",1991,31.3,41,26,8,14,19,17,49,34.7,32,27,2,25,11,52,5,0,"https://fbref.com/en/players/2677a1de/Wahbi-Khazri"
"2134","Timothée Kolodziejczak_2019",2019,"Saint-Étienne","Ligue 1","Timothée Kolodziejczak","FRA","DF","26",1991,35.4,34,22,21,10,3,20,45,44.4,25,25,11,14,53,87,118,2,"https://fbref.com/en/players/ab096c6f/Timothee-Kolodziejczak"
"2135","Yann M'Vila_2019",2019,"Saint-Étienne","Ligue 1","Yann M'Vila","FRA","MF","28",1990,36.2,72,40,22,48,2,29,72,40.3,43,42,12,30,74,146,86,5,"https://fbref.com/en/players/d4133fa1/Yann-MVila"
"2136","Kévin Monnet-Paquet_2019",2019,"Saint-Étienne","Ligue 1","Kévin Monnet-Paquet","FRA","DF,MF","29",1988,16.5,46,25,23,16,7,20,36,55.6,16,22,4,18,14,60,28,0,"https://fbref.com/en/players/4a57580c/Kevin-Monnet-Paquet"
"2137","Jessy Moulin_2019",2019,"Saint-Étienne","Ligue 1","Jessy Moulin","FRA","GK","32",1986,1,1,0,1,0,0,1,1,100,0,0,0,0,0,1,2,0,"https://fbref.com/en/players/28a65a2c/Jessy-Moulin"
"2138","Arnaud Nordin_2019",2019,"Saint-Étienne","Ligue 1","Arnaud Nordin","FRA","FW,MF","20",1998,11.7,14,12,4,4,6,4,11,36.4,7,13,2,11,5,19,9,0,"https://fbref.com/en/players/7b9a9e25/Arnaud-Nordin"
"2139","Mickaël Panos_2019",2019,"Saint-Étienne","Ligue 1","Mickaël Panos","FRA","DF","21",1997,0.3,1,0,0,1,0,1,2,50,1,2,0,2,1,2,0,0,"https://fbref.com/en/players/d8fc044e/Mickael-Panos"
"2140","Loïc Perrin_2019",2019,"Saint-Étienne","Ligue 1","Loïc Perrin","FRA","DF","32",1985,30,53,36,34,17,2,20,33,60.6,13,37,24,13,44,97,118,2,"https://fbref.com/en/players/6b200d45/Loic-Perrin"
"2141","Pierre-Yves Polomat_2019",2019,"Saint-Étienne","Ligue 1","Pierre-Yves Polomat","FRA","DF","24",1993,10.6,18,13,11,6,1,10,18,55.6,8,4,2,2,21,39,27,0,"https://fbref.com/en/players/2ef637bd/Pierre-Yves-Polomat"
"2142","Kenny Rocha Santos_2019",2019,"Saint-Étienne","Ligue 1","Kenny Rocha Santos","CPV","MF","18",2000,0,0,0,0,0,0,0,0,NA,0,0,0,0,0,0,0,0,"https://fbref.com/en/players/86df8ac0/Kenny-Rocha-Santos"
"2143","Stéphane Ruffier_2019",2019,"Saint-Étienne","Ligue 1","Stéphane Ruffier","FRA","GK","31",1986,37,2,2,2,0,0,2,4,50,2,0,0,0,0,2,18,3,"https://fbref.com/en/players/cac76a72/Stephane-Ruffier"
"2144","William Saliba_2019",2019,"Saint-Étienne","Ligue 1","William Saliba","FRA","DF","17",2001,14.2,32,20,28,4,0,16,24,66.7,8,11,10,1,28,60,44,2,"https://fbref.com/en/players/972aeb2a/William-Saliba"
"2145","Yannis Salibur_2019",2019,"Saint-Étienne","Ligue 1","Yannis Salibur","FRA","FW,MF","27",1991,9.8,9,5,1,7,1,1,7,14.3,6,6,0,6,8,17,4,0,"https://fbref.com/en/players/bb4a42be/Yannis-Salibur"
"2146","Ole Selnæs_2019",2019,"Saint-Étienne","Ligue 1","Ole Selnæs","NOR","MF","24",1994,18.5,44,26,12,23,9,13,35,37.1,22,24,7,17,19,63,29,0,"https://fbref.com/en/players/4db2157a/Ole-Selnaes"
"2147","Gabriel Silva_2019",2019,"Saint-Étienne","Ligue 1","Gabriel Silva","BRA","DF","27",1991,15.9,19,10,13,6,0,6,17,35.3,11,15,3,12,14,33,60,1,"https://fbref.com/en/players/4914ed4a/Gabriel-Silva"
"2148","Neven Subotić_2019",2019,"Saint-Étienne","Ligue 1","Neven Subotić","SRB","DF","29",1988,23.9,44,23,36,7,1,20,39,51.3,19,14,6,8,38,82,107,3,"https://fbref.com/en/players/821233cc/Neven-Subotic"
"2149","Valentín Vada_2019",2019,"Saint-Étienne","Ligue 1","Valentín Vada","ARG","MF","22",1996,4.5,7,4,4,3,0,3,12,25,9,4,1,3,7,14,4,0,"https://fbref.com/en/players/dcf7cf44/Valentin-Vada"
"2150","Joachim Andersen_2019",2019,"Sampdoria","Serie A","Joachim Andersen","DEN","DF","22",1996,32,40,27,31,8,1,19,31,61.3,12,30,15,15,35,75,147,1,"https://fbref.com/en/players/e34fc66d/Joachim-Andersen"
"2151","Emil Audero_2019",2019,"Sampdoria","Serie A","Emil Audero","ITA","GK","21",1997,36,4,3,4,0,0,3,3,100,0,0,0,0,1,5,21,4,"https://fbref.com/en/players/649b01d8/Emil-Audero"
"2152","Édgar Barreto_2019",2019,"Sampdoria","Serie A","Édgar Barreto","PAR","MF","34",1984,8.7,28,19,15,6,7,10,26,38.5,16,11,3,8,17,45,7,0,"https://fbref.com/en/players/43a1bea5/Edgar-Barreto"
"2153","Bartosz Bereszyński_2019",2019,"Sampdoria","Serie A","Bartosz Bereszyński","POL","DF","26",1992,24.4,46,30,27,15,4,24,51,47.1,27,22,7,15,31,77,76,0,"https://fbref.com/en/players/61b3978f/Bartosz-Bereszynski"
"2154","Rafael Cabral_2019",2019,"Sampdoria","Serie A","Rafael Cabral","BRA","GK","28",1990,2,0,0,0,0,0,0,0,NA,0,0,0,0,0,0,0,0,"https://fbref.com/en/players/806f7a26/Rafael-Cabral"
"2155","Gianluca Caprari_2019",2019,"Sampdoria","Serie A","Gianluca Caprari","ITA","FW,MF","25",1993,11.5,15,9,4,9,2,5,12,41.7,7,7,0,7,4,19,3,0,"https://fbref.com/en/players/54e53b7e/Gianluca-Caprari"
"2156","Omar Colley_2019",2019,"Sampdoria","Serie A","Omar Colley","GAM","DF","25",1992,19.6,18,11,12,6,0,12,13,92.3,1,24,16,8,22,40,102,0,"https://fbref.com/en/players/8b95acda/Omar-Colley"
"2157","Grégoire Defrel_2019",2019,"Sampdoria","Serie A","Grégoire Defrel","MTQ","FW,MF","27",1991,26,40,29,10,16,14,9,21,42.9,12,15,0,15,3,43,9,0,"https://fbref.com/en/players/854ee61a/Gregoire-Defrel"
"2158","Albin Ekdal_2019",2019,"Sampdoria","Serie A","Albin Ekdal","SWE","MF","29",1989,29.4,61,39,16,38,7,37,68,54.4,31,42,12,30,53,114,62,1,"https://fbref.com/en/players/f503ea63/Albin-Ekdal"
"2159","Alex Ferrari_2019",2019,"Sampdoria","Serie A","Alex Ferrari","ITA","DF","24",1994,6,10,8,4,6,0,5,7,71.4,2,7,4,3,9,19,26,0,"https://fbref.com/en/players/d0dbca9f/Alex-Ferrari"
"2160","Manolo Gabbiadini_2019",2019,"Sampdoria","Serie A","Manolo Gabbiadini","ITA","FW","26",1991,9,5,2,1,3,1,3,11,27.3,8,6,1,5,4,9,4,0,"https://fbref.com/en/players/8f866fe8/Manolo-Gabbiadini"
"2161","Jakub Jankto_2019",2019,"Sampdoria","Serie A","Jakub Jankto","CZE","MF","22",1996,10.7,7,4,5,2,0,4,15,26.7,11,18,2,16,9,16,16,0,"https://fbref.com/en/players/1ea5f91c/Jakub-Jankto"
"2162","Dawid Kownacki_2019",2019,"Sampdoria","Serie A","Dawid Kownacki","POL","FW","21",1997,1.9,2,1,0,1,1,1,4,25,3,0,0,0,0,2,0,0,"https://fbref.com/en/players/be5e1c4c/Dawid-Kownacki"
"2163","Karol Linetty_2019",2019,"Sampdoria","Serie A","Karol Linetty","POL","MF","23",1995,27.9,72,48,26,32,14,15,69,21.7,54,39,4,35,25,97,17,0,"https://fbref.com/en/players/d023d70f/Karol-Linetty"
"2164","Nicola Murru_2019",2019,"Sampdoria","Serie A","Nicola Murru","ITA","DF","23",1994,32.6,83,59,42,25,16,41,54,75.9,13,50,22,28,41,124,99,0,"https://fbref.com/en/players/d183e9d6/Nicola-Murru"
"2165","Dennis Praet_2019",2019,"Sampdoria","Serie A","Dennis Praet","BEL","MF","24",1994,32.1,62,44,30,25,7,27,51,52.9,24,33,4,29,36,98,31,0,"https://fbref.com/en/players/86695068/Dennis-Praet"
"2166","Fabio Quagliarella_2019",2019,"Sampdoria","Serie A","Fabio Quagliarella","ITA","FW","35",1983,35.5,14,8,6,4,4,2,15,13.3,13,32,1,31,8,22,17,0,"https://fbref.com/en/players/ee4f2f3b/Fabio-Quagliarella"
"2167","Gastón Ramírez_2019",2019,"Sampdoria","Serie A","Gastón Ramírez","URU","MF","27",1990,17.5,38,22,12,18,8,11,31,35.5,20,28,4,24,8,46,27,0,"https://fbref.com/en/players/2c851997/Gaston-Ramirez"
"2168","Jacopo Sala_2019",2019,"Sampdoria","Serie A","Jacopo Sala","ITA","DF","26",1991,16.9,38,23,20,14,4,23,41,56.1,18,11,3,8,20,58,47,2,"https://fbref.com/en/players/da5a981b/Jacopo-Sala"
"2169","Riccardo Saponara_2019",2019,"Sampdoria","Serie A","Riccardo Saponara","ITA","MF","26",1991,10.1,12,6,2,6,4,3,12,25,9,5,1,4,4,16,10,0,"https://fbref.com/en/players/3bb7af3b/Riccardo-Saponara"
"2170","Marco Sau_2019",2019,"Sampdoria","Serie A","Marco Sau","ITA","MF,FW","30",1987,0.6,0,0,0,0,0,0,0,NA,0,1,0,1,0,0,0,0,"https://fbref.com/en/players/1ad1f50d/Marco-Sau"
"2171","Júnior Tavares_2019",2019,"Sampdoria","Serie A","Júnior Tavares","BRA","DF","21",1996,2,2,1,1,1,0,2,4,50,2,0,0,0,2,4,1,0,"https://fbref.com/en/players/f1675fdd/Junior-Tavares"
"2172","Lorenzo Tonelli_2019",2019,"Sampdoria","Serie A","Lorenzo Tonelli","ITA","DF","28",1990,18.4,31,22,19,9,3,15,19,78.9,4,27,21,6,24,55,92,0,"https://fbref.com/en/players/8cc29864/Lorenzo-Tonelli"
"2173","Ronaldo Vieira_2019",2019,"Sampdoria","Serie A","Ronaldo Vieira","GNB","MF","20",1998,6.7,NA,10,NA,NA,NA,NA,NA,NA,NA,NA,NA,NA,7,NA,NA,NA,"https://fbref.com/en/players/75e60d75/Ronaldo-Vieira"
"2174","Claud Adjapong_2019",2019,"Sassuolo","Serie A","Claud Adjapong","ITA","MF,FW","20",1998,3,4,2,1,3,0,1,2,50,1,3,1,2,1,5,4,0,"https://fbref.com/en/players/ce5b170a/Claud-Adjapong"
"2175","Khouma Babacar_2019",2019,"Sassuolo","Serie A","Khouma Babacar","SEN","FW","25",1993,16.5,7,3,2,5,0,2,10,20,8,8,2,6,3,10,25,1,"https://fbref.com/en/players/422ec08a/Khouma-Babacar"
"2176","Domenico Berardi_2019",2019,"Sassuolo","Serie A","Domenico Berardi","ITA","FW,MF","23",1994,31.9,38,21,16,9,13,15,73,20.5,58,31,2,29,27,65,24,0,"https://fbref.com/en/players/53a0e358/Domenico-Berardi"
"2177","Kevin-Prince Boateng_2019",2019,"Sassuolo","Serie A","Kevin-Prince Boateng","GHA","FW","31",1987,10.4,5,4,0,4,1,1,4,25,3,7,3,4,3,8,13,0,"https://fbref.com/en/players/f4ec4fd0/Kevin-Prince-Boateng"
"2178","Jeremie Boga_2019",2019,"Sassuolo","Serie A","Jeremie Boga","CIV","FW,MF","21",1997,16,7,4,5,1,1,4,14,28.6,10,19,0,19,2,9,4,0,"https://fbref.com/en/players/fe012aca/Jeremie-Boga"
"2179","Mehdi Bourabia_2019",2019,"Sassuolo","Serie A","Mehdi Bourabia","MAR","MF","26",1991,22.3,51,28,23,21,7,15,46,32.6,31,28,5,23,33,84,32,0,"https://fbref.com/en/players/0d077b88/Mehdi-Bourabia"
"2180","Enrico Brignola_2019",2019,"Sassuolo","Serie A","Enrico Brignola","ITA","FW,MF","19",1999,1.9,2,2,2,0,0,0,2,0,2,0,0,0,1,3,1,0,"https://fbref.com/en/players/d0643f8f/Enrico-Brignola"
"2181","Andrea Consigli_2019",2019,"Sassuolo","Serie A","Andrea Consigli","ITA","GK","31",1987,35.7,0,0,0,0,0,0,2,0,2,0,0,0,1,1,15,6,"https://fbref.com/en/players/8cabdc1e/Andrea-Consigli"
"2182","Cristian Dell'Orco_2019",2019,"Sassuolo","Serie A","Cristian Dell'Orco","ITA","DF","24",1994,1.2,1,1,1,0,0,1,3,33.3,2,1,0,1,1,2,3,0,"https://fbref.com/en/players/b0243215/Cristian-DellOrco"
"2183","Merih Demiral_2019",2019,"Sassuolo","Serie A","Merih Demiral","TUR","DF","20",1998,14,24,16,23,1,0,10,13,76.9,3,16,11,5,19,43,80,0,"https://fbref.com/en/players/e3cceee6/Merih-Demiral"
"2184","Federico Di Francesco_2019",2019,"Sassuolo","Serie A","Federico Di Francesco","ITA","FW,MF","24",1994,11.9,10,6,3,4,3,4,7,57.1,3,12,1,11,5,15,5,0,"https://fbref.com/en/players/1fca9171/Federico-Di-Francesco"
"2185","Alfred Duncan_2019",2019,"Sassuolo","Serie A","Alfred Duncan","GHA","MF","25",1993,20.5,33,21,15,15,3,19,48,39.6,29,20,6,14,15,48,18,0,"https://fbref.com/en/players/528492ea/Alfred-Duncan"
"2186","Mauricio Lemos_2019",2019,"Sassuolo","Serie A","Mauricio Lemos","URU","DF","22",1995,2,2,1,2,0,0,1,2,50,1,2,1,1,3,5,10,1,"https://fbref.com/en/players/dbe5a587/Mauricio-Lemos"
"2187","Pol Lirola_2019",2019,"Sassuolo","Serie A","Pol Lirola","ESP","DF,MF","20",1997,33.1,35,22,19,11,5,21,34,61.8,13,25,5,20,32,67,89,0,"https://fbref.com/en/players/ff800ed8/Pol-Lirola"
"2188","Manuel Locatelli_2019",2019,"Sassuolo","Serie A","Manuel Locatelli","ITA","MF","20",1998,20.5,44,28,19,15,10,13,29,44.8,16,21,3,18,27,71,33,1,"https://fbref.com/en/players/a8a874f1/Manuel-Locatelli"
"2189","Francesco Magnanelli_2019",2019,"Sassuolo","Serie A","Francesco Magnanelli","ITA","MF","33",1984,20.7,52,33,29,22,1,22,49,44.9,27,18,5,13,24,76,38,2,"https://fbref.com/en/players/07767f42/Francesco-Magnanelli"
"2190","Giangiacomo Magnani_2019",2019,"Sassuolo","Serie A","Giangiacomo Magnani","ITA","DF","22",1995,16.8,11,9,9,2,0,6,15,40,9,17,13,4,16,27,99,1,"https://fbref.com/en/players/cce9f582/Giangiacomo-Magnani"
"2191","Gian Marco Ferrari_2019",2019,"Sassuolo","Serie A","Gian Marco Ferrari","ITA","DF","26",1992,31,41,23,27,12,2,12,16,75,4,36,20,16,36,77,97,1,"https://fbref.com/en/players/8650af85/Gian-Marco-Ferrari"
"2192","Marlon_2019",2019,"Sassuolo","Serie A","Marlon","BRA","DF","22",1995,16.8,29,18,25,3,1,15,21,71.4,6,22,12,10,24,53,39,0,"https://fbref.com/en/players/cdf65d12/Marlon"
"2193","Alessandro Matri_2019",2019,"Sassuolo","Serie A","Alessandro Matri","ITA","FW","33",1984,6.7,2,1,0,0,2,0,3,0,3,4,2,2,4,6,7,0,"https://fbref.com/en/players/58d97e77/Alessandro-Matri"
"2194","Jens Odgaard_2019",2019,"Sassuolo","Serie A","Jens Odgaard","DEN","FW","19",1999,0.2,0,0,0,0,0,0,0,NA,0,1,0,1,0,0,1,0,"https://fbref.com/en/players/75374ee7/Jens-Odgaard"
"2195","Gianluca Pegolo_2019",2019,"Sassuolo","Serie A","Gianluca Pegolo","ITA","GK","37",1981,2.3,0,0,0,0,0,0,0,NA,0,0,0,0,0,0,0,0,"https://fbref.com/en/players/f058ed1f/Gianluca-Pegolo"
"2196","Federico Peluso_2019",2019,"Sassuolo","Serie A","Federico Peluso","ITA","DF","34",1984,15.1,23,14,15,5,3,13,16,81.3,3,8,3,5,23,46,70,0,"https://fbref.com/en/players/4f2908e5/Federico-Peluso"
"2197","Giacomo Raspadori_2019",2019,"Sassuolo","Serie A","Giacomo Raspadori","ITA","DF","18",2000,0,0,0,0,0,0,0,0,NA,0,0,0,0,0,0,0,0,"https://fbref.com/en/players/6e058f06/Giacomo-Raspadori"
"2198","Rogério_2019",2019,"Sassuolo","Serie A","Rogério","BRA","DF,MF","20",1998,29.7,55,38,35,13,7,30,55,54.5,25,32,7,25,37,92,109,1,"https://fbref.com/en/players/10e7f486/Rogerio"
"2199","Stefano Sensi_2019",2019,"Sassuolo","Serie A","Stefano Sensi","ITA","MF","22",1995,21.9,36,20,15,18,3,6,30,20,24,36,7,29,33,69,17,0,"https://fbref.com/en/players/b70bde8f/Stefano-Sensi"
"2200","Leonardo Sernicola_2019",2019,"Sassuolo","Serie A","Leonardo Sernicola","ITA","FW","21",1997,0.1,0,0,0,0,0,0,0,NA,0,0,0,0,0,0,0,0,"https://fbref.com/en/players/dd7febd8/Leonardo-Sernicola"
"2201","Marcello Trotta_2019",2019,"Sassuolo","Serie A","Marcello Trotta","ITA","MF","25",1992,0.1,0,0,0,0,0,0,1,0,1,0,0,0,0,0,0,0,"https://fbref.com/en/players/acdad0aa/Marcello-Trotta"
"2202","Filip Đuričić_2019",2019,"Sassuolo","Serie A","Filip Đuričić","SRB","FW,MF","26",1992,13.9,17,13,2,11,4,5,22,22.7,17,20,1,19,8,25,8,1,"https://fbref.com/en/players/eccbe56a/Filip-Djuricic"
"2203","Nabil Bentaleb_2019",2019,"Schalke 04","Bundesliga","Nabil Bentaleb","ALG","MF","23",1994,19.9,32,17,8,21,3,4,18,22.2,14,28,8,20,35,67,19,0,"https://fbref.com/en/players/3189f61a/Nabil-Bentaleb"
"2204","Nassim Boujellab_2019",2019,"Schalke 04","Bundesliga","Nassim Boujellab","MAR","MF","19",1999,4.2,10,4,3,6,1,3,11,27.3,8,6,0,6,2,12,3,0,"https://fbref.com/en/players/541127d5/Nassim-Boujellab"
"2205","Jeffrey Bruma_2019",2019,"Schalke 04","Bundesliga","Jeffrey Bruma","NED","DF","26",1991,6.9,12,11,8,4,0,6,12,50,6,8,2,6,4,16,35,0,"https://fbref.com/en/players/fbffc4b1/Jeffrey-Bruma"
"2206","Guido Burgstaller_2019",2019,"Schalke 04","Bundesliga","Guido Burgstaller","AUT","FW","29",1989,17,11,9,2,5,4,3,8,37.5,5,5,0,5,2,13,10,0,"https://fbref.com/en/players/2bcc6d52/Guido-Burgstaller"
"2207","Daniel Caligiuri_2019",2019,"Schalke 04","Bundesliga","Daniel Caligiuri","ITA","DF,FW","30",1988,30.6,93,52,55,29,9,44,103,42.7,59,66,10,56,50,143,72,1,"https://fbref.com/en/players/d1273f09/Daniel-Caligiuri"
"2208","Jonas Carls_2019",2019,"Schalke 04","Bundesliga","Jonas Carls","GER","FW","21",1997,1,5,2,4,0,1,5,5,100,0,0,0,0,1,6,0,0,"https://fbref.com/en/players/2bb48e86/Jonas-Carls"
"2209","Franco Di Santo_2019",2019,"Schalke 04","Bundesliga","Franco Di Santo","ARG","MF,FW","29",1989,2.7,2,1,0,2,0,1,4,25,3,3,1,2,1,3,3,0,"https://fbref.com/en/players/549c6ba7/Franco-Di-Santo"
"2210","Breel Embolo_2019",2019,"Schalke 04","Bundesliga","Breel Embolo","SUI","FW","21",1997,14.9,22,17,4,13,5,1,9,11.1,8,11,0,11,4,26,6,0,"https://fbref.com/en/players/0b4f388a/Breel-Embolo"
"2211","Ralf Fährmann_2019",2019,"Schalke 04","Bundesliga","Ralf Fährmann","GER","GK","29",1988,16.3,0,0,0,0,0,0,0,NA,0,0,0,0,2,2,10,4,"https://fbref.com/en/players/1e43fad8/Ralf-Fahrmann"
"2212","Amine Harit_2019",2019,"Schalke 04","Bundesliga","Amine Harit","MAR","MF,FW","21",1997,12,15,8,4,9,2,8,24,33.3,16,11,1,10,9,24,2,0,"https://fbref.com/en/players/e7d59f4f/Amine-Harit"
"2213","Yevhen Konoplyanka_2019",2019,"Schalke 04","Bundesliga","Yevhen Konoplyanka","UKR","FW,MF","28",1989,7.3,2,0,0,0,2,2,4,50,2,6,0,6,3,5,3,0,"https://fbref.com/en/players/d9a5d930/Yevhen-Konoplyanka"
"2214","Ahmed Kutucu_2019",2019,"Schalke 04","Bundesliga","Ahmed Kutucu","TUR","FW,MF","18",2000,4.7,8,3,3,4,1,1,3,33.3,2,2,1,1,0,8,0,0,"https://fbref.com/en/players/beda9675/Ahmed-Kutucu"
"2215","Omar Mascarell_2019",2019,"Schalke 04","Bundesliga","Omar Mascarell","ESP","MF","25",1993,11,20,10,9,9,2,10,24,41.7,14,21,7,14,23,43,8,0,"https://fbref.com/en/players/11fd2b75/Omar-Mascarell"
"2216","Rabbi Matondo_2019",2019,"Schalke 04","Bundesliga","Rabbi Matondo","WAL","FW,MF","17",2000,2.1,4,1,4,0,0,1,5,20,4,2,0,2,0,4,1,0,"https://fbref.com/en/players/33144cc5/Rabbi-Matondo"
"2217","Weston McKennie_2019",2019,"Schalke 04","Bundesliga","Weston McKennie","USA","MF,FW","19",1998,19.4,28,14,5,17,6,11,35,31.4,24,28,9,19,36,64,46,1,"https://fbref.com/en/players/01c3aff5/Weston-McKennie"
"2218","Hamza Mendyl_2019",2019,"Schalke 04","Bundesliga","Hamza Mendyl","MAR","DF","20",1997,6,17,15,6,8,3,8,18,44.4,10,11,2,9,8,25,8,0,"https://fbref.com/en/players/f99fe221/Hamza-Mendyl"
"2219","Naldo_2019",2019,"Schalke 04","Bundesliga","Naldo","BRA","DF","35",1982,7,10,7,8,2,0,5,8,62.5,3,8,3,5,14,24,25,0,"https://fbref.com/en/players/03bd0bf4/Naldo"
"2220","Matija Nastasić_2019",2019,"Schalke 04","Bundesliga","Matija Nastasić","SRB","DF","25",1993,27.2,35,23,22,13,0,20,29,69,9,32,20,12,38,73,114,1,"https://fbref.com/en/players/f35430a4/Matija-Nastasic"
"2221","Alexander Nübel_2019",2019,"Schalke 04","Bundesliga","Alexander Nübel","GER","GK","21",1996,17.6,0,0,0,0,0,0,1,0,1,0,0,0,1,1,4,1,"https://fbref.com/en/players/afb0c500/Alexander-Nubel"
"2222","Bastian Oczipka_2019",2019,"Schalke 04","Bundesliga","Bastian Oczipka","GER","DF,FW","29",1989,20.8,41,27,20,19,2,21,26,80.8,5,23,5,18,24,65,24,2,"https://fbref.com/en/players/d1661819/Bastian-Oczipka"
"2223","Baba Rahman_2019",2019,"Schalke 04","Bundesliga","Baba Rahman","GHA","DF","24",1994,1.8,3,1,1,1,1,1,1,100,0,3,0,3,2,5,2,0,"https://fbref.com/en/players/e4086af3/Baba-Rahman"
"2224","Sascha Riether_2019",2019,"Schalke 04","Bundesliga","Sascha Riether","GER","FW","35",1983,0,0,0,0,0,0,0,0,NA,0,0,0,0,0,0,0,0,"https://fbref.com/en/players/3cb009c5/Sascha-Riether"
"2225","Sebastian Rudy_2019",2019,"Schalke 04","Bundesliga","Sebastian Rudy","GER","MF","28",1990,15.1,44,24,11,27,6,11,41,26.8,30,23,2,21,15,59,15,0,"https://fbref.com/en/players/80f36c88/Sebastian-Rudy"
"2226","Salif Sané_2019",2019,"Schalke 04","Bundesliga","Salif Sané","SEN","DF","27",1990,29,54,37,34,19,1,27,46,58.7,19,44,29,15,68,122,146,3,"https://fbref.com/en/players/791abba1/Salif-Sane"
"2227","Alessandro Schöpf_2019",2019,"Schalke 04","Bundesliga","Alessandro Schöpf","AUT","MF,DF","24",1994,11.2,26,16,12,13,1,12,29,41.4,17,14,0,14,9,35,12,0,"https://fbref.com/en/players/106bca06/Alessandro-Schopf"
"2228","Suat Serdar_2019",2019,"Schalke 04","Bundesliga","Suat Serdar","GER","MF","21",1997,19.2,51,32,20,26,5,14,49,28.6,35,37,6,31,23,74,5,1,"https://fbref.com/en/players/b3325a30/Suat-Serdar"
"2229","Steven Skrzybski_2019",2019,"Schalke 04","Bundesliga","Steven Skrzybski","GER","FW,MF","25",1992,7.4,9,3,0,6,3,3,11,27.3,8,8,1,7,3,12,2,0,"https://fbref.com/en/players/58ce23e5/Steven-Skrzybski"
"2230","Benjamin Stambouli_2019",2019,"Schalke 04","Bundesliga","Benjamin Stambouli","FRA","DF,MF","27",1990,19.6,51,31,24,24,3,25,46,54.3,21,41,9,32,32,83,65,2,"https://fbref.com/en/players/5939baa2/Benjamin-Stambouli"
"2231","Cedric Teuchert_2019",2019,"Schalke 04","Bundesliga","Cedric Teuchert","GER","FW,MF","21",1997,1.8,0,0,0,0,0,0,0,NA,0,2,0,2,1,1,0,0,"https://fbref.com/en/players/f956479d/Cedric-Teuchert"
"2232","George Timotheou_2019",2019,"Schalke 04","Bundesliga","George Timotheou","AUS","DF","21",1997,1,3,3,3,0,0,0,0,NA,0,1,1,0,1,4,4,0,"https://fbref.com/en/players/8fa80ec8/George-Timotheou"
"2233","Mark Uth_2019",2019,"Schalke 04","Bundesliga","Mark Uth","GER","FW,MF","26",1991,15.6,20,11,8,8,4,4,23,17.4,19,19,2,17,8,28,12,0,"https://fbref.com/en/players/a3ddb1b9/Mark-Uth"
"2234","Haji Wright_2019",2019,"Schalke 04","Bundesliga","Haji Wright","USA","FW","20",1998,2.2,3,2,1,1,1,0,1,0,1,1,0,1,0,3,1,0,"https://fbref.com/en/players/91cd37b7/Haji-Wright"
"2235","Ibrahim Amadou_2019",2019,"Sevilla","La Liga","Ibrahim Amadou","FRA","MF,DF","25",1993,8.5,27,20,9,15,3,2,9,22.2,7,7,4,3,11,38,24,0,"https://fbref.com/en/players/9260926b/Ibrahim-Amadou"
"2236","Guilherme Arana_2019",2019,"Sevilla","La Liga","Guilherme Arana","BRA","DF","21",1997,7,11,6,5,5,1,6,7,85.7,1,6,3,3,9,20,8,0,"https://fbref.com/en/players/2b15a82a/Guilherme-Arana"
"2237","Éver Banega_2019",2019,"Sevilla","La Liga","Éver Banega","ARG","MF","30",1988,29.6,71,50,32,35,4,20,70,28.6,50,26,5,21,28,99,28,0,"https://fbref.com/en/players/fa937f7a/Ever-Banega"
"2238","Wissam Ben Yedder_2019",2019,"Sevilla","La Liga","Wissam Ben Yedder","FRA","FW","27",1990,31.2,18,16,3,11,4,2,12,16.7,10,18,0,18,11,29,2,0,"https://fbref.com/en/players/942b4f90/Wissam-Ben-Yedder"
"2239","Daniel Carriço_2019",2019,"Sevilla","La Liga","Daniel Carriço","POR","DF","29",1988,23.7,35,18,23,11,1,12,20,60,8,19,12,7,31,66,104,1,"https://fbref.com/en/players/e1deea75/Daniel-Carrico"
"2240","Javier Díaz_2019",2019,"Sevilla","La Liga","Javier Díaz","ESP","GK","21",1997,1,0,0,0,0,0,0,0,NA,0,0,0,0,0,0,0,0,"https://fbref.com/en/players/17a1299d/Javier-Diaz"
"2241","Sergio Escudero_2019",2019,"Sevilla","La Liga","Sergio Escudero","ESP","DF,FW","28",1989,17.2,43,29,20,18,5,18,35,51.4,17,22,4,18,24,67,52,0,"https://fbref.com/en/players/b0616e3d/Sergio-Escudero"
"2242","Bryan Gil_2019",2019,"Sevilla","La Liga","Bryan Gil","ESP","MF,FW","17",2001,1.9,6,4,4,1,1,1,5,20,4,0,0,0,1,7,0,0,"https://fbref.com/en/players/7b5ab7f2/Bryan-Gil"
"2243","Joris Gnagnon_2019",2019,"Sevilla","La Liga","Joris Gnagnon","FRA","DF,MF","21",1997,5,11,8,6,4,1,4,7,57.1,3,2,2,0,10,21,16,0,"https://fbref.com/en/players/1232e1dc/Joris-Gnagnon"
"2244","Sergi Gómez_2019",2019,"Sevilla","La Liga","Sergi Gómez","ESP","DF","26",1992,30.7,49,38,33,12,4,18,28,64.3,10,30,20,10,40,89,135,1,"https://fbref.com/en/players/bc6f5f06/Sergi-Gomez"
"2245","Maxime Gonalons_2019",2019,"Sevilla","La Liga","Maxime Gonalons","FRA","MF","29",1989,6,8,4,2,5,1,1,15,6.7,14,10,4,6,5,13,12,0,"https://fbref.com/en/players/b8c1de25/Maxime-Gonalons"
"2246","Munir El Haddadi_2019",2019,"Sevilla","La Liga","Munir El Haddadi","MAR","FW,MF","22",1995,11.6,17,10,5,7,5,2,7,28.6,5,15,0,15,6,23,9,0,"https://fbref.com/en/players/8696bc90/Munir-El-Haddadi"
"2247","Simon Kjær_2019",2019,"Sevilla","La Liga","Simon Kjær","DEN","DF","29",1989,22.3,29,19,25,3,1,9,16,56.3,7,41,34,7,27,56,136,0,"https://fbref.com/en/players/8b8a56ce/Simon-Kjaer"
"2248","Gabriel Mercado_2019",2019,"Sevilla","La Liga","Gabriel Mercado","ARG","DF","31",1987,19.3,35,23,21,12,2,18,36,50,18,24,12,12,26,61,75,1,"https://fbref.com/en/players/bf97c188/Gabriel-Mercado"
"2249","Roque Mesa_2019",2019,"Sevilla","La Liga","Roque Mesa","ESP","MF","29",1989,19.4,46,27,16,22,8,15,38,39.5,23,16,0,16,14,60,12,4,"https://fbref.com/en/players/7c4243d4/Roque-Mesa"
"2250","Luis Muriel_2019",2019,"Sevilla","La Liga","Luis Muriel","COL","MF,FW","27",1991,1.4,0,0,0,0,0,0,6,0,6,3,0,3,0,0,1,0,"https://fbref.com/en/players/eb2fe5b6/Luis-Muriel"
"2251","Jesús Navas_2019",2019,"Sevilla","La Liga","Jesús Navas","ESP","DF,FW","32",1985,30.1,28,21,15,11,2,16,24,66.7,8,23,5,18,29,57,62,0,"https://fbref.com/en/players/3f10bd22/Jesus-Navas"
"2252","Nolito_2019",2019,"Sevilla","La Liga","Nolito","ESP","FW,DF","31",1986,0.8,3,2,1,1,1,1,2,50,1,2,0,2,0,3,1,0,"https://fbref.com/en/players/b2d0ec1b/Nolito"
"2253","Quincy Promes_2019",2019,"Sevilla","La Liga","Quincy Promes","NED","FW,DF","26",1992,17.6,35,25,23,9,3,15,22,68.2,7,19,3,16,25,60,22,1,"https://fbref.com/en/players/b182a240/Quincy-Promes"
"2254","Marko Rog_2019",2019,"Sevilla","La Liga","Marko Rog","CRO","MF","23",1995,4,12,11,4,8,0,5,9,55.6,4,4,0,4,8,20,1,0,"https://fbref.com/en/players/b6b2b820/Marko-Rog"
"2255","Pablo Sarabia_2019",2019,"Sevilla","La Liga","Pablo Sarabia","ESP","MF,FW","26",1992,30.3,30,15,6,15,9,6,47,12.8,41,30,3,27,22,52,20,0,"https://fbref.com/en/players/9744ff80/Pablo-Sarabia"
"2256","André Silva_2019",2019,"Sevilla","La Liga","André Silva","POR","FW","22",1995,24,8,5,1,4,3,1,11,9.1,10,17,1,16,3,11,32,0,"https://fbref.com/en/players/3effaa34/Andre-Silva"
"2257","Juan Soriano_2019",2019,"Sevilla","La Liga","Juan Soriano","ESP","GK","20",1997,4,0,0,0,0,0,0,0,NA,0,0,0,0,1,1,1,0,"https://fbref.com/en/players/5512b1a9/Juan-Soriano"
"2258","Tomáš Vaclík_2019",2019,"Sevilla","La Liga","Tomáš Vaclík","CZE","GK","29",1989,33,0,0,0,0,0,0,1,0,1,0,0,0,0,0,9,6,"https://fbref.com/en/players/7b456af7/Tomas-Vaclik"
"2259","Franco Vázquez_2019",2019,"Sevilla","La Liga","Franco Vázquez","ARG","MF","29",1989,25.3,51,37,21,21,9,23,66,34.8,43,25,2,23,23,74,27,1,"https://fbref.com/en/players/467bae22/Franco-Vazquez"
"2260","Aleix Vidal_2019",2019,"Sevilla","La Liga","Aleix Vidal","ESP","DF,MF","28",1989,5.9,13,11,5,5,3,5,14,35.7,9,5,0,5,4,17,12,0,"https://fbref.com/en/players/04965583/Aleix-Vidal"
"2261","Maximilian Wöber_2019",2019,"Sevilla","La Liga","Maximilian Wöber","AUT","DF","20",1998,6,12,9,8,2,2,3,6,50,3,6,0,6,7,19,16,0,"https://fbref.com/en/players/4b803b3c/Maximilian-Wober"
"2262","Stuart Armstrong_2019",2019,"Southampton","Premier League","Stuart Armstrong","SCO","MF","26",1992,15.9,28,20,14,6,8,8,42,19,34,14,0,14,12,40,12,0,"https://fbref.com/en/players/97333cf5/Stuart-Armstrong"
"2263","Charlie Austin_2019",2019,"Southampton","Premier League","Charlie Austin","ENG","FW","29",1989,10.9,13,7,3,6,4,6,11,54.5,5,12,2,10,2,15,13,0,"https://fbref.com/en/players/8d228291/Charlie-Austin"
"2264","Jan Bednarek_2019",2019,"Southampton","Premier League","Jan Bednarek","POL","DF","22",1996,23.9,41,25,25,16,0,21,37,56.8,16,44,27,17,71,112,171,0,"https://fbref.com/en/players/4115ce4e/Jan-Bednarek"
"2265","Ryan Bertrand_2019",2019,"Southampton","Premier League","Ryan Bertrand","ENG","DF","28",1989,24,46,27,22,20,4,16,31,51.6,15,27,5,22,28,74,51,0,"https://fbref.com/en/players/01226327/Ryan-Bertrand"
"2266","Steven Davis_2019",2019,"Southampton","Premier League","Steven Davis","NIR","MF","33",1985,1.1,2,2,0,2,0,0,0,NA,0,2,0,2,1,3,5,0,"https://fbref.com/en/players/cf15bbb1/Steven-Davis"
"2267","Mohamed Elyounoussi_2019",2019,"Southampton","Premier League","Mohamed Elyounoussi","NOR","MF","23",1994,8.8,16,12,7,6,3,6,19,31.6,13,11,1,10,6,22,5,0,"https://fbref.com/en/players/68dc0dac/Mohamed-Elyounoussi"
"2268","Fraser Forster_2019",2019,"Southampton","Premier League","Fraser Forster","ENG","GK","30",1988,1,0,0,0,0,0,0,0,NA,0,0,0,0,0,0,1,0,"https://fbref.com/en/players/c3e39f12/Fraser-Forster"
"2269","Manolo Gabbiadini_2019",2019,"Southampton","Premier League","Manolo Gabbiadini","ITA","FW,MF","26",1991,5.3,6,2,1,4,1,1,2,50,1,5,0,5,3,9,6,0,"https://fbref.com/en/players/8f866fe8/Manolo-Gabbiadini"
"2270","Sam Gallagher_2019",2019,"Southampton","Premier League","Sam Gallagher","ENG","FW","22",1995,0.4,0,0,0,0,0,0,0,NA,0,1,0,1,0,0,1,0,"https://fbref.com/en/players/44361ade/Sam-Gallagher"
"2271","Angus Gunn_2019",2019,"Southampton","Premier League","Angus Gunn","SCO","GK","22",1996,12,0,0,0,0,0,0,0,NA,0,0,0,0,0,0,8,3,"https://fbref.com/en/players/e082af5b/Angus-Gunn"
"2272","Wesley Hoedt_2019",2019,"Southampton","Premier League","Wesley Hoedt","NED","DF","24",1994,13,28,12,23,5,0,17,26,65.4,9,20,13,7,23,51,79,2,"https://fbref.com/en/players/875898c7/Wesley-Hoedt"
"2273","Pierre Højbjerg_2019",2019,"Southampton","Premier League","Pierre Højbjerg","DEN","MF","22",1995,30.7,71,49,20,44,7,24,73,32.9,49,51,8,43,60,131,30,1,"https://fbref.com/en/players/8b04d6c1/Pierre-Hojbjerg"
"2274","Danny Ings_2019",2019,"Southampton","Premier League","Danny Ings","ENG","FW","26",1992,18.3,30,14,5,19,6,11,28,39.3,17,30,2,28,5,35,9,0,"https://fbref.com/en/players/07802f7f/Danny-Ings"
"2275","Tyreke Johnson_2019",2019,"Southampton","Premier League","Tyreke Johnson","ENG","MF","19",1998,0,0,0,0,0,0,0,0,NA,0,0,0,0,0,0,0,0,"https://fbref.com/en/players/4701e130/Tyreke-Johnson"
"2276","Mario Lemina_2019",2019,"Southampton","Premier League","Mario Lemina","GAB","MF","24",1993,17.9,49,32,23,23,3,15,34,44.1,19,27,3,24,43,92,31,1,"https://fbref.com/en/players/2b471f99/Mario-Lemina"
"2277","Shane Long_2019",2019,"Southampton","Premier League","Shane Long","IRL","FW,MF","31",1987,14.1,15,8,4,5,6,3,16,18.8,13,10,1,9,7,22,18,0,"https://fbref.com/en/players/9f472354/Shane-Long"
"2278","Alex McCarthy_2019",2019,"Southampton","Premier League","Alex McCarthy","ENG","GK","28",1989,25,0,0,0,0,0,0,0,NA,0,0,0,0,0,0,6,2,"https://fbref.com/en/players/36c2ca73/Alex-McCarthy"
"2279","Michael Obafemi_2019",2019,"Southampton","Premier League","Michael Obafemi","IRL","FW","18",2000,1.5,1,1,0,0,1,0,0,NA,0,1,1,0,1,2,0,0,"https://fbref.com/en/players/caa1a7f0/Michael-Obafemi"
"2280","Kayne Ramsey_2019",2019,"Southampton","Premier League","Kayne Ramsey","ENG","DF","17",2000,1,0,0,0,0,0,0,0,NA,0,0,0,0,0,0,7,0,"https://fbref.com/en/players/dc31b84c/Kayne-Ramsey"
"2281","Nathan Redmond_2019",2019,"Southampton","Premier League","Nathan Redmond","ENG","MF,FW","24",1994,36.3,45,22,14,19,12,14,41,34.1,27,54,2,52,20,65,23,1,"https://fbref.com/en/players/ab651565/Nathan-Redmond"
"2282","Oriol Romeu_2019",2019,"Southampton","Premier League","Oriol Romeu","ESP","MF","26",1991,23.7,81,46,39,38,4,32,77,41.6,45,43,17,26,52,133,44,1,"https://fbref.com/en/players/4b511457/Oriol-Romeu"
"2283","Josh Sims_2019",2019,"Southampton","Premier League","Josh Sims","ENG","MF","21",1997,2.4,1,0,1,0,0,1,3,33.3,2,2,0,2,1,2,1,0,"https://fbref.com/en/players/6d6f09dc/Josh-Sims"
"2284","Callum Slattery_2019",2019,"Southampton","Premier League","Callum Slattery","ENG","MF","19",1999,1.2,4,3,0,4,0,3,7,42.9,4,1,1,0,2,6,1,0,"https://fbref.com/en/players/059948df/Callum-Slattery"
"2285","Cédric Soares_2019",2019,"Southampton","Premier League","Cédric Soares","POR","DF","26",1991,16.6,22,16,15,6,1,9,15,60,6,21,5,16,22,44,60,2,"https://fbref.com/en/players/839c14e1/Cedric-Soares"
"2286","Jack Stephens_2019",2019,"Southampton","Premier League","Jack Stephens","ENG","DF","24",1994,18.9,25,13,17,7,1,16,28,57.1,12,25,13,12,37,62,96,2,"https://fbref.com/en/players/6adbc307/Jack-Stephens"
"2287","Matt Targett_2019",2019,"Southampton","Premier League","Matt Targett","ENG","DF","22",1995,13.2,27,19,15,7,5,12,26,46.2,14,19,3,16,27,54,42,0,"https://fbref.com/en/players/e514ab62/Matt-Targett"
"2288","Yan Valery_2019",2019,"Southampton","Premier League","Yan Valery","TUN","DF","19",1999,19,42,36,26,10,6,16,29,55.2,13,24,3,21,22,64,72,1,"https://fbref.com/en/players/531a4aa8/Yan-Valery"
"2289","Jannik Vestergaard_2019",2019,"Southampton","Premier League","Jannik Vestergaard","DEN","DF","25",1992,22.5,53,33,37,13,3,28,45,62.2,17,35,20,15,35,88,174,1,"https://fbref.com/en/players/1900032e/Jannik-Vestergaard"
"2290","James Ward-Prowse_2019",2019,"Southampton","Premier League","James Ward-Prowse","ENG","MF,DF","23",1994,21.6,36,17,19,13,4,14,43,32.6,29,30,6,24,27,63,59,0,"https://fbref.com/en/players/3515d404/James-Ward-Prowse"
"2291","Maya Yoshida_2019",2019,"Southampton","Premier League","Maya Yoshida","JPN","DF","29",1988,16.9,16,12,5,10,1,4,13,30.8,9,24,20,4,42,58,103,1,"https://fbref.com/en/players/caffaf5a/Maya-Yoshida"
"2292","Ismael Aaneba_2019",2019,"Strasbourg","Ligue 1","Ismael Aaneba","FRA","DF","19",1999,2.3,12,6,7,5,0,5,10,50,5,5,0,5,8,20,9,0,"https://fbref.com/en/players/a7e4760c/Ismael-Aaneba"
"2293","Ludovic Ajorque_2019",2019,"Strasbourg","Ligue 1","Ludovic Ajorque","FRA","FW","24",1994,17,17,13,1,10,6,4,9,44.4,5,5,0,5,5,22,9,0,"https://fbref.com/en/players/462475ed/Ludovic-Ajorque"
"2294","Anthony Caci_2019",2019,"Strasbourg","Ligue 1","Anthony Caci","FRA","DF","21",1997,25.5,56,30,38,14,4,24,46,52.2,22,20,10,10,47,103,63,0,"https://fbref.com/en/players/0118c54c/Anthony-Caci"
"2295","Lionel Carole_2019",2019,"Strasbourg","Ligue 1","Lionel Carole","FRA","DF,FW","27",1991,19.2,25,12,16,7,2,11,16,68.8,5,19,5,14,32,57,51,0,"https://fbref.com/en/players/5b5724d2/Lionel-Carole"
"2296","Benjamin Corgnet_2019",2019,"Strasbourg","Ligue 1","Benjamin Corgnet","FRA","MF,FW","31",1987,7.5,21,12,7,9,5,4,11,36.4,7,1,0,1,6,27,9,0,"https://fbref.com/en/players/cfd8dde3/Benjamin-Corgnet"
"2297","Nuno da Costa_2019",2019,"Strasbourg","Ligue 1","Nuno da Costa","CPV","FW","27",1991,22.8,39,27,10,19,10,10,38,26.3,28,24,1,23,14,53,9,0,"https://fbref.com/en/players/909222de/Nuno-da-Costa"
"2298","Youssouf Fofana_2019",2019,"Strasbourg","Ligue 1","Youssouf Fofana","FRA","MF","19",1999,10.1,28,20,5,20,3,9,27,33.3,18,7,0,7,11,39,8,0,"https://fbref.com/en/players/822d51d7/Youssouf-Fofana"
"2299","Anthony Gonçalves_2019",2019,"Strasbourg","Ligue 1","Anthony Gonçalves","FRA","MF,FW","32",1986,11.8,22,15,12,8,2,7,22,31.8,15,21,2,19,10,32,17,0,"https://fbref.com/en/players/c27dfb82/Anthony-Goncalves"
"2300","Samuel Grandsir_2019",2019,"Strasbourg","Ligue 1","Samuel Grandsir","FRA","MF,FW","21",1996,2.6,9,6,5,3,1,3,7,42.9,4,2,0,2,1,10,0,0,"https://fbref.com/en/players/d2448564/Samuel-Grandsir"
"2301","Jérémy Grimm_2019",2019,"Strasbourg","Ligue 1","Jérémy Grimm","FRA","MF","31",1987,1.9,4,2,2,2,0,3,5,60,2,1,0,1,4,8,5,0,"https://fbref.com/en/players/53283127/Jeremy-Grimm"
"2302","Eiji Kawashima_2019",2019,"Strasbourg","Ligue 1","Eiji Kawashima","JPN","GK","35",1983,1,0,0,0,0,0,0,0,NA,0,0,0,0,0,0,0,0,"https://fbref.com/en/players/a4527d33/Eiji-Kawashima"
"2303","Lamine Koné_2019",2019,"Strasbourg","Ligue 1","Lamine Koné","CIV","DF","29",1989,23.9,21,16,9,9,3,6,9,66.7,3,18,13,5,33,54,66,3,"https://fbref.com/en/players/a46472d0/Lamine-Kone"
"2304","Kenny Lala_2019",2019,"Strasbourg","Ligue 1","Kenny Lala","FRA","DF,FW","26",1991,34,78,45,48,23,7,30,53,56.6,23,26,9,17,28,106,62,2,"https://fbref.com/en/players/770d7eb8/Kenny-Lala"
"2305","Dimitri Liénard_2019",2019,"Strasbourg","Ligue 1","Dimitri Liénard","FRA","MF,DF","30",1988,14.3,33,18,20,9,4,21,45,46.7,24,11,2,9,18,51,22,0,"https://fbref.com/en/players/f7691f63/Dimitri-Lienard"
"2306","Jonas Martin_2019",2019,"Strasbourg","Ligue 1","Jonas Martin","FRA","MF","28",1990,22.9,46,28,23,18,5,17,33,51.5,16,30,12,18,30,76,42,0,"https://fbref.com/en/players/468fdbad/Jonas-Martin"
"2307","Pablo Martinez_2019",2019,"Strasbourg","Ligue 1","Pablo Martinez","FRA","DF","29",1989,31.3,51,34,34,17,0,30,49,61.2,19,37,23,14,52,103,132,1,"https://fbref.com/en/players/1ad8cb67/Pablo-Martinez"
"2308","Stefan Mitrović_2019",2019,"Strasbourg","Ligue 1","Stefan Mitrović","SRB","DF","28",1990,33.6,23,16,20,3,0,12,24,50,12,41,31,10,46,69,146,2,"https://fbref.com/en/players/e6777e6b/Stefan-Mitrovic"
"2309","Lebo Mothiba_2019",2019,"Strasbourg","Ligue 1","Lebo Mothiba","RSA","FW","22",1996,19.7,10,9,2,7,1,0,8,0,8,5,1,4,0,10,6,0,"https://fbref.com/en/players/3eaf8817/Lebo-Mothiba"
"2310","Abdallah N'dour_2019",2019,"Strasbourg","Ligue 1","Abdallah N'dour","SEN","DF","24",1993,3.2,6,4,3,3,0,4,9,44.4,5,4,2,2,5,11,8,0,"https://fbref.com/en/players/4749367a/Abdallah-Ndour"
"2311","Sanjin Prcić_2019",2019,"Strasbourg","Ligue 1","Sanjin Prcić","BIH","MF","24",1993,11.7,19,14,11,7,1,8,18,44.4,10,22,8,14,18,37,7,1,"https://fbref.com/en/players/51c30111/Sanjin-Prcic"
"2312","Idriss Saadi_2019",2019,"Strasbourg","Ligue 1","Idriss Saadi","ALG","FW,MF","26",1992,0.1,0,0,0,0,0,0,0,NA,0,0,0,0,0,0,0,0,"https://fbref.com/en/players/17f29fb0/Idriss-Saadi"
"2313","Matz Sels_2019",2019,"Strasbourg","Ligue 1","Matz Sels","BEL","GK","26",1992,37,0,0,0,0,0,0,1,0,1,0,0,0,1,1,24,1,"https://fbref.com/en/players/834b5c4c/Matz-Sels"
"2314","Ibrahima Sissoko_2019",2019,"Strasbourg","Ligue 1","Ibrahima Sissoko","FRA","MF","20",1997,29.6,60,41,23,34,3,23,55,41.8,32,37,3,34,34,94,39,1,"https://fbref.com/en/players/0f8418aa/Ibrahima-Sissoko"
"2315","Adrien Thomasson_2019",2019,"Strasbourg","Ligue 1","Adrien Thomasson","FRA","MF,FW","24",1993,27.5,54,27,18,23,13,21,66,31.8,45,29,5,24,18,72,12,1,"https://fbref.com/en/players/c76b7567/Adrien-Thomasson"
"2316","Mootaz Zemzemi_2019",2019,"Strasbourg","Ligue 1","Mootaz Zemzemi","TUN","FW,MF","18",1999,0,1,0,0,0,1,0,0,NA,0,0,0,0,0,1,0,0,"https://fbref.com/en/players/242b350c/Mootaz-Zemzemi"
"2317","Kévin Zohi_2019",2019,"Strasbourg","Ligue 1","Kévin Zohi","MLI","FW,MF","21",1996,7,14,10,6,6,2,5,9,55.6,4,8,0,8,7,21,5,0,"https://fbref.com/en/players/775185ae/Kevin-Zohi"
"2318","Antonis Aidonis_2019",2019,"Stuttgart","Bundesliga","Antonis Aidonis","GER","DF","17",2001,0.9,3,1,1,1,1,1,4,25,3,1,0,1,2,5,2,0,"https://fbref.com/en/players/54507986/Antonis-Aidonis"
"2319","Chadrac Akolo_2019",2019,"Stuttgart","Bundesliga","Chadrac Akolo","COD","MF,FW","23",1995,5.8,9,6,2,7,0,1,3,33.3,2,7,0,7,4,13,1,0,"https://fbref.com/en/players/debc2f28/Chadrac-Akolo"
"2320","Dennis Aogo_2019",2019,"Stuttgart","Bundesliga","Dennis Aogo","GER","MF","31",1987,11.4,15,10,6,7,2,6,15,40,9,8,1,7,9,24,19,0,"https://fbref.com/en/players/c311243f/Dennis-Aogo"
"2321","Santiago Ascacíbar_2019",2019,"Stuttgart","Bundesliga","Santiago Ascacíbar","ARG","MF","21",1997,27,78,50,43,29,6,34,74,45.9,40,48,10,38,43,121,34,1,"https://fbref.com/en/players/e26fcca3/Santiago-Ascacibar"
"2322","Holger Badstuber_2019",2019,"Stuttgart","Bundesliga","Holger Badstuber","GER","DF","29",1989,5.8,12,4,8,4,0,7,8,87.5,1,6,2,4,9,21,21,1,"https://fbref.com/en/players/45b7edae/Holger-Badstuber"
"2323","Timo Baumgartl_2019",2019,"Stuttgart","Bundesliga","Timo Baumgartl","GER","DF","22",1996,18,33,23,21,12,0,11,19,57.9,8,31,22,9,26,59,100,0,"https://fbref.com/en/players/bd7d2e6d/Timo-Baumgartl"
"2324","Andreas Beck_2019",2019,"Stuttgart","Bundesliga","Andreas Beck","GER","DF","31",1987,19.7,35,19,17,17,1,11,27,40.7,16,32,6,26,22,57,54,0,"https://fbref.com/en/players/00a6485f/Andreas-Beck"
"2325","Gonzalo Castro_2019",2019,"Stuttgart","Bundesliga","Gonzalo Castro","GER","MF","31",1987,18.8,50,28,21,25,4,19,43,44.2,24,23,5,18,29,79,22,1,"https://fbref.com/en/players/68829001/Gonzalo-Castro"
"2326","Leon Dajaku_2019",2019,"Stuttgart","Bundesliga","Leon Dajaku","GER","DF,MF","17",2001,0.3,2,1,0,1,1,0,0,NA,0,1,0,1,0,2,0,0,"https://fbref.com/en/players/aeaf1bc1/Leon-Dajaku"
"2327","Daniel Didavi_2019",2019,"Stuttgart","Bundesliga","Daniel Didavi","GER","MF,FW","28",1990,10.6,21,15,8,10,3,7,20,35,13,11,1,10,4,25,5,0,"https://fbref.com/en/players/d3096421/Daniel-Didavi"
"2328","Anastasios Donis_2019",2019,"Stuttgart","Bundesliga","Anastasios Donis","GRE","FW,MF","21",1996,10.7,15,13,8,4,3,3,11,27.3,8,7,0,7,4,19,0,0,"https://fbref.com/en/players/0f26fd24/Anastasios-Donis"
"2329","Alexander Esswein_2019",2019,"Stuttgart","Bundesliga","Alexander Esswein","GER","MF,FW","28",1990,13.9,17,11,6,4,7,6,21,28.6,15,17,0,17,12,29,16,0,"https://fbref.com/en/players/b48215cd/Alexander-Esswein"
"2330","Christian Gentner_2019",2019,"Stuttgart","Bundesliga","Christian Gentner","GER","MF,FW","32",1985,22.4,61,38,29,26,6,16,50,32,34,30,3,27,31,92,41,1,"https://fbref.com/en/players/a4f94a0d/Christian-Gentner"
"2331","Mario Gómez_2019",2019,"Stuttgart","Bundesliga","Mario Gómez","GER","FW","33",1985,24.6,19,11,6,10,3,2,12,16.7,10,17,6,11,5,24,33,0,"https://fbref.com/en/players/71a20ce8/Mario-Gomez"
"2332","Nicolás González_2019",2019,"Stuttgart","Bundesliga","Nicolás González","ARG","FW,MF","20",1998,24,19,14,3,7,9,9,19,47.4,10,32,2,30,11,30,27,0,"https://fbref.com/en/players/2374aaca/Nicolas-Gonzalez"
"2333","Emiliano Insúa_2019",2019,"Stuttgart","Bundesliga","Emiliano Insúa","ARG","DF","29",1989,23.5,51,33,26,18,7,25,42,59.5,17,29,2,27,31,82,55,1,"https://fbref.com/en/players/f3cccffe/Emiliano-Insua"
"2334","Ozan Kabak_2019",2019,"Stuttgart","Bundesliga","Ozan Kabak","TUR","DF","18",2000,15,33,19,22,9,2,9,19,47.4,10,15,8,7,23,56,58,1,"https://fbref.com/en/players/2d61d13a/Ozan-Kabak"
"2335","Marc-Oliver Kempf_2019",2019,"Stuttgart","Bundesliga","Marc-Oliver Kempf","GER","DF","23",1995,22.5,33,18,26,7,0,12,24,50,12,35,21,14,46,79,141,1,"https://fbref.com/en/players/815c314f/Marc-Oliver-Kempf"
"2336","Pablo Maffeo_2019",2019,"Stuttgart","Bundesliga","Pablo Maffeo","ESP","DF,MF","21",1997,6.6,15,13,10,5,0,6,13,46.2,7,8,4,4,13,28,17,0,"https://fbref.com/en/players/5db04597/Pablo-Maffeo"
"2337","Hans Nunoo Sarpei_2019",2019,"Stuttgart","Bundesliga","Hans Nunoo Sarpei","GHA","FW,MF","19",1998,0.5,1,1,0,1,0,0,0,NA,0,0,0,0,0,1,0,0,"https://fbref.com/en/players/9593331d/Hans-Nunoo-Sarpei"
"2338","Berkay Özcan_2019",2019,"Stuttgart","Bundesliga","Berkay Özcan","TUR","MF,DF","20",1998,0.6,0,0,0,0,0,0,0,NA,0,1,0,1,0,0,0,0,"https://fbref.com/en/players/31114001/Berkay-Ozcan"
"2339","Benjamin Pavard_2019",2019,"Stuttgart","Bundesliga","Benjamin Pavard","FRA","DF","22",1996,29,28,20,21,6,1,12,19,63.2,7,27,19,8,48,76,189,2,"https://fbref.com/en/players/45a03961/Benjamin-Pavard"
"2340","Borna Sosa_2019",2019,"Stuttgart","Bundesliga","Borna Sosa","CRO","DF,MF","20",1998,6.8,13,7,8,4,1,4,9,44.4,5,5,1,4,6,19,34,0,"https://fbref.com/en/players/af0d79a9/Borna-Sosa"
"2341","Erik Thommy_2019",2019,"Stuttgart","Bundesliga","Erik Thommy","GER","MF,FW","23",1994,8.8,5,3,3,1,1,1,7,14.3,6,16,1,15,14,19,4,0,"https://fbref.com/en/players/df8e7b62/Erik-Thommy"
"2342","Ron-Robert Zieler_2019",2019,"Stuttgart","Bundesliga","Ron-Robert Zieler","GER","GK","29",1989,34,2,1,2,0,0,1,4,25,3,1,0,1,1,3,19,3,"https://fbref.com/en/players/a0606ae8/Ron-Robert-Zieler"
"2343","Steven Zuber_2019",2019,"Stuttgart","Bundesliga","Steven Zuber","SUI","MF,FW","26",1991,11.7,6,3,2,2,2,1,13,7.7,12,14,2,12,6,12,6,0,"https://fbref.com/en/players/b6a6e0a7/Steven-Zuber"
"2344","Ola Aina_2019",2019,"Torino","Serie A","Ola Aina","NGA","DF","21",1996,24,54,36,32,20,2,23,48,47.9,25,30,3,27,39,93,59,2,"https://fbref.com/en/players/246d153b/Ola-Aina"
"2345","Cristian Ansaldi_2019",2019,"Torino","Serie A","Cristian Ansaldi","ARG","DF,MF","31",1986,20.1,50,26,19,21,10,15,30,50,15,21,4,17,15,65,31,0,"https://fbref.com/en/players/bbafc0c4/Cristian-Ansaldi"
"2346","Daniele Baselli_2019",2019,"Torino","Serie A","Daniele Baselli","ITA","MF","26",1992,26.4,65,45,22,34,9,16,44,36.4,28,30,6,24,34,99,32,0,"https://fbref.com/en/players/ea06dd97/Daniele-Baselli"
"2347","Andrea Belotti_2019",2019,"Torino","Serie A","Andrea Belotti","ITA","FW","24",1993,36.7,33,22,8,15,10,6,30,20,24,36,5,31,15,48,23,0,"https://fbref.com/en/players/d705ba44/Andrea-Belotti"
"2348","Álex Berenguer_2019",2019,"Torino","Serie A","Álex Berenguer","ESP","MF,DF","23",1995,16.5,31,20,12,17,2,14,34,41.2,20,20,1,19,8,39,14,0,"https://fbref.com/en/players/dc1c2fce/Alex-Berenguer"
"2349","Gleison Bremer_2019",2019,"Torino","Serie A","Gleison Bremer","BRA","DF","21",1997,2,3,1,1,2,0,1,2,50,1,4,1,3,8,11,9,0,"https://fbref.com/en/players/5fd5ed86/Gleison-Bremer"
"2350","Vitalie Damașcan_2019",2019,"Torino","Serie A","Vitalie Damașcan","MDA","MF","19",1999,0,1,1,0,1,0,1,1,100,0,0,0,0,0,1,0,0,"https://fbref.com/en/players/54e0c0cc/Vitalie-Damascan"
"2351","Lorenzo De Silvestri_2019",2019,"Torino","Serie A","Lorenzo De Silvestri","ITA","DF","30",1988,26.8,15,11,8,5,2,7,24,29.2,17,53,3,50,22,37,69,2,"https://fbref.com/en/players/e74f0e59/Lorenzo-De-Silvestri"
"2352","Koffi Djidji_2019",2019,"Torino","Serie A","Koffi Djidji","CIV","DF","25",1992,15.4,37,23,27,9,1,12,20,60,8,26,19,7,24,61,72,1,"https://fbref.com/en/players/933d3b51/Koffi-Djidji"
"2353","Simone Edera_2019",2019,"Torino","Serie A","Simone Edera","ITA","MF","21",1997,0.9,0,0,0,0,0,0,1,0,1,1,0,1,1,1,0,0,"https://fbref.com/en/players/8697c095/Simone-Edera"
"2354","Iago Falque_2019",2019,"Torino","Serie A","Iago Falque","ESP","FW,MF","28",1990,17.9,13,8,3,8,2,3,16,18.8,13,14,0,14,3,16,2,0,"https://fbref.com/en/players/440c84ed/Iago-Falque"
"2355","Salvador Ichazo_2019",2019,"Torino","Serie A","Salvador Ichazo","URU","GK","26",1992,2.8,0,0,0,0,0,0,0,NA,0,0,0,0,0,0,0,0,"https://fbref.com/en/players/514f0896/Salvador-Ichazo"
"2356","Armando Izzo_2019",2019,"Torino","Serie A","Armando Izzo","ITA","DF","26",1992,36.3,76,50,35,35,6,33,53,62.3,20,52,24,28,88,164,149,2,"https://fbref.com/en/players/89976232/Armando-Izzo"
"2357","Adem Ljajić_2019",2019,"Torino","Serie A","Adem Ljajić","SRB","MF","26",1991,0.3,0,0,0,0,0,0,1,0,1,0,0,0,0,0,0,0,"https://fbref.com/en/players/2648e18f/Adem-Ljajic"
"2358","Saša Lukić_2019",2019,"Torino","Serie A","Saša Lukić","SRB","MF","21",1996,11,21,11,5,11,5,5,16,31.3,11,13,4,9,12,33,11,0,"https://fbref.com/en/players/c6e8cf1f/Sasa-Lukic"
"2359","Lyanco_2019",2019,"Torino","Serie A","Lyanco","BRA","DF","21",1997,1,1,1,1,0,0,0,0,NA,0,1,1,0,4,5,5,0,"https://fbref.com/en/players/b5bf1770/Lyanco"
"2360","Soualiho Meïté_2019",2019,"Torino","Serie A","Soualiho Meïté","FRA","MF","24",1994,29.5,46,21,13,22,11,23,46,50,23,46,6,40,29,75,26,0,"https://fbref.com/en/players/5cec2c74/Soualiho-Meite"
"2361","Vincenzo Millico_2019",2019,"Torino","Serie A","Vincenzo Millico","ITA","MF","17",2000,0,0,0,0,0,0,0,0,NA,0,0,0,0,0,0,0,0,"https://fbref.com/en/players/6817095b/Vincenzo-Millico"
"2362","Emiliano Moretti_2019",2019,"Torino","Serie A","Emiliano Moretti","ITA","DF","37",1981,22.3,30,21,21,9,0,13,20,65,7,14,6,8,24,54,65,1,"https://fbref.com/en/players/55667895/Emiliano-Moretti"
"2363","Nicolas Nkoulou_2019",2019,"Torino","Serie A","Nicolas Nkoulou","CMR","DF","28",1990,35.7,45,29,34,10,1,15,25,60,10,42,28,14,70,115,174,2,"https://fbref.com/en/players/93cf32a8/Nicolas-Nkoulou"
"2364","Vittorio Parigini_2019",2019,"Torino","Serie A","Vittorio Parigini","ITA","MF,DF","22",1996,4.2,11,10,3,6,2,6,9,66.7,3,3,0,3,1,12,5,0,"https://fbref.com/en/players/75efed2e/Vittorio-Parigini"
"2365","Tomás Rincón_2019",2019,"Torino","Serie A","Tomás Rincón","VEN","MF","30",1988,31.1,75,44,25,41,9,31,68,45.6,37,35,5,30,42,117,71,1,"https://fbref.com/en/players/f1cfc209/Tomas-Rincon"
"2366","Salvatore Sirigu_2019",2019,"Torino","Serie A","Salvatore Sirigu","ITA","GK","31",1987,35.2,0,0,0,0,0,0,2,0,2,0,0,0,2,2,21,1,"https://fbref.com/en/players/10dc46f0/Salvatore-Sirigu"
"2367","Roberto Soriano_2019",2019,"Torino","Serie A","Roberto Soriano","ITA","MF","27",1991,5.2,9,5,0,5,4,1,8,12.5,7,9,0,9,6,15,1,0,"https://fbref.com/en/players/9d4c45d6/Roberto-Soriano"
"2368","Simone Zaza_2019",2019,"Torino","Serie A","Simone Zaza","ITA","FW,MF","27",1991,16,20,9,3,12,5,1,8,12.5,7,12,1,11,4,24,9,0,"https://fbref.com/en/players/9592289a/Simone-Zaza"
"2369","Toby Alderweireld_2019",2019,"Tottenham","Premier League","Toby Alderweireld","BEL","DF","29",1989,32.5,37,23,25,10,2,12,22,54.5,10,41,22,19,24,61,175,0,"https://fbref.com/en/players/f7d50789/Toby-Alderweireld"
"2370","Dele Alli_2019",2019,"Tottenham","Premier League","Dele Alli","ENG","MF","22",1996,20.3,33,19,6,14,13,5,24,20.8,19,33,5,28,19,52,20,0,"https://fbref.com/en/players/cea4ee8f/Dele-Alli"
"2371","Luke Amos_2019",2019,"Tottenham","Premier League","Luke Amos","ENG","MF","21",1997,0,1,0,0,1,0,0,0,NA,0,0,0,0,0,1,0,0,"https://fbref.com/en/players/77128f7e/Luke-Amos"
"2372","Serge Aurier_2019",2019,"Tottenham","Premier League","Serge Aurier","CIV","DF","25",1992,6.3,20,12,12,4,4,8,15,53.3,7,8,2,6,7,27,20,0,"https://fbref.com/en/players/5c2b4f07/Serge-Aurier"
"2373","Ben Davies_2019",2019,"Tottenham","Premier League","Ben Davies","WAL","DF","25",1993,20.5,56,30,39,13,4,38,54,70.4,16,23,10,13,23,79,68,1,"https://fbref.com/en/players/44781702/Ben-Davies"
"2374","Mousa Dembélé_2019",2019,"Tottenham","Premier League","Mousa Dembélé","BEL","MF","31",1987,5.7,13,9,6,6,1,4,7,57.1,3,4,1,3,7,20,5,2,"https://fbref.com/en/players/f7ee69fb/Mousa-Dembele"
"2375","Eric Dier_2019",2019,"Tottenham","Premier League","Eric Dier","ENG","MF,DF","24",1994,16.7,26,16,7,15,4,19,47,40.4,28,27,12,15,21,47,46,1,"https://fbref.com/en/players/ac861941/Eric-Dier"
"2376","Christian Eriksen_2019",2019,"Tottenham","Premier League","Christian Eriksen","DEN","MF","26",1992,30.8,41,25,8,20,13,17,59,28.8,42,26,3,23,15,56,13,0,"https://fbref.com/en/players/980522ec/Christian-Eriksen"
"2377","Juan Foyth_2019",2019,"Tottenham","Premier League","Juan Foyth","ARG","DF","20",1998,9.9,31,17,20,11,0,14,19,73.7,5,12,5,7,10,41,50,1,"https://fbref.com/en/players/6c7762c3/Juan-Foyth"
"2378","Paulo Gazzaniga_2019",2019,"Tottenham","Premier League","Paulo Gazzaniga","ARG","GK","26",1992,3,0,0,0,0,0,0,0,NA,0,0,0,0,0,0,1,0,"https://fbref.com/en/players/63d17038/Paulo-Gazzaniga"
"2379","Son Heung-min_2019",2019,"Tottenham","Premier League","Son Heung-min","KOR","FW,MF","26",1992,22.7,23,12,7,12,4,10,34,29.4,24,26,2,24,8,31,4,1,"https://fbref.com/en/players/92e7e919/Son-Heung-min"
"2380","Vincent Janssen_2019",2019,"Tottenham","Premier League","Vincent Janssen","NED","FW","24",1994,0.4,2,1,0,2,0,0,0,NA,0,0,0,0,0,2,1,0,"https://fbref.com/en/players/31dce0c8/Vincent-Janssen"
"2381","Harry Kane_2019",2019,"Tottenham","Premier League","Harry Kane","ENG","FW","25",1993,26.9,10,6,2,8,0,1,14,7.1,13,16,6,10,1,11,14,0,"https://fbref.com/en/players/21a66f6a/Harry-Kane"
"2382","Érik Lamela_2019",2019,"Tottenham","Premier League","Érik Lamela","ARG","MF,FW","26",1992,10.8,17,13,6,7,4,5,14,35.7,9,14,0,14,7,24,1,0,"https://fbref.com/en/players/abe66106/Erik-Lamela"
"2383","Fernando Llorente_2019",2019,"Tottenham","Premier League","Fernando Llorente","ESP","FW","33",1985,7.7,4,2,3,0,1,2,3,66.7,1,7,2,5,1,5,10,0,"https://fbref.com/en/players/82dbf623/Fernando-Llorente"
"2384","Hugo Lloris_2019",2019,"Tottenham","Premier League","Hugo Lloris","FRA","GK","31",1986,33,1,0,1,0,0,0,2,0,2,0,0,0,0,1,13,5,"https://fbref.com/en/players/8f62b6ee/Hugo-Lloris"
"2385","Lucas Moura_2019",2019,"Tottenham","Premier League","Lucas Moura","BRA","FW,MF","25",1992,23.6,35,18,8,20,7,9,27,33.3,18,15,1,14,24,59,24,0,"https://fbref.com/en/players/2b622f01/Lucas-Moura"
"2386","Georges-Kévin N'Koudou_2019",2019,"Tottenham","Premier League","Georges-Kévin N'Koudou","CMR","FW","23",1995,0.1,0,0,0,0,0,0,0,NA,0,0,0,0,0,0,0,0,"https://fbref.com/en/players/76c131da/Georges-Kevin-NKoudou"
"2387","Danny Rose_2019",2019,"Tottenham","Premier League","Danny Rose","ENG","DF","28",1990,20,49,31,26,16,7,20,32,62.5,12,24,4,20,24,73,28,3,"https://fbref.com/en/players/89d10e53/Danny-Rose"
"2388","Davinson Sánchez_2019",2019,"Tottenham","Premier League","Davinson Sánchez","COL","DF","22",1996,21.6,37,20,28,9,0,20,37,54.1,17,17,9,8,30,67,103,2,"https://fbref.com/en/players/da7b447d/Davinson-Sanchez"
"2389","Moussa Sissoko_2019",2019,"Tottenham","Premier League","Moussa Sissoko","FRA","MF,FW","28",1989,25.9,36,25,18,14,4,15,29,51.7,14,31,4,27,16,52,25,2,"https://fbref.com/en/players/2acd49b9/Moussa-Sissoko"
"2390","Oliver Skipp_2019",2019,"Tottenham","Premier League","Oliver Skipp","ENG","MF","17",2000,2.4,7,3,4,3,0,4,6,66.7,2,2,1,1,1,8,7,0,"https://fbref.com/en/players/6250083a/Oliver-Skipp"
"2391","Kieran Trippier_2019",2019,"Tottenham","Premier League","Kieran Trippier","ENG","DF","27",1990,25.3,67,37,43,16,8,37,62,59.7,25,38,5,33,23,90,77,2,"https://fbref.com/en/players/21512407/Kieran-Trippier"
"2392","Jan Vertonghen_2019",2019,"Tottenham","Premier League","Jan Vertonghen","BEL","DF","31",1987,21.2,39,24,17,20,2,14,24,58.3,10,18,11,7,32,71,81,0,"https://fbref.com/en/players/ba23a904/Jan-Vertonghen"
"2393","Michel Vorm_2019",2019,"Tottenham","Premier League","Michel Vorm","NED","GK","34",1983,2,0,0,0,0,0,0,0,NA,0,0,0,0,0,0,1,0,"https://fbref.com/en/players/1bebde9d/Michel-Vorm"
"2394","Kyle Walker-Peters_2019",2019,"Tottenham","Premier League","Kyle Walker-Peters","ENG","DF","21",1997,4.2,7,4,4,2,1,3,4,75,1,5,1,4,4,11,6,0,"https://fbref.com/en/players/984a5a64/Kyle-Walker-Peters"
"2395","Victor Wanyama_2019",2019,"Tottenham","Premier League","Victor Wanyama","KEN","MF","27",1991,5.7,13,13,8,5,0,6,12,50,6,9,3,6,7,20,11,0,"https://fbref.com/en/players/e0900238/Victor-Wanyama"
"2396","Harry Winks_2019",2019,"Tottenham","Premier League","Harry Winks","ENG","MF","22",1996,17.7,22,13,12,9,1,5,30,16.7,25,19,3,16,21,43,19,0,"https://fbref.com/en/players/2f7acede/Harry-Winks"
"2397","Kelvin Amian_2019",2019,"Toulouse","Ligue 1","Kelvin Amian","FRA","DF","20",1998,32,68,45,54,12,2,20,30,66.7,10,36,13,23,36,104,113,1,"https://fbref.com/en/players/bcc81786/Kelvin-Amian"
"2398","Yann Bodiger_2019",2019,"Toulouse","Ligue 1","Yann Bodiger","FRA","MF","23",1995,0.1,0,0,0,0,0,0,1,0,1,0,0,0,0,0,0,0,"https://fbref.com/en/players/8c2c48a9/Yann-Bodiger"
"2399","John Bostock_2019",2019,"Toulouse","Ligue 1","John Bostock","TRI","MF","26",1992,10.9,24,14,14,10,0,9,30,30,21,12,2,10,17,41,11,0,"https://fbref.com/en/players/46291841/John-Bostock"
"2400","Yannick Cahuzac_2019",2019,"Toulouse","Ligue 1","Yannick Cahuzac","FRA","MF,DF","33",1985,15.9,33,19,15,15,3,17,32,53.1,15,16,4,12,24,57,55,0,"https://fbref.com/en/players/677ee102/Yannick-Cahuzac"
"2401","Bafodé Diakité_2019",2019,"Toulouse","Ligue 1","Bafodé Diakité","FRA","DF","17",2001,7,15,7,5,9,1,10,14,71.4,4,15,3,12,11,26,29,0,"https://fbref.com/en/players/1bfb6fef/Bafode-Diakite"
"2402","Mathieu Dossevi_2019",2019,"Toulouse","Ligue 1","Mathieu Dossevi","TOG","FW,MF","30",1988,27.4,42,28,20,11,11,13,40,32.5,27,29,1,28,33,75,13,0,"https://fbref.com/en/players/6421dd73/Mathieu-Dossevi"
"2403","Jimmy Durmaz_2019",2019,"Toulouse","Ligue 1","Jimmy Durmaz","SWE","MF,FW","29",1989,21.1,34,22,8,13,13,15,38,39.5,23,14,2,12,11,45,16,1,"https://fbref.com/en/players/f09a8b75/Jimmy-Durmaz"
"2404","Steven Fortes_2019",2019,"Toulouse","Ligue 1","Steven Fortes","CPV","DF","26",1992,1.5,3,1,1,2,0,0,0,NA,0,1,1,0,2,5,9,2,"https://fbref.com/en/players/574aa9ec/Steven-Fortes"
"2405","Manu García_2019",2019,"Toulouse","Ligue 1","Manu García","ESP","MF","20",1998,20.5,37,26,14,17,6,15,49,30.6,34,16,1,15,15,52,5,0,"https://fbref.com/en/players/6ed1a2a2/Manu-Garcia"
"2406","Mauro Goicoechea_2019",2019,"Toulouse","Ligue 1","Mauro Goicoechea","URU","GK","30",1988,7.9,0,0,0,0,0,0,0,NA,0,0,0,0,0,0,7,0,"https://fbref.com/en/players/132bb875/Mauro-Goicoechea"
"2407","Max Gradel_2019",2019,"Toulouse","Ligue 1","Max Gradel","CIV","FW,MF","30",1987,36,58,35,34,19,5,24,70,34.3,46,53,9,44,18,76,41,0,"https://fbref.com/en/players/c5a500ca/Max-Gradel"
"2408","Corentin Jean_2019",2019,"Toulouse","Ligue 1","Corentin Jean","FRA","FW,MF","23",1995,7,9,6,3,6,0,2,8,25,6,8,0,8,2,11,5,0,"https://fbref.com/en/players/7d9b37bf/Corentin-Jean"
"2409","Christopher Jullien_2019",2019,"Toulouse","Ligue 1","Christopher Jullien","FRA","DF","25",1993,33.5,35,24,23,10,2,12,32,37.5,20,39,27,12,41,76,203,4,"https://fbref.com/en/players/f323d995/Christopher-Jullien"
"2410","Kouadio Koné_2019",2019,"Toulouse","Ligue 1","Kouadio Koné","FRA","MF","17",2001,0.8,4,2,0,4,0,2,4,50,2,0,0,0,0,4,0,0,"https://fbref.com/en/players/86574238/Kouadio-Kone"
"2411","Aaron Leya Iseka_2019",2019,"Toulouse","Ligue 1","Aaron Leya Iseka","BEL","FW","20",1997,16,6,4,1,4,1,1,4,25,3,5,3,2,1,7,10,0,"https://fbref.com/en/players/29ef0f49/Aaron-Leya-Iseka"
"2412","Stéphane Mbia_2019",2019,"Toulouse","Ligue 1","Stéphane Mbia","CMR","DF,MF","32",1986,5,1,0,1,0,0,1,2,50,1,9,4,5,7,8,25,1,"https://fbref.com/en/players/c39d9657/Stephane-Mbia"
"2413","Clément Michelin_2019",2019,"Toulouse","Ligue 1","Clément Michelin","FRA","DF","21",1997,1,3,2,2,1,0,2,3,66.7,1,0,0,0,3,6,7,0,"https://fbref.com/en/players/cb9ec45d/Clement-Michelin"
"2414","Hakim El Mokeddem_2019",2019,"Toulouse","Ligue 1","Hakim El Mokeddem","BRA","FW,MF","19",1999,0.3,1,1,1,0,0,0,1,0,1,0,0,0,0,1,1,0,"https://fbref.com/en/players/e493cff8/Hakim-El-Mokeddem"
"2415","Steven Moreira_2019",2019,"Toulouse","Ligue 1","Steven Moreira","FRA","DF,MF","23",1994,9.6,19,8,13,5,1,10,17,58.8,7,14,0,14,10,29,19,1,"https://fbref.com/en/players/f10983ae/Steven-Moreira"
"2416","François Moubandje_2019",2019,"Toulouse","Ligue 1","François Moubandje","SUI","DF","28",1990,21.5,38,22,22,10,6,17,22,77.3,5,18,4,14,27,65,74,0,"https://fbref.com/en/players/6ca88b2a/Francois-Moubandje"
"2417","Ndombe Mubele_2019",2019,"Toulouse","Ligue 1","Ndombe Mubele","COD","FW","24",1994,5.2,9,4,5,2,2,4,9,44.4,5,4,0,4,2,11,2,0,"https://fbref.com/en/players/176674ab/Ndombe-Mubele"
"2418","Nathan N'Goumou_2019",2019,"Toulouse","Ligue 1","Nathan N'Goumou","FRA","FW","18",2000,0.8,1,1,0,1,0,0,1,0,1,1,0,1,0,1,3,0,"https://fbref.com/en/players/e110ea4b/Nathan-NGoumou"
"2419","Baptiste Reynet_2019",2019,"Toulouse","Ligue 1","Baptiste Reynet","FRA","GK","27",1990,30,0,0,0,0,0,0,3,0,3,0,0,0,1,1,14,2,"https://fbref.com/en/players/bcf1b2e9/Baptiste-Reynet"
"2420","Ibrahim Sangaré_2019",2019,"Toulouse","Ligue 1","Ibrahim Sangaré","CIV","MF","20",1997,27.4,102,66,50,44,8,32,63,50.8,31,52,20,32,29,131,49,2,"https://fbref.com/en/players/bced0375/Ibrahim-Sangare"
"2421","Yaya Sanogo_2019",2019,"Toulouse","Ligue 1","Yaya Sanogo","FRA","FW","25",1993,13.8,4,2,0,2,2,2,4,50,2,3,0,3,3,7,15,0,"https://fbref.com/en/players/11ced928/Yaya-Sanogo"
"2422","Gen Shoji_2019",2019,"Toulouse","Ligue 1","Gen Shoji","JPN","DF","25",1992,18,24,13,16,8,0,11,24,45.8,13,22,14,8,21,45,56,0,"https://fbref.com/en/players/8b28686a/Gen-Shoji"
"2423","Kalidou Sidibé_2019",2019,"Toulouse","Ligue 1","Kalidou Sidibé","FRA","MF","19",1999,14,24,12,11,12,1,7,15,46.7,8,16,3,13,17,41,26,1,"https://fbref.com/en/players/ea540835/Kalidou-Sidibe"
"2424","Issiaga Sylla_2019",2019,"Toulouse","Ligue 1","Issiaga Sylla","GUI","DF,MF","24",1994,22.2,54,36,30,24,0,28,53,52.8,25,36,10,26,39,93,77,0,"https://fbref.com/en/players/b99bec05/Issiaga-Sylla"
"2425","Jean-Clair Todibo_2019",2019,"Toulouse","Ligue 1","Jean-Clair Todibo","FRA","DF","18",1999,9.3,21,18,19,2,0,11,13,84.6,2,14,5,9,14,35,62,2,"https://fbref.com/en/players/88f130ed/Jean-Clair-Todibo"
"2426","Emmanuel Agyemang-Badu_2019",2019,"Udinese","Serie A","Emmanuel Agyemang-Badu","GHA","MF","27",1990,1.8,4,0,1,2,1,1,1,100,0,2,0,2,1,5,2,0,"https://fbref.com/en/players/fe0b8f0e/Emmanuel-Agyemang-Badu"
"2427","Andrija Balić_2019",2019,"Udinese","Serie A","Andrija Balić","CRO","FW,MF","20",1997,0.3,1,0,0,0,1,0,1,0,1,0,0,0,0,1,1,0,"https://fbref.com/en/players/9be4ee80/Andrija-Balic"
"2428","Antonín Barák_2019",2019,"Udinese","Serie A","Antonín Barák","CZE","MF,FW","23",1994,3.7,9,6,4,5,0,2,11,18.2,9,4,0,4,2,11,2,0,"https://fbref.com/en/players/01efac19/Antonin-Barak"
"2429","Valon Behrami_2019",2019,"Udinese","Serie A","Valon Behrami","SUI","MF","33",1985,15.1,65,38,25,34,6,18,44,40.9,26,29,12,17,18,83,26,0,"https://fbref.com/en/players/d3d758d8/Valon-Behrami"
"2430","Marco D'Alessandro_2019",2019,"Udinese","Serie A","Marco D'Alessandro","ITA","DF","27",1991,16.6,55,34,34,15,6,29,49,59.2,20,24,2,22,9,64,50,1,"https://fbref.com/en/players/060606ec/Marco-DAlessandro"
"2431","Sebastien De Maio_2019",2019,"Udinese","Serie A","Sebastien De Maio","FRA","DF","31",1987,13,11,7,7,4,0,3,12,25,9,22,17,5,12,23,93,0,"https://fbref.com/en/players/952a03fe/Sebastien-De-Maio"
"2432","Rodrigo De Paul_2019",2019,"Udinese","Serie A","Rodrigo De Paul","ARG","MF,FW","24",1994,35.4,53,33,21,27,5,13,42,31,29,35,2,33,32,85,28,0,"https://fbref.com/en/players/162efffd/Rodrigo-De-Paul"
"2433","Seko Fofana_2019",2019,"Udinese","Serie A","Seko Fofana","CIV","MF","23",1995,29.3,25,13,14,10,1,6,36,16.7,30,20,7,13,29,54,18,3,"https://fbref.com/en/players/5313ed43/Seko-Fofana"
"2434","Emil Hallfreðsson_2019",2019,"Udinese","Serie A","Emil Hallfreðsson","ISL","MF","34",1984,1.5,0,0,0,0,0,0,1,0,1,1,1,0,3,3,4,0,"https://fbref.com/en/players/86015b20/Emil-Hallfredsson"
"2435","Svante Ingelsson_2019",2019,"Udinese","Serie A","Svante Ingelsson","SWE","DF,MF","20",1998,1.1,1,1,1,0,0,0,0,NA,0,2,0,2,0,1,4,0,"https://fbref.com/en/players/4133cfcf/Svante-Ingelsson"
"2436","Kevin Lasagna_2019",2019,"Udinese","Serie A","Kevin Lasagna","ITA","FW","25",1992,27.3,6,1,0,3,3,2,12,16.7,10,20,2,18,8,14,35,0,"https://fbref.com/en/players/09538fdb/Kevin-Lasagna"
"2437","Darwin Machís_2019",2019,"Udinese","Serie A","Darwin Machís","VEN","FW,MF","25",1993,5.1,7,6,4,3,0,0,4,0,4,6,0,6,2,9,8,0,"https://fbref.com/en/players/ed6ea4d9/Darwin-Machis"
"2438","Rolando Mandragora_2019",2019,"Udinese","Serie A","Rolando Mandragora","ITA","MF","21",1997,32.4,66,35,25,34,7,24,69,34.8,45,49,9,40,43,109,59,0,"https://fbref.com/en/players/c7259b83/Rolando-Mandragora"
"2439","Petar Mićin_2019",2019,"Udinese","Serie A","Petar Mićin","SRB","MF","19",1998,0,0,0,0,0,0,0,0,NA,0,0,0,0,0,0,0,0,"https://fbref.com/en/players/259deea9/Petar-Micin"
"2440","Juan Musso_2019",2019,"Udinese","Serie A","Juan Musso","ARG","GK","24",1994,29,0,0,0,0,0,0,1,0,1,0,0,0,0,0,10,4,"https://fbref.com/en/players/a111cf41/Juan-Musso"
"2441","Bram Nuytinck_2019",2019,"Udinese","Serie A","Bram Nuytinck","NED","DF","28",1990,23.6,50,35,34,13,3,25,33,75.8,8,44,27,17,29,79,126,0,"https://fbref.com/en/players/e33f36d5/Bram-Nuytinck"
"2442","Stefano Okaka_2019",2019,"Udinese","Serie A","Stefano Okaka","ITA","FW","28",1989,10.8,13,7,4,5,4,2,8,25,6,6,1,5,0,13,16,1,"https://fbref.com/en/players/601ef102/Stefano-Okaka"
"2443","Nicholas Opoku_2019",2019,"Udinese","Serie A","Nicholas Opoku","GHA","DF","20",1997,10.1,16,9,15,1,0,10,17,58.8,7,8,5,3,18,34,29,0,"https://fbref.com/en/players/b871bf55/Nicholas-Opoku"
"2444","Giuseppe Pezzella_2019",2019,"Udinese","Serie A","Giuseppe Pezzella","ITA","DF","20",1997,2,5,4,4,1,0,2,8,25,6,2,1,1,1,6,9,0,"https://fbref.com/en/players/149c5f5d/Giuseppe-Pezzella"
"2445","Ignacio Pussetto_2019",2019,"Udinese","Serie A","Ignacio Pussetto","ARG","FW,MF","22",1995,24.2,65,40,25,30,10,15,43,34.9,28,28,3,25,29,94,34,0,"https://fbref.com/en/players/62437b4f/Ignacio-Pussetto"
"2446","Sandro_2019",2019,"Udinese","Serie A","Sandro","BRA","MF","29",1989,6.6,18,10,10,8,0,7,13,53.8,6,14,5,9,11,29,16,0,"https://fbref.com/en/players/c1c2c925/Sandro"
"2447","Samir Santos_2019",2019,"Udinese","Serie A","Samir Santos","BRA","DF","23",1994,20,47,33,27,18,2,19,25,76,6,18,9,9,34,81,96,0,"https://fbref.com/en/players/92b4758e/Samir-Santos"
"2448","Simone Scuffet_2019",2019,"Udinese","Serie A","Simone Scuffet","ITA","GK","22",1996,9,0,0,0,0,0,0,1,0,1,0,0,0,0,0,4,2,"https://fbref.com/en/players/41bd99ea/Simone-Scuffet"
"2449","Jens Stryger Larsen_2019",2019,"Udinese","Serie A","Jens Stryger Larsen","DEN","DF","27",1991,35.9,42,20,24,14,4,22,44,50,22,27,8,19,26,68,98,1,"https://fbref.com/en/players/f91e81c9/Jens-Stryger-Larsen"
"2450","Łukasz Teodorczyk_2019",2019,"Udinese","Serie A","Łukasz Teodorczyk","POL","FW","27",1991,4.4,4,2,2,2,0,2,8,25,6,8,2,6,1,5,4,0,"https://fbref.com/en/players/7e81a17d/Lukasz-Teodorczyk"
"2451","Hidde ter Avest_2019",2019,"Udinese","Serie A","Hidde ter Avest","NED","DF,FW","21",1997,10.8,26,14,17,6,3,14,20,70,6,14,3,11,10,36,39,1,"https://fbref.com/en/players/18f9dbd0/Hidde-ter-Avest"
"2452","William Troost-Ekong_2019",2019,"Udinese","Serie A","William Troost-Ekong","NGA","DF","24",1993,34,31,15,21,9,1,13,24,54.2,11,53,41,12,40,71,200,2,"https://fbref.com/en/players/7ed4921e/William-Troost-Ekong"
"2453","Felipe Vizeu_2019",2019,"Udinese","Serie A","Felipe Vizeu","BRA","FW,DF","21",1997,0.4,0,0,0,0,0,0,0,NA,0,0,0,0,0,0,0,0,"https://fbref.com/en/players/0412b9cd/Felipe-Vizeu"
"2454","Molla Wagué_2019",2019,"Udinese","Serie A","Molla Wagué","MLI","DF","27",1991,1.1,1,1,1,0,0,0,1,0,1,1,0,1,4,5,5,0,"https://fbref.com/en/players/a440d8ca/Molla-Wague"
"2455","Ben Wilmot_2019",2019,"Udinese","Serie A","Ben Wilmot","ENG","DF,MF","18",1999,2.2,0,0,0,0,0,0,2,0,2,2,2,0,2,2,11,0,"https://fbref.com/en/players/2876eaa3/Ben-Wilmot"
"2456","Marvin Zeegelaar_2019",2019,"Udinese","Serie A","Marvin Zeegelaar","NED","DF","27",1990,10.6,30,23,21,6,3,16,24,66.7,8,11,2,9,17,47,38,0,"https://fbref.com/en/players/8abd0c03/Marvin-Zeegelaar"
"2457","Michy Batshuayi_2019",2019,"Valencia","La Liga","Michy Batshuayi","BEL","FW","24",1993,5.9,1,1,0,1,0,0,3,0,3,5,2,3,0,1,3,0,"https://fbref.com/en/players/2973d8ff/Michy-Batshuayi"
"2458","Denis Cheryshev_2019",2019,"Valencia","La Liga","Denis Cheryshev","RUS","MF","27",1990,19,46,32,15,22,9,17,37,45.9,20,35,3,32,15,61,16,0,"https://fbref.com/en/players/0ac94a23/Denis-Cheryshev"
"2459","Francis Coquelin_2019",2019,"Valencia","La Liga","Francis Coquelin","FRA","MF","27",1991,19.6,46,31,25,14,7,17,35,48.6,18,21,5,16,49,95,29,1,"https://fbref.com/en/players/a6951bf8/Francis-Coquelin"
"2460","Mouctar Diakhaby_2019",2019,"Valencia","La Liga","Mouctar Diakhaby","GUI","DF","21",1996,17.6,14,8,10,4,0,5,10,50,5,24,16,8,20,34,94,1,"https://fbref.com/en/players/d2110326/Mouctar-Diakhaby"
"2461","Jaume Doménech_2019",2019,"Valencia","La Liga","Jaume Doménech","ESP","GK","27",1990,4,0,0,0,0,0,0,1,0,1,0,0,0,0,0,1,0,"https://fbref.com/en/players/c9cb972b/Jaume-Domenech"
"2462","Kévin Gameiro_2019",2019,"Valencia","La Liga","Kévin Gameiro","FRA","FW","31",1987,17.9,14,9,4,6,4,1,6,16.7,5,12,2,10,5,19,3,0,"https://fbref.com/en/players/42276181/Kevin-Gameiro"
"2463","Ezequiel Garay_2019",2019,"Valencia","La Liga","Ezequiel Garay","ARG","DF","31",1986,23.7,20,17,15,3,2,9,18,50,9,30,23,7,16,36,140,0,"https://fbref.com/en/players/ac3fb1be/Ezequiel-Garay"
"2464","Gonçalo Guedes_2019",2019,"Valencia","La Liga","Gonçalo Guedes","POR","MF,FW","21",1996,16.3,31,13,16,12,3,14,43,32.6,29,15,0,15,7,38,1,0,"https://fbref.com/en/players/e6bc67d7/Goncalo-Guedes"
"2465","Lee Kangin_2019",2019,"Valencia","La Liga","Lee Kangin","KOR","MF,FW","17",2001,0.3,2,0,1,1,0,1,3,33.3,2,0,0,0,1,3,0,0,"https://fbref.com/en/players/8455ad90/Lee-Kangin"
"2466","Geoffrey Kondogbia_2019",2019,"Valencia","La Liga","Geoffrey Kondogbia","CTA","MF","25",1993,13.8,47,33,18,23,6,12,27,44.4,15,20,7,13,27,74,22,2,"https://fbref.com/en/players/cce181df/Geoffrey-Kondogbia"
"2467","Toni Lato_2019",2019,"Valencia","La Liga","Toni Lato","ESP","DF","20",1997,3,6,4,4,1,1,1,5,20,4,9,3,6,6,12,13,0,"https://fbref.com/en/players/8e088e04/Toni-Lato"
"2468","José Luis Gayà_2019",2019,"Valencia","La Liga","José Luis Gayà","ESP","DF","23",1995,34.9,83,59,56,20,7,46,80,57.5,34,48,6,42,43,126,105,1,"https://fbref.com/en/players/b05e2dbd/Jose-Luis-Gaya"
"2469","Santi Mina_2019",2019,"Valencia","La Liga","Santi Mina","ESP","FW","22",1995,20.6,17,10,1,15,1,3,25,12,22,19,2,17,4,21,20,0,"https://fbref.com/en/players/0b90bb97/Santi-Mina"
"2470","Jeison Murillo_2019",2019,"Valencia","La Liga","Jeison Murillo","COL","DF","26",1992,1,2,1,1,1,0,1,2,50,1,1,0,1,2,4,6,0,"https://fbref.com/en/players/b233e8e4/Jeison-Murillo"
"2471","Neto_2019",2019,"Valencia","La Liga","Neto","BRA","GK","29",1989,34,2,0,2,0,0,2,3,66.7,1,0,0,0,1,3,9,3,"https://fbref.com/en/players/a9dc785c/Neto"
"2472","Daniel Parejo_2019",2019,"Valencia","La Liga","Daniel Parejo","ESP","MF","29",1989,34,73,42,41,24,8,31,90,34.4,59,41,7,34,46,119,26,2,"https://fbref.com/en/players/7460ca0d/Daniel-Parejo"
"2473","Gabriel Paulista_2019",2019,"Valencia","La Liga","Gabriel Paulista","BRA","DF","27",1990,29.1,29,16,20,6,3,14,28,50,14,37,21,16,70,99,162,1,"https://fbref.com/en/players/b7ca5c51/Gabriel-Paulista"
"2474","Cristiano Piccini_2019",2019,"Valencia","La Liga","Cristiano Piccini","ITA","DF","25",1992,20.8,32,23,25,7,0,13,26,50,13,27,7,20,27,59,64,1,"https://fbref.com/en/players/32c0491f/Cristiano-Piccini"
"2475","Rodrigo_2019",2019,"Valencia","La Liga","Rodrigo","ESP","FW","27",1991,28.1,21,10,6,9,6,3,17,17.6,14,17,1,16,3,24,18,0,"https://fbref.com/en/players/1fb1c435/Rodrigo"
"2476","Facundo Roncaglia_2019",2019,"Valencia","La Liga","Facundo Roncaglia","ARG","DF","31",1987,6.7,13,10,8,5,0,4,6,66.7,2,4,2,2,10,23,22,0,"https://fbref.com/en/players/51e3954c/Facundo-Roncaglia"
"2477","Rubén Sobrino_2019",2019,"Valencia","La Liga","Rubén Sobrino","ESP","FW,MF","26",1992,2.1,6,3,1,4,1,1,1,100,0,1,1,0,1,7,1,0,"https://fbref.com/en/players/19b776e9/Ruben-Sobrino"
"2478","Carlos Soler_2019",2019,"Valencia","La Liga","Carlos Soler","ESP","MF","21",1997,27.3,41,28,15,23,3,16,65,24.6,49,46,6,40,19,60,37,0,"https://fbref.com/en/players/fed17f5a/Carlos-Soler"
"2479","Ferrán Torres_2019",2019,"Valencia","La Liga","Ferrán Torres","ESP","MF","18",2000,9.4,15,8,4,8,3,5,11,45.5,6,10,1,9,10,25,9,0,"https://fbref.com/en/players/9e1035f8/Ferran-Torres"
"2480","Rúben Vezo_2019",2019,"Valencia","La Liga","Rúben Vezo","POR","DF","24",1994,2.2,2,1,2,0,0,2,4,50,2,2,1,1,2,4,10,0,"https://fbref.com/en/players/c67cd65c/Ruben-Vezo"
"2481","Daniel Wass_2019",2019,"Valencia","La Liga","Daniel Wass","DEN","DF,MF","29",1989,26.2,35,25,9,19,7,20,42,47.6,22,23,4,19,34,69,49,0,"https://fbref.com/en/players/d83bbc54/Daniel-Wass"
"2482","Rubén Alcaraz_2019",2019,"Valladolid","La Liga","Rubén Alcaraz","ESP","MF","27",1991,33.1,96,54,50,40,6,32,89,36,57,59,10,49,38,134,52,1,"https://fbref.com/en/players/036bba5f/Ruben-Alcaraz"
"2483","Antoñito_2019",2019,"Valladolid","La Liga","Antoñito","ESP","DF,MF","30",1987,20.7,35,21,16,15,4,18,42,42.9,24,21,8,13,18,53,31,0,"https://fbref.com/en/players/dbe519cf/Antonito"
"2484","Anuar_2019",2019,"Valladolid","La Liga","Anuar","MAR","MF,FW","23",1995,12,33,19,15,16,2,6,14,42.9,8,14,1,13,11,44,25,1,"https://fbref.com/en/players/c93231dc/Anuar"
"2485","Fernando Calero_2019",2019,"Valladolid","La Liga","Fernando Calero","ESP","DF","22",1995,34.8,51,31,33,18,0,23,38,60.5,15,55,31,24,55,106,170,0,"https://fbref.com/en/players/41b3069f/Fernando-Calero"
"2486","Duje Čop_2019",2019,"Valladolid","La Liga","Duje Čop","CRO","FW","28",1990,7.6,5,4,1,2,2,0,8,0,8,8,3,5,3,8,3,0,"https://fbref.com/en/players/8b0b02c9/Duje-Cop"
"2487","Moisés Delgado_2019",2019,"Valladolid","La Liga","Moisés Delgado","ESP","DF","24",1994,3,7,6,3,3,1,2,3,66.7,1,2,1,1,3,10,9,0,"https://fbref.com/en/players/248c409d/Moises-Delgado"
"2488","Borja Fernández_2019",2019,"Valladolid","La Liga","Borja Fernández","ESP","MF,DF","37",1981,9.3,17,12,7,9,1,6,16,37.5,10,14,2,12,14,31,25,0,"https://fbref.com/en/players/9127f9ce/Borja-Fernandez"
"2489","Joaquín Fernández_2019",2019,"Valladolid","La Liga","Joaquín Fernández","ESP","DF,MF","22",1996,9.3,16,9,14,1,1,8,16,50,8,9,7,2,17,33,45,0,"https://fbref.com/en/players/b86a64b2/Joaquin-Fernandez"
"2490","Sergi Guardiola_2019",2019,"Valladolid","La Liga","Sergi Guardiola","ESP","FW","27",1991,16.8,19,11,1,10,8,2,13,15.4,11,12,0,12,5,24,17,0,"https://fbref.com/en/players/32974271/Sergi-Guardiola"
"2491","Hacen_2019",2019,"Valladolid","La Liga","Hacen","MTN","MF","20",1997,0,0,0,0,0,0,0,0,NA,0,1,0,1,1,1,1,0,"https://fbref.com/en/players/7c689c48/Hacen"
"2492","Pablo Hervías_2019",2019,"Valladolid","La Liga","Pablo Hervías","ESP","MF","25",1993,1.8,1,0,0,1,0,0,1,0,1,0,0,0,2,3,0,0,"https://fbref.com/en/players/ba5a9545/Pablo-Hervias"
"2493","Ivi_2019",2019,"Valladolid","La Liga","Ivi","ESP","MF,FW","24",1994,0.2,0,0,0,0,0,0,0,NA,0,0,0,0,0,0,0,0,"https://fbref.com/en/players/d2fa73e7/Ivi"
"2494","Keko_2019",2019,"Valladolid","La Liga","Keko","ESP","MF,FW","26",1991,17,42,18,21,15,6,18,50,36,32,20,1,19,14,56,17,0,"https://fbref.com/en/players/1512328c/Keko"
"2495","Jordi Masip_2019",2019,"Valladolid","La Liga","Jordi Masip","ESP","GK","29",1989,35,1,1,1,0,0,0,0,NA,0,1,0,1,1,2,3,3,"https://fbref.com/en/players/8fae77ea/Jordi-Masip"
"2496","Míchel_2019",2019,"Valladolid","La Liga","Míchel","ESP","MF","30",1988,28.4,60,38,25,31,4,18,73,24.7,55,40,4,36,43,103,30,1,"https://fbref.com/en/players/418f8f61/Michel"
"2497","Miguel_2019",2019,"Valladolid","La Liga","Miguel","ESP","FW","18",1999,0.1,0,0,0,0,0,0,1,0,1,0,0,0,1,1,0,0,"https://fbref.com/en/players/6763373d/Miguel"
"2498","Javi Moyano_2019",2019,"Valladolid","La Liga","Javi Moyano","ESP","DF","32",1986,23.3,25,17,17,6,2,15,30,50,15,20,9,11,25,50,88,2,"https://fbref.com/en/players/933e8c8a/Javi-Moyano"
"2499","Nacho_2019",2019,"Valladolid","La Liga","Nacho","ESP","DF","29",1989,35,110,66,73,30,7,67,100,67,33,43,10,33,45,155,113,2,"https://fbref.com/en/players/e29d1111/Nacho"
"2500","Kiko Olivas_2019",2019,"Valladolid","La Liga","Kiko Olivas","ESP","DF","29",1988,34.4,51,38,35,15,1,22,48,45.8,26,31,18,13,46,97,173,2,"https://fbref.com/en/players/72b07a9c/Kiko-Olivas"
"2501","Óscar Plano_2019",2019,"Valladolid","La Liga","Óscar Plano","ESP","MF,FW","27",1991,29.9,63,45,23,28,12,14,48,29.2,34,19,3,16,22,85,28,1,"https://fbref.com/en/players/7c388b20/Oscar-Plano"
"2502","Stiven Plaza_2019",2019,"Valladolid","La Liga","Stiven Plaza","ECU","FW,MF","19",1999,0.4,0,0,0,0,0,0,0,NA,0,0,0,0,0,0,0,0,"https://fbref.com/en/players/f4b7f2ec/Stiven-Plaza"
"2503","Chris Ramos_2019",2019,"Valladolid","La Liga","Chris Ramos","ESP","FW","21",1997,0.7,1,1,0,0,1,1,1,100,0,0,0,0,0,1,1,0,"https://fbref.com/en/players/44e07fac/Chris-Ramos"
"2504","Waldo Rubio_2019",2019,"Valladolid","La Liga","Waldo Rubio","ESP","MF","22",1995,5.5,4,2,3,1,0,1,6,16.7,5,2,0,2,1,5,8,1,"https://fbref.com/en/players/ccaa5728/Waldo-Rubio"
"2505","Leonardo Suárez_2019",2019,"Valladolid","La Liga","Leonardo Suárez","ARG","FW,MF","22",1996,5.7,3,3,2,0,1,2,4,50,2,7,1,6,1,4,4,0,"https://fbref.com/en/players/25c72b36/Leonardo-Suarez"
"2506","Enes Ünal_2019",2019,"Valladolid","La Liga","Enes Ünal","TUR","FW","21",1997,23.9,17,10,3,4,10,4,24,16.7,20,17,4,13,2,19,18,0,"https://fbref.com/en/players/f8eca1b6/Enes-Unal"
"2507","Daniele Verde_2019",2019,"Valladolid","La Liga","Daniele Verde","ITA","MF,FW","22",1996,7.3,6,3,2,2,2,1,6,16.7,5,3,0,3,7,13,3,1,"https://fbref.com/en/players/d3298c99/Daniele-Verde"
"2508","Toni Villa_2019",2019,"Valladolid","La Liga","Toni Villa","ESP","MF,FW","23",1995,19.6,51,32,24,18,9,20,47,42.6,27,15,0,15,12,63,10,0,"https://fbref.com/en/players/636eae97/Toni-Villa"
"2509","Yoel_2019",2019,"Valladolid","La Liga","Yoel","ESP","GK","29",1988,3,0,0,0,0,0,0,0,NA,0,0,0,0,0,0,0,1,"https://fbref.com/en/players/61bb7498/Yoel"
"2510","Sergio Asenjo_2019",2019,"Villarreal","La Liga","Sergio Asenjo","ESP","GK","29",1989,32,0,0,0,0,0,0,1,0,1,0,0,0,3,3,26,2,"https://fbref.com/en/players/9f0ea33f/Sergio-Asenjo"
"2511","Carlos Bacca_2019",2019,"Villarreal","La Liga","Carlos Bacca","COL","FW","31",1986,14.1,4,2,1,2,1,0,5,0,5,4,0,4,8,12,5,0,"https://fbref.com/en/players/09a9e921/Carlos-Bacca"
"2512","Daniele Bonera_2019",2019,"Villarreal","La Liga","Daniele Bonera","ITA","DF","37",1981,2.6,2,2,2,0,0,1,1,100,0,5,5,0,4,6,10,0,"https://fbref.com/en/players/13b0c150/Daniele-Bonera"
"2513","Santiago Cáseres_2019",2019,"Villarreal","La Liga","Santiago Cáseres","ARG","MF","21",1997,17.6,67,35,20,38,9,25,57,43.9,32,22,9,13,14,81,24,1,"https://fbref.com/en/players/958bba56/Santiago-Caseres"
"2514","Santi Cazorla_2019",2019,"Villarreal","La Liga","Santi Cazorla","ESP","MF,FW","33",1984,29.4,69,34,32,26,11,24,69,34.8,45,35,6,29,28,97,17,1,"https://fbref.com/en/players/e2e9c250/Santi-Cazorla"
"2515","Samuel Chukwueze_2019",2019,"Villarreal","La Liga","Samuel Chukwueze","NGA","MF,FW","19",1999,19,19,11,7,10,2,9,31,29,22,11,2,9,10,29,2,0,"https://fbref.com/en/players/b8a642fc/Samuel-Chukwueze"
"2516","Jaume Costa_2019",2019,"Villarreal","La Liga","Jaume Costa","ESP","DF","30",1988,16.6,33,21,26,5,2,20,33,60.6,13,12,3,9,21,54,61,0,"https://fbref.com/en/players/808d48f3/Jaume-Costa"
"2517","Andrés Fernández_2019",2019,"Villarreal","La Liga","Andrés Fernández","ESP","GK","31",1986,6,1,0,1,0,0,1,1,100,0,0,0,0,0,1,4,1,"https://fbref.com/en/players/307fcd26/Andres-Fernandez"
"2518","Pablo Fornals_2019",2019,"Villarreal","La Liga","Pablo Fornals","ESP","MF,FW","22",1996,27.5,49,26,14,26,9,15,54,27.8,39,32,4,28,24,73,19,0,"https://fbref.com/en/players/82927de4/Pablo-Fornals"
"2519","Javi Fuego_2019",2019,"Villarreal","La Liga","Javi Fuego","ESP","MF","34",1984,2.6,6,3,5,1,0,4,8,50,4,2,0,2,3,9,9,0,"https://fbref.com/en/players/2e8fc160/Javi-Fuego"
"2520","Ramiro Funes Mori_2019",2019,"Villarreal","La Liga","Ramiro Funes Mori","ARG","DF,MF","27",1991,29.2,41,29,30,9,2,19,44,43.2,25,36,24,12,42,83,149,2,"https://fbref.com/en/players/89cbc961/Ramiro-Funes-Mori"
"2521","Mario Gaspar_2019",2019,"Villarreal","La Liga","Mario Gaspar","ESP","DF","27",1990,28.9,62,43,39,17,6,29,49,59.2,20,48,11,37,42,104,91,0,"https://fbref.com/en/players/fb5d47b3/Mario-Gaspar"
"2522","Álvaro González_2019",2019,"Villarreal","La Liga","Álvaro González","ESP","DF","28",1990,32.9,49,35,33,14,2,25,35,71.4,10,34,24,10,37,86,177,2,"https://fbref.com/en/players/42dcf26d/Alvaro-Gonzalez"
"2523","Vicente Iborra_2019",2019,"Villarreal","La Liga","Vicente Iborra","ESP","MF","30",1988,18.5,31,18,22,5,4,14,37,37.8,23,25,7,18,22,53,41,1,"https://fbref.com/en/players/ad1ffcfd/Vicente-Iborra"
"2524","Manuel Iturra_2019",2019,"Villarreal","La Liga","Manuel Iturra","CHI","MF","34",1984,0.8,2,0,0,2,0,0,0,NA,0,1,0,1,2,4,2,0,"https://fbref.com/en/players/000b3da6/Manuel-Iturra"
"2525","Miguel Juan Llambrich_2019",2019,"Villarreal","La Liga","Miguel Juan Llambrich","ESP","DF,FW","22",1996,6,21,14,11,9,1,6,14,42.9,8,9,2,7,12,33,17,0,"https://fbref.com/en/players/d83f09ff/Miguel-Juan-Llambrich"
"2526","Miguel Layún_2019",2019,"Villarreal","La Liga","Miguel Layún","MEX","MF,DF","30",1988,5.6,8,2,0,7,1,2,6,33.3,4,8,2,6,1,9,10,0,"https://fbref.com/en/players/ad6295d4/Miguel-Layun"
"2527","Gerard Moreno_2019",2019,"Villarreal","La Liga","Gerard Moreno","ESP","FW","26",1992,25.7,22,12,2,15,5,8,27,29.6,19,23,9,14,9,31,39,0,"https://fbref.com/en/players/81f0781e/Gerard-Moreno"
"2528","Manu Morlanes_2019",2019,"Villarreal","La Liga","Manu Morlanes","ESP","MF","19",1999,6.8,21,11,9,9,3,7,19,36.8,12,7,3,4,5,26,9,0,"https://fbref.com/en/players/a0255c67/Manu-Morlanes"
"2529","Alfonso Pedraza_2019",2019,"Villarreal","La Liga","Alfonso Pedraza","ESP","DF,FW","22",1996,23.3,59,44,34,19,6,22,62,35.5,40,33,7,26,29,88,55,0,"https://fbref.com/en/players/63f04c6c/Alfonso-Pedraza"
"2530","Xavi Quintillà_2019",2019,"Villarreal","La Liga","Xavi Quintillà","ESP","DF","21",1996,7,10,4,5,4,1,6,12,50,6,5,2,3,8,18,17,0,"https://fbref.com/en/players/84fb6aff/Xavi-Quintilla"
"2531","Dani Raba_2019",2019,"Villarreal","La Liga","Dani Raba","ESP","MF,FW","22",1995,2.1,6,5,1,2,3,1,5,20,4,1,0,1,1,7,0,0,"https://fbref.com/en/players/ea6a7ab4/Dani-Raba"
"2532","Víctor Ruiz_2019",2019,"Villarreal","La Liga","Víctor Ruiz","ESP","DF","29",1989,21.9,28,19,20,6,2,13,18,72.2,5,28,16,12,38,66,67,1,"https://fbref.com/en/players/b3dc6eca/Victor-Ruiz"
"2533","Nicola Sansone_2019",2019,"Villarreal","La Liga","Nicola Sansone","ITA","FW,MF","26",1991,0.4,0,0,0,0,0,0,0,NA,0,0,0,0,0,0,0,0,"https://fbref.com/en/players/7eb97a8e/Nicola-Sansone"
"2534","Karl Toko Ekambi_2019",2019,"Villarreal","La Liga","Karl Toko Ekambi","CMR","FW,MF","25",1992,23.8,11,8,1,6,4,2,14,14.3,12,8,0,8,11,22,9,1,"https://fbref.com/en/players/5ceba7fc/Karl-Toko-Ekambi"
"2535","Manu Trigueros_2019",2019,"Villarreal","La Liga","Manu Trigueros","ESP","MF","26",1991,17.2,46,35,18,23,5,20,57,35.1,37,17,6,11,16,62,17,0,"https://fbref.com/en/players/963829d0/Manu-Trigueros"
"2536","Miguel Britos_2019",2019,"Watford","Premier League","Miguel Britos","URU","DF","33",1985,2.1,4,2,4,0,0,2,4,50,2,1,1,0,3,7,11,1,"https://fbref.com/en/players/356a9a62/Miguel-Britos"
"2537","Étienne Capoue_2019",2019,"Watford","Premier League","Étienne Capoue","FRA","MF","30",1988,32.7,91,56,36,48,7,33,87,37.9,54,50,13,37,85,176,96,1,"https://fbref.com/en/players/5acc4a10/Etienne-Capoue"
"2538","Craig Cathcart_2019",2019,"Watford","Premier League","Craig Cathcart","NIR","DF","29",1989,34.4,50,31,36,11,3,21,37,56.8,16,42,30,12,38,88,184,4,"https://fbref.com/en/players/89e4b358/Craig-Cathcart"
"2539","Nathaniel Chalobah_2019",2019,"Watford","Premier League","Nathaniel Chalobah","ENG","MF","23",1994,3,3,2,1,2,0,2,7,28.6,5,2,1,1,5,8,7,0,"https://fbref.com/en/players/422862ea/Nathaniel-Chalobah"
"2540","Tom Cleverley_2019",2019,"Watford","Premier League","Tom Cleverley","ENG","MF","28",1989,5.3,17,9,11,4,2,6,22,27.3,16,4,0,4,5,22,11,0,"https://fbref.com/en/players/6cdd8245/Tom-Cleverley"
"2541","Troy Deeney_2019",2019,"Watford","Premier League","Troy Deeney","ENG","FW","30",1988,28.3,24,14,8,10,6,7,32,21.9,25,22,4,18,7,31,29,0,"https://fbref.com/en/players/82e34b69/Troy-Deeney"
"2542","Gerard Deulofeu_2019",2019,"Watford","Premier League","Gerard Deulofeu","ESP","FW,MF","24",1994,23,11,6,5,3,3,4,26,15.4,22,16,0,16,14,25,3,0,"https://fbref.com/en/players/39583cfd/Gerard-Deulofeu"
"2543","Abdoulaye Doucouré_2019",2019,"Watford","Premier League","Abdoulaye Doucouré","MLI","MF","25",1993,34,71,38,27,32,12,19,57,33.3,38,31,8,23,34,105,55,5,"https://fbref.com/en/players/02b29014/Abdoulaye-Doucoure"
"2544","Kiko Femenía_2019",2019,"Watford","Premier League","Kiko Femenía","ESP","DF","27",1991,22.8,48,30,34,12,2,24,51,47.1,27,24,6,18,36,84,68,0,"https://fbref.com/en/players/e5d01ecf/Kiko-Femenia"
"2545","Ben Foster_2019",2019,"Watford","Premier League","Ben Foster","ENG","GK","35",1983,38,2,2,2,0,0,2,6,33.3,4,0,0,0,2,4,34,3,"https://fbref.com/en/players/d0b3ceb9/Ben-Foster"
"2546","Andre Gray_2019",2019,"Watford","Premier League","Andre Gray","JAM","FW","27",1991,15.2,3,1,0,2,1,1,6,16.7,5,3,1,2,2,5,6,0,"https://fbref.com/en/players/c24dba2a/Andre-Gray"
"2547","José Holebas_2019",2019,"Watford","Premier League","José Holebas","GRE","DF","34",1984,26.6,68,40,44,20,4,28,53,52.8,25,27,8,19,21,89,97,0,"https://fbref.com/en/players/12aa7661/Jose-Holebas"
"2548","Will Hughes_2019",2019,"Watford","Premier League","Will Hughes","ENG","MF","23",1995,26.9,74,43,27,35,12,25,59,42.4,34,55,6,49,25,99,30,0,"https://fbref.com/en/players/a0666d3e/Will-Hughes"
"2549","Daryl Janmaat_2019",2019,"Watford","Premier League","Daryl Janmaat","NED","DF","29",1989,16.9,36,24,23,11,2,20,29,69,9,16,6,10,33,69,71,0,"https://fbref.com/en/players/45da6694/Daryl-Janmaat"
"2550","Christian Kabasele_2019",2019,"Watford","Premier League","Christian Kabasele","BEL","DF","27",1991,17.6,25,14,20,5,0,10,23,43.5,13,21,16,5,38,63,111,0,"https://fbref.com/en/players/914ab9a1/Christian-Kabasele"
"2551","Adrian Mariappa_2019",2019,"Watford","Premier League","Adrian Mariappa","JAM","DF","31",1986,21.4,35,22,29,6,0,16,32,50,16,23,15,8,26,61,120,2,"https://fbref.com/en/players/8aa5f52c/Adrian-Mariappa"
"2552","Adam Masina_2019",2019,"Watford","Premier League","Adam Masina","MAR","DF","24",1994,11.2,30,17,16,13,1,13,25,52,12,19,4,15,17,47,40,0,"https://fbref.com/en/players/de0f152c/Adam-Masina"
"2553","Marc Navarro_2019",2019,"Watford","Premier League","Marc Navarro","ESP","DF","23",1995,0.9,4,2,3,1,0,3,4,75,1,0,0,0,0,4,4,0,"https://fbref.com/en/players/c2846353/Marc-Navarro"
"2554","Stefano Okaka_2019",2019,"Watford","Premier League","Stefano Okaka","ITA","FW,MF","28",1989,0.3,0,0,0,0,0,0,0,NA,0,1,0,1,0,0,0,0,"https://fbref.com/en/players/601ef102/Stefano-Okaka"
"2555","Roberto Pereyra_2019",2019,"Watford","Premier League","Roberto Pereyra","ARG","MF","27",1991,31.3,21,12,10,10,1,7,24,29.2,17,26,0,26,24,45,27,2,"https://fbref.com/en/players/75f2c59f/Roberto-Pereyra"
"2556","Sebastian Prödl_2019",2019,"Watford","Premier League","Sebastian Prödl","AUT","DF","31",1987,0.1,0,0,0,0,0,0,0,NA,0,0,0,0,0,0,0,0,"https://fbref.com/en/players/f5e6d08d/Sebastian-Prodl"
"2557","Domingos Quina_2019",2019,"Watford","Premier League","Domingos Quina","POR","MF","18",1999,3.8,9,7,3,5,1,3,11,27.3,8,6,0,6,3,12,1,0,"https://fbref.com/en/players/41fb0f4e/Domingos-Quina"
"2558","Ken Sema_2019",2019,"Watford","Premier League","Ken Sema","SWE","MF,FW","24",1993,8.4,15,7,7,5,3,9,21,42.9,12,7,0,7,8,23,5,0,"https://fbref.com/en/players/1770bd68/Ken-Sema"
"2559","Isaac Success_2019",2019,"Watford","Premier League","Isaac Success","NGA","FW,MF","22",1996,11.7,15,12,4,8,3,2,5,40,3,6,0,6,2,17,11,0,"https://fbref.com/en/players/f573a8bf/Isaac-Success"
"2560","Ben Wilmot_2019",2019,"Watford","Premier League","Ben Wilmot","ENG","MF,DF","18",1999,0.3,0,0,0,0,0,0,1,0,1,2,1,1,0,0,1,0,"https://fbref.com/en/players/2876eaa3/Ben-Wilmot"
"2561","Ludwig Augustinsson_2019",2019,"Werder Bremen","Bundesliga","Ludwig Augustinsson","SWE","DF","24",1994,33.6,53,31,25,22,6,23,39,59,16,37,11,26,38,91,86,1,"https://fbref.com/en/players/9fec8860/Ludwig-Augustinsson"
"2562","Philipp Bargfrede_2019",2019,"Werder Bremen","Bundesliga","Philipp Bargfrede","GER","MF,DF","29",1989,12,23,15,9,12,2,10,28,35.7,18,35,11,24,34,57,45,1,"https://fbref.com/en/players/3f7cd8f1/Philipp-Bargfrede"
"2563","Fin Bartels_2019",2019,"Werder Bremen","Bundesliga","Fin Bartels","GER","MF,FW","31",1987,0.3,0,0,0,0,0,0,1,0,1,0,0,0,1,1,0,0,"https://fbref.com/en/players/acc7b7ec/Fin-Bartels"
"2564","Johannes Eggestein_2019",2019,"Werder Bremen","Bundesliga","Johannes Eggestein","GER","FW,MF","20",1998,12.4,13,9,7,4,2,5,19,26.3,14,13,0,13,4,17,7,0,"https://fbref.com/en/players/d571df78/Johannes-Eggestein"
"2565","Maximilian Eggestein_2019",2019,"Werder Bremen","Bundesliga","Maximilian Eggestein","GER","MF","21",1996,33.9,68,42,29,34,5,24,54,44.4,30,49,10,39,30,98,69,0,"https://fbref.com/en/players/beb882a8/Maximilian-Eggestein"
"2566","Marco Friedl_2019",2019,"Werder Bremen","Bundesliga","Marco Friedl","AUT","DF","20",1998,5.3,8,6,4,3,1,3,11,27.3,8,9,6,3,13,21,21,0,"https://fbref.com/en/players/f86ad3f5/Marco-Friedl"
"2567","Theodor Gebre Selassie_2019",2019,"Werder Bremen","Bundesliga","Theodor Gebre Selassie","CZE","DF","31",1986,31.3,53,38,27,16,10,22,51,43.1,29,33,8,25,69,122,100,0,"https://fbref.com/en/players/3f65898c/Theodor-Gebre-Selassie"
"2568","Martin Harnik_2019",2019,"Werder Bremen","Bundesliga","Martin Harnik","AUT","FW,MF","31",1987,9.2,12,7,4,3,5,4,15,26.7,11,8,0,8,3,15,10,0,"https://fbref.com/en/players/99b7584f/Martin-Harnik"
"2569","Aron Jóhannsson_2019",2019,"Werder Bremen","Bundesliga","Aron Jóhannsson","USA","MF","27",1990,0,0,0,0,0,0,0,0,NA,0,0,0,0,0,0,0,0,"https://fbref.com/en/players/c0dc9fc7/Aron-Johannsson"
"2570","Florian Kainz_2019",2019,"Werder Bremen","Bundesliga","Florian Kainz","AUT","FW","25",1992,4.1,6,5,5,1,0,3,6,50,3,4,1,3,3,9,5,0,"https://fbref.com/en/players/94c18565/Florian-Kainz"
"2571","Stefanos Kapino_2019",2019,"Werder Bremen","Bundesliga","Stefanos Kapino","GRE","GK","24",1994,0.5,0,0,0,0,0,0,0,NA,0,0,0,0,0,0,0,0,"https://fbref.com/en/players/62ba5881/Stefanos-Kapino"
"2572","Davy Klaassen_2019",2019,"Werder Bremen","Bundesliga","Davy Klaassen","NED","MF","25",1993,31.3,64,47,24,33,7,14,49,28.6,35,44,9,35,47,111,47,0,"https://fbref.com/en/players/15fd5593/Davy-Klaassen"
"2573","Max Kruse_2019",2019,"Werder Bremen","Bundesliga","Max Kruse","GER","FW,MF","30",1988,31.5,17,5,2,13,2,6,38,15.8,32,16,1,15,8,25,6,2,"https://fbref.com/en/players/f9446dcd/Max-Kruse"
"2574","Sebastian Langkamp_2019",2019,"Werder Bremen","Bundesliga","Sebastian Langkamp","GER","DF","30",1988,15.7,24,15,18,6,0,7,14,50,7,17,11,6,20,44,79,1,"https://fbref.com/en/players/74d70fb5/Sebastian-Langkamp"
"2575","Kevin Möhwald_2019",2019,"Werder Bremen","Bundesliga","Kevin Möhwald","GER","MF","25",1993,9.7,16,10,3,11,2,3,20,15,17,14,0,14,17,33,14,0,"https://fbref.com/en/players/a5ce09f2/Kevin-Mohwald"
"2576","Niklas Moisander_2019",2019,"Werder Bremen","Bundesliga","Niklas Moisander","FIN","DF","32",1985,29.3,34,23,26,8,0,22,51,43.1,29,42,19,23,39,73,140,2,"https://fbref.com/en/players/00844823/Niklas-Moisander"
"2577","Yuya Osako_2019",2019,"Werder Bremen","Bundesliga","Yuya Osako","JPN","FW,MF","28",1990,15,23,11,6,12,5,7,22,31.8,15,15,3,12,7,30,8,0,"https://fbref.com/en/players/f69fba57/Yuya-Osako"
"2578","Jiří Pavlenka_2019",2019,"Werder Bremen","Bundesliga","Jiří Pavlenka","CZE","GK","26",1992,33.1,3,0,3,0,0,3,6,50,3,1,0,1,3,6,14,1,"https://fbref.com/en/players/0a1cb833/Jiri-Pavlenka"
"2579","Claudio Pizarro_2019",2019,"Werder Bremen","Bundesliga","Claudio Pizarro","PER","FW","39",1978,7.7,10,6,4,2,4,4,7,57.1,3,14,1,13,1,11,7,0,"https://fbref.com/en/players/54b6ee79/Claudio-Pizarro"
"2580","Luca Plogmann_2019",2019,"Werder Bremen","Bundesliga","Luca Plogmann","GER","GK","18",2000,0.4,0,0,0,0,0,0,0,NA,0,0,0,0,0,0,0,0,"https://fbref.com/en/players/206c37d3/Luca-Plogmann"
"2581","Milot Rashica_2019",2019,"Werder Bremen","Bundesliga","Milot Rashica","KVX","FW,MF","22",1996,17.2,24,16,8,11,5,9,24,37.5,15,16,2,14,6,30,6,1,"https://fbref.com/en/players/6c6a3300/Milot-Rashica"
"2582","Nuri Şahin_2019",2019,"Werder Bremen","Bundesliga","Nuri Şahin","TUR","MF","29",1988,16.4,60,33,22,33,5,23,59,39,36,30,3,27,37,97,39,1,"https://fbref.com/en/players/f4081572/Nuri-Sahin"
"2583","Josh Sargent_2019",2019,"Werder Bremen","Bundesliga","Josh Sargent","USA","FW","18",2000,2.4,2,1,1,0,1,2,2,100,0,2,0,2,0,2,3,0,"https://fbref.com/en/players/a8d4428b/Josh-Sargent"
"2584","Miloš Veljković_2019",2019,"Werder Bremen","Bundesliga","Miloš Veljković","SRB","DF","22",1995,20.9,36,24,29,6,1,22,37,59.5,15,27,13,14,27,63,111,0,"https://fbref.com/en/players/a5ae8f8e/Milos-Veljkovic"
"2585","Felipe Anderson_2019",2019,"West Ham","Premier League","Felipe Anderson","BRA","MF,FW","25",1993,33.8,89,49,33,44,12,31,101,30.7,70,71,0,71,41,130,18,1,"https://fbref.com/en/players/9f1893b9/Felipe-Anderson"
"2586","Michail Antonio_2019",2019,"West Ham","Premier League","Michail Antonio","JAM","MF,FW","28",1990,23.4,23,14,12,6,5,6,12,50,6,38,3,35,18,41,26,1,"https://fbref.com/en/players/ac05f970/Michail-Antonio"
"2587","Marko Arnautović_2019",2019,"West Ham","Premier League","Marko Arnautović","AUT","FW","29",1989,22.1,9,5,4,3,2,1,7,14.3,6,4,2,2,3,12,6,0,"https://fbref.com/en/players/00459419/Marko-Arnautovic"
"2588","Fabián Balbuena_2019",2019,"West Ham","Premier League","Fabián Balbuena","PAR","DF","26",1991,22.4,40,20,34,6,0,16,42,38.1,26,23,15,8,53,93,175,0,"https://fbref.com/en/players/3626f7d9/Fabian-Balbuena"
"2589","Andy Carroll_2019",2019,"West Ham","Premier League","Andy Carroll","ENG","FW","29",1989,5.1,4,2,1,3,0,1,4,25,3,3,2,1,1,5,8,0,"https://fbref.com/en/players/b581987a/Andy-Carroll"
"2590","Aaron Cresswell_2019",2019,"West Ham","Premier League","Aaron Cresswell","ENG","DF","28",1989,17.7,29,16,14,11,4,13,25,52,12,28,7,21,23,52,58,0,"https://fbref.com/en/players/4f974391/Aaron-Cresswell"
"2591","Grady Diangana_2019",2019,"West Ham","Premier League","Grady Diangana","ENG","MF,FW","20",1998,6.8,20,9,8,8,4,5,14,35.7,9,11,0,11,1,21,4,0,"https://fbref.com/en/players/f522d7ec/Grady-Diangana"
"2592","Issa Diop_2019",2019,"West Ham","Premier League","Issa Diop","FRA","DF","21",1997,33,68,38,47,21,0,37,57,64.9,20,58,36,22,64,132,161,4,"https://fbref.com/en/players/a712ca2b/Issa-Diop"
"2593","Łukasz Fabiański_2019",2019,"West Ham","Premier League","Łukasz Fabiański","POL","GK","33",1985,38,1,0,1,0,0,1,3,33.3,2,0,0,0,1,2,10,1,"https://fbref.com/en/players/9328b835/Lukasz-Fabianski"
"2594","Ryan Fredericks_2019",2019,"West Ham","Premier League","Ryan Fredericks","ENG","DF","25",1992,12.1,38,23,33,5,0,21,32,65.6,11,15,5,10,13,51,49,1,"https://fbref.com/en/players/c067631c/Ryan-Fredericks"
"2595","Javier Hernández_2019",2019,"West Ham","Premier League","Javier Hernández","MEX","FW","30",1988,14.8,3,0,0,3,0,0,6,0,6,8,1,7,1,4,8,0,"https://fbref.com/en/players/189cee7b/Javier-Hernandez"
"2596","Ben Johnson_2019",2019,"West Ham","Premier League","Ben Johnson","ENG","DF","18",2000,0.7,1,0,1,0,0,0,1,0,1,0,0,0,1,2,5,0,"https://fbref.com/en/players/9319781b/Ben-Johnson"
"2597","Manuel Lanzini_2019",2019,"West Ham","Premier League","Manuel Lanzini","ARG","MF","25",1993,7.6,12,7,5,6,1,5,18,27.8,13,3,1,2,9,21,7,1,"https://fbref.com/en/players/26f6dca8/Manuel-Lanzini"
"2598","Arthur Masuaku_2019",2019,"West Ham","Premier League","Arthur Masuaku","COD","DF","24",1993,19.5,57,25,38,13,6,31,56,55.4,25,27,6,21,36,93,72,0,"https://fbref.com/en/players/57df7a11/Arthur-Masuaku"
"2599","Samir Nasri_2019",2019,"West Ham","Premier League","Samir Nasri","FRA","MF","31",1987,2.7,0,0,0,0,0,0,0,NA,0,1,0,1,1,1,1,0,"https://fbref.com/en/players/165bed61/Samir-Nasri"
"2600","Mark Noble_2019",2019,"West Ham","Premier League","Mark Noble","ENG","MF","31",1987,25.5,47,26,19,24,4,17,52,32.7,35,17,2,15,21,68,13,0,"https://fbref.com/en/players/ff527768/Mark-Noble"
"2601","Pedro Obiang_2019",2019,"West Ham","Premier League","Pedro Obiang","EQG","MF","26",1992,12.5,41,23,23,16,2,18,43,41.9,25,27,9,18,12,53,18,0,"https://fbref.com/en/players/ba1e04b3/Pedro-Obiang"
"2602","Angelo Ogbonna_2019",2019,"West Ham","Premier League","Angelo Ogbonna","ITA","DF","30",1988,20.8,31,13,23,6,2,14,23,60.9,9,29,19,10,35,66,101,0,"https://fbref.com/en/players/74b2cd7e/Angelo-Ogbonna"
"2603","Lucas Pérez_2019",2019,"West Ham","Premier League","Lucas Pérez","ESP","FW,MF","29",1988,5.3,6,4,3,2,1,1,3,33.3,2,2,1,1,2,8,2,0,"https://fbref.com/en/players/a300ac7e/Lucas-Perez"
"2604","Declan Rice_2019",2019,"West Ham","Premier League","Declan Rice","ENG","MF","19",1999,33.4,98,60,35,58,5,38,88,43.2,50,51,12,39,52,150,56,0,"https://fbref.com/en/players/1c7012b8/Declan-Rice"
"2605","Carlos Sánchez_2019",2019,"West Ham","Premier League","Carlos Sánchez","COL","MF","32",1986,2.7,4,3,4,0,0,3,8,37.5,5,1,0,1,1,5,5,2,"https://fbref.com/en/players/50b51fac/Carlos-Sanchez"
"2606","Xande Silva_2019",2019,"West Ham","Premier League","Xande Silva","POR","FW","21",1997,0.2,0,0,0,0,0,0,0,NA,0,1,0,1,0,0,0,0,"https://fbref.com/en/players/15d561fa/Xande-Silva"
"2607","Robert Snodgrass_2019",2019,"West Ham","Premier League","Robert Snodgrass","SCO","MF","30",1987,24.7,44,27,18,24,2,13,46,28.3,33,24,4,20,11,55,23,0,"https://fbref.com/en/players/9f4647e9/Robert-Snodgrass"
"2608","Jack Wilshere_2019",2019,"West Ham","Premier League","Jack Wilshere","ENG","MF","26",1992,4.4,7,4,1,4,2,2,6,33.3,4,3,1,2,7,14,0,0,"https://fbref.com/en/players/9c318325/Jack-Wilshere"
"2609","Andriy Yarmolenko_2019",2019,"West Ham","Premier League","Andriy Yarmolenko","UKR","MF,FW","28",1989,5.1,4,1,2,1,1,4,6,66.7,2,4,1,3,2,6,4,2,"https://fbref.com/en/players/849c826a/Andriy-Yarmolenko"
"2610","Pablo Zabaleta_2019",2019,"West Ham","Premier League","Pablo Zabaleta","ARG","DF","33",1985,23.2,47,24,26,15,6,17,44,38.6,27,39,15,24,48,95,96,3,"https://fbref.com/en/players/6813ac34/Pablo-Zabaleta"
"2611","Maximilian Arnold_2019",2019,"Wolfsburg","Bundesliga","Maximilian Arnold","GER","MF","24",1994,31.9,52,30,21,27,4,21,61,34.4,40,31,10,21,35,87,48,1,"https://fbref.com/en/players/86e119e0/Maximilian-Arnold"
"2612","Josip Brekalo_2019",2019,"Wolfsburg","Bundesliga","Josip Brekalo","CRO","FW,MF","20",1998,15.7,15,7,7,6,2,5,18,27.8,13,15,1,14,12,27,9,1,"https://fbref.com/en/players/d4a2533d/Josip-Brekalo"
"2613","John Brooks_2019",2019,"Wolfsburg","Bundesliga","John Brooks","USA","DF","25",1993,29,29,15,18,9,2,13,27,48.1,14,28,13,15,37,66,135,3,"https://fbref.com/en/players/e27da244/John-Brooks"
"2614","Jakub Błaszczykowski_2019",2019,"Wolfsburg","Bundesliga","Jakub Błaszczykowski","POL","MF","32",1985,0.1,0,0,0,0,0,0,0,NA,0,0,0,0,0,0,0,0,"https://fbref.com/en/players/2b350e6b/Jakub-Blaszczykowski"
"2615","Ignacio Camacho_2019",2019,"Wolfsburg","Bundesliga","Ignacio Camacho","ESP","MF","28",1990,6,15,9,9,6,0,3,7,42.9,4,7,2,5,18,33,12,0,"https://fbref.com/en/players/8ed9b33a/Ignacio-Camacho"
"2616","Koen Casteels_2019",2019,"Wolfsburg","Bundesliga","Koen Casteels","BEL","GK","26",1992,25.5,1,0,1,0,0,1,2,50,1,1,0,1,0,1,11,1,"https://fbref.com/en/players/db401046/Koen-Casteels"
"2617","Ohis Felix Uduokhai_2019",2019,"Wolfsburg","Bundesliga","Ohis Felix Uduokhai","GER","DF","20",1997,2.7,13,7,7,5,1,9,10,90,1,6,2,4,6,19,11,1,"https://fbref.com/en/players/677da306/Ohis-Felix-Uduokhai"
"2618","Yannick Gerhardt_2019",2019,"Wolfsburg","Bundesliga","Yannick Gerhardt","GER","MF","24",1994,27.3,52,34,22,20,10,16,43,37.2,27,35,7,28,30,82,34,0,"https://fbref.com/en/players/62ab9184/Yannick-Gerhardt"
"2619","Daniel Ginczek_2019",2019,"Wolfsburg","Bundesliga","Daniel Ginczek","GER","FW","27",1991,14.2,9,7,4,3,2,5,19,26.3,14,12,2,10,3,12,23,1,"https://fbref.com/en/players/e5f63987/Daniel-Ginczek"
"2620","Josuha Guilavogui_2019",2019,"Wolfsburg","Bundesliga","Josuha Guilavogui","FRA","MF","27",1990,17.4,31,16,18,13,0,14,25,56,11,17,8,9,43,74,56,2,"https://fbref.com/en/players/e6c43eec/Josuha-Guilavogui"
"2621","Gian-Luca Itter_2019",2019,"Wolfsburg","Bundesliga","Gian-Luca Itter","GER","DF","19",1999,1,4,3,3,1,0,1,2,50,1,2,0,2,1,5,2,0,"https://fbref.com/en/players/e6c15f6e/Gian-Luca-Itter"
"2622","Sebastian Jung_2019",2019,"Wolfsburg","Bundesliga","Sebastian Jung","GER","DF","28",1990,0.6,1,0,0,1,0,1,1,100,0,0,0,0,0,1,1,0,"https://fbref.com/en/players/86b30561/Sebastian-Jung"
"2623","Felix Klaus_2019",2019,"Wolfsburg","Bundesliga","Felix Klaus","GER","FW,MF","25",1992,4.9,10,7,4,5,1,2,7,28.6,5,5,0,5,4,14,0,0,"https://fbref.com/en/players/aeda1f69/Felix-Klaus"
"2624","Robin Knoche_2019",2019,"Wolfsburg","Bundesliga","Robin Knoche","GER","DF","26",1992,31,26,20,19,6,1,16,29,55.2,13,46,29,17,44,70,138,2,"https://fbref.com/en/players/6bd5cd5d/Robin-Knoche"
"2625","Yunus Mallı_2019",2019,"Wolfsburg","Bundesliga","Yunus Mallı","TUR","MF,FW","26",1992,7.8,15,7,8,6,1,2,11,18.2,9,2,0,2,4,19,1,0,"https://fbref.com/en/players/f3722c97/Yunus-Malli"
"2626","Admir Mehmedi_2019",2019,"Wolfsburg","Bundesliga","Admir Mehmedi","SUI","FW,MF","27",1991,18.8,46,28,19,19,8,18,44,40.9,26,25,0,25,12,58,9,0,"https://fbref.com/en/players/b500b384/Admir-Mehmedi"
"2627","Pavao Pervan_2019",2019,"Wolfsburg","Bundesliga","Pavao Pervan","AUT","GK","30",1987,8.5,0,0,0,0,0,0,0,NA,0,0,0,0,0,0,3,1,"https://fbref.com/en/players/c89e8aae/Pavao-Pervan"
"2628","Elvis Rexhbeçaj_2019",2019,"Wolfsburg","Bundesliga","Elvis Rexhbeçaj","GER","MF","20",1997,12.7,28,18,11,12,5,12,24,50,12,18,2,16,14,42,21,0,"https://fbref.com/en/players/1ae836b1/Elvis-Rexhbecaj"
"2629","Jérôme Roussillon_2019",2019,"Wolfsburg","Bundesliga","Jérôme Roussillon","FRA","DF","25",1993,27.3,42,29,25,15,2,20,30,66.7,10,50,7,43,31,73,54,0,"https://fbref.com/en/players/13203c45/Jerome-Roussillon"
"2630","Renato Steffen_2019",2019,"Wolfsburg","Bundesliga","Renato Steffen","SUI","FW,MF","26",1991,16.7,26,17,5,17,4,7,17,41.2,10,13,2,11,16,42,14,0,"https://fbref.com/en/players/dd669209/Renato-Steffen"
"2631","Marcel Tisserand_2019",2019,"Wolfsburg","Bundesliga","Marcel Tisserand","COD","DF","25",1993,9.8,14,9,9,5,0,10,13,76.9,3,12,5,7,20,34,42,1,"https://fbref.com/en/players/45954ec7/Marcel-Tisserand"
"2632","Paul Verhaegh_2019",2019,"Wolfsburg","Bundesliga","Paul Verhaegh","NED","DF","34",1983,2,1,0,0,0,1,1,2,50,1,5,0,5,1,2,7,1,"https://fbref.com/en/players/97655ccd/Paul-Verhaegh"
"2633","Wout Weghorst_2019",2019,"Wolfsburg","Bundesliga","Wout Weghorst","NED","FW","25",1992,32.5,30,23,10,12,8,7,35,20,28,27,3,24,9,39,33,0,"https://fbref.com/en/players/c4e87b8b/Wout-Weghorst"
"2634","William_2019",2019,"Wolfsburg","Bundesliga","William","BRA","DF","23",1995,29.7,82,57,52,21,9,35,75,46.7,40,41,2,39,85,167,127,3,"https://fbref.com/en/players/d4d0a9ad/William"
"2635","John Yeboah_2019",2019,"Wolfsburg","Bundesliga","John Yeboah","GER","MF,FW","18",2000,0.6,0,0,0,0,0,0,3,0,3,1,0,1,1,1,0,0,"https://fbref.com/en/players/8dfdc6c3/John-Yeboah"
"2636","Ryan Bennett_2019",2019,"Wolves","Premier League","Ryan Bennett","ENG","DF","28",1990,34,58,32,41,16,1,25,41,61,16,42,21,21,43,101,131,1,"https://fbref.com/en/players/0bad4516/Ryan-Bennett"
"2637","Willy Boly_2019",2019,"Wolves","Premier League","Willy Boly","CIV","DF","27",1991,35.2,85,52,49,34,2,34,56,60.7,22,55,32,23,72,157,177,6,"https://fbref.com/en/players/a4ac4b8f/Willy-Boly"
"2638","Léo Bonatini_2019",2019,"Wolves","Premier League","Léo Bonatini","BRA","FW","24",1994,1.5,1,1,0,0,1,1,5,20,4,1,0,1,0,1,0,0,"https://fbref.com/en/players/da23d58d/Leo-Bonatini"
"2639","Jonny Castro_2019",2019,"Wolves","Premier League","Jonny Castro","ESP","DF,MF","24",1994,30.8,79,43,42,33,4,31,60,51.7,29,45,8,37,60,139,64,2,"https://fbref.com/en/players/e28868f3/Jonny-Castro"
"2640","Ivan Cavaleiro_2019",2019,"Wolves","Premier League","Ivan Cavaleiro","POR","FW,MF","24",1993,7.7,5,4,3,1,1,1,14,7.1,13,12,0,12,4,9,5,0,"https://fbref.com/en/players/979b811d/Ivan-Cavaleiro"
"2641","Conor Coady_2019",2019,"Wolves","Premier League","Conor Coady","ENG","DF","25",1993,38,31,19,26,5,0,17,32,53.1,15,35,27,8,30,61,133,3,"https://fbref.com/en/players/2928dca2/Conor-Coady"
"2642","Hélder Costa_2019",2019,"Wolves","Premier League","Hélder Costa","ANG","FW,MF","24",1994,14.9,18,14,7,7,4,7,23,30.4,16,15,0,15,9,27,6,0,"https://fbref.com/en/players/f13d02a6/Helder-Costa"
"2643","Leander Dendoncker_2019",2019,"Wolves","Premier League","Leander Dendoncker","BEL","MF","23",1995,16.3,53,26,25,25,3,16,47,34,31,35,6,29,23,76,34,1,"https://fbref.com/en/players/5a7301ae/Leander-Dendoncker"
"2644","Matt Doherty_2019",2019,"Wolves","Premier League","Matt Doherty","IRL","DF,MF","26",1992,34.9,67,42,48,15,4,35,58,60.3,23,49,7,42,60,127,107,2,"https://fbref.com/en/players/d557d734/Matt-Doherty"
"2645","Morgan Gibbs-White_2019",2019,"Wolves","Premier League","Morgan Gibbs-White","ENG","MF,FW","18",2000,7.4,6,3,2,4,0,1,4,25,3,6,0,6,1,7,0,0,"https://fbref.com/en/players/32f60ed8/Morgan-Gibbs-White"
"2646","Raúl Jiménez_2019",2019,"Wolves","Premier League","Raúl Jiménez","MEX","FW","27",1991,34.6,30,18,5,17,8,6,23,26.1,17,25,3,22,26,56,40,0,"https://fbref.com/en/players/b561db50/Raul-Jimenez"
"2647","Diogo Jota_2019",2019,"Wolves","Premier League","Diogo Jota","POR","FW,MF","21",1996,26.2,28,16,11,11,6,10,38,26.3,28,20,1,19,13,41,11,0,"https://fbref.com/en/players/178ae8f8/Diogo-Jota"
"2648","Max Kilman_2019",2019,"Wolves","Premier League","Max Kilman","ENG","DF","21",1997,0,0,0,0,0,0,0,0,NA,0,0,0,0,0,0,0,0,"https://fbref.com/en/players/d0f72bf1/Max-Kilman"
"2649","João Moutinho_2019",2019,"Wolves","Premier League","João Moutinho","POR","MF","31",1986,33.7,113,58,50,56,7,44,126,34.9,82,56,11,45,40,153,50,0,"https://fbref.com/en/players/f5a00fa4/Joao-Moutinho"
"2650","Rúben Neves_2019",2019,"Wolves","Premier League","Rúben Neves","POR","MF","21",1997,33.4,75,32,33,36,6,27,83,32.5,56,57,18,39,73,148,46,3,"https://fbref.com/en/players/44bfb6c5/Ruben-Neves"
"2651","Will Norris_2019",2019,"Wolves","Premier League","Will Norris","ENG","GK","24",1993,0,0,0,0,0,0,0,0,NA,0,0,0,0,0,0,0,0,"https://fbref.com/en/players/c73ada83/Will-Norris"
"2652","Rui Patrício_2019",2019,"Wolves","Premier League","Rui Patrício","POR","GK","30",1988,37,2,0,2,0,0,2,3,66.7,1,0,0,0,1,3,7,4,"https://fbref.com/en/players/79b0d6a0/Rui-Patricio"
"2653","John Ruddy_2019",2019,"Wolves","Premier League","John Ruddy","ENG","GK","31",1986,1,0,0,0,0,0,0,0,NA,0,0,0,0,0,0,0,0,"https://fbref.com/en/players/da8b19e2/John-Ruddy"
"2654","Romain Saïss_2019",2019,"Wolves","Premier League","Romain Saïss","MAR","MF,DF","28",1990,12.8,39,26,23,14,2,20,37,54.1,17,25,12,13,26,65,61,0,"https://fbref.com/en/players/9fbbcf39/Romain-Saiss"
"2655","Adama Traoré_2019",2019,"Wolves","Premier League","Adama Traoré","ESP","FW,MF","22",1996,10,16,13,11,3,2,4,9,44.4,5,11,0,11,6,22,7,0,"https://fbref.com/en/players/9a28eba4/Adama-Traore"
"2656","Rúben Vinagre_2019",2019,"Wolves","Premier League","Rúben Vinagre","POR","DF,MF","19",1999,7.9,14,9,7,7,0,2,5,40,3,10,2,8,14,28,16,1,"https://fbref.com/en/players/b937e490/Ruben-Vinagre"
"2657","Martin Agirregabiria_2020",2020,"Alavés","La Liga","Martin Agirregabiria","ESP","DF","23",1996,23.3,55,30,32,18,5,30,54,55.6,24,19,7,12,18,73,48,0,"https://fbref.com/en/players/355c883a/Martin-Agirregabiria"
"2658","Burgui_2020",2020,"Alavés","La Liga","Burgui","ESP","MF","25",1993,0.2,0,0,0,0,0,0,0,NA,0,0,0,0,0,0,0,0,"https://fbref.com/en/players/45e304c8/Burgui"
"2659","Oliver Burke_2020",2020,"Alavés","La Liga","Oliver Burke","SCO","MF,FW","22",1997,15.9,19,14,8,9,2,10,23,43.5,13,24,0,24,8,27,16,0,"https://fbref.com/en/players/f631c17f/Oliver-Burke"
"2660","Víctor Camarasa_2020",2020,"Alavés","La Liga","Víctor Camarasa","ESP","MF","25",1994,14.4,18,10,5,10,3,7,18,38.9,11,8,3,5,15,33,12,0,"https://fbref.com/en/players/b2d03887/Victor-Camarasa"
"2661","Rubén Duarte_2020",2020,"Alavés","La Liga","Rubén Duarte","ESP","DF","23",1995,29.6,61,32,30,28,3,34,60,56.7,26,30,8,22,47,108,71,0,"https://fbref.com/en/players/1fe0492d/Ruben-Duarte"
"2662","Rodrigo Ely_2020",2020,"Alavés","La Liga","Rodrigo Ely","BRA","DF","25",1993,23.6,22,13,15,7,0,13,29,44.8,16,23,19,4,32,54,116,0,"https://fbref.com/en/players/fd47b4f2/Rodrigo-Ely"
"2663","Ljubomir Fejsa_2020",2020,"Alavés","La Liga","Ljubomir Fejsa","SRB","MF","30",1988,8.7,19,13,8,10,1,6,23,26.1,17,8,1,7,6,25,13,0,"https://fbref.com/en/players/874d7a32/Ljubomir-Fejsa"
"2664","Manu García_2020",2020,"Alavés","La Liga","Manu García","ESP","MF","33",1986,21.9,46,23,11,31,4,17,72,23.6,55,28,12,16,28,74,32,1,"https://fbref.com/en/players/05a4465d/Manu-Garcia"
"2665","John Guidetti_2020",2020,"Alavés","La Liga","John Guidetti","SWE","FW,MF","27",1992,1.1,2,1,0,1,1,0,0,NA,0,1,0,1,0,2,0,0,"https://fbref.com/en/players/99bebd12/John-Guidetti"
"2666","Joselu_2020",2020,"Alavés","La Liga","Joselu","ESP","FW","29",1990,30.9,26,17,4,12,10,4,32,12.5,28,36,5,31,13,39,46,0,"https://fbref.com/en/players/6265208f/Joselu"
"2667","Víctor Laguardia_2020",2020,"Alavés","La Liga","Víctor Laguardia","ESP","DF","29",1989,29.5,21,15,15,6,0,16,30,53.3,14,24,18,6,37,58,131,1,"https://fbref.com/en/players/b7c99b9b/Victor-Laguardia"
"2668","Javi López_2020",2020,"Alavés","La Liga","Javi López","ESP","DF","17",2002,1,6,5,4,2,0,4,5,80,1,1,1,0,1,7,5,0,"https://fbref.com/en/players/e9ada8cf/Javi-Lopez"
"2669","José Luis Rodríguez_2020",2020,"Alavés","La Liga","José Luis Rodríguez","PAN","FW","21",1998,0.2,0,0,0,0,0,0,2,0,2,0,0,0,0,0,0,0,"https://fbref.com/en/players/b333b014/Jose-Luis-Rodriguez"
"2670","Lisandro Magallán_2020",2020,"Alavés","La Liga","Lisandro Magallán","ARG","DF","25",1993,13.3,22,15,10,12,0,8,14,57.1,6,17,6,11,16,38,43,1,"https://fbref.com/en/players/01a49bd2/Lisandro-Magallan"
"2671","Abdallahi Mahmoud_2020",2020,"Alavés","La Liga","Abdallahi Mahmoud","MTN","MF","19",2000,1.7,4,4,2,1,1,1,6,16.7,5,0,0,0,5,9,2,0,"https://fbref.com/en/players/ab99e4a0/Abdallahi-Mahmoud"
"2672","Adrián Marín_2020",2020,"Alavés","La Liga","Adrián Marín","ESP","DF","22",1997,9.5,22,15,14,6,2,13,15,86.7,2,13,4,9,13,35,32,0,"https://fbref.com/en/players/b7f2edff/Adrian-Marin"
"2673","Guillermo Maripán_2020",2020,"Alavés","La Liga","Guillermo Maripán","CHI","DF","25",1994,1,1,1,1,0,0,1,2,50,1,0,0,0,2,3,10,0,"https://fbref.com/en/players/d9764034/Guillermo-Maripan"
"2674","Édgar Méndez_2020",2020,"Alavés","La Liga","Édgar Méndez","ESP","MF,FW","29",1990,9.6,11,7,4,6,1,5,13,38.5,8,10,2,8,5,16,7,0,"https://fbref.com/en/players/aed746df/Edgar-Mendez"
"2675","Javier Muñoz_2020",2020,"Alavés","La Liga","Javier Muñoz","ESP","FW,MF","24",1995,0.6,0,0,0,0,0,0,0,NA,0,1,1,0,0,0,0,0,"https://fbref.com/en/players/ec7c84c2/Javier-Munoz"
"2676","Ximo Navarro_2020",2020,"Alavés","La Liga","Ximo Navarro","ESP","DF","29",1990,21.1,34,19,17,15,2,16,28,57.1,12,20,7,13,52,86,76,2,"https://fbref.com/en/players/8db394aa/Ximo-Navarro"
"2677","Fernando Pacheco_2020",2020,"Alavés","La Liga","Fernando Pacheco","ESP","GK","27",1992,26.2,1,0,1,0,0,1,3,33.3,2,0,0,0,0,1,10,0,"https://fbref.com/en/players/97852360/Fernando-Pacheco"
"2678","Paulino_2020",2020,"Alavés","La Liga","Paulino","ESP","FW,MF","22",1997,0.8,0,0,0,0,0,0,1,0,1,1,0,1,1,1,0,0,"https://fbref.com/en/players/f20fce1b/Paulino"
"2679","Lucas Pérez_2020",2020,"Alavés","La Liga","Lucas Pérez","ESP","FW","30",1988,27.7,12,6,2,8,2,3,13,23.1,10,13,2,11,2,14,0,0,"https://fbref.com/en/players/a300ac7e/Lucas-Perez"
"2680","Tomás Pina Isla_2020",2020,"Alavés","La Liga","Tomás Pina Isla","ESP","MF","31",1987,14.9,37,22,13,21,3,12,24,50,12,15,5,10,16,53,31,0,"https://fbref.com/en/players/e54bd0a2/Tomas-Pina-Isla"
"2681","Pere Pons_2020",2020,"Alavés","La Liga","Pere Pons","ESP","MF","26",1993,12.1,28,16,14,12,2,12,26,46.2,14,16,3,13,12,40,8,1,"https://fbref.com/en/players/29b61deb/Pere-Pons"
"2682","Luis Rioja_2020",2020,"Alavés","La Liga","Luis Rioja","ESP","MF","25",1993,18.2,18,12,11,6,1,8,25,32,17,21,0,21,16,34,6,0,"https://fbref.com/en/players/eb3dd471/Luis-Rioja"
"2683","Roberto_2020",2020,"Alavés","La Liga","Roberto","ESP","GK","33",1986,8.8,1,1,1,0,0,1,1,100,0,0,0,0,0,1,2,0,"https://fbref.com/en/players/ba3ca78f/Roberto"
"2684","Borja Sainz_2020",2020,"Alavés","La Liga","Borja Sainz","ESP","MF,FW","18",2001,6.4,16,9,4,9,3,8,26,30.8,18,14,0,14,3,19,0,0,"https://fbref.com/en/players/1b40049a/Borja-Sainz"
"2685","Antonio Sivera_2020",2020,"Alavés","La Liga","Antonio Sivera","ESP","GK","22",1996,3,0,0,0,0,0,0,0,NA,0,0,0,0,0,0,2,0,"https://fbref.com/en/players/9970da54/Antonio-Sivera"
"2686","Tachi_2020",2020,"Alavés","La Liga","Tachi","ESP","DF","21",1997,2.6,2,1,2,0,0,1,4,25,3,5,4,1,4,6,12,0,"https://fbref.com/en/players/8b625720/Tachi"
"2687","Aleix Vidal_2020",2020,"Alavés","La Liga","Aleix Vidal","ESP","MF","29",1989,24.1,21,14,8,11,2,8,37,21.6,29,14,1,13,23,44,18,0,"https://fbref.com/en/players/04965583/Aleix-Vidal"
"2688","Wakaso_2020",2020,"Alavés","La Liga","Wakaso","GHA","MF","29",1990,14.3,54,31,25,24,5,16,33,48.5,17,23,5,18,17,71,17,1,"https://fbref.com/en/players/999908af/Wakaso"
"2689","Chadrac Akolo_2020",2020,"Amiens","Ligue 1","Chadrac Akolo","COD","FW,MF","24",1995,6,16,8,8,6,2,5,12,41.7,7,6,1,5,5,21,5,0,"https://fbref.com/en/players/debc2f28/Chadrac-Akolo"
"2690","Haitam Aleesami_2020",2020,"Amiens","Ligue 1","Haitam Aleesami","NOR","DF","28",1991,21.3,36,16,25,9,2,18,43,41.9,25,33,10,23,34,70,59,1,"https://fbref.com/en/players/4085f08e/Haitam-Aleesami"
"2691","Alexis Blin_2020",2020,"Amiens","Ligue 1","Alexis Blin","FRA","MF","22",1996,20.5,39,25,18,15,6,20,61,32.8,41,25,6,19,16,55,49,0,"https://fbref.com/en/players/c69ef855/Alexis-Blin"
"2692","Mathieu Bodmer_2020",2020,"Amiens","Ligue 1","Mathieu Bodmer","FRA","MF,FW","36",1982,1,0,0,0,0,0,0,1,0,1,1,1,0,1,1,1,0,"https://fbref.com/en/players/f3642ba8/Mathieu-Bodmer"
"2693","Arturo Calabresi_2020",2020,"Amiens","Ligue 1","Arturo Calabresi","ITA","DF","23",1996,20.9,53,33,29,20,4,33,75,44,42,24,11,13,29,82,60,0,"https://fbref.com/en/players/34bb6fbd/Arturo-Calabresi"
"2694","Aurélien Chedjou_2020",2020,"Amiens","Ligue 1","Aurélien Chedjou","CMR","DF","34",1985,21.9,27,19,18,9,0,10,22,45.5,12,15,11,4,40,67,120,3,"https://fbref.com/en/players/80e4c841/Aurelien-Chedjou"
"2695","Quentin Cornette_2020",2020,"Amiens","Ligue 1","Quentin Cornette","FRA","FW,MF","25",1994,3.9,8,3,3,2,3,3,9,33.3,6,7,1,6,6,14,5,0,"https://fbref.com/en/players/5d42d487/Quentin-Cornette"
"2696","Fousseni Diabaté_2020",2020,"Amiens","Ligue 1","Fousseni Diabaté","MLI","FW,MF","23",1995,13.2,16,10,6,6,4,5,16,31.3,11,11,0,11,8,24,3,1,"https://fbref.com/en/players/d07e3b41/Fousseni-Diabate"
"2697","Bakaye Dibassy_2020",2020,"Amiens","Ligue 1","Bakaye Dibassy","MLI","DF","29",1989,20.8,26,14,17,8,1,15,20,75,5,29,18,11,37,63,78,2,"https://fbref.com/en/players/247accfd/Bakaye-Dibassy"
"2698","Juan Ferney Otero_2020",2020,"Amiens","Ligue 1","Juan Ferney Otero","COL","FW,MF","24",1995,13.4,17,10,6,9,2,8,24,33.3,16,12,1,11,19,36,10,0,"https://fbref.com/en/players/05816e19/Juan-Ferney-Otero"
"2699","Saman Ghoddos_2020",2020,"Amiens","Ligue 1","Saman Ghoddos","IRN","FW","25",1993,2.6,2,2,0,1,1,1,2,50,1,5,0,5,2,4,3,0,"https://fbref.com/en/players/f7b1d4e0/Saman-Ghoddos"
"2700","Eddy Gnahoré_2020",2020,"Amiens","Ligue 1","Eddy Gnahoré","FRA","MF","25",1993,12.6,24,12,7,15,2,8,28,28.6,20,25,4,21,9,33,25,0,"https://fbref.com/en/players/a0434482/Eddy-Gnahore"
"2701","Prince-Désir Gouano_2020",2020,"Amiens","Ligue 1","Prince-Désir Gouano","FRA","DF","25",1993,3,3,1,0,3,0,0,0,NA,0,6,3,3,2,5,15,0,"https://fbref.com/en/players/7c6d6c96/Prince-Desir-Gouano"
"2702","Sehrou Guirassy_2020",2020,"Amiens","Ligue 1","Sehrou Guirassy","GUI","FW","23",1996,21.3,7,3,1,4,2,2,7,28.6,5,13,6,7,4,11,21,0,"https://fbref.com/en/players/923f4dda/Sehrou-Guirassy"
"2703","Régis Gurtner_2020",2020,"Amiens","Ligue 1","Régis Gurtner","FRA","GK","32",1986,28,1,1,1,0,0,1,2,50,1,0,0,0,0,1,10,4,"https://fbref.com/en/players/bc270726/Regis-Gurtner"
"2704","Christophe Jallet_2020",2020,"Amiens","Ligue 1","Christophe Jallet","FRA","DF","35",1983,9.5,24,16,14,8,2,14,37,37.8,23,8,2,6,18,42,29,0,"https://fbref.com/en/players/46d50339/Christophe-Jallet"
"2705","Gaël Kakuta_2020",2020,"Amiens","Ligue 1","Gaël Kakuta","COD","MF,FW","28",1991,22.2,46,27,13,27,6,17,48,35.4,31,15,1,14,16,62,8,2,"https://fbref.com/en/players/5b1bf5e3/Gael-Kakuta"
"2706","Moussa Konaté_2020",2020,"Amiens","Ligue 1","Moussa Konaté","SEN","FW","26",1993,6.8,3,0,0,3,0,0,2,0,2,2,0,2,1,4,1,0,"https://fbref.com/en/players/fcbcbd94/Moussa-Konate"
"2707","Jack Lahne_2020",2020,"Amiens","Ligue 1","Jack Lahne","SWE","FW","17",2001,0.1,1,1,0,0,1,0,0,NA,0,0,0,0,0,1,0,0,"https://fbref.com/en/players/07f73a4f/Jack-Lahne"
"2708","Jordan Lefort_2020",2020,"Amiens","Ligue 1","Jordan Lefort","FRA","DF","25",1993,9.4,3,2,2,1,0,3,5,60,2,4,1,3,9,12,29,0,"https://fbref.com/en/players/c3e4ecbb/Jordan-Lefort"
"2709","Isaac Mbenza_2020",2020,"Amiens","Ligue 1","Isaac Mbenza","BEL","FW","23",1996,0.9,0,0,0,0,0,0,1,0,1,0,0,0,0,0,0,0,"https://fbref.com/en/players/aa1a8c7e/Isaac-Mbenza"
"2710","Stiven Mendoza_2020",2020,"Amiens","Ligue 1","Stiven Mendoza","COL","FW,MF","27",1992,12.2,12,7,4,5,3,4,22,18.2,18,13,2,11,9,21,3,1,"https://fbref.com/en/players/e68f2cb4/Stiven-Mendoza"
"2711","Thomas Monconduit_2020",2020,"Amiens","Ligue 1","Thomas Monconduit","FRA","MF","28",1991,15.2,26,12,6,18,2,9,26,34.6,17,11,4,7,10,36,25,3,"https://fbref.com/en/players/84d94b91/Thomas-Monconduit"
"2712","Nicholas Opoku_2020",2020,"Amiens","Ligue 1","Nicholas Opoku","GHA","DF","21",1997,7,7,5,6,1,0,7,14,50,7,6,2,4,7,14,32,0,"https://fbref.com/en/players/b871bf55/Nicholas-Opoku"
"2713","Mahdi Talal_2020",2020,"Amiens","Ligue 1","Mahdi Talal","FRA","FW","21",1997,0.2,0,0,0,0,0,0,1,0,1,1,0,1,0,0,2,0,"https://fbref.com/en/players/814ac171/Mahdi-Talal"
"2714","Cheick Timite_2020",2020,"Amiens","Ligue 1","Cheick Timite","CIV","MF,FW","21",1997,1.3,1,0,0,1,0,0,1,0,1,0,0,0,2,3,1,0,"https://fbref.com/en/players/2c92d3c0/Cheick-Timite"
"2715","Bongani Zungu_2020",2020,"Amiens","Ligue 1","Bongani Zungu","RSA","MF","26",1992,11,27,11,10,13,4,18,31,58.1,13,8,2,6,16,43,21,0,"https://fbref.com/en/players/a8797cf1/Bongani-Zungu"
"2716","Rayan Aït Nouri_2020",2020,"Angers","Ligue 1","Rayan Aït Nouri","ALG","DF","18",2001,14.2,29,22,14,8,7,10,21,47.6,11,14,1,13,18,47,33,0,"https://fbref.com/en/players/9b398aea/Rayan-Ait-Nouri"
"2717","Rachid Alioui_2020",2020,"Angers","Ligue 1","Rachid Alioui","MAR","FW","27",1992,17.4,8,5,0,7,1,2,13,15.4,11,3,0,3,2,10,9,0,"https://fbref.com/en/players/bdedd861/Rachid-Alioui"
"2718","Stéphane Bahoken_2020",2020,"Angers","Ligue 1","Stéphane Bahoken","CMR","FW","27",1992,10.1,7,4,1,2,4,1,7,14.3,6,4,1,3,2,9,2,0,"https://fbref.com/en/players/5046b7d4/Stephane-Bahoken"
"2719","Abdoulaye Bamba_2020",2020,"Angers","Ligue 1","Abdoulaye Bamba","CIV","DF","29",1990,6.2,10,7,7,1,2,8,15,53.3,7,4,1,3,4,14,18,0,"https://fbref.com/en/players/7fecbcdb/Abdoulaye-Bamba"
"2720","Antonin Bobichon_2020",2020,"Angers","Ligue 1","Antonin Bobichon","FRA","MF","23",1995,7.2,9,4,4,5,0,2,19,10.5,17,7,0,7,7,16,4,0,"https://fbref.com/en/players/7d937aa1/Antonin-Bobichon"
"2721","Ludovic Butelle_2020",2020,"Angers","Ligue 1","Ludovic Butelle","FRA","GK","36",1983,26,1,1,1,0,0,1,2,50,1,1,0,1,0,1,10,4,"https://fbref.com/en/players/26975a92/Ludovic-Butelle"
"2722","Pierrick Capelle_2020",2020,"Angers","Ligue 1","Pierrick Capelle","FRA","MF,DF","32",1987,19.4,42,32,18,16,8,16,48,33.3,32,17,3,14,21,63,28,0,"https://fbref.com/en/players/79b2399c/Pierrick-Capelle"
"2723","Ibrahim Cissé_2020",2020,"Angers","Ligue 1","Ibrahim Cissé","SEN","DF","23",1996,0.7,2,1,0,2,0,0,0,NA,0,0,0,0,0,2,2,0,"https://fbref.com/en/players/0f87f8c2/Ibrahim-Cisse"
"2724","Souleyman Doumbia_2020",2020,"Angers","Ligue 1","Souleyman Doumbia","CIV","DF","22",1996,5,10,4,7,2,1,5,6,83.3,1,5,0,5,6,16,18,0,"https://fbref.com/en/players/9daeac61/Souleyman-Doumbia"
"2725","Angelo Fulgini_2020",2020,"Angers","Ligue 1","Angelo Fulgini","FRA","MF","22",1996,17.5,28,18,8,15,5,12,23,52.2,11,6,1,5,19,47,10,0,"https://fbref.com/en/players/4b96c347/Angelo-Fulgini"
"2726","Wilfried Kanga_2020",2020,"Angers","Ligue 1","Wilfried Kanga","CIV","FW","21",1998,0.8,0,0,0,0,0,0,1,0,1,0,0,0,0,0,0,0,"https://fbref.com/en/players/b4c816a9/Wilfried-Kanga"
"2727","Vincent Manceau_2020",2020,"Angers","Ligue 1","Vincent Manceau","FRA","DF","30",1989,22,34,22,18,13,3,16,36,44.4,20,16,3,13,22,56,51,0,"https://fbref.com/en/players/c26a3918/Vincent-Manceau"
"2728","Thomas Mangani_2020",2020,"Angers","Ligue 1","Thomas Mangani","FRA","MF","32",1987,20.8,33,23,15,16,2,14,47,29.8,33,17,2,15,12,45,20,1,"https://fbref.com/en/players/c801616a/Thomas-Mangani"
"2729","Farid El Melali_2020",2020,"Angers","Ligue 1","Farid El Melali","ALG","MF,FW","22",1997,3.4,7,5,2,2,3,4,14,28.6,10,5,0,5,2,9,4,0,"https://fbref.com/en/players/d21e361a/Farid-El-Melali"
"2730","Casimir Ninga_2020",2020,"Angers","Ligue 1","Casimir Ninga","CHA","MF,FW","26",1993,7.6,5,5,4,0,1,1,5,20,4,5,0,5,3,8,2,0,"https://fbref.com/en/players/91f2da4c/Casimir-Ninga"
"2731","Zinédine Ould Khaled_2020",2020,"Angers","Ligue 1","Zinédine Ould Khaled","FRA","MF","19",2000,0.7,2,1,0,2,0,2,4,50,2,0,0,0,4,6,0,0,"https://fbref.com/en/players/6b4436ba/Zinedine-Ould-Khaled"
"2732","Vincent Pajot_2020",2020,"Angers","Ligue 1","Vincent Pajot","FRA","MF","28",1990,1.3,2,2,1,1,0,1,1,100,0,3,0,3,5,7,0,0,"https://fbref.com/en/players/f86ca403/Vincent-Pajot"
"2733","Mateo Pavlović_2020",2020,"Angers","Ligue 1","Mateo Pavlović","BIH","DF","29",1990,9,8,2,6,2,0,5,7,71.4,2,4,2,2,5,13,38,1,"https://fbref.com/en/players/450e277f/Mateo-Pavlovic"
"2734","Théo Pellenard_2020",2020,"Angers","Ligue 1","Théo Pellenard","FRA","DF","25",1994,5.1,11,8,6,3,2,6,13,46.2,7,4,0,4,5,16,8,0,"https://fbref.com/en/players/97fb4608/Theo-Pellenard"
"2735","Mathias Pereira Lage_2020",2020,"Angers","Ligue 1","Mathias Pereira Lage","POR","MF","22",1996,17.1,30,18,16,13,1,12,37,32.4,25,19,0,19,17,47,9,0,"https://fbref.com/en/players/8846a40f/Mathias-Pereira-Lage"
"2736","Danijel Petković_2020",2020,"Angers","Ligue 1","Danijel Petković","MNE","GK","26",1993,2,0,0,0,0,0,0,0,NA,0,0,0,0,0,0,2,0,"https://fbref.com/en/players/b98cea65/Danijel-Petkovic"
"2737","Jeff Reine-Adélaïde_2020",2020,"Angers","Ligue 1","Jeff Reine-Adélaïde","FRA","MF","21",1998,0.9,3,1,1,2,0,1,1,100,0,1,0,1,0,3,1,0,"https://fbref.com/en/players/d504b3e1/Jeff-Reine-Adelaide"
"2738","Baptiste Santamaria_2020",2020,"Angers","Ligue 1","Baptiste Santamaria","FRA","MF","24",1995,27.8,91,53,39,43,9,35,79,44.3,44,27,5,22,43,134,36,0,"https://fbref.com/en/players/5e22e2a4/Baptiste-Santamaria"
"2739","Sada Thioub_2020",2020,"Angers","Ligue 1","Sada Thioub","SEN","MF,FW","24",1995,16.8,20,12,8,9,3,5,18,27.8,13,9,1,8,4,24,5,0,"https://fbref.com/en/players/f4bc42b1/Sada-Thioub"
"2740","Romain Thomas_2020",2020,"Angers","Ligue 1","Romain Thomas","FRA","DF","31",1988,26,24,17,16,7,1,8,18,44.4,10,35,18,17,39,63,118,1,"https://fbref.com/en/players/275e2c51/Romain-Thomas"
"2741","Ismaël Traoré_2020",2020,"Angers","Ligue 1","Ismaël Traoré","CIV","DF","32",1986,22.8,23,12,14,7,2,10,17,58.8,7,23,13,10,27,50,85,1,"https://fbref.com/en/players/b666421b/Ismael-Traore"
"2742","Pierre-Emerick Aubameyang_2020",2020,"Arsenal","Premier League","Pierre-Emerick Aubameyang","GAB","FW","30",1989,34.8,31,19,10,12,9,12,51,23.5,39,39,1,38,14,45,16,0,"https://fbref.com/en/players/d5dd5f1f/Pierre-Emerick-Aubameyang"
"2743","Héctor Bellerín_2020",2020,"Arsenal","Premier League","Héctor Bellerín","ESP","DF,MF","24",1995,12.9,20,13,7,11,2,11,29,37.9,18,20,4,16,19,39,27,1,"https://fbref.com/en/players/f874dd44/Hector-Bellerin"
"2744","Dani Ceballos_2020",2020,"Arsenal","Premier League","Dani Ceballos","ESP","MF","22",1996,18.8,45,23,26,14,5,18,61,29.5,43,14,3,11,32,77,16,1,"https://fbref.com/en/players/c0617e2b/Dani-Ceballos"
"2745","Calum Chambers_2020",2020,"Arsenal","Premier League","Calum Chambers","ENG","DF","24",1995,12.2,26,10,12,8,6,11,16,68.8,5,13,7,6,16,42,43,1,"https://fbref.com/en/players/dc6f5bdd/Calum-Chambers"
"2746","Mattéo Guendouzi_2020",2020,"Arsenal","Premier League","Mattéo Guendouzi","FRA","MF","20",1999,19.4,31,16,14,13,4,14,43,32.6,29,21,7,14,29,60,38,2,"https://fbref.com/en/players/5ea8ef20/Matteo-Guendouzi"
"2747","Rob Holding_2020",2020,"Arsenal","Premier League","Rob Holding","ENG","DF","23",1995,6.5,4,2,3,1,0,1,3,33.3,2,10,6,4,5,9,45,1,"https://fbref.com/en/players/d79a8c87/Rob-Holding"
"2748","Sead Kolašinac_2020",2020,"Arsenal","Premier League","Sead Kolašinac","BIH","DF","26",1993,18.9,29,16,18,6,5,12,23,52.2,11,14,4,10,25,54,34,1,"https://fbref.com/en/players/3935e52e/Sead-Kolasinac"
"2749","Alexandre Lacazette_2020",2020,"Arsenal","Premier League","Alexandre Lacazette","FRA","FW","28",1991,20.8,31,16,8,21,2,9,24,37.5,15,14,0,14,7,38,15,0,"https://fbref.com/en/players/9dbb75ca/Alexandre-Lacazette"
"2750","Bernd Leno_2020",2020,"Arsenal","Premier League","Bernd Leno","GER","GK","27",1992,29.4,0,0,0,0,0,0,2,0,2,0,0,0,0,0,9,2,"https://fbref.com/en/players/2628fd2b/Bernd-Leno"
"2751","David Luiz_2020",2020,"Arsenal","Premier League","David Luiz","BRA","DF","32",1987,31.2,28,16,14,14,0,13,24,54.2,11,42,37,5,32,60,133,2,"https://fbref.com/en/players/c0e27d1a/David-Luiz"
"2752","Ainsley Maitland-Niles_2020",2020,"Arsenal","Premier League","Ainsley Maitland-Niles","ENG","DF","21",1997,15.4,41,23,34,5,2,22,43,51.2,21,12,3,9,28,69,38,0,"https://fbref.com/en/players/e3a5814e/Ainsley-Maitland-Niles"
"2753","Pablo Marí_2020",2020,"Arsenal","Premier League","Pablo Marí","ESP","DF","25",1993,1.3,2,1,2,0,0,0,0,NA,0,0,0,0,1,3,10,0,"https://fbref.com/en/players/aa54ec6f/Pablo-Mari"
"2754","Martinelli_2020",2020,"Arsenal","Premier League","Martinelli","BRA","FW","18",2001,7.4,20,15,10,6,4,7,20,35,13,15,1,14,3,23,8,0,"https://fbref.com/en/players/48a5a5d6/Martinelli"
"2755","Emiliano Martínez_2020",2020,"Arsenal","Premier League","Emiliano Martínez","ARG","GK","26",1992,8.6,0,0,0,0,0,0,0,NA,0,0,0,0,0,0,1,0,"https://fbref.com/en/players/7956236f/Emiliano-Martinez"
"2756","Henrikh Mkhitaryan_2020",2020,"Arsenal","Premier League","Henrikh Mkhitaryan","ARM","FW","30",1989,1.2,0,0,0,0,0,0,2,0,2,3,0,3,0,0,1,0,"https://fbref.com/en/players/dd0daf32/Henrikh-Mkhitaryan"
"2757","Nacho Monreal_2020",2020,"Arsenal","Premier League","Nacho Monreal","ESP","DF","33",1986,3,1,1,1,0,0,1,3,33.3,2,3,1,2,3,4,10,0,"https://fbref.com/en/players/d4cb83cc/Nacho-Monreal"
"2758","Shkodran Mustafi_2020",2020,"Arsenal","Premier League","Shkodran Mustafi","GER","DF","27",1992,13.4,17,10,11,5,1,6,12,50,6,10,6,4,18,35,72,0,"https://fbref.com/en/players/3f2d59fe/Shkodran-Mustafi"
"2759","Reiss Nelson_2020",2020,"Arsenal","Premier League","Reiss Nelson","ENG","FW","19",1999,7,11,8,5,4,2,7,17,41.2,10,13,2,11,3,14,3,0,"https://fbref.com/en/players/c5bdb6e3/Reiss-Nelson"
"2760","Eddie Nketiah_2020",2020,"Arsenal","Premier League","Eddie Nketiah","ENG","FW","20",1999,7,7,5,3,4,0,2,6,33.3,4,9,0,9,2,9,5,0,"https://fbref.com/en/players/a53649b7/Eddie-Nketiah"
"2761","Mesut Özil_2020",2020,"Arsenal","Premier League","Mesut Özil","GER","MF","30",1988,16,17,8,9,7,1,4,23,17.4,19,4,0,4,5,22,1,0,"https://fbref.com/en/players/16380240/Mesut-Ozil"
"2762","Sokratis Papastathopoulos_2020",2020,"Arsenal","Premier League","Sokratis Papastathopoulos","GRE","DF","31",1988,18.8,25,16,17,7,1,10,21,47.6,11,30,24,6,17,42,68,1,"https://fbref.com/en/players/b682dcf6/Sokratis-Papastathopoulos"
"2763","Nicolas Pépé_2020",2020,"Arsenal","Premier League","Nicolas Pépé","CIV","FW","24",1995,22.3,32,17,15,13,4,8,16,50,8,15,2,13,8,40,5,0,"https://fbref.com/en/players/57e3f0c7/Nicolas-Pepe"
"2764","Bukayo Saka_2020",2020,"Arsenal","Premier League","Bukayo Saka","ENG","DF,FW","17",2001,19.5,36,21,21,8,7,19,37,51.4,18,12,3,9,12,48,19,0,"https://fbref.com/en/players/bc7dc64d/Bukayo-Saka"
"2765","Emile Smith Rowe_2020",2020,"Arsenal","Premier League","Emile Smith Rowe","ENG","MF","19",2000,1.1,1,1,1,0,0,1,3,33.3,2,0,0,0,1,2,2,0,"https://fbref.com/en/players/17695062/Emile-Smith-Rowe"
"2766","Cédric Soares_2020",2020,"Arsenal","Premier League","Cédric Soares","POR","MF,DF","27",1991,2.8,8,6,2,6,0,1,3,33.3,2,3,0,3,3,11,4,0,"https://fbref.com/en/players/839c14e1/Cedric-Soares"
"2767","Kieran Tierney_2020",2020,"Arsenal","Premier League","Kieran Tierney","SCO","DF,MF","22",1997,11,20,16,13,6,1,11,15,73.3,4,10,4,6,9,29,37,1,"https://fbref.com/en/players/fce2302c/Kieran-Tierney"
"2768","Lucas Torreira_2020",2020,"Arsenal","Premier League","Lucas Torreira","URU","MF","23",1996,16.8,31,16,11,15,5,16,39,41,23,24,8,16,34,65,24,0,"https://fbref.com/en/players/52611641/Lucas-Torreira"
"2769","Joe Willock_2020",2020,"Arsenal","Premier League","Joe Willock","ENG","MF,FW","19",1999,9.5,25,16,9,12,4,8,21,38.1,13,16,2,14,4,29,11,2,"https://fbref.com/en/players/a3b03921/Joe-Willock"
"2770","Granit Xhaka_2020",2020,"Arsenal","Premier League","Granit Xhaka","SUI","MF","26",1992,28.7,45,25,20,19,6,25,55,45.5,30,32,16,16,21,66,59,3,"https://fbref.com/en/players/e61b8aee/Granit-Xhaka"
"2771","Borja Bastón_2020",2020,"Aston Villa","Premier League","Borja Bastón","ESP","MF,FW","26",1992,0.2,1,0,0,1,0,0,2,0,2,1,0,1,0,1,0,1,"https://fbref.com/en/players/8c44e37b/Borja-Baston"
"2772","Keinan Davis_2020",2020,"Aston Villa","Premier League","Keinan Davis","ENG","FW","21",1998,6.1,1,1,0,1,0,0,3,0,3,4,0,4,0,1,3,0,"https://fbref.com/en/players/9deaf2c8/Keinan-Davis"
"2773","Danny Drinkwater_2020",2020,"Aston Villa","Premier League","Danny Drinkwater","ENG","MF","29",1990,2.9,5,3,3,2,0,2,18,11.1,16,5,0,5,5,10,5,1,"https://fbref.com/en/players/2649ff32/Danny-Drinkwater"
"2774","Ahmed Elmohamady_2020",2020,"Aston Villa","Premier League","Ahmed Elmohamady","EGY","DF","31",1987,11.5,19,9,10,7,2,10,21,47.6,11,11,5,6,13,32,25,1,"https://fbref.com/en/players/615ef733/Ahmed-Elmohamady"
"2775","Björn Engels_2020",2020,"Aston Villa","Premier League","Björn Engels","BEL","DF","24",1994,16.1,11,6,8,2,1,8,13,61.5,5,18,17,1,28,39,86,3,"https://fbref.com/en/players/4fdf1fd9/Bjorn-Engels"
"2776","Anwar El Ghazi_2020",2020,"Aston Villa","Premier League","Anwar El Ghazi","NED","FW,MF","24",1995,22.8,20,11,12,5,3,8,26,30.8,18,10,1,9,13,33,16,1,"https://fbref.com/en/players/ffa90327/Anwar-El-Ghazi"
"2777","Jack Grealish_2020",2020,"Aston Villa","Premier League","Jack Grealish","ENG","FW,MF","23",1995,35.9,29,19,12,12,5,13,34,38.2,21,33,12,21,22,51,22,1,"https://fbref.com/en/players/b0b4fd3e/Jack-Grealish"
"2778","Frederic Guilbert_2020",2020,"Aston Villa","Premier League","Frederic Guilbert","FRA","DF,MF","24",1994,22.7,74,43,48,20,6,36,67,53.7,31,33,10,23,49,123,74,2,"https://fbref.com/en/players/5d8d7454/Frederic-Guilbert"
"2779","Kortney Hause_2020",2020,"Aston Villa","Premier League","Kortney Hause","ENG","DF","24",1995,17.2,21,9,15,5,1,8,15,53.3,7,27,19,8,20,41,98,4,"https://fbref.com/en/players/bf8fad51/Kortney-Hause"
"2780","Tom Heaton_2020",2020,"Aston Villa","Premier League","Tom Heaton","ENG","GK","33",1986,19.9,3,2,3,0,0,3,4,75,1,0,0,0,0,3,6,0,"https://fbref.com/en/players/a6de6361/Tom-Heaton"
"2781","Conor Hourihane_2020",2020,"Aston Villa","Premier League","Conor Hourihane","IRL","MF","28",1991,17,16,10,4,8,4,10,25,40,15,19,4,15,9,25,31,0,"https://fbref.com/en/players/fcab00a0/Conor-Hourihane"
"2782","Jota_2020",2020,"Aston Villa","Premier League","Jota","ESP","FW,MF","28",1991,3.7,3,1,2,0,1,2,5,40,3,1,0,1,3,6,6,0,"https://fbref.com/en/players/9f351459/Jota"
"2783","Jonathan Kodjia_2020",2020,"Aston Villa","Premier League","Jonathan Kodjia","CIV","FW","29",1989,1.3,0,0,0,0,0,0,1,0,1,0,0,0,0,0,1,0,"https://fbref.com/en/players/ecf44e09/Jonathan-Kodjia"
"2784","Ezri Konsa_2020",2020,"Aston Villa","Premier League","Ezri Konsa","ENG","DF","21",1997,22.7,18,9,12,6,0,7,16,43.8,9,34,24,10,25,43,70,2,"https://fbref.com/en/players/0313a347/Ezri-Konsa"
"2785","Henri Lansbury_2020",2020,"Aston Villa","Premier League","Henri Lansbury","ENG","MF","28",1990,2.2,6,2,3,1,2,2,8,25,6,4,0,4,0,6,3,0,"https://fbref.com/en/players/fe8e6fa1/Henri-Lansbury"
"2786","Douglas Luiz_2020",2020,"Aston Villa","Premier League","Douglas Luiz","BRA","MF","21",1998,29,46,24,25,17,4,19,65,29.2,46,42,15,27,36,82,54,1,"https://fbref.com/en/players/6f7d826d/Douglas-Luiz"
"2787","John McGinn_2020",2020,"Aston Villa","Premier League","John McGinn","SCO","MF","24",1994,25.7,53,35,19,23,11,18,62,29,44,25,1,24,25,78,18,0,"https://fbref.com/en/players/90f91999/John-McGinn"
"2788","Tyrone Mings_2020",2020,"Aston Villa","Premier League","Tyrone Mings","ENG","DF","26",1993,32.2,15,11,11,3,1,10,13,76.9,3,56,48,8,30,45,190,4,"https://fbref.com/en/players/8397a50c/Tyrone-Mings"
"2789","Wesley Moraes_2020",2020,"Aston Villa","Premier League","Wesley Moraes","BRA","FW","22",1996,19.8,15,8,3,8,4,0,5,0,5,10,2,8,4,19,23,0,"https://fbref.com/en/players/bfae110f/Wesley-Moraes"
"2790","Marvelous Nakamba_2020",2020,"Aston Villa","Premier League","Marvelous Nakamba","ZIM","MF","25",1994,20.4,55,28,28,20,7,24,67,35.8,43,50,11,39,39,94,38,3,"https://fbref.com/en/players/de5b5570/Marvelous-Nakamba"
"2791","Ørjan Nyland_2020",2020,"Aston Villa","Premier League","Ørjan Nyland","NOR","GK","28",1990,6,0,0,0,0,0,0,0,NA,0,0,0,0,0,0,1,1,"https://fbref.com/en/players/bdedffac/Orjan-Nyland"
"2792","Pepe Reina_2020",2020,"Aston Villa","Premier League","Pepe Reina","ESP","GK","36",1982,12,0,0,0,0,0,0,2,0,2,0,0,0,0,0,9,1,"https://fbref.com/en/players/e358587b/Pepe-Reina"
"2793","Mbwana Samatta_2020",2020,"Aston Villa","Premier League","Mbwana Samatta","TAN","FW","26",1992,10.5,6,4,0,3,3,1,8,12.5,7,7,0,7,1,7,6,0,"https://fbref.com/en/players/dae8623e/Mbwana-Samatta"
"2794","Jed Steer_2020",2020,"Aston Villa","Premier League","Jed Steer","ENG","GK","26",1992,0.1,0,0,0,0,0,0,0,NA,0,0,0,0,0,0,0,0,"https://fbref.com/en/players/a8a3d139/Jed-Steer"
"2795","Matt Targett_2020",2020,"Aston Villa","Premier League","Matt Targett","ENG","DF,MF","23",1995,25.5,52,29,37,11,4,22,53,41.5,31,28,8,20,56,108,82,0,"https://fbref.com/en/players/e514ab62/Matt-Targett"
"2796","Neil Taylor_2020",2020,"Aston Villa","Premier League","Neil Taylor","WAL","DF","30",1989,12.1,16,11,12,4,0,11,20,55,9,15,5,10,20,36,43,0,"https://fbref.com/en/players/c2f9d19f/Neil-Taylor"
"2797","Trézéguet_2020",2020,"Aston Villa","Premier League","Trézéguet","EGY","FW,MF","24",1994,21.7,38,16,18,15,5,9,44,20.5,35,23,2,21,25,63,18,0,"https://fbref.com/en/players/3ae14ed1/Trezeguet"
"2798","Indiana Vassilev_2020",2020,"Aston Villa","Premier League","Indiana Vassilev","USA","FW,MF","18",2001,0.6,0,0,0,0,0,0,0,NA,0,0,0,0,0,0,0,0,"https://fbref.com/en/players/04e195ee/Indiana-Vassilev"
"2799","Guilherme Arana_2020",2020,"Atalanta","Serie A","Guilherme Arana","BRA","DF","22",1997,0.9,4,4,1,3,0,3,5,60,2,0,0,0,2,6,0,0,"https://fbref.com/en/players/2b15a82a/Guilherme-Arana"
"2800","Musa Barrow_2020",2020,"Atalanta","Serie A","Musa Barrow","GAM","FW,MF","20",1998,2.1,1,1,0,0,1,1,4,25,3,4,0,4,0,1,1,0,"https://fbref.com/en/players/e5bf73f3/Musa-Barrow"
"2801","Raoul Bellanova_2020",2020,"Atalanta","Serie A","Raoul Bellanova","ITA","DF","19",2000,0.2,0,0,0,0,0,0,0,NA,0,0,0,0,0,0,0,0,"https://fbref.com/en/players/e3756e72/Raoul-Bellanova"
"2802","Mattia Caldara_2020",2020,"Atalanta","Serie A","Mattia Caldara","ITA","DF","25",1994,10.7,21,11,12,8,1,5,11,45.5,6,9,5,4,30,51,22,1,"https://fbref.com/en/players/ac7e640b/Mattia-Caldara"
"2803","Timothy Castagne_2020",2020,"Atalanta","Serie A","Timothy Castagne","BEL","DF","23",1995,19.7,31,20,9,16,6,13,25,52,12,34,5,29,17,48,23,0,"https://fbref.com/en/players/197640fd/Timothy-Castagne"
"2804","Ebrima Colley_2020",2020,"Atalanta","Serie A","Ebrima Colley","GAM","FW","19",2000,0.9,2,1,1,0,1,1,2,50,1,1,0,1,1,3,0,0,"https://fbref.com/en/players/bf356094/Ebrima-Colley"
"2805","Lennart-Marten Czyborra_2020",2020,"Atalanta","Serie A","Lennart-Marten Czyborra","GER","DF","20",1999,0.2,0,0,0,0,0,0,0,NA,0,2,0,2,0,0,0,0,"https://fbref.com/en/players/7ba1f1ef/Lennart-Marten-Czyborra"
"2806","Jacopo Da Riva_2020",2020,"Atalanta","Serie A","Jacopo Da Riva","ITA","MF","18",2000,0,0,0,0,0,0,0,0,NA,0,0,0,0,0,0,0,0,"https://fbref.com/en/players/9591723b/Jacopo-Da-Riva"
"2807","Amad Diallo_2020",2020,"Atalanta","Serie A","Amad Diallo","CIV","FW","17",2002,0.3,1,1,0,1,0,0,0,NA,0,0,0,0,0,1,0,0,"https://fbref.com/en/players/9dc96f10/Amad-Diallo"
"2808","Berat Djimsiti_2020",2020,"Atalanta","Serie A","Berat Djimsiti","ALB","DF","26",1993,30.9,42,23,17,23,2,22,39,56.4,17,21,14,7,49,91,92,0,"https://fbref.com/en/players/6eee05f1/Berat-Djimsiti"
"2809","Remo Freuler_2020",2020,"Atalanta","Serie A","Remo Freuler","SUI","MF","27",1992,26,51,30,18,25,8,22,63,34.9,41,41,6,35,28,79,26,0,"https://fbref.com/en/players/98d2c2c4/Remo-Freuler"
"2810","Pierluigi Gollini_2020",2020,"Atalanta","Serie A","Pierluigi Gollini","ITA","GK","24",1995,32,0,0,0,0,0,0,2,0,2,0,0,0,0,0,13,2,"https://fbref.com/en/players/f0f7f62f/Pierluigi-Gollini"
"2811","Papu Gómez_2020",2020,"Atalanta","Serie A","Papu Gómez","ARG","MF,FW","31",1988,31.6,27,13,5,13,9,13,45,28.9,32,24,0,24,17,44,6,1,"https://fbref.com/en/players/6e4df551/Papu-Gomez"
"2812","Robin Gosens_2020",2020,"Atalanta","Serie A","Robin Gosens","GER","DF","25",1994,29.1,53,27,19,26,8,23,51,45.1,28,38,10,28,39,92,40,0,"https://fbref.com/en/players/2d970560/Robin-Gosens"
"2813","Hans Hateboer_2020",2020,"Atalanta","Serie A","Hans Hateboer","NED","DF","25",1994,26.2,36,23,20,9,7,18,38,47.4,20,22,7,15,10,46,32,1,"https://fbref.com/en/players/3b333ac3/Hans-Hateboer"
"2814","Josip Iličić_2020",2020,"Atalanta","Serie A","Josip Iličić","SVN","FW,MF","31",1988,18.5,26,19,7,10,9,7,28,25,21,9,0,9,9,35,4,0,"https://fbref.com/en/players/68252d6d/Josip-Ilicic"
"2815","Simon Kjær_2020",2020,"Atalanta","Serie A","Simon Kjær","DEN","DF","30",1989,3.2,9,6,1,8,0,3,4,75,1,5,4,1,7,16,10,1,"https://fbref.com/en/players/8b8a56ce/Simon-Kjaer"
"2816","José Luis Palomino_2020",2020,"Atalanta","Serie A","José Luis Palomino","ARG","DF","29",1990,27.6,81,44,46,33,2,28,54,51.9,26,39,14,25,61,142,74,2,"https://fbref.com/en/players/921f6058/Jose-Luis-Palomino"
"2817","Ruslan Malinovskyi_2020",2020,"Atalanta","Serie A","Ruslan Malinovskyi","UKR","MF,FW","26",1993,17.1,22,14,2,17,3,9,31,29,22,13,2,11,5,27,5,0,"https://fbref.com/en/players/48d5bd33/Ruslan-Malinovskyi"
"2818","Andrea Masiello_2020",2020,"Atalanta","Serie A","Andrea Masiello","ITA","DF","33",1986,6,11,4,6,4,1,7,14,50,7,6,4,2,10,21,13,0,"https://fbref.com/en/players/e0314d87/Andrea-Masiello"
"2819","Luis Muriel_2020",2020,"Atalanta","Serie A","Luis Muriel","COL","FW","28",1991,14,15,9,3,8,4,3,14,21.4,11,12,0,12,4,19,0,0,"https://fbref.com/en/players/eb2fe5b6/Luis-Muriel"
"2820","Mario Pašalić_2020",2020,"Atalanta","Serie A","Mario Pašalić","CRO","MF","24",1995,26.9,47,21,17,18,12,16,52,30.8,36,27,7,20,27,74,22,2,"https://fbref.com/en/players/e599253a/Mario-Pasalic"
"2821","Roberto Piccoli_2020",2020,"Atalanta","Serie A","Roberto Piccoli","ITA","FW","18",2001,0.2,0,0,0,0,0,0,0,NA,0,1,0,1,0,0,0,0,"https://fbref.com/en/players/1cadaf34/Roberto-Piccoli"
"2822","Marten de Roon_2020",2020,"Atalanta","Serie A","Marten de Roon","NED","MF,DF","28",1991,30.2,77,43,36,29,12,34,75,45.3,41,32,8,24,46,123,45,0,"https://fbref.com/en/players/2a1beb34/Marten-de-Roon"
"2823","Francesco Rossi_2020",2020,"Atalanta","Serie A","Francesco Rossi","ITA","GK","28",1991,0.1,0,0,0,0,0,0,0,NA,0,0,0,0,0,0,0,0,"https://fbref.com/en/players/7b5f516f/Francesco-Rossi"
"2824","Marco Sportiello_2020",2020,"Atalanta","Serie A","Marco Sportiello","ITA","GK","27",1992,5.8,0,0,0,0,0,0,0,NA,0,0,0,0,0,0,3,0,"https://fbref.com/en/players/ac4003af/Marco-Sportiello"
"2825","Bosko Sutalo_2020",2020,"Atalanta","Serie A","Bosko Sutalo","CRO","DF","19",2000,3.1,3,2,2,1,0,0,2,0,2,4,0,4,6,9,6,1,"https://fbref.com/en/players/1d0bb7e4/Bosko-Sutalo"
"2826","Adrien Tameze_2020",2020,"Atalanta","Serie A","Adrien Tameze","CMR","MF","25",1994,2.3,4,3,1,1,2,1,2,50,1,3,1,2,3,7,4,1,"https://fbref.com/en/players/8da74c05/Adrien-Tameze"
"2827","Rafael Tolói_2020",2020,"Atalanta","Serie A","Rafael Tolói","ITA","DF","28",1990,29,56,29,28,23,5,33,76,43.4,43,31,17,14,45,101,80,0,"https://fbref.com/en/players/c56dc39e/Rafael-Toloi"
"2828","Duván Zapata_2020",2020,"Atalanta","Serie A","Duván Zapata","COL","FW","28",1991,22.5,7,3,1,2,4,1,6,16.7,5,18,7,11,2,9,11,0,"https://fbref.com/en/players/d3de9af0/Duvan-Zapata"
"2829","Aritz Aduriz_2020",2020,"Athletic Club","La Liga","Aritz Aduriz","ESP","FW,MF","38",1981,2.3,3,2,0,3,0,0,0,NA,0,0,0,0,0,3,2,0,"https://fbref.com/en/players/293211e1/Aritz-Aduriz"
"2830","Yeray Álvarez_2020",2020,"Athletic Club","La Liga","Yeray Álvarez","ESP","DF","24",1995,31.2,36,19,28,7,1,17,30,56.7,13,33,22,11,62,98,138,2,"https://fbref.com/en/players/3ecc11d8/Yeray-Alvarez"
"2831","Mikel Balenziaga_2020",2020,"Athletic Club","La Liga","Mikel Balenziaga","ESP","DF","31",1988,6.3,15,10,4,10,1,9,11,81.8,2,4,1,3,2,17,20,0,"https://fbref.com/en/players/1fe67e86/Mikel-Balenziaga"
"2832","Yuri Berchiche_2020",2020,"Athletic Club","La Liga","Yuri Berchiche","ESP","DF","29",1990,31.7,48,35,32,15,1,21,40,52.5,19,26,4,22,30,78,73,1,"https://fbref.com/en/players/b6e50615/Yuri-Berchiche"
"2833","Ander Capa_2020",2020,"Athletic Club","La Liga","Ander Capa","ESP","DF","27",1992,31.9,64,36,37,21,6,24,59,40.7,35,26,7,19,28,92,63,0,"https://fbref.com/en/players/37f1cf47/Ander-Capa"
"2834","Iñigo Córdoba_2020",2020,"Athletic Club","La Liga","Iñigo Córdoba","ESP","FW","22",1997,16,33,20,16,12,5,14,52,26.9,38,30,2,28,16,49,13,0,"https://fbref.com/en/players/49ea92be/Inigo-Cordoba"
"2835","Beñat Etxebarria_2020",2020,"Athletic Club","La Liga","Beñat Etxebarria","ESP","MF","32",1987,4.4,6,1,2,3,1,2,13,15.4,11,6,1,5,4,10,6,0,"https://fbref.com/en/players/b037bd4f/Benat-Etxebarria"
"2836","Dani García_2020",2020,"Athletic Club","La Liga","Dani García","ESP","MF","29",1990,33.7,59,30,30,27,2,30,86,34.9,56,25,7,18,52,111,56,1,"https://fbref.com/en/players/240d3a0b/Dani-Garcia"
"2837","Raúl García_2020",2020,"Athletic Club","La Liga","Raúl García","ESP","MF,FW","33",1986,31.9,57,37,19,26,12,16,76,21.1,60,46,6,40,24,81,44,0,"https://fbref.com/en/players/b418dbd4/Raul-Garcia"
"2838","Ibai Gómez_2020",2020,"Athletic Club","La Liga","Ibai Gómez","ESP","FW","29",1989,7.7,5,3,2,2,1,3,8,37.5,5,4,0,4,3,8,6,0,"https://fbref.com/en/players/9d2a3d5f/Ibai-Gomez"
"2839","Iago Herrerín_2020",2020,"Athletic Club","La Liga","Iago Herrerín","ESP","GK","31",1988,4.7,0,0,0,0,0,0,0,NA,0,0,0,0,0,0,0,0,"https://fbref.com/en/players/9109185e/Iago-Herrerin"
"2840","Kenan Kodro_2020",2020,"Athletic Club","La Liga","Kenan Kodro","BIH","FW,MF","25",1993,4,1,0,0,0,1,0,2,0,2,1,0,1,0,1,4,0,"https://fbref.com/en/players/e82d2807/Kenan-Kodro"
"2841","Larra_2020",2020,"Athletic Club","La Liga","Larra","ESP","FW,MF","21",1997,2.8,2,2,0,1,1,0,0,NA,0,1,0,1,0,2,0,0,"https://fbref.com/en/players/0d690336/Larra"
"2842","Iñigo Lekue_2020",2020,"Athletic Club","La Liga","Iñigo Lekue","ESP","FW,DF","26",1993,6.9,22,12,14,6,2,11,14,78.6,3,7,0,7,3,25,11,0,"https://fbref.com/en/players/59b7d823/Inigo-Lekue"
"2843","Unai López_2020",2020,"Athletic Club","La Liga","Unai López","ESP","MF","23",1995,19.9,30,22,8,18,4,10,41,24.4,31,13,2,11,18,48,12,1,"https://fbref.com/en/players/88050721/Unai-Lopez"
"2844","Óscar de Marcos_2020",2020,"Athletic Club","La Liga","Óscar de Marcos","ESP","DF,FW","30",1989,6,5,3,2,1,2,3,6,50,3,6,0,6,8,13,8,0,"https://fbref.com/en/players/9f323c71/Oscar-de-Marcos"
"2845","Iñigo Martínez_2020",2020,"Athletic Club","La Liga","Iñigo Martínez","ESP","DF","28",1991,33,48,30,33,13,2,27,47,57.4,20,28,13,15,39,87,140,0,"https://fbref.com/en/players/3fc45c73/Inigo-Martinez"
"2846","Iker Muniain_2020",2020,"Athletic Club","La Liga","Iker Muniain","ESP","FW,MF","26",1992,26.5,26,19,11,10,5,4,24,16.7,20,9,0,9,12,38,7,0,"https://fbref.com/en/players/c05dfb74/Iker-Muniain"
"2847","Unai Núñez_2020",2020,"Athletic Club","La Liga","Unai Núñez","ESP","DF","22",1997,17.5,13,10,10,2,1,6,16,37.5,10,25,17,8,23,36,71,0,"https://fbref.com/en/players/be170419/Unai-Nunez"
"2848","Mikel San José_2020",2020,"Athletic Club","La Liga","Mikel San José","ESP","MF","30",1989,4,9,4,2,4,3,2,10,20,8,3,1,2,9,18,12,0,"https://fbref.com/en/players/003a5c72/Mikel-San-Jose"
"2849","Oihan Sancet_2020",2020,"Athletic Club","La Liga","Oihan Sancet","ESP","MF,FW","19",2000,8.2,11,7,5,4,2,4,11,36.4,7,6,0,6,2,13,2,0,"https://fbref.com/en/players/bdb624a3/Oihan-Sancet"
"2850","Unai Simón_2020",2020,"Athletic Club","La Liga","Unai Simón","ESP","GK","22",1997,33.2,0,0,0,0,0,0,1,0,1,1,0,1,1,1,10,1,"https://fbref.com/en/players/5dcf3e90/Unai-Simon"
"2851","Unai Vencedor Paris_2020",2020,"Athletic Club","La Liga","Unai Vencedor Paris","ESP","MF","18",2000,0.8,0,0,0,0,0,0,0,NA,0,0,0,0,0,0,0,0,"https://fbref.com/en/players/4112ace5/Unai-Vencedor-Paris"
"2852","Mikel Vesga_2020",2020,"Athletic Club","La Liga","Mikel Vesga","ESP","MF","26",1993,14.1,25,17,7,12,6,9,45,20,36,18,7,11,31,56,24,1,"https://fbref.com/en/players/b0fce72c/Mikel-Vesga"
"2853","Asier Villalibre_2020",2020,"Athletic Club","La Liga","Asier Villalibre","ESP","FW","21",1997,5.9,0,0,0,0,0,0,3,0,3,3,0,3,1,1,4,0,"https://fbref.com/en/players/57be54ec/Asier-Villalibre"
"2854","Iñaki Williams_2020",2020,"Athletic Club","La Liga","Iñaki Williams","GHA","FW","25",1994,32.7,15,5,0,7,8,5,18,27.8,13,18,2,16,5,20,29,0,"https://fbref.com/en/players/6a99e0b1/Inaki-Williams"
"2855","Antonio Adán_2020",2020,"Atlético Madrid","La Liga","Antonio Adán","ESP","GK","32",1987,0.3,0,0,0,0,0,0,0,NA,0,0,0,0,0,0,0,0,"https://fbref.com/en/players/65d62814/Antonio-Adan"
"2856","Santiago Arias_2020",2020,"Atlético Madrid","La Liga","Santiago Arias","COL","DF","27",1992,12,36,24,20,12,4,10,18,55.6,8,12,7,5,19,55,20,1,"https://fbref.com/en/players/fdd60087/Santiago-Arias"
"2857","Sergio Camello_2020",2020,"Atlético Madrid","La Liga","Sergio Camello","ESP","FW","18",2001,0.3,0,0,0,0,0,0,0,NA,0,0,0,0,0,0,0,0,"https://fbref.com/en/players/873619c6/Sergio-Camello"
"2858","Yannick Carrasco_2020",2020,"Atlético Madrid","La Liga","Yannick Carrasco","BEL","MF,FW","25",1993,7,11,7,4,4,3,7,21,33.3,14,9,0,9,5,16,2,0,"https://fbref.com/en/players/de39485a/Yannick-Carrasco"
"2859","Óscar Clemente_2020",2020,"Atlético Madrid","La Liga","Óscar Clemente","ESP","MF","20",1999,0,0,0,0,0,0,0,0,NA,0,1,0,1,0,0,0,0,"https://fbref.com/en/players/9dfdbdeb/Oscar-Clemente"
"2860","Ángel Correa_2020",2020,"Atlético Madrid","La Liga","Ángel Correa","ARG","MF,FW","24",1995,22.9,25,9,7,9,9,9,36,25,27,23,5,18,14,39,21,0,"https://fbref.com/en/players/01eb744d/Angel-Correa"
"2861","Diego Costa_2020",2020,"Atlético Madrid","La Liga","Diego Costa","ESP","FW","30",1988,15,9,5,1,4,4,1,10,10,9,4,2,2,3,12,10,0,"https://fbref.com/en/players/a190d597/Diego-Costa"
"2862","Felipe_2020",2020,"Atlético Madrid","La Liga","Felipe","BRA","DF","30",1989,23.4,27,19,21,6,0,14,24,58.3,10,18,13,5,40,67,130,0,"https://fbref.com/en/players/51a3c4c8/Felipe"
"2863","João Félix_2020",2020,"Atlético Madrid","La Liga","João Félix","POR","FW,MF","19",1999,19.4,9,3,3,3,3,4,14,28.6,10,4,0,4,10,19,4,1,"https://fbref.com/en/players/8aafd64f/Joao-Felix"
"2864","Mario Hermoso_2020",2020,"Atlético Madrid","La Liga","Mario Hermoso","ESP","DF","24",1995,13.5,15,8,12,2,1,11,20,55,9,11,5,6,12,27,61,0,"https://fbref.com/en/players/555f3a0b/Mario-Hermoso"
"2865","Héctor Herrera_2020",2020,"Atlético Madrid","La Liga","Héctor Herrera","MEX","MF","29",1990,12.5,31,21,9,18,4,13,32,40.6,19,16,7,9,17,48,13,2,"https://fbref.com/en/players/a8542814/Hector-Herrera"
"2866","Koke_2020",2020,"Atlético Madrid","La Liga","Koke","ESP","MF","27",1992,30,70,42,27,30,13,29,89,32.6,60,33,8,25,29,99,28,2,"https://fbref.com/en/players/55126f3b/Koke"
"2867","Thomas Lemar_2020",2020,"Atlético Madrid","La Liga","Thomas Lemar","FRA","MF","23",1995,10.3,12,8,4,5,3,2,11,18.2,9,14,1,13,6,18,6,0,"https://fbref.com/en/players/4dbd0916/Thomas-Lemar"
"2868","Marcos Llorente_2020",2020,"Atlético Madrid","La Liga","Marcos Llorente","ESP","MF,FW","24",1995,15.2,29,15,7,16,6,7,21,33.3,14,24,4,20,14,43,9,0,"https://fbref.com/en/players/02c15616/Marcos-Llorente"
"2869","Renan Lodi_2020",2020,"Atlético Madrid","La Liga","Renan Lodi","BRA","DF","21",1998,26.6,73,46,28,35,10,40,65,61.5,25,28,7,21,38,111,56,0,"https://fbref.com/en/players/ed9f7cfe/Renan-Lodi"
"2870","José María Giménez_2020",2020,"Atlético Madrid","La Liga","José María Giménez","URU","DF","24",1995,19.5,20,16,18,1,1,7,11,63.6,4,14,7,7,23,43,75,1,"https://fbref.com/en/players/f0da930c/Jose-Maria-Gimenez"
"2871","Álvaro Morata_2020",2020,"Atlético Madrid","La Liga","Álvaro Morata","ESP","FW","26",1992,23.3,17,8,4,9,4,1,13,7.7,12,12,2,10,5,22,23,0,"https://fbref.com/en/players/129af0db/Alvaro-Morata"
"2872","Toni Moya_2020",2020,"Atlético Madrid","La Liga","Toni Moya","ESP","MF","21",1998,0,0,0,0,0,0,0,0,NA,0,0,0,0,0,0,0,0,"https://fbref.com/en/players/9e098912/Toni-Moya"
"2873","Saúl Ñíguez_2020",2020,"Atlético Madrid","La Liga","Saúl Ñíguez","ESP","MF,DF","24",1994,34.1,95,59,44,42,9,39,88,44.3,49,58,13,45,55,150,68,1,"https://fbref.com/en/players/c14bc029/Saul-Niguez"
"2874","Jan Oblak_2020",2020,"Atlético Madrid","La Liga","Jan Oblak","SVN","GK","26",1993,37.7,0,0,0,0,0,0,0,NA,0,0,0,0,1,1,4,2,"https://fbref.com/en/players/ee8508c0/Jan-Oblak"
"2875","Thomas Partey_2020",2020,"Atlético Madrid","La Liga","Thomas Partey","GHA","MF","26",1993,28.3,70,41,34,30,6,26,58,44.8,32,32,8,24,48,118,41,7,"https://fbref.com/en/players/529f49ab/Thomas-Partey"
"2876","Darío Poveda_2020",2020,"Atlético Madrid","La Liga","Darío Poveda","ESP","MF","22",1997,0.1,1,0,0,1,0,0,0,NA,0,0,0,0,0,1,0,0,"https://fbref.com/en/players/cbdf7d5c/Dario-Poveda"
"2877","Rodrigo Riquelme_2020",2020,"Atlético Madrid","La Liga","Rodrigo Riquelme","ESP","FW,MF","19",2000,0.1,0,0,0,0,0,0,0,NA,0,0,0,0,0,0,0,0,"https://fbref.com/en/players/65154df0/Rodrigo-Riquelme"
"2878","Manu Sánchez_2020",2020,"Atlético Madrid","La Liga","Manu Sánchez","ESP","DF","18",2000,3.6,13,7,2,7,4,8,15,53.3,7,3,0,3,7,20,1,0,"https://fbref.com/en/players/ffacd3d5/Manu-Sanchez"
"2879","Ivan Šaponjić_2020",2020,"Atlético Madrid","La Liga","Ivan Šaponjić","SRB","DF,FW","21",1997,0.1,0,0,0,0,0,0,0,NA,0,0,0,0,0,0,0,0,"https://fbref.com/en/players/d2aea9ac/Ivan-Saponjic"
"2880","Stefan Savić_2020",2020,"Atlético Madrid","La Liga","Stefan Savić","MNE","DF","28",1991,22,22,17,11,10,1,11,18,61.1,7,16,9,7,24,46,91,1,"https://fbref.com/en/players/f6ac68c1/Stefan-Savic"
"2881","Kieran Trippier_2020",2020,"Atlético Madrid","La Liga","Kieran Trippier","ENG","DF","28",1990,22,52,34,24,21,7,34,53,64.2,19,33,7,26,24,76,46,0,"https://fbref.com/en/players/21512407/Kieran-Trippier"
"2882","Germán Valera_2020",2020,"Atlético Madrid","La Liga","Germán Valera","ESP","FW","17",2002,0,0,0,0,0,0,0,0,NA,0,1,0,1,0,0,0,0,"https://fbref.com/en/players/84f55b4a/German-Valera"
"2883","Vitolo_2020",2020,"Atlético Madrid","La Liga","Vitolo","ESP","FW,MF","29",1989,13.6,15,12,7,7,1,5,17,29.4,12,9,0,9,10,25,9,0,"https://fbref.com/en/players/db750822/Vitolo"
"2884","Šime Vrsaljko_2020",2020,"Atlético Madrid","La Liga","Šime Vrsaljko","CRO","DF","27",1992,4,6,5,6,0,0,5,6,83.3,1,5,3,2,8,14,11,0,"https://fbref.com/en/players/46a8347f/Sime-Vrsaljko"
"2885","Daniel Baier_2020",2020,"Augsburg","Bundesliga","Daniel Baier","GER","MF","35",1984,21.6,33,17,14,14,5,15,43,34.9,28,19,7,12,58,91,27,0,"https://fbref.com/en/players/f261abcb/Daniel-Baier"
"2886","Noah Joel Sarenren Bazee_2020",2020,"Augsburg","Bundesliga","Noah Joel Sarenren Bazee","NGA","FW","22",1996,4.2,4,3,0,4,0,1,4,25,3,2,1,1,5,9,4,0,"https://fbref.com/en/players/fbbc8e15/Noah-Joel-Sarenren-Bazee"
"2887","Sergio Córdova_2020",2020,"Augsburg","Bundesliga","Sergio Córdova","VEN","FW","21",1997,4.1,3,0,0,2,1,1,10,10,9,0,0,0,0,3,3,0,"https://fbref.com/en/players/229cd98a/Sergio-Cordova"
"2888","Ohis Felix Uduokhai_2020",2020,"Augsburg","Bundesliga","Ohis Felix Uduokhai","GER","DF","21",1997,21.8,43,26,30,12,1,19,29,65.5,10,40,30,10,36,79,125,2,"https://fbref.com/en/players/677da306/Ohis-Felix-Uduokhai"
"2889","Alfreð Finnbogason_2020",2020,"Augsburg","Bundesliga","Alfreð Finnbogason","ISL","FW","30",1989,10.7,11,6,1,9,1,2,7,28.6,5,8,2,6,3,14,8,0,"https://fbref.com/en/players/f9e7c4ac/Alfred-Finnbogason"
"2890","Raphael Framberger_2020",2020,"Augsburg","Bundesliga","Raphael Framberger","GER","DF","23",1995,13.1,43,25,23,16,4,21,29,72.4,8,23,9,14,20,63,26,0,"https://fbref.com/en/players/626fab5f/Raphael-Framberger"
"2891","Jeffrey Gouweleeuw_2020",2020,"Augsburg","Bundesliga","Jeffrey Gouweleeuw","NED","DF","28",1991,18.3,28,16,22,5,1,12,21,57.1,9,15,8,7,37,65,97,0,"https://fbref.com/en/players/1025db8e/Jeffrey-Gouweleeuw"
"2892","Michael Gregoritsch_2020",2020,"Augsburg","Bundesliga","Michael Gregoritsch","AUT","MF,FW","25",1994,3.4,2,2,0,2,0,0,4,0,4,4,1,3,3,5,7,0,"https://fbref.com/en/players/8e235926/Michael-Gregoritsch"
"2893","Carlos Gruezo_2020",2020,"Augsburg","Bundesliga","Carlos Gruezo","ECU","MF","24",1995,9.8,28,12,12,15,1,5,24,20.8,19,5,0,5,6,34,5,0,"https://fbref.com/en/players/f2dd9a21/Carlos-Gruezo"
"2894","André Hahn_2020",2020,"Augsburg","Bundesliga","André Hahn","GER","FW,MF","28",1990,7.8,15,9,7,5,3,5,21,23.8,16,23,5,18,13,28,14,0,"https://fbref.com/en/players/cd82452e/Andre-Hahn"
"2895","Iago_2020",2020,"Augsburg","Bundesliga","Iago","BRA","DF,MF","22",1997,7.5,19,12,12,7,0,9,18,50,9,6,2,4,14,33,27,0,"https://fbref.com/en/players/054849d2/Iago"
"2896","Tin Jedvaj_2020",2020,"Augsburg","Bundesliga","Tin Jedvaj","CRO","DF","23",1995,29.3,44,26,25,19,0,23,47,48.9,24,36,18,18,60,104,123,1,"https://fbref.com/en/players/f820504e/Tin-Jedvaj"
"2897","Fredrik Jensen_2020",2020,"Augsburg","Bundesliga","Fredrik Jensen","FIN","MF,FW","21",1997,5.1,3,1,2,1,0,2,7,28.6,5,7,1,6,1,4,3,0,"https://fbref.com/en/players/3eeb80e0/Fredrik-Jensen"
"2898","Rani Khedira_2020",2020,"Augsburg","Bundesliga","Rani Khedira","GER","MF","25",1994,29.4,60,36,21,35,4,18,45,40,27,47,12,35,48,108,62,0,"https://fbref.com/en/players/59e4b92e/Rani-Khedira"
"2899","Tomáš Koubek_2020",2020,"Augsburg","Bundesliga","Tomáš Koubek","CZE","GK","26",1992,24,3,2,3,0,0,3,11,27.3,8,1,0,1,1,4,23,3,"https://fbref.com/en/players/dc366c36/Tomas-Koubek"
"2900","Stephan Lichtsteiner_2020",2020,"Augsburg","Bundesliga","Stephan Lichtsteiner","SUI","DF","35",1984,14.9,23,14,16,5,2,10,22,45.5,12,15,7,8,16,39,35,0,"https://fbref.com/en/players/99b1d0e6/Stephan-Lichtsteiner"
"2901","Eduard Löwen_2020",2020,"Augsburg","Bundesliga","Eduard Löwen","GER","MF","22",1997,7.5,10,8,6,2,2,6,18,33.3,12,11,2,9,5,15,7,0,"https://fbref.com/en/players/70678132/Eduard-Lowen"
"2902","Andreas Luthe_2020",2020,"Augsburg","Bundesliga","Andreas Luthe","GER","GK","32",1987,10,1,0,1,0,0,1,2,50,1,0,0,0,0,1,5,1,"https://fbref.com/en/players/7fe12375/Andreas-Luthe"
"2903","Philipp Max_2020",2020,"Augsburg","Bundesliga","Philipp Max","GER","DF","25",1993,30.1,42,29,22,16,4,20,45,44.4,25,19,4,15,26,68,50,0,"https://fbref.com/en/players/826e8b63/Philipp-Max"
"2904","Jan Morávek_2020",2020,"Augsburg","Bundesliga","Jan Morávek","CZE","MF","29",1989,5.3,23,12,9,14,0,11,24,45.8,13,4,1,3,8,31,11,0,"https://fbref.com/en/players/e7d22eae/Jan-Moravek"
"2905","Florian Niederlechner_2020",2020,"Augsburg","Bundesliga","Florian Niederlechner","GER","FW,MF","28",1990,30.2,21,13,7,9,5,4,21,19,17,21,5,16,8,29,38,0,"https://fbref.com/en/players/d6862409/Florian-Niederlechner"
"2906","Reece Oxford_2020",2020,"Augsburg","Bundesliga","Reece Oxford","ENG","MF","20",1998,4.2,7,4,2,4,1,2,8,25,6,8,5,3,5,12,10,1,"https://fbref.com/en/players/8b6e0db2/Reece-Oxford"
"2907","Mads Pedersen_2020",2020,"Augsburg","Bundesliga","Mads Pedersen","DEN","DF","22",1996,1.1,4,2,3,0,1,2,6,33.3,4,3,1,2,2,6,0,0,"https://fbref.com/en/players/582a5247/Mads-Pedersen"
"2908","Marco Richter_2020",2020,"Augsburg","Bundesliga","Marco Richter","GER","MF,FW","21",1997,25.3,21,16,7,9,5,14,51,27.5,37,15,0,15,24,45,17,0,"https://fbref.com/en/players/f972644c/Marco-Richter"
"2909","Julian Schieber_2020",2020,"Augsburg","Bundesliga","Julian Schieber","GER","FW","30",1989,0.5,1,1,0,1,0,0,0,NA,0,0,0,0,0,1,0,0,"https://fbref.com/en/players/37c213cf/Julian-Schieber"
"2910","Marek Suchý_2020",2020,"Augsburg","Bundesliga","Marek Suchý","CZE","DF","31",1988,4.4,7,5,7,0,0,4,6,66.7,2,4,1,3,6,13,15,0,"https://fbref.com/en/players/c5224618/Marek-Suchy"
"2911","Georg Teigl_2020",2020,"Augsburg","Bundesliga","Georg Teigl","AUT","DF,MF","28",1991,1.2,3,1,1,2,0,2,4,50,2,0,0,0,3,6,1,0,"https://fbref.com/en/players/c8cfb04d/Georg-Teigl"
"2912","Ruben Vargas_2020",2020,"Augsburg","Bundesliga","Ruben Vargas","SUI","FW,MF","20",1998,28.1,32,16,18,7,7,8,36,22.2,28,26,1,25,26,58,35,0,"https://fbref.com/en/players/6ecbddf6/Ruben-Vargas"
"2913","Jordi Alba_2020",2020,"Barcelona","La Liga","Jordi Alba","ESP","DF","30",1989,24.3,20,13,9,7,4,6,27,22.2,21,12,3,9,37,57,40,0,"https://fbref.com/en/players/4601e194/Jordi-Alba"
"2914","Carles Aleñá_2020",2020,"Barcelona","La Liga","Carles Aleñá","ESP","MF","21",1998,1.9,2,1,1,1,0,1,4,25,3,1,0,1,0,2,0,0,"https://fbref.com/en/players/6c811eb7/Carles-Alena"
"2915","Ronald Araújo_2020",2020,"Barcelona","La Liga","Ronald Araújo","URU","DF","20",1999,2.6,3,2,2,1,0,1,1,100,0,6,2,4,0,3,9,0,"https://fbref.com/en/players/2bef2bca/Ronald-Araujo"
"2916","Martin Braithwaite_2020",2020,"Barcelona","La Liga","Martin Braithwaite","DEN","FW,MF","28",1991,4.5,2,2,2,0,0,0,8,0,8,3,0,3,1,3,1,0,"https://fbref.com/en/players/fd771f95/Martin-Braithwaite"
"2917","Sergio Busquets_2020",2020,"Barcelona","La Liga","Sergio Busquets","ESP","MF","31",1988,27.6,80,44,23,43,14,41,71,57.7,30,36,5,31,44,124,24,2,"https://fbref.com/en/players/5ab0ea87/Sergio-Busquets"
"2918","Álex Collado_2020",2020,"Barcelona","La Liga","Álex Collado","ESP","FW","20",1999,0.1,0,0,0,0,0,0,0,NA,0,0,0,0,0,0,0,0,"https://fbref.com/en/players/85dace26/Alex-Collado"
"2919","Ousmane Dembélé_2020",2020,"Barcelona","La Liga","Ousmane Dembélé","FRA","FW","22",1997,4,2,2,1,1,0,2,5,40,3,4,0,4,0,2,0,1,"https://fbref.com/en/players/b19db005/Ousmane-Dembele"
"2920","Ansu Fati_2020",2020,"Barcelona","La Liga","Ansu Fati","ESP","FW","16",2002,11.4,16,8,4,7,5,5,15,33.3,10,14,1,13,8,24,3,0,"https://fbref.com/en/players/0ba976e4/Ansu-Fati"
"2921","Junior Firpo_2020",2020,"Barcelona","La Liga","Junior Firpo","ESP","DF","22",1996,11.3,23,15,12,8,3,11,17,64.7,6,15,3,12,17,40,12,1,"https://fbref.com/en/players/24f59bb2/Junior-Firpo"
"2922","Antoine Griezmann_2020",2020,"Barcelona","La Liga","Antoine Griezmann","FRA","FW","28",1991,28.3,33,18,12,11,10,9,34,26.5,25,22,3,19,12,45,20,1,"https://fbref.com/en/players/df69b544/Antoine-Griezmann"
"2923","Frenkie de Jong_2020",2020,"Barcelona","La Liga","Frenkie de Jong","NED","MF","22",1997,23.5,26,19,7,12,7,7,22,31.8,15,17,7,10,21,47,9,0,"https://fbref.com/en/players/1bacc518/Frenkie-de-Jong"
"2924","Clément Lenglet_2020",2020,"Barcelona","La Liga","Clément Lenglet","FRA","DF","24",1995,26.9,44,31,29,15,0,16,32,50,16,29,15,14,35,79,79,1,"https://fbref.com/en/players/4f28a6ff/Clement-Lenglet"
"2925","Arthur Melo_2020",2020,"Barcelona","La Liga","Arthur Melo","BRA","MF","22",1996,13.1,15,10,4,7,4,4,12,33.3,8,9,0,9,4,19,5,2,"https://fbref.com/en/players/48b3dd60/Arthur-Melo"
"2926","Lionel Messi_2020",2020,"Barcelona","La Liga","Lionel Messi","ARG","FW","32",1987,32,21,10,4,7,10,3,21,14.3,18,9,0,9,7,28,1,0,"https://fbref.com/en/players/d70ce98e/Lionel-Messi"
"2927","Neto_2020",2020,"Barcelona","La Liga","Neto","BRA","GK","30",1989,2,0,0,0,0,0,0,0,NA,0,0,0,0,0,0,1,0,"https://fbref.com/en/players/a9dc785c/Neto"
"2928","Carles Pérez_2020",2020,"Barcelona","La Liga","Carles Pérez","ESP","FW","21",1998,5.3,7,4,2,2,3,3,15,20,12,5,2,3,1,8,1,0,"https://fbref.com/en/players/a8f21b9f/Carles-Perez"
"2929","Gerard Piqué_2020",2020,"Barcelona","La Liga","Gerard Piqué","ESP","DF","32",1987,34.4,32,23,20,11,1,16,26,61.5,10,39,24,15,36,68,157,0,"https://fbref.com/en/players/adfc9123/Gerard-Pique"
"2930","Riqui Puig_2020",2020,"Barcelona","La Liga","Riqui Puig","ESP","MF","19",1999,5.7,11,7,1,9,1,5,17,29.4,12,2,0,2,5,16,1,0,"https://fbref.com/en/players/f090a37a/Riqui-Puig"
"2931","Rafinha_2020",2020,"Barcelona","La Liga","Rafinha","BRA","FW,MF","26",1993,2.1,3,2,1,1,1,1,2,50,1,0,0,0,1,4,0,0,"https://fbref.com/en/players/0c2ac3cb/Rafinha"
"2932","Ivan Rakitić_2020",2020,"Barcelona","La Liga","Ivan Rakitić","CRO","MF","31",1988,17.7,27,14,8,15,4,10,28,35.7,18,19,6,13,15,42,18,1,"https://fbref.com/en/players/89f951b5/Ivan-Rakitic"
"2933","Sergi Roberto_2020",2020,"Barcelona","La Liga","Sergi Roberto","ESP","DF,MF","27",1992,26,35,22,16,11,8,15,25,60,10,12,3,9,33,68,36,0,"https://fbref.com/en/players/335fa267/Sergi-Roberto"
"2934","Nélson Semedo_2020",2020,"Barcelona","La Liga","Nélson Semedo","POR","DF","25",1993,23.3,51,30,27,18,6,21,36,58.3,15,18,3,15,22,73,30,0,"https://fbref.com/en/players/d04b94db/Nelson-Semedo"
"2935","Luis Suárez_2020",2020,"Barcelona","La Liga","Luis Suárez","URU","FW","32",1987,22.2,4,0,0,1,3,2,12,16.7,10,6,1,5,1,5,11,0,"https://fbref.com/en/players/a6154613/Luis-Suarez"
"2936","Marc-André ter Stegen_2020",2020,"Barcelona","La Liga","Marc-André ter Stegen","GER","GK","27",1992,36,2,2,2,0,0,2,3,66.7,1,0,0,0,2,4,17,6,"https://fbref.com/en/players/6f51e382/Marc-Andre-ter-Stegen"
"2937","Jean-Clair Todibo_2020",2020,"Barcelona","La Liga","Jean-Clair Todibo","FRA","DF","19",1999,0.9,1,0,1,0,0,0,1,0,1,0,0,0,0,1,6,0,"https://fbref.com/en/players/88f130ed/Jean-Clair-Todibo"
"2938","Samuel Umtiti_2020",2020,"Barcelona","La Liga","Samuel Umtiti","FRA","DF","25",1993,10.5,11,5,5,5,1,5,8,62.5,3,4,2,2,22,33,32,0,"https://fbref.com/en/players/3eed9821/Samuel-Umtiti"
"2939","Arturo Vidal_2020",2020,"Barcelona","La Liga","Arturo Vidal","CHI","MF","32",1987,18.6,63,38,22,30,11,24,58,41.4,34,31,7,24,17,80,16,1,"https://fbref.com/en/players/67cdbc0e/Arturo-Vidal"
"2940","Moussa Wagué_2020",2020,"Barcelona","La Liga","Moussa Wagué","SEN","DF","20",1998,1,2,1,1,0,1,1,1,100,0,0,0,0,1,3,0,0,"https://fbref.com/en/players/808df563/Moussa-Wague"
"2941","David Alaba_2020",2020,"Bayern Munich","Bundesliga","David Alaba","AUT","DF","27",1992,27.8,30,17,14,15,1,16,25,64,9,19,10,9,29,59,40,0,"https://fbref.com/en/players/05439de2/David-Alaba"
"2942","Thiago Alcántara_2020",2020,"Bayern Munich","Bundesliga","Thiago Alcántara","ESP","MF","28",1991,19.7,45,26,17,23,5,12,33,36.4,21,12,3,9,45,90,13,1,"https://fbref.com/en/players/77e84962/Thiago-Alcantara"
"2943","Oliver Batista-Meier_2020",2020,"Bayern Munich","Bundesliga","Oliver Batista-Meier","GER","MF","18",2001,0.1,0,0,0,0,0,0,2,0,2,0,0,0,0,0,0,0,"https://fbref.com/en/players/b7828a08/Oliver-Batista-Meier"
"2944","Jérôme Boateng_2020",2020,"Bayern Munich","Bundesliga","Jérôme Boateng","GER","DF","30",1988,20,21,14,9,12,0,11,22,50,11,15,11,4,33,54,58,1,"https://fbref.com/en/players/2db2fd7b/Jerome-Boateng"
"2945","Kingsley Coman_2020",2020,"Bayern Munich","Bundesliga","Kingsley Coman","FRA","FW,MF","23",1996,16.7,19,11,6,7,6,12,27,44.4,15,9,0,9,4,23,3,0,"https://fbref.com/en/players/042e8a49/Kingsley-Coman"
"2946","Philippe Coutinho_2020",2020,"Bayern Munich","Bundesliga","Philippe Coutinho","BRA","MF,FW","27",1992,15.7,21,15,1,13,7,2,13,15.4,11,9,2,7,6,27,0,0,"https://fbref.com/en/players/0ef89a37/Philippe-Coutinho"
"2947","Mickaël Cuisance_2020",2020,"Bayern Munich","Bundesliga","Mickaël Cuisance","FRA","MF,FW","19",1999,3.4,2,1,0,2,0,1,9,11.1,8,1,1,0,3,5,0,0,"https://fbref.com/en/players/5722eced/Mickael-Cuisance"
"2948","Leon Dajaku_2020",2020,"Bayern Munich","Bundesliga","Leon Dajaku","GER","DF,MF","18",2001,0.1,0,0,0,0,0,0,1,0,1,0,0,0,0,0,0,0,"https://fbref.com/en/players/aeaf1bc1/Leon-Dajaku"
"2949","Alphonso Davies_2020",2020,"Bayern Munich","Bundesliga","Alphonso Davies","CAN","DF","18",2000,24.8,70,43,35,24,11,38,58,65.5,20,35,6,29,31,101,51,0,"https://fbref.com/en/players/d781d855/Alphonso-Davies"
"2950","Serge Gnabry_2020",2020,"Bayern Munich","Bundesliga","Serge Gnabry","GER","FW,MF","24",1995,24.4,36,16,4,19,13,9,29,31,20,17,0,17,16,52,2,1,"https://fbref.com/en/players/88e357ef/Serge-Gnabry"
"2951","Leon Goretzka_2020",2020,"Bayern Munich","Bundesliga","Leon Goretzka","GER","MF","24",1995,16.8,28,15,7,18,3,10,32,31.3,22,18,2,16,24,52,8,0,"https://fbref.com/en/players/cc86b9a3/Leon-Goretzka"
"2952","Lucas Hernández_2020",2020,"Bayern Munich","Bundesliga","Lucas Hernández","FRA","DF","23",1996,10.2,18,9,13,3,2,9,15,60,6,6,1,5,15,33,17,0,"https://fbref.com/en/players/c3ee18ef/Lucas-Hernandez"
"2953","Joshua Kimmich_2020",2020,"Bayern Munich","Bundesliga","Joshua Kimmich","GER","MF,DF","24",1995,31.3,52,29,21,20,11,22,55,40,33,38,9,29,29,81,29,0,"https://fbref.com/en/players/49296448/Joshua-Kimmich"
"2954","Robert Lewandowski_2020",2020,"Bayern Munich","Bundesliga","Robert Lewandowski","POL","FW","30",1988,30.7,18,9,3,9,6,3,15,20,12,13,1,12,7,25,13,0,"https://fbref.com/en/players/8d78e732/Robert-Lewandowski"
"2955","Javi Martínez_2020",2020,"Bayern Munich","Bundesliga","Javi Martínez","ESP","DF,MF","30",1988,7.5,16,12,9,7,0,9,11,81.8,2,9,8,1,18,34,30,0,"https://fbref.com/en/players/7f97771d/Javi-Martinez"
"2956","Thomas Müller_2020",2020,"Bayern Munich","Bundesliga","Thomas Müller","GER","MF,FW","29",1989,25.1,45,27,7,26,12,22,69,31.9,47,27,3,24,12,57,8,0,"https://fbref.com/en/players/3c6089ab/Thomas-Muller"
"2957","Jamal Musiala_2020",2020,"Bayern Munich","Bundesliga","Jamal Musiala","GER","MF","16",2003,0,0,0,0,0,0,0,0,NA,0,0,0,0,0,0,0,0,"https://fbref.com/en/players/2c0558b8/Jamal-Musiala"
"2958","Manuel Neuer_2020",2020,"Bayern Munich","Bundesliga","Manuel Neuer","GER","GK","33",1986,33,2,1,1,0,1,2,4,50,2,0,0,0,0,2,15,4,"https://fbref.com/en/players/8778c910/Manuel-Neuer"
"2959","Álvaro Odriozola_2020",2020,"Bayern Munich","Bundesliga","Álvaro Odriozola","ESP","DF","23",1995,1.7,2,2,1,0,1,2,3,66.7,1,1,0,1,1,3,2,0,"https://fbref.com/en/players/1d1691ad/Alvaro-Odriozola"
"2960","Kwasi Okyere Wriedt_2020",2020,"Bayern Munich","Bundesliga","Kwasi Okyere Wriedt","GHA","FW","25",1994,0.2,0,0,0,0,0,0,0,NA,0,0,0,0,0,0,0,0,"https://fbref.com/en/players/7124239e/Kwasi-Okyere-Wriedt"
"2961","Benjamin Pavard_2020",2020,"Bayern Munich","Bundesliga","Benjamin Pavard","FRA","DF","23",1996,31,34,22,15,10,9,16,28,57.1,12,28,10,18,52,86,60,0,"https://fbref.com/en/players/45a03961/Benjamin-Pavard"
"2962","Ivan Perišić_2020",2020,"Bayern Munich","Bundesliga","Ivan Perišić","CRO","FW,MF","30",1989,13.4,16,12,5,6,5,8,33,24.2,25,14,3,11,4,20,8,0,"https://fbref.com/en/players/6fe90922/Ivan-Perisic"
"2963","Chris Richards_2020",2020,"Bayern Munich","Bundesliga","Chris Richards","USA","DF","19",2000,0.1,0,0,0,0,0,0,0,NA,0,0,0,0,0,0,1,0,"https://fbref.com/en/players/0a3d6d2b/Chris-Richards"
"2964","Renato Sanches_2020",2020,"Bayern Munich","Bundesliga","Renato Sanches","POR","MF","21",1997,0.1,0,0,0,0,0,0,0,NA,0,0,0,0,0,0,0,0,"https://fbref.com/en/players/032f894e/Renato-Sanches"
"2965","Sarpreet Singh_2020",2020,"Bayern Munich","Bundesliga","Sarpreet Singh","NZL","FW,MF","20",1999,0.8,1,0,0,1,0,0,1,0,1,0,0,0,0,1,0,0,"https://fbref.com/en/players/4ba886c6/Sarpreet-Singh"
"2966","Niklas Süle_2020",2020,"Bayern Munich","Bundesliga","Niklas Süle","GER","DF","23",1995,7.1,10,6,8,2,0,4,5,80,1,8,6,2,8,18,22,1,"https://fbref.com/en/players/e33c06cf/Niklas-Sule"
"2967","Corentin Tolisso_2020",2020,"Bayern Munich","Bundesliga","Corentin Tolisso","FRA","MF","24",1994,7.1,9,4,4,3,2,1,9,11.1,8,9,3,6,4,13,2,1,"https://fbref.com/en/players/652d4c37/Corentin-Tolisso"
"2968","Sven Ulreich_2020",2020,"Bayern Munich","Bundesliga","Sven Ulreich","GER","GK","30",1988,1,0,0,0,0,0,0,0,NA,0,0,0,0,0,0,0,0,"https://fbref.com/en/players/7d3e7da6/Sven-Ulreich"
"2969","Joshua Zirkzee_2020",2020,"Bayern Munich","Bundesliga","Joshua Zirkzee","NED","FW","18",2001,3.3,5,2,0,2,3,2,4,50,2,2,0,2,1,6,0,0,"https://fbref.com/en/players/028e70b9/Joshua-Zirkzee"
"2970","Carles Aleñá_2020",2020,"Betis","La Liga","Carles Aleñá","ESP","MF,FW","21",1998,8.2,14,9,5,7,2,3,17,17.6,14,4,1,3,1,15,3,0,"https://fbref.com/en/players/6c811eb7/Carles-Alena"
"2971","Antonio Barragán_2020",2020,"Betis","La Liga","Antonio Barragán","ESP","DF","32",1987,7.1,7,5,4,2,1,3,6,50,3,2,2,0,8,15,22,0,"https://fbref.com/en/players/487d9b09/Antonio-Barragan"
"2972","Marc Bartra_2020",2020,"Betis","La Liga","Marc Bartra","ESP","DF,MF","28",1991,28,62,34,39,23,0,27,54,50,27,45,24,21,35,97,127,0,"https://fbref.com/en/players/b742cc0d/Marc-Bartra"
"2973","Sergio Canales_2020",2020,"Betis","La Liga","Sergio Canales","ESP","MF,FW","28",1991,35.1,25,16,14,6,5,7,28,25,21,30,1,29,13,38,16,0,"https://fbref.com/en/players/a6de370d/Sergio-Canales"
"2974","William Carvalho_2020",2020,"Betis","La Liga","William Carvalho","POR","MF","27",1992,9.9,7,4,4,2,1,4,14,28.6,10,7,5,2,4,11,8,1,"https://fbref.com/en/players/dee86451/William-Carvalho"
"2975","Emerson_2020",2020,"Betis","La Liga","Emerson","BRA","DF","20",1999,31.5,74,46,49,19,6,36,79,45.6,43,30,9,21,31,105,57,1,"https://fbref.com/en/players/df8b52a5/Emerson"
"2976","Zouhair Feddal_2020",2020,"Betis","La Liga","Zouhair Feddal","MAR","DF","30",1989,15.9,20,13,14,5,1,10,14,71.4,4,15,9,6,23,43,74,0,"https://fbref.com/en/players/89151b16/Zouhair-Feddal"
"2977","Nabil Fekir_2020",2020,"Betis","La Liga","Nabil Fekir","FRA","MF,FW","26",1993,29.3,41,26,14,19,8,12,37,32.4,25,27,3,24,10,51,3,0,"https://fbref.com/en/players/bece776f/Nabil-Fekir"
"2978","Javi García_2020",2020,"Betis","La Liga","Javi García","ESP","MF","32",1987,4.2,2,2,2,0,0,2,3,66.7,1,1,0,1,4,6,15,0,"https://fbref.com/en/players/167c1bb0/Javi-Garcia"
"2979","Édgar González_2020",2020,"Betis","La Liga","Édgar González","ESP","MF","22",1997,7.6,8,3,3,5,0,2,14,14.3,12,4,2,2,10,18,16,0,"https://fbref.com/en/players/49d028db/Edgar-Gonzalez"
"2980","Andrés Guardado_2020",2020,"Betis","La Liga","Andrés Guardado","MEX","MF","32",1986,22.7,30,14,15,11,4,15,41,36.6,26,15,4,11,18,48,22,1,"https://fbref.com/en/players/ef322658/Andres-Guardado"
"2981","Borja Iglesias_2020",2020,"Betis","La Liga","Borja Iglesias","ESP","FW","26",1993,21.4,7,5,1,4,2,0,9,0,9,7,4,3,5,12,18,0,"https://fbref.com/en/players/75645f0e/Borja-Iglesias"
"2982","Ismael_2020",2020,"Betis","La Liga","Ismael","ESP","MF","18",2000,0.9,2,1,1,1,0,1,2,50,1,2,1,1,2,4,2,0,"https://fbref.com/en/players/19cdceb0/Ismael"
"2983","Joaquín_2020",2020,"Betis","La Liga","Joaquín","ESP","MF,FW","38",1981,22.9,14,7,4,8,2,4,11,36.4,7,10,2,8,15,29,22,1,"https://fbref.com/en/players/4c5b14d2/Joaquin"
"2984","Juanmi_2020",2020,"Betis","La Liga","Juanmi","ESP","FW,MF","26",1993,2.9,4,1,1,2,1,1,4,25,3,1,0,1,0,4,0,0,"https://fbref.com/en/players/84399660/Juanmi"
"2985","Wilfrid Kaptoum_2020",2020,"Betis","La Liga","Wilfrid Kaptoum","CMR","MF","23",1996,2.2,5,2,3,2,0,3,3,100,0,4,1,3,1,6,3,0,"https://fbref.com/en/players/d717630e/Wilfrid-Kaptoum"
"2986","Diego Lainez_2020",2020,"Betis","La Liga","Diego Lainez","MEX","MF,FW","19",2000,3.9,6,5,2,4,0,5,8,62.5,3,6,0,6,1,7,1,0,"https://fbref.com/en/players/bf12926c/Diego-Lainez"
"2987","Aïssa Mandi_2020",2020,"Betis","La Liga","Aïssa Mandi","ALG","DF","27",1991,28.6,33,15,22,8,3,18,28,64.3,10,29,15,14,38,71,93,0,"https://fbref.com/en/players/fbd6378b/Aissa-Mandi"
"2988","Daniel Martín_2020",2020,"Betis","La Liga","Daniel Martín","ESP","GK","21",1998,5.9,0,0,0,0,0,0,0,NA,0,0,0,0,0,0,3,0,"https://fbref.com/en/players/4df0dff8/Daniel-Martin"
"2989","Álex Moreno_2020",2020,"Betis","La Liga","Álex Moreno","ESP","DF","26",1993,25.2,37,20,27,8,2,12,32,37.5,20,21,8,13,23,60,47,1,"https://fbref.com/en/players/16e9d0ea/Alex-Moreno"
"2990","Loren Morón_2020",2020,"Betis","La Liga","Loren Morón","ESP","FW","25",1993,22.6,18,12,6,7,5,9,23,39.1,14,25,6,19,9,27,13,0,"https://fbref.com/en/players/3aa4a3be/Loren-Moron"
"2991","Alfonso Pedraza_2020",2020,"Betis","La Liga","Alfonso Pedraza","ESP","DF","23",1996,15,30,19,16,11,3,19,33,57.6,14,18,6,12,16,46,26,1,"https://fbref.com/en/players/63f04c6c/Alfonso-Pedraza"
"2992","Raúl_2020",2020,"Betis","La Liga","Raúl","ESP","FW,MF","18",2000,0.2,0,0,0,0,0,0,2,0,2,0,0,0,0,0,0,0,"https://fbref.com/en/players/18f0a9f0/Raul"
"2993","Joel Robles_2020",2020,"Betis","La Liga","Joel Robles","ESP","GK","29",1990,32.1,0,0,0,0,0,0,2,0,2,0,0,0,0,0,13,2,"https://fbref.com/en/players/cda0b317/Joel-Robles"
"2994","Guido Rodríguez_2020",2020,"Betis","La Liga","Guido Rodríguez","ARG","MF","25",1994,10.4,24,16,11,11,2,15,25,60,10,13,4,9,10,34,21,0,"https://fbref.com/en/players/34e393f2/Guido-Rodriguez"
"2995","Sidnei_2020",2020,"Betis","La Liga","Sidnei","BRA","DF","29",1989,13.1,23,19,17,6,0,9,14,64.3,5,15,12,3,21,44,57,0,"https://fbref.com/en/players/b14d0c5d/Sidnei"
"2996","Cristian Tello_2020",2020,"Betis","La Liga","Cristian Tello","ESP","MF,FW","27",1991,8.7,8,5,2,2,4,4,8,50,4,5,0,5,4,12,0,0,"https://fbref.com/en/players/72a99e38/Cristian-Tello"
"2997","Mattia Bani_2020",2020,"Bologna","Serie A","Mattia Bani","ITA","DF","25",1993,24.5,47,28,27,19,1,25,36,69.4,11,29,15,14,52,99,92,2,"https://fbref.com/en/players/0821331c/Mattia-Bani"
"2998","Musa Barrow_2020",2020,"Bologna","Serie A","Musa Barrow","GAM","FW,MF","20",1998,15,20,13,11,7,2,6,20,30,14,15,0,15,5,25,11,0,"https://fbref.com/en/players/e5bf73f3/Musa-Barrow"
"2999","Federico Bonini_2020",2020,"Bologna","Serie A","Federico Bonini","ITA","DF","17",2001,0.1,0,0,0,0,0,0,0,NA,0,0,0,0,0,0,0,0,"https://fbref.com/en/players/f8f0744b/Federico-Bonini"
"3000","Gianmarco Cangiano_2020",2020,"Bologna","Serie A","Gianmarco Cangiano","ITA","FW,MF","17",2001,0.2,1,1,0,1,0,0,0,NA,0,0,0,0,1,2,0,0,"https://fbref.com/en/players/a36084cd/Gianmarco-Cangiano"
"3001","Gabriele Corbo_2020",2020,"Bologna","Serie A","Gabriele Corbo","ITA","DF","19",2000,1.4,1,1,1,0,0,0,3,0,3,2,2,0,4,5,5,0,"https://fbref.com/en/players/091795f2/Gabriele-Corbo"
"3002","Angelo da Costa Júnior_2020",2020,"Bologna","Serie A","Angelo da Costa Júnior","BRA","GK","35",1983,1,0,0,0,0,0,0,0,NA,0,0,0,0,0,0,0,0,"https://fbref.com/en/players/18736214/Angelo-da-Costa-Junior"
"3003","Stefano Denswil_2020",2020,"Bologna","Serie A","Stefano Denswil","NED","DF","26",1993,24.9,49,28,29,19,1,26,44,59.1,18,23,8,15,31,80,68,0,"https://fbref.com/en/players/5832ebfe/Stefano-Denswil"
"3004","Mattia Destro_2020",2020,"Bologna","Serie A","Mattia Destro","ITA","FW","28",1991,2.1,3,2,1,2,0,1,3,33.3,2,1,0,1,0,3,0,0,"https://fbref.com/en/players/d7d32194/Mattia-Destro"
"3005","Mitchell Dijks_2020",2020,"Bologna","Serie A","Mitchell Dijks","NED","DF","26",1993,11.2,13,10,6,5,2,8,12,66.7,4,5,1,4,10,23,23,0,"https://fbref.com/en/players/0a3065c8/Mitchell-Dijks"
"3006","Nicolás Domínguez_2020",2020,"Bologna","Serie A","Nicolás Domínguez","ARG","MF","21",1998,7.8,21,14,15,5,1,7,18,38.9,11,12,2,10,12,33,7,0,"https://fbref.com/en/players/20b3a502/Nicolas-Dominguez"
"3007","Blerim Džemaili_2020",2020,"Bologna","Serie A","Blerim Džemaili","SUI","MF","33",1986,7.8,19,12,3,13,3,4,22,18.2,18,9,3,6,7,26,6,0,"https://fbref.com/en/players/756959aa/Blerim-Dzemaili"
"3008","Andri Fannar Baldursson_2020",2020,"Bologna","Serie A","Andri Fannar Baldursson","ISL","MF","17",2002,1.6,1,0,0,1,0,0,1,0,1,2,0,2,1,2,3,0,"https://fbref.com/en/players/61f2f56a/Andri-Fannar-Baldursson"
"3009","Musa Juwara_2020",2020,"Bologna","Serie A","Musa Juwara","GAM","FW,MF","17",2001,1.7,4,2,1,1,2,1,5,20,4,2,1,1,0,4,1,0,"https://fbref.com/en/players/7737dee2/Musa-Juwara"
"3010","Ladislav Krejčí_2020",2020,"Bologna","Serie A","Ladislav Krejčí","CZE","DF","27",1992,11.7,15,10,6,7,2,9,19,47.4,10,7,4,3,10,25,23,0,"https://fbref.com/en/players/58027adc/Ladislav-Krejci"
"3011","Danilo Larangeira_2020",2020,"Bologna","Serie A","Danilo Larangeira","BRA","DF","35",1984,29.3,34,17,19,15,0,16,28,57.1,12,54,39,15,30,64,99,0,"https://fbref.com/en/players/fed5f993/Danilo-Larangeira"
"3012","Ibrahima Mbaye_2020",2020,"Bologna","Serie A","Ibrahima Mbaye","SEN","DF","24",1994,16.7,19,10,13,4,2,7,17,41.2,10,22,11,11,15,34,42,0,"https://fbref.com/en/players/cfbf9881/Ibrahima-Mbaye"
"3013","Gary Medel_2020",2020,"Bologna","Serie A","Gary Medel","CHI","MF","31",1987,19.8,43,22,15,24,4,16,43,37.2,27,24,8,16,34,77,31,2,"https://fbref.com/en/players/563a68ad/Gary-Medel"
"3014","Kingsley Michael_2020",2020,"Bologna","Serie A","Kingsley Michael","NGA","MF","19",1999,0.8,2,1,0,2,0,0,0,NA,0,0,0,0,1,3,1,0,"https://fbref.com/en/players/e63e122d/Kingsley-Michael"
"3015","Riccardo Orsolini_2020",2020,"Bologna","Serie A","Riccardo Orsolini","ITA","FW,MF","22",1997,29.8,36,22,21,10,5,12,47,25.5,35,23,1,22,16,52,20,0,"https://fbref.com/en/players/e14ec482/Riccardo-Orsolini"
"3016","Rodrigo Palacio_2020",2020,"Bologna","Serie A","Rodrigo Palacio","ARG","FW","37",1982,28,19,11,0,9,10,4,27,14.8,23,17,3,14,5,24,38,2,"https://fbref.com/en/players/8d8178ac/Rodrigo-Palacio"
"3017","Nehuén Paz_2020",2020,"Bologna","Serie A","Nehuén Paz","ARG","DF","26",1993,1.3,1,1,0,1,0,0,2,0,2,3,3,0,5,6,12,0,"https://fbref.com/en/players/42b1a58a/Nehuen-Paz"
"3018","Andrea Poli_2020",2020,"Bologna","Serie A","Andrea Poli","ITA","MF","29",1989,21.3,44,24,19,21,4,16,52,30.8,36,19,3,16,40,84,11,0,"https://fbref.com/en/players/b3fd7075/Andrea-Poli"
"3019","Dion Ruffo Luci_2020",2020,"Bologna","Serie A","Dion Ruffo Luci","ITA","MF","18",2001,0,0,0,0,0,0,0,0,NA,0,0,0,0,0,0,0,0,"https://fbref.com/en/players/f239e6dd/Dion-Ruffo-Luci"
"3020","Nicola Sansone_2020",2020,"Bologna","Serie A","Nicola Sansone","ITA","FW,MF","27",1991,25.2,34,20,12,18,4,15,59,25.4,44,21,0,21,11,45,9,0,"https://fbref.com/en/players/7eb97a8e/Nicola-Sansone"
"3021","Federico Santander_2020",2020,"Bologna","Serie A","Federico Santander","PAR","FW","28",1991,8.6,13,8,3,0,10,1,4,25,3,3,0,3,7,20,12,0,"https://fbref.com/en/players/df85d472/Federico-Santander"
"3022","Jerdy Schouten_2020",2020,"Bologna","Serie A","Jerdy Schouten","NED","MF","22",1997,12,26,16,13,11,2,10,26,38.5,16,19,7,12,26,52,22,0,"https://fbref.com/en/players/2cfae697/Jerdy-Schouten"
"3023","Łukasz Skorupski_2020",2020,"Bologna","Serie A","Łukasz Skorupski","POL","GK","28",1991,37,1,0,1,0,0,0,1,0,1,0,0,0,2,3,15,5,"https://fbref.com/en/players/ab4449d6/Lukasz-Skorupski"
"3024","Andreas Skov Olsen_2020",2020,"Bologna","Serie A","Andreas Skov Olsen","DEN","FW,MF","19",1999,8.4,11,8,5,5,1,4,12,33.3,8,10,1,9,8,19,5,0,"https://fbref.com/en/players/c50cee19/Andreas-Skov-Olsen"
"3025","Roberto Soriano_2020",2020,"Bologna","Serie A","Roberto Soriano","ITA","MF","28",1991,27.4,43,25,15,21,7,10,46,21.7,36,19,0,19,17,60,23,1,"https://fbref.com/en/players/9d4c45d6/Roberto-Soriano"
"3026","Mattias Svanberg_2020",2020,"Bologna","Serie A","Mattias Svanberg","SWE","MF","20",1999,11.7,13,8,9,4,0,6,31,19.4,25,15,4,11,13,26,10,0,"https://fbref.com/en/players/92d83c27/Mattias-Svanberg"
"3027","Takehiro Tomiyasu_2020",2020,"Bologna","Serie A","Takehiro Tomiyasu","JPN","DF","20",1998,28.1,42,24,25,13,4,22,41,53.7,19,34,9,25,49,91,78,1,"https://fbref.com/en/players/b3af9be1/Takehiro-Tomiyasu"
"3028","Yacine Adli_2020",2020,"Bordeaux","Ligue 1","Yacine Adli","FRA","MF","19",2000,11.3,22,14,4,15,3,11,34,32.4,23,10,0,10,8,30,3,0,"https://fbref.com/en/players/26777636/Yacine-Adli"
"3029","Youssef Aït Bennasser_2020",2020,"Bordeaux","Ligue 1","Youssef Aït Bennasser","MAR","MF","23",1996,6,11,8,6,4,1,4,24,16.7,20,6,1,5,4,15,10,1,"https://fbref.com/en/players/c46fa34c/Youssef-Ait-Bennasser"
"3030","Toma Bašić_2020",2020,"Bordeaux","Ligue 1","Toma Bašić","CRO","MF","22",1996,11,26,22,9,16,1,12,27,44.4,15,14,2,12,9,35,12,1,"https://fbref.com/en/players/80556f08/Toma-Basic"
"3031","Raoul Bellanova_2020",2020,"Bordeaux","Ligue 1","Raoul Bellanova","ITA","DF","19",2000,0.7,1,1,1,0,0,0,1,0,1,0,0,0,0,1,0,0,"https://fbref.com/en/players/e3756e72/Raoul-Bellanova"
"3032","Loris Benito_2020",2020,"Bordeaux","Ligue 1","Loris Benito","SUI","DF","27",1992,21.1,40,25,23,11,6,16,43,37.2,27,14,5,9,29,69,58,1,"https://fbref.com/en/players/f5b6fb78/Loris-Benito"
"3033","Yassine Benrahou_2020",2020,"Bordeaux","Ligue 1","Yassine Benrahou","FRA","FW,MF","20",1999,1.9,3,0,1,1,1,2,5,40,3,1,0,1,2,5,1,0,"https://fbref.com/en/players/fbf76716/Yassine-Benrahou"
"3034","Jimmy Briand_2020",2020,"Bordeaux","Ligue 1","Jimmy Briand","FRA","FW","33",1985,16.9,12,8,5,4,3,3,13,23.1,10,8,4,4,6,18,12,0,"https://fbref.com/en/players/f83c8d6c/Jimmy-Briand"
"3035","Jonathan Cafu_2020",2020,"Bordeaux","Ligue 1","Jonathan Cafu","BRA","DF","28",1991,2.2,7,3,4,3,0,4,7,57.1,3,1,0,1,1,8,3,0,"https://fbref.com/en/players/8d043f1d/Jonathan-Cafu"
"3036","Benoît Costil_2020",2020,"Bordeaux","Ligue 1","Benoît Costil","FRA","GK","32",1987,28,0,0,0,0,0,0,3,0,3,0,0,0,2,2,9,0,"https://fbref.com/en/players/2434f24a/Benoit-Costil"
"3037","Vukašin Jovanović_2020",2020,"Bordeaux","Ligue 1","Vukašin Jovanović","SRB","DF","23",1996,6.4,18,11,12,6,0,14,21,66.7,7,5,3,2,15,33,15,0,"https://fbref.com/en/players/0eb03d5b/Vukasin-Jovanovic"
"3038","Samuel Kalu_2020",2020,"Bordeaux","Ligue 1","Samuel Kalu","NGA","DF,FW","21",1997,15.1,33,17,19,12,2,16,36,44.4,20,13,1,12,24,57,10,0,"https://fbref.com/en/players/b8d22478/Samuel-Kalu"
"3039","François Kamano_2020",2020,"Bordeaux","Ligue 1","François Kamano","GUI","DF,MF","23",1996,7.2,12,6,5,4,3,8,15,53.3,7,5,0,5,3,15,2,0,"https://fbref.com/en/players/81d3318f/Francois-Kamano"
"3040","Laurent Koscielny_2020",2020,"Bordeaux","Ligue 1","Laurent Koscielny","FRA","DF","33",1985,24.3,28,13,24,4,0,10,20,50,10,23,19,4,26,54,104,0,"https://fbref.com/en/players/f5efb153/Laurent-Koscielny"
"3041","Enock Kwateng_2020",2020,"Bordeaux","Ligue 1","Enock Kwateng","FRA","DF","22",1997,10.9,36,22,17,17,2,22,47,46.8,25,16,6,10,22,58,41,0,"https://fbref.com/en/players/4bf69118/Enock-Kwateng"
"3042","Albert Lottin_2020",2020,"Bordeaux","Ligue 1","Albert Lottin","FRA","MF","17",2001,0.5,2,0,2,0,0,1,4,25,3,0,0,0,2,4,2,0,"https://fbref.com/en/players/934a0957/Albert-Lottin"
"3043","Josh Maja_2020",2020,"Bordeaux","Ligue 1","Josh Maja","NGA","FW","20",1998,8.2,5,2,0,2,3,1,10,10,9,8,4,4,1,6,3,0,"https://fbref.com/en/players/bc0bfc64/Josh-Maja"
"3044","Mexer_2020",2020,"Bordeaux","Ligue 1","Mexer","MOZ","DF","30",1988,16.5,16,11,14,1,1,10,30,33.3,20,14,13,1,15,31,47,0,"https://fbref.com/en/players/ce492295/Mexer"
"3045","Otávio_2020",2020,"Bordeaux","Ligue 1","Otávio","BRA","MF","25",1994,24.6,80,45,23,52,5,35,82,42.7,47,26,9,17,41,121,40,6,"https://fbref.com/en/players/243f4a0b/Otavio"
"3046","Remi Oudin_2020",2020,"Bordeaux","Ligue 1","Remi Oudin","FRA","FW,MF","22",1996,6.2,9,6,4,4,1,4,14,28.6,10,7,1,6,9,18,5,0,"https://fbref.com/en/players/ea02beaf/Remi-Oudin"
"3047","Pablo_2020",2020,"Bordeaux","Ligue 1","Pablo","BRA","DF","28",1991,24.1,27,15,22,5,0,16,31,51.6,15,25,14,11,40,67,130,2,"https://fbref.com/en/players/29d8ad3f/Pablo"
"3048","Rubén Pardo_2020",2020,"Bordeaux","Ligue 1","Rubén Pardo","ESP","MF","26",1992,2.1,3,2,2,1,0,2,3,66.7,1,0,0,0,1,4,2,1,"https://fbref.com/en/players/2306bfde/Ruben-Pardo"
"3049","Maxime Poundjé_2020",2020,"Bordeaux","Ligue 1","Maxime Poundjé","FRA","DF","26",1992,0,0,0,0,0,0,0,0,NA,0,0,0,0,0,0,0,0,"https://fbref.com/en/players/b92edde2/Maxime-Poundje"
"3050","Nicolas de Préville_2020",2020,"Bordeaux","Ligue 1","Nicolas de Préville","FRA","MF,FW","28",1991,22.2,35,21,9,22,4,18,56,32.1,38,15,3,12,6,41,19,0,"https://fbref.com/en/players/b0547a87/Nicolas-de-Preville"
"3051","Youssouf Sabaly_2020",2020,"Bordeaux","Ligue 1","Youssouf Sabaly","SEN","DF","26",1993,10.1,18,11,9,4,5,6,22,27.3,16,8,1,7,18,36,23,0,"https://fbref.com/en/players/fbbb9269/Youssouf-Sabaly"
"3052","Aurélien Tchouaméni_2020",2020,"Bordeaux","Ligue 1","Aurélien Tchouaméni","FRA","MF","19",2000,12.3,30,14,15,13,2,11,27,40.7,16,11,3,8,13,43,19,1,"https://fbref.com/en/players/4f255115/Aurelien-Tchouameni"
"3053","Hwang Ui-jo_2020",2020,"Bordeaux","Ligue 1","Hwang Ui-jo","KOR","FW,MF","26",1992,18.1,9,7,2,5,2,4,20,20,16,7,0,7,5,14,5,0,"https://fbref.com/en/players/a2d873dd/Hwang-Ui-jo"
"3054","Nathan Aké_2020",2020,"Bournemouth","Premier League","Nathan Aké","NED","DF","24",1995,27.8,31,21,23,8,0,14,23,60.9,9,40,29,11,36,67,152,0,"https://fbref.com/en/players/eaeca114/Nathan-Ake"
"3055","Philip Billing_2020",2020,"Bournemouth","Premier League","Philip Billing","DEN","MF","23",1996,28.1,72,46,30,37,5,17,65,26.2,48,59,16,43,66,138,97,1,"https://fbref.com/en/players/d328a254/Philip-Billing"
"3056","David Brooks_2020",2020,"Bournemouth","Premier League","David Brooks","WAL","MF,FW","22",1997,5.6,5,5,1,2,2,2,14,14.3,12,5,1,4,2,7,1,0,"https://fbref.com/en/players/dc4cae05/David-Brooks"
"3057","Lewis Cook_2020",2020,"Bournemouth","Premier League","Lewis Cook","ENG","MF,FW","22",1997,15,27,14,15,9,3,10,47,21.3,37,17,5,12,17,44,17,1,"https://fbref.com/en/players/2afc7272/Lewis-Cook"
"3058","Steve Cook_2020",2020,"Bournemouth","Premier League","Steve Cook","ENG","DF","28",1991,27,22,11,18,4,0,8,20,40,12,32,23,9,44,66,153,1,"https://fbref.com/en/players/3e5e4e63/Steve-Cook"
"3059","Charlie Daniels_2020",2020,"Bournemouth","Premier League","Charlie Daniels","ENG","DF","32",1986,1.4,1,1,0,1,0,0,1,0,1,2,0,2,1,2,5,1,"https://fbref.com/en/players/9d107085/Charlie-Daniels"
"3060","Arnaut Danjuma_2020",2020,"Bournemouth","Premier League","Arnaut Danjuma","NED","MF","22",1997,7,4,2,3,1,0,1,4,25,3,2,0,2,8,12,4,1,"https://fbref.com/en/players/f08490a6/Arnaut-Danjuma"
"3061","Simon Francis_2020",2020,"Bournemouth","Premier League","Simon Francis","ENG","DF","34",1985,10.8,13,9,11,2,0,11,21,52.4,10,17,12,5,20,33,71,0,"https://fbref.com/en/players/1e0b6a73/Simon-Francis"
"3062","Ryan Fraser_2020",2020,"Bournemouth","Premier League","Ryan Fraser","SCO","MF,FW","25",1994,23,12,6,5,5,2,7,22,31.8,15,15,3,12,15,27,24,0,"https://fbref.com/en/players/d56543a0/Ryan-Fraser"
"3063","Dan Gosling_2020",2020,"Bournemouth","Premier League","Dan Gosling","ENG","MF","29",1990,14,26,10,14,9,3,6,27,22.2,21,31,11,20,20,46,26,0,"https://fbref.com/en/players/7fec31a0/Dan-Gosling"
"3064","Jordon Ibe_2020",2020,"Bournemouth","Premier League","Jordon Ibe","ENG","DF","23",1995,0.6,2,2,2,0,0,1,1,100,0,0,0,0,0,2,1,0,"https://fbref.com/en/players/9f736ed2/Jordon-Ibe"
"3065","Lloyd Kelly_2020",2020,"Bournemouth","Premier League","Lloyd Kelly","ENG","DF","20",1998,7.1,7,3,3,4,0,6,7,85.7,1,9,5,4,6,13,15,1,"https://fbref.com/en/players/f31def1e/Lloyd-Kelly"
"3066","Joshua King_2020",2020,"Bournemouth","Premier League","Joshua King","NOR","FW,MF","27",1992,22.3,16,6,4,8,4,4,16,25,12,20,3,17,8,24,9,0,"https://fbref.com/en/players/43458538/Joshua-King"
"3067","Jefferson Lerma_2020",2020,"Bournemouth","Premier League","Jefferson Lerma","COL","MF","24",1994,30,54,32,17,31,6,22,48,45.8,26,28,12,16,57,111,54,1,"https://fbref.com/en/players/9b5ce51a/Jefferson-Lerma"
"3068","Chris Mepham_2020",2020,"Bournemouth","Premier League","Chris Mepham","WAL","DF","21",1997,10.1,20,9,13,7,0,11,14,78.6,3,17,11,6,17,37,62,1,"https://fbref.com/en/players/fed96827/Chris-Mepham"
"3069","Aaron Ramsdale_2020",2020,"Bournemouth","Premier League","Aaron Ramsdale","ENG","GK","21",1998,37,4,3,4,0,0,3,3,100,0,0,0,0,0,4,25,1,"https://fbref.com/en/players/466fb2c5/Aaron-Ramsdale"
"3070","Diego Rico_2020",2020,"Bournemouth","Premier League","Diego Rico","ESP","DF","26",1993,25.9,61,39,32,24,5,29,59,49.2,30,31,7,24,84,145,91,0,"https://fbref.com/en/players/d9ba39fc/Diego-Rico"
"3071","Jack Simpson_2020",2020,"Bournemouth","Premier League","Jack Simpson","ENG","DF","22",1996,2.7,5,2,4,1,0,2,8,25,6,1,0,1,2,7,12,1,"https://fbref.com/en/players/76fa5f80/Jack-Simpson"
"3072","Adam Smith_2020",2020,"Bournemouth","Premier League","Adam Smith","ENG","DF","28",1991,22.8,47,32,29,16,2,23,50,46,27,27,6,21,25,72,64,1,"https://fbref.com/en/players/20b104bc/Adam-Smith"
"3073","Dominic Solanke_2020",2020,"Bournemouth","Premier League","Dominic Solanke","ENG","FW","21",1997,18.3,8,4,2,5,1,5,33,15.2,28,9,1,8,8,16,18,1,"https://fbref.com/en/players/e77dc3b2/Dominic-Solanke"
"3074","Jack Stacey_2020",2020,"Bournemouth","Premier League","Jack Stacey","ENG","DF","23",1996,17.2,21,11,9,11,1,8,22,36.4,14,27,11,16,18,39,64,1,"https://fbref.com/en/players/558807c0/Jack-Stacey"
"3075","Junior Stanislas_2020",2020,"Bournemouth","Premier League","Junior Stanislas","ENG","MF,FW","29",1989,7.9,10,7,2,3,5,3,8,37.5,5,6,0,6,4,14,6,0,"https://fbref.com/en/players/6992791d/Junior-Stanislas"
"3076","Andrew Surman_2020",2020,"Bournemouth","Premier League","Andrew Surman","ENG","MF","32",1986,2.6,4,2,2,2,0,1,3,33.3,2,1,0,1,1,5,5,1,"https://fbref.com/en/players/7d41b619/Andrew-Surman"
"3077","Sam Surridge_2020",2020,"Bournemouth","Premier League","Sam Surridge","ENG","FW,MF","21",1998,0.3,0,0,0,0,0,0,0,NA,0,1,0,1,1,1,0,0,"https://fbref.com/en/players/b017b770/Sam-Surridge"
"3078","Mark Travers_2020",2020,"Bournemouth","Premier League","Mark Travers","IRL","GK","20",1999,1,0,0,0,0,0,0,0,NA,0,0,0,0,0,0,1,1,"https://fbref.com/en/players/fe558029/Mark-Travers"
"3079","Callum Wilson_2020",2020,"Bournemouth","Premier League","Callum Wilson","ENG","FW","27",1992,32.3,12,9,3,6,3,2,17,11.8,15,16,2,14,4,16,16,0,"https://fbref.com/en/players/c596fcb0/Callum-Wilson"
"3080","Harry Wilson_2020",2020,"Bournemouth","Premier League","Harry Wilson","WAL","MF,FW","22",1997,18.3,23,13,8,10,5,11,34,32.4,23,26,2,24,11,34,15,1,"https://fbref.com/en/players/c6dc9ecd/Harry-Wilson"
"3081","Enrico Alfonso_2020",2020,"Brescia","Serie A","Enrico Alfonso","ITA","GK","31",1988,3.1,0,0,0,0,0,0,0,NA,0,0,0,0,0,0,2,0,"https://fbref.com/en/players/95adf1e1/Enrico-Alfonso"
"3082","Lorenzo Andrenacci_2020",2020,"Brescia","Serie A","Lorenzo Andrenacci","ITA","GK","24",1995,5.9,1,0,1,0,0,1,3,33.3,2,0,0,0,0,1,0,0,"https://fbref.com/en/players/fe471a89/Lorenzo-Andrenacci"
"3083","Florian Ayé_2020",2020,"Brescia","Serie A","Florian Ayé","FRA","FW,MF","22",1997,15.3,17,9,9,5,3,6,13,46.2,7,17,2,15,4,21,18,1,"https://fbref.com/en/players/718b8afd/Florian-Aye"
"3084","Mario Balotelli_2020",2020,"Brescia","Serie A","Mario Balotelli","ITA","FW","28",1990,15.6,2,2,0,2,0,0,2,0,2,1,1,0,8,10,22,0,"https://fbref.com/en/players/8ff07990/Mario-Balotelli"
"3085","Dimitri Bisoli_2020",2020,"Brescia","Serie A","Dimitri Bisoli","ITA","MF","25",1994,23.9,64,35,34,20,10,30,49,61.2,19,41,7,34,25,89,49,0,"https://fbref.com/en/players/16569fef/Dimitri-Bisoli"
"3086","Birkir Bjarnason_2020",2020,"Brescia","Serie A","Birkir Bjarnason","ISL","MF,FW","31",1988,8.9,5,3,1,3,1,2,13,15.4,11,9,4,5,5,10,4,0,"https://fbref.com/en/players/da13074e/Birkir-Bjarnason"
"3087","Jhon Chancellor_2020",2020,"Brescia","Serie A","Jhon Chancellor","VEN","DF","27",1992,24.9,30,14,22,8,0,11,22,50,11,34,29,5,34,64,145,3,"https://fbref.com/en/players/84b6acaa/Jhon-Chancellor"
"3088","Andrea Cistana_2020",2020,"Brescia","Serie A","Andrea Cistana","ITA","DF","22",1997,20.4,20,8,13,7,0,6,17,35.3,11,38,34,4,33,53,96,1,"https://fbref.com/en/players/fe6a7685/Andrea-Cistana"
"3089","Felipe Curcio_2020",2020,"Brescia","Serie A","Felipe Curcio","BRA","DF","25",1993,0.1,0,0,0,0,0,0,0,NA,0,0,0,0,0,0,0,0,"https://fbref.com/en/players/8913a9f9/Felipe-Curcio"
"3090","Daniele Dessena_2020",2020,"Brescia","Serie A","Daniele Dessena","ITA","MF","32",1987,20.8,21,11,5,14,2,6,25,24,19,11,1,10,11,32,21,0,"https://fbref.com/en/players/02b2937c/Daniele-Dessena"
"3091","Alfredo Donnarumma_2020",2020,"Brescia","Serie A","Alfredo Donnarumma","ITA","FW","28",1990,18.7,17,9,3,9,5,6,18,33.3,12,7,0,7,5,22,1,0,"https://fbref.com/en/players/5592007b/Alfredo-Donnarumma"
"3092","Daniele Gastaldello_2020",2020,"Brescia","Serie A","Daniele Gastaldello","ITA","DF","36",1983,4.3,8,5,5,3,0,2,3,66.7,1,6,3,3,5,13,29,1,"https://fbref.com/en/players/13f89eaa/Daniele-Gastaldello"
"3093","Andrea Ghezzi_2020",2020,"Brescia","Serie A","Andrea Ghezzi","ITA","FW,MF","18",2001,0.4,2,0,0,1,1,1,1,100,0,0,0,0,0,2,0,0,"https://fbref.com/en/players/c840baa2/Andrea-Ghezzi"
"3094","Jesse Joronen_2020",2020,"Brescia","Serie A","Jesse Joronen","FIN","GK","26",1993,29,3,1,3,0,0,3,3,100,0,0,0,0,6,9,22,0,"https://fbref.com/en/players/7f66ea09/Jesse-Joronen"
"3095","Giangiacomo Magnani_2020",2020,"Brescia","Serie A","Giangiacomo Magnani","ITA","DF","23",1995,1.3,0,0,0,0,0,0,1,0,1,2,2,0,2,2,6,0,"https://fbref.com/en/players/cce9f582/Giangiacomo-Magnani"
"3096","Massimiliano Mangraviti_2020",2020,"Brescia","Serie A","Massimiliano Mangraviti","ITA","DF","21",1998,10.8,8,6,1,6,1,3,6,50,3,11,6,5,8,16,43,0,"https://fbref.com/en/players/33914f14/Massimiliano-Mangraviti"
"3097","Bruno Martella_2020",2020,"Brescia","Serie A","Bruno Martella","ITA","DF","26",1992,14.1,18,9,14,3,1,9,16,56.3,7,13,7,6,17,35,48,1,"https://fbref.com/en/players/1e12c53b/Bruno-Martella"
"3098","Aleš Matějů_2020",2020,"Brescia","Serie A","Aleš Matějů","CZE","DF","23",1996,28.3,48,27,33,9,6,23,45,51.1,22,41,24,17,37,85,109,3,"https://fbref.com/en/players/deb748c9/Ales-Mateju"
"3099","Alessandro Matri_2020",2020,"Brescia","Serie A","Alessandro Matri","ITA","FW,MF","34",1984,1,1,0,0,0,1,0,0,NA,0,1,0,1,0,1,1,0,"https://fbref.com/en/players/58d97e77/Alessandro-Matri"
"3100","Leonardo Morosini_2020",2020,"Brescia","Serie A","Leonardo Morosini","ITA","FW,DF","23",1995,0.3,1,1,1,0,0,0,0,NA,0,1,0,1,1,2,1,0,"https://fbref.com/en/players/d89b0ebb/Leonardo-Morosini"
"3101","Emanuele Ndoj_2020",2020,"Brescia","Serie A","Emanuele Ndoj","ALB","MF","22",1996,6.2,9,6,2,6,1,3,13,23.1,10,7,0,7,5,14,5,0,"https://fbref.com/en/players/482145e9/Emanuele-Ndoj"
"3102","Andrea Papetti_2020",2020,"Brescia","Serie A","Andrea Papetti","ITA","DF","17",2002,10.2,9,7,8,1,0,4,14,28.6,10,15,11,4,15,24,39,0,"https://fbref.com/en/players/4195b8b6/Andrea-Papetti"
"3103","Rômulo_2020",2020,"Brescia","Serie A","Rômulo","ITA","MF","32",1987,19.1,30,19,12,14,4,12,34,35.3,22,18,1,17,8,38,12,1,"https://fbref.com/en/players/07abb358/Romulo"
"3104","Stefano Sabelli_2020",2020,"Brescia","Serie A","Stefano Sabelli","ITA","DF","26",1993,35.2,83,44,51,28,4,50,106,47.2,56,40,13,27,58,141,107,0,"https://fbref.com/en/players/0ccac09c/Stefano-Sabelli"
"3105","Alessandro Semprini_2020",2020,"Brescia","Serie A","Alessandro Semprini","ITA","DF","21",1998,7,10,4,7,3,0,7,9,77.8,2,10,3,7,9,19,16,0,"https://fbref.com/en/players/dd29f81d/Alessandro-Semprini"
"3106","Simon Skrabb_2020",2020,"Brescia","Serie A","Simon Skrabb","FIN","FW,MF","24",1995,2.9,7,6,2,4,1,6,12,50,6,4,1,3,0,7,3,0,"https://fbref.com/en/players/45af5134/Simon-Skrabb"
"3107","Nikolas Špalek_2020",2020,"Brescia","Serie A","Nikolas Špalek","SVK","MF,FW","22",1997,17.5,24,10,6,11,7,7,31,22.6,24,15,1,14,6,30,10,0,"https://fbref.com/en/players/9e90fb5d/Nikolas-Spalek"
"3108","Sandro Tonali_2020",2020,"Brescia","Serie A","Sandro Tonali","ITA","MF","19",2000,33.5,39,25,16,20,3,16,55,29.1,39,36,14,22,41,80,42,0,"https://fbref.com/en/players/0db169ae/Sandro-Tonali"
"3109","Ernesto Torregrossa_2020",2020,"Brescia","Serie A","Ernesto Torregrossa","VEN","FW","27",1992,20.5,17,7,5,10,2,6,22,27.3,16,10,2,8,5,22,22,0,"https://fbref.com/en/players/bf39bdec/Ernesto-Torregrossa"
"3110","Luca Tremolada_2020",2020,"Brescia","Serie A","Luca Tremolada","ITA","MF","27",1991,0.2,0,0,0,0,0,0,0,NA,0,0,0,0,0,0,0,0,"https://fbref.com/en/players/ed65da8c/Luca-Tremolada"
"3111","Mattia Viviani_2020",2020,"Brescia","Serie A","Mattia Viviani","ITA","MF","18",2000,3.8,3,1,0,3,0,1,8,12.5,7,3,3,0,9,12,2,1,"https://fbref.com/en/players/360b2bb1/Mattia-Viviani"
"3112","Jaromír Zmrhal_2020",2020,"Brescia","Serie A","Jaromír Zmrhal","CZE","MF","25",1993,12.5,10,4,2,5,3,5,18,27.8,13,8,1,7,4,14,11,0,"https://fbref.com/en/players/cbec1196/Jaromir-Zmrhal"
"3113","Mathias Autret_2020",2020,"Brest","Ligue 1","Mathias Autret","FRA","MF,FW","28",1991,13.6,23,17,5,11,7,8,25,32,17,14,1,13,10,33,3,0,"https://fbref.com/en/players/7dfbba27/Mathias-Autret"
"3114","Ludovic Baal_2020",2020,"Brest","Ligue 1","Ludovic Baal","GUF","DF","33",1986,9.2,27,15,13,12,2,10,22,45.5,12,9,3,6,17,44,20,0,"https://fbref.com/en/players/d3ce9f1f/Ludovic-Baal"
"3115","Dénys Bain_2020",2020,"Brest","Ligue 1","Dénys Bain","FRA","DF","26",1993,14.1,21,14,15,6,0,9,9,100,0,13,10,3,28,49,66,0,"https://fbref.com/en/players/5065d67d/Denys-Bain"
"3116","Cristian Battocchio_2020",2020,"Brest","Ligue 1","Cristian Battocchio","ITA","MF","27",1992,15.5,31,24,13,13,5,14,36,38.9,22,13,4,9,19,50,21,0,"https://fbref.com/en/players/0f9b8301/Cristian-Battocchio"
"3117","Gaëtan Belaud_2020",2020,"Brest","Ligue 1","Gaëtan Belaud","FRA","DF","32",1986,6.4,13,7,10,2,1,4,8,50,4,8,3,5,15,28,15,0,"https://fbref.com/en/players/3f1a7191/Gaetan-Belaud"
"3118","Haris Belkebla_2020",2020,"Brest","Ligue 1","Haris Belkebla","ALG","MF","25",1994,20.2,44,24,17,17,10,10,28,35.7,18,25,5,20,53,97,21,2,"https://fbref.com/en/players/2b1bed19/Haris-Belkebla"
"3119","Irvin Cardona_2020",2020,"Brest","Ligue 1","Irvin Cardona","FRA","FW,MF","21",1997,16.1,13,8,5,6,2,9,32,28.1,23,8,0,8,1,14,7,0,"https://fbref.com/en/players/5e080f73/Irvin-Cardona"
"3120","Jean-Charles Castelletto_2020",2020,"Brest","Ligue 1","Jean-Charles Castelletto","CMR","DF","24",1995,20.4,18,9,13,5,0,9,18,50,9,20,16,4,33,51,87,1,"https://fbref.com/en/players/e0f3a1f6/Jean-Charles-Castelletto"
"3121","Gaëtan Charbonnier_2020",2020,"Brest","Ligue 1","Gaëtan Charbonnier","FRA","FW,MF","30",1988,22.9,36,16,11,11,14,10,35,28.6,25,19,6,13,7,43,33,1,"https://fbref.com/en/players/18ebca4b/Gaetan-Charbonnier"
"3122","Brendan Chardonnet_2020",2020,"Brest","Ligue 1","Brendan Chardonnet","FRA","DF","24",1994,9.1,12,6,10,2,0,7,12,58.3,5,8,5,3,15,27,50,0,"https://fbref.com/en/players/16aa7d4c/Brendan-Chardonnet"
"3123","Yoann Court_2020",2020,"Brest","Ligue 1","Yoann Court","FRA","FW,MF","29",1990,16.3,48,26,28,17,3,20,64,31.3,44,21,0,21,15,63,14,0,"https://fbref.com/en/players/26e4447b/Yoann-Court"
"3124","Ibrahima Diallo_2020",2020,"Brest","Ligue 1","Ibrahima Diallo","FRA","MF","20",1999,17.3,38,24,15,22,1,12,29,41.4,17,9,2,7,23,61,16,3,"https://fbref.com/en/players/11ff3d56/Ibrahima-Diallo"
"3125","Jean-Kevin Duverne_2020",2020,"Brest","Ligue 1","Jean-Kevin Duverne","FRA","DF","22",1997,13.1,12,8,5,6,1,2,6,33.3,4,23,8,15,20,32,50,0,"https://fbref.com/en/players/0cbc8baa/Jean-Kevin-Duverne"
"3126","Julien Faussurier_2020",2020,"Brest","Ligue 1","Julien Faussurier","FRA","DF","32",1987,22,36,22,23,13,0,21,53,39.6,32,22,7,15,33,69,46,1,"https://fbref.com/en/players/767212e6/Julien-Faussurier"
"3127","Samuel Grandsir_2020",2020,"Brest","Ligue 1","Samuel Grandsir","FRA","FW,MF","22",1996,16.6,34,22,13,16,5,11,30,36.7,19,9,0,9,14,48,5,0,"https://fbref.com/en/players/d2448564/Samuel-Grandsir"
"3128","Gautier Larsonneur_2020",2020,"Brest","Ligue 1","Gautier Larsonneur","FRA","GK","22",1997,26.6,2,1,2,0,0,2,4,50,2,1,0,1,4,6,14,3,"https://fbref.com/en/players/b49729cb/Gautier-Larsonneur"
"3129","Paul Lasne_2020",2020,"Brest","Ligue 1","Paul Lasne","FRA","MF,FW","30",1989,13.6,25,13,13,11,1,6,20,30,14,7,2,5,7,32,5,0,"https://fbref.com/en/players/542cc80f/Paul-Lasne"
"3130","Donovan Léon_2020",2020,"Brest","Ligue 1","Donovan Léon","GUF","GK","26",1992,1.4,0,0,0,0,0,0,0,NA,0,1,0,1,0,0,0,0,"https://fbref.com/en/players/51c83a90/Donovan-Leon"
"3131","Hugo Magnetti_2020",2020,"Brest","Ligue 1","Hugo Magnetti","FRA","MF","21",1998,2.6,16,10,7,7,2,5,9,55.6,4,4,0,4,7,23,4,0,"https://fbref.com/en/players/d4d35152/Hugo-Magnetti"
"3132","Hianga Mananga Mbock_2020",2020,"Brest","Ligue 1","Hianga Mananga Mbock","FRA","MF","19",1999,1.6,1,1,1,0,0,0,0,NA,0,0,0,0,4,5,0,0,"https://fbref.com/en/players/0f86995c/Hianga-Mananga-Mbock"
"3133","Kévin Mayi_2020",2020,"Brest","Ligue 1","Kévin Mayi","GAB","FW,MF","26",1993,0,0,0,0,0,0,0,0,NA,0,0,0,0,0,0,0,0,"https://fbref.com/en/players/6a26e528/Kevin-Mayi"
"3134","Alexandre Mendy_2020",2020,"Brest","Ligue 1","Alexandre Mendy","GNB","FW","25",1994,10,5,1,1,0,4,1,4,25,3,4,1,3,0,5,10,0,"https://fbref.com/en/players/e067808c/Alexandre-Mendy"
"3135","Ferris N'Goma_2020",2020,"Brest","Ligue 1","Ferris N'Goma","FRA","MF,FW","26",1993,0.3,0,0,0,0,0,0,0,NA,0,1,0,1,0,0,0,0,"https://fbref.com/en/players/2b3d9aad/Ferris-NGoma"
"3136","Romain Perraud_2020",2020,"Brest","Ligue 1","Romain Perraud","FRA","DF","21",1997,18.6,29,14,18,9,2,14,28,50,14,24,9,15,27,56,50,0,"https://fbref.com/en/players/6dfd8f05/Romain-Perraud"
"3137","Steven Alzate_2020",2020,"Brighton","Premier League","Steven Alzate","COL","MF,DF","20",1998,13.2,33,19,20,11,2,17,27,63,10,18,3,15,14,47,13,0,"https://fbref.com/en/players/ad1f61f3/Steven-Alzate"
"3138","Florin Andone_2020",2020,"Brighton","Premier League","Florin Andone","ROU","FW","26",1993,0.8,1,1,0,1,0,1,1,100,0,1,1,0,0,1,1,0,"https://fbref.com/en/players/dc008610/Florin-Andone"
"3139","Bernardo_2020",2020,"Brighton","Premier League","Bernardo","BRA","DF,MF","24",1995,7.5,27,16,12,9,6,13,17,76.5,4,7,3,4,6,33,24,0,"https://fbref.com/en/players/17370b95/Bernardo"
"3140","Yves Bissouma_2020",2020,"Brighton","Premier League","Yves Bissouma","MLI","MF","22",1996,14,49,38,24,22,3,17,40,42.5,23,18,2,16,21,70,23,0,"https://fbref.com/en/players/6c203af0/Yves-Bissouma"
"3141","Gaëtan Bong_2020",2020,"Brighton","Premier League","Gaëtan Bong","CMR","DF,MF","31",1988,0.7,1,0,0,0,1,0,0,NA,0,1,1,0,0,1,0,0,"https://fbref.com/en/players/cfd5e123/Gaetan-Bong"
"3142","Dan Burn_2020",2020,"Brighton","Premier League","Dan Burn","ENG","DF","27",1992,32,67,42,35,27,5,25,53,47.2,28,44,20,24,42,109,130,0,"https://fbref.com/en/players/b2d31e83/Dan-Burn"
"3143","Aaron Connolly_2020",2020,"Brighton","Premier League","Aaron Connolly","IRL","FW","19",2000,14,7,6,1,4,2,3,10,30,7,11,0,11,0,7,3,0,"https://fbref.com/en/players/27c01749/Aaron-Connolly"
"3144","Shane Duffy_2020",2020,"Brighton","Premier League","Shane Duffy","IRL","DF","27",1992,13.8,18,9,14,4,0,6,17,35.3,11,13,7,6,21,39,72,0,"https://fbref.com/en/players/7314bba4/Shane-Duffy"
"3145","Lewis Dunk_2020",2020,"Brighton","Premier League","Lewis Dunk","ENG","DF","27",1991,35.9,40,24,23,17,0,15,34,44.1,19,55,33,22,55,95,125,2,"https://fbref.com/en/players/282f75f3/Lewis-Dunk"
"3146","Pascal Groß_2020",2020,"Brighton","Premier League","Pascal Groß","GER","MF,FW","28",1991,20,36,13,8,21,7,14,39,35.9,25,25,3,22,9,45,7,0,"https://fbref.com/en/players/8aec0537/Pascal-Gross"
"3147","Alireza Jahanbakhsh_2020",2020,"Brighton","Premier League","Alireza Jahanbakhsh","IRN","FW,MF","25",1993,3.5,8,4,3,2,3,0,2,0,2,5,0,5,3,11,2,0,"https://fbref.com/en/players/08452314/Alireza-Jahanbakhsh"
"3148","Tariq Lamptey_2020",2020,"Brighton","Premier League","Tariq Lamptey","GHA","DF","18",2000,6.5,7,6,6,1,0,2,9,22.2,7,6,0,6,16,23,17,0,"https://fbref.com/en/players/f4e433d4/Tariq-Lamptey"
"3149","Jürgen Locadia_2020",2020,"Brighton","Premier League","Jürgen Locadia","NED","FW,MF","25",1993,1,0,0,0,0,0,0,0,NA,0,0,0,0,0,0,0,0,"https://fbref.com/en/players/6cc47ae1/Jurgen-Locadia"
"3150","Alexis Mac Allister_2020",2020,"Brighton","Premier League","Alexis Mac Allister","ARG","MF,FW","20",1998,3.9,9,5,4,3,2,5,9,55.6,4,12,0,12,1,10,2,0,"https://fbref.com/en/players/83d074ff/Alexis-Mac-Allister"
"3151","Solly March_2020",2020,"Brighton","Premier League","Solly March","ENG","FW,MF","25",1994,12.7,25,12,16,6,3,9,19,47.4,10,16,4,12,20,45,14,2,"https://fbref.com/en/players/bb5fbd2b/Solly-March"
"3152","Neal Maupay_2020",2020,"Brighton","Premier League","Neal Maupay","FRA","FW","22",1996,30.7,20,12,1,13,6,9,29,31,20,24,0,24,4,24,10,0,"https://fbref.com/en/players/4bcf39f6/Neal-Maupay"
"3153","Martín Montoya_2020",2020,"Brighton","Premier League","Martín Montoya","ESP","DF,MF","28",1991,21.1,57,29,31,20,6,30,56,53.6,26,19,5,14,24,81,40,0,"https://fbref.com/en/players/5cec2487/Martin-Montoya"
"3154","Aaron Mooy_2020",2020,"Brighton","Premier League","Aaron Mooy","AUS","MF,FW","28",1990,23.2,37,24,9,18,10,6,40,15,34,36,7,29,23,60,32,1,"https://fbref.com/en/players/47b7e3af/Aaron-Mooy"
"3155","Glenn Murray_2020",2020,"Brighton","Premier League","Glenn Murray","ENG","FW","35",1983,8.9,5,2,0,3,2,2,9,22.2,7,6,2,4,1,6,12,0,"https://fbref.com/en/players/f2f29dda/Glenn-Murray"
"3156","Davy Pröpper_2020",2020,"Brighton","Premier League","Davy Pröpper","NED","MF","27",1991,31.4,64,35,28,28,8,23,74,31.1,51,27,8,19,38,102,36,4,"https://fbref.com/en/players/fdd85f94/Davy-Propper"
"3157","Mathew Ryan_2020",2020,"Brighton","Premier League","Mathew Ryan","AUS","GK","27",1992,38,1,1,1,0,0,1,4,25,3,0,0,0,2,3,13,2,"https://fbref.com/en/players/4535e4bb/Mathew-Ryan"
"3158","Ezequiel Schelotto_2020",2020,"Brighton","Premier League","Ezequiel Schelotto","ITA","DF","30",1989,4,4,3,1,2,1,2,8,25,6,3,0,3,7,11,14,0,"https://fbref.com/en/players/a6e316c1/Ezequiel-Schelotto"
"3159","Dale Stephens_2020",2020,"Brighton","Premier League","Dale Stephens","ENG","MF","30",1989,28.1,73,44,30,37,6,25,75,33.3,50,31,11,20,58,131,42,2,"https://fbref.com/en/players/653ee42d/Dale-Stephens"
"3160","Leandro Trossard_2020",2020,"Brighton","Premier League","Leandro Trossard","BEL","FW,MF","24",1994,22.3,22,17,7,12,3,6,38,15.8,32,16,1,15,9,31,8,0,"https://fbref.com/en/players/38ceb24a/Leandro-Trossard"
"3161","Adam Webster_2020",2020,"Brighton","Premier League","Adam Webster","ENG","DF","24",1995,29.6,30,17,21,8,1,14,32,43.8,18,43,26,17,45,75,110,2,"https://fbref.com/en/players/c40b6180/Adam-Webster"
"3162","Phil Bardsley_2020",2020,"Burnley","Premier League","Phil Bardsley","SCO","DF","34",1985,21,49,36,16,24,9,24,37,64.9,13,24,11,13,30,79,73,0,"https://fbref.com/en/players/1ae30132/Phil-Bardsley"
"3163","Ashley Barnes_2020",2020,"Burnley","Premier League","Ashley Barnes","ENG","FW","29",1989,15,10,5,3,5,2,3,9,33.3,6,7,2,5,6,16,9,0,"https://fbref.com/en/players/2691c772/Ashley-Barnes"
"3164","Jóhann Berg Guðmundsson_2020",2020,"Burnley","Premier League","Jóhann Berg Guðmundsson","ISL","MF","28",1990,6.9,4,2,2,2,0,1,8,12.5,7,8,1,7,7,11,9,0,"https://fbref.com/en/players/f72293fc/Johann-Berg-Gudmundsson"
"3165","Robbie Brady_2020",2020,"Burnley","Premier League","Robbie Brady","IRL","MF","27",1992,5,11,9,5,4,2,3,10,30,7,10,2,8,5,16,8,0,"https://fbref.com/en/players/96bb8cc2/Robbie-Brady"
"3166","Josh Brownhill_2020",2020,"Burnley","Premier League","Josh Brownhill","ENG","MF","23",1995,8.9,14,8,5,7,2,5,13,38.5,8,9,4,5,14,28,18,0,"https://fbref.com/en/players/47369df8/Josh-Brownhill"
"3167","Jack Cork_2020",2020,"Burnley","Premier League","Jack Cork","ENG","MF","30",1989,29,35,24,10,20,5,12,62,19.4,50,34,12,22,28,63,49,0,"https://fbref.com/en/players/74e12f1e/Jack-Cork"
"3168","Danny Drinkwater_2020",2020,"Burnley","Premier League","Danny Drinkwater","ENG","MF","29",1990,0.6,2,1,1,1,0,0,1,0,1,0,0,0,1,3,0,0,"https://fbref.com/en/players/2649ff32/Danny-Drinkwater"
"3169","Jeff Hendrick_2020",2020,"Burnley","Premier League","Jeff Hendrick","IRL","MF","27",1992,21.5,18,10,7,8,3,7,27,25.9,20,21,8,13,20,38,20,0,"https://fbref.com/en/players/989d5705/Jeff-Hendrick"
"3170","Aaron Lennon_2020",2020,"Burnley","Premier League","Aaron Lennon","ENG","MF","32",1987,5.5,14,8,7,4,3,7,10,70,3,6,1,5,8,22,3,0,"https://fbref.com/en/players/2ff964a0/Aaron-Lennon"
"3171","Kevin Long_2020",2020,"Burnley","Premier League","Kevin Long","IRL","DF","28",1990,6.3,7,5,6,1,0,4,9,44.4,5,9,7,2,4,11,31,0,"https://fbref.com/en/players/5a4280b1/Kevin-Long"
"3172","Matthew Lowton_2020",2020,"Burnley","Premier League","Matthew Lowton","ENG","DF","30",1989,17,41,22,20,18,3,22,33,66.7,11,20,6,14,27,68,57,1,"https://fbref.com/en/players/9a9c05db/Matthew-Lowton"
"3173","Dwight McNeil_2020",2020,"Burnley","Premier League","Dwight McNeil","ENG","MF","19",1999,37.1,47,33,18,22,7,23,71,32.4,48,60,8,52,30,77,34,0,"https://fbref.com/en/players/fc15fb84/Dwight-McNeil"
"3174","Ben Mee_2020",2020,"Burnley","Premier League","Ben Mee","ENG","DF","29",1989,32,41,22,25,16,0,17,29,58.6,12,42,31,11,42,83,165,2,"https://fbref.com/en/players/8df7a2fb/Ben-Mee"
"3175","Erik Pieters_2020",2020,"Burnley","Premier League","Erik Pieters","NED","DF,MF","30",1988,20.9,54,32,18,29,7,28,69,40.6,41,30,4,26,28,82,60,1,"https://fbref.com/en/players/1ef37668/Erik-Pieters"
"3176","Nick Pope_2020",2020,"Burnley","Premier League","Nick Pope","ENG","GK","27",1992,38,1,1,1,0,0,1,2,50,1,0,0,0,3,4,15,3,"https://fbref.com/en/players/4b40d9ca/Nick-Pope"
"3177","Jay Rodriguez_2020",2020,"Burnley","Premier League","Jay Rodriguez","ENG","FW","30",1989,22.4,29,19,4,13,12,8,33,24.2,25,33,6,27,5,34,12,0,"https://fbref.com/en/players/4ab53cdb/Jay-Rodriguez"
"3178","James Tarkowski_2020",2020,"Burnley","Premier League","James Tarkowski","ENG","DF","26",1992,38,66,43,47,19,0,31,54,57.4,23,63,47,16,63,129,204,4,"https://fbref.com/en/players/15ea812b/James-Tarkowski"
"3179","Charlie Taylor_2020",2020,"Burnley","Premier League","Charlie Taylor","ENG","DF","25",1993,21.6,39,24,26,9,4,19,39,48.7,20,29,9,20,29,68,78,1,"https://fbref.com/en/players/cc2d7ad5/Charlie-Taylor"
"3180","Max Thompson_2020",2020,"Burnley","Premier League","Max Thompson","ENG","FW","17",2002,0,0,0,0,0,0,0,0,NA,0,0,0,0,0,0,0,0,"https://fbref.com/en/players/fa38722f/Max-Thompson"
"3181","Matěj Vydra_2020",2020,"Burnley","Premier League","Matěj Vydra","CZE","FW","27",1992,9.1,4,3,0,3,1,3,6,50,3,7,3,4,1,5,6,0,"https://fbref.com/en/players/0d4ceb32/Matej-Vydra"
"3182","Ashley Westwood_2020",2020,"Burnley","Premier League","Ashley Westwood","ENG","MF","29",1990,35,54,33,15,32,7,17,48,35.4,31,23,11,12,32,86,32,3,"https://fbref.com/en/players/495945ef/Ashley-Westwood"
"3183","Chris Wood_2020",2020,"Burnley","Premier League","Chris Wood","NZL","FW","27",1991,27.1,7,4,2,4,1,5,15,33.3,10,15,2,13,4,11,18,0,"https://fbref.com/en/players/4e9a0555/Chris-Wood"
"3184","Valter Birsa_2020",2020,"Cagliari","Serie A","Valter Birsa","SVN","MF,FW","32",1986,4.8,10,6,3,6,1,7,21,33.3,14,6,1,5,4,14,3,0,"https://fbref.com/en/players/455a2b79/Valter-Birsa"
"3185","Fabrizio Cacciatore_2020",2020,"Cagliari","Serie A","Fabrizio Cacciatore","ITA","DF","32",1986,12.8,14,4,9,4,1,6,9,66.7,3,10,6,4,16,30,44,0,"https://fbref.com/en/players/00b0bb87/Fabrizio-Cacciatore"
"3186","Andrea Carboni_2020",2020,"Cagliari","Serie A","Andrea Carboni","ITA","DF","18",2001,4.1,8,4,3,5,0,3,4,75,1,6,6,0,7,15,20,0,"https://fbref.com/en/players/f7e2af2c/Andrea-Carboni"
"3187","Lucas Castro_2020",2020,"Cagliari","Serie A","Lucas Castro","ARG","MF","30",1989,6.7,7,3,3,4,0,1,12,8.3,11,6,1,5,8,15,14,0,"https://fbref.com/en/players/56b2957b/Lucas-Castro"
"3188","Luca Ceppitelli_2020",2020,"Cagliari","Serie A","Luca Ceppitelli","ITA","DF","29",1989,13.8,22,15,16,6,0,6,11,54.5,5,23,17,6,23,45,66,2,"https://fbref.com/en/players/7d50454d/Luca-Ceppitelli"
"3189","Alberto Cerri_2020",2020,"Cagliari","Serie A","Alberto Cerri","ITA","FW","23",1996,2.7,3,1,1,0,2,2,6,33.3,4,1,0,1,2,5,4,0,"https://fbref.com/en/players/1079c685/Alberto-Cerri"
"3190","Luca Cigarini_2020",2020,"Cagliari","Serie A","Luca Cigarini","ITA","MF","33",1986,17.8,37,20,23,13,1,16,40,40,24,28,10,18,20,57,29,0,"https://fbref.com/en/players/ae64d449/Luca-Cigarini"
"3191","Alessio Cragno_2020",2020,"Cagliari","Serie A","Alessio Cragno","ITA","GK","25",1994,16,0,0,0,0,0,0,0,NA,0,0,0,0,0,0,10,0,"https://fbref.com/en/players/f554e29b/Alessio-Cragno"
"3192","Alessandro Deiola_2020",2020,"Cagliari","Serie A","Alessandro Deiola","ITA","MF","23",1995,0,0,0,0,0,0,0,0,NA,0,0,0,0,1,1,0,0,"https://fbref.com/en/players/7f267d66/Alessandro-Deiola"
"3193","Paolo Faragò_2020",2020,"Cagliari","Serie A","Paolo Faragò","ITA","DF,MF","26",1993,14.9,41,28,21,15,5,23,46,50,23,18,9,9,10,51,58,0,"https://fbref.com/en/players/9085dd7c/Paolo-Farago"
"3194","Luca Gagliano_2020",2020,"Cagliari","Serie A","Luca Gagliano","ITA","FW","19",2000,0.6,0,0,0,0,0,0,0,NA,0,0,0,0,1,1,0,0,"https://fbref.com/en/players/1d00a56c/Luca-Gagliano"
"3195","Artur Ioniță_2020",2020,"Cagliari","Serie A","Artur Ioniță","MDA","MF","28",1990,21.1,38,23,12,22,4,12,37,32.4,25,32,10,22,18,56,24,2,"https://fbref.com/en/players/cedb3e36/Artur-Ionita"
"3196","Ragnar Klavan_2020",2020,"Cagliari","Serie A","Ragnar Klavan","EST","DF","33",1985,26.2,29,16,20,9,0,14,28,50,14,29,19,10,25,54,118,1,"https://fbref.com/en/players/008a6e6d/Ragnar-Klavan"
"3197","Riccardo Ladinetti_2020",2020,"Cagliari","Serie A","Riccardo Ladinetti","ITA","MF","18",2000,1.4,2,2,0,2,0,1,1,100,0,0,0,0,4,6,0,1,"https://fbref.com/en/players/ff4296df/Riccardo-Ladinetti"
"3198","Charalambos Lykogiannis_2020",2020,"Cagliari","Serie A","Charalambos Lykogiannis","GRE","DF","25",1993,14.9,14,9,9,3,2,7,18,38.9,11,25,9,16,23,37,71,0,"https://fbref.com/en/players/5efc5389/Charalambos-Lykogiannis"
"3199","Federico Marigosu_2020",2020,"Cagliari","Serie A","Federico Marigosu","ITA","MF","18",2001,0.3,0,0,0,0,0,0,0,NA,0,0,0,0,0,0,1,0,"https://fbref.com/en/players/66a9470c/Federico-Marigosu"
"3200","Federico Mattiello_2020",2020,"Cagliari","Serie A","Federico Mattiello","ITA","DF","24",1995,10.3,30,21,19,7,4,11,27,40.7,16,20,7,13,18,48,22,0,"https://fbref.com/en/players/fba81826/Federico-Mattiello"
"3201","Radja Nainggolan_2020",2020,"Cagliari","Serie A","Radja Nainggolan","BEL","MF","31",1988,23,30,18,9,12,9,9,29,31,20,25,6,19,13,43,30,0,"https://fbref.com/en/players/1f9328da/Radja-Nainggolan"
"3202","Nahitan Nández_2020",2020,"Cagliari","Serie A","Nahitan Nández","URU","MF,DF","23",1995,32.2,58,38,37,17,4,25,69,36.2,44,30,1,29,25,83,26,0,"https://fbref.com/en/players/95facda1/Nahitan-Nandez"
"3203","Christian Oliva_2020",2020,"Cagliari","Serie A","Christian Oliva","URU","MF","23",1996,5.2,13,7,9,4,0,5,15,33.3,10,5,0,5,7,20,14,0,"https://fbref.com/en/players/d3b888e3/Christian-Oliva"
"3204","Robin Olsen_2020",2020,"Cagliari","Serie A","Robin Olsen","SWE","GK","29",1990,16.9,0,0,0,0,0,0,1,0,1,0,0,0,0,0,8,0,"https://fbref.com/en/players/e7ee38c3/Robin-Olsen"
"3205","Alberto Paloschi_2020",2020,"Cagliari","Serie A","Alberto Paloschi","ITA","FW,MF","29",1990,2.3,0,0,0,0,0,0,1,0,1,1,0,1,1,1,3,0,"https://fbref.com/en/players/b5cae4e6/Alberto-Paloschi"
"3206","Leonardo Pavoletti_2020",2020,"Cagliari","Serie A","Leonardo Pavoletti","ITA","FW","30",1988,0.5,0,0,0,0,0,0,0,NA,0,0,0,0,1,1,3,0,"https://fbref.com/en/players/d37b0350/Leonardo-Pavoletti"
"3207","João Pedro_2020",2020,"Cagliari","Serie A","João Pedro","ITA","FW,MF","27",1992,35,17,11,5,7,5,4,24,16.7,20,35,8,27,9,26,39,0,"https://fbref.com/en/players/81255c03/Joao-Pedro"
"3208","Luca Pellegrini_2020",2020,"Cagliari","Serie A","Luca Pellegrini","ITA","DF","20",1999,21.2,31,15,20,7,4,15,38,39.5,23,19,2,17,21,52,45,2,"https://fbref.com/en/players/3b61c9ec/Luca-Pellegrini"
"3209","Gastón Pereiro_2020",2020,"Cagliari","Serie A","Gastón Pereiro","URU","MF,FW","24",1995,3.9,2,2,2,0,0,1,4,25,3,1,0,1,0,2,1,1,"https://fbref.com/en/players/7ec7738e/Gaston-Pereiro"
"3210","Simone Pinna_2020",2020,"Cagliari","Serie A","Simone Pinna","ITA","DF","21",1997,1,1,1,0,1,0,0,0,NA,0,3,1,2,5,6,4,1,"https://fbref.com/en/players/6523afa4/Simone-Pinna"
"3211","Fabio Pisacane_2020",2020,"Cagliari","Serie A","Fabio Pisacane","ITA","DF","33",1986,27.1,32,21,22,10,0,21,37,56.8,16,36,28,8,27,59,110,2,"https://fbref.com/en/players/56400c01/Fabio-Pisacane"
"3212","Rafael_2020",2020,"Cagliari","Serie A","Rafael","BRA","GK","37",1982,5,0,0,0,0,0,0,0,NA,0,0,0,0,0,0,3,0,"https://fbref.com/en/players/dd06d56c/Rafael"
"3213","Daniele Ragatzu_2020",2020,"Cagliari","Serie A","Daniele Ragatzu","ITA","MF,FW","27",1991,3.5,3,2,0,2,1,1,3,33.3,2,1,0,1,1,4,5,0,"https://fbref.com/en/players/282b3a4d/Daniele-Ragatzu"
"3214","Marko Rog_2020",2020,"Cagliari","Serie A","Marko Rog","CRO","MF","24",1995,25.7,69,47,31,29,9,22,84,26.2,62,40,12,28,22,91,23,0,"https://fbref.com/en/players/b6b2b820/Marko-Rog"
"3215","Giovanni Simeone_2020",2020,"Cagliari","Serie A","Giovanni Simeone","ARG","FW","24",1995,32.5,24,13,9,10,5,5,32,15.6,27,24,7,17,11,35,16,1,"https://fbref.com/en/players/343c0d52/Giovanni-Simeone"
"3216","Sebastian Walukiewicz_2020",2020,"Cagliari","Serie A","Sebastian Walukiewicz","POL","DF","19",2000,12.9,25,11,17,8,0,14,22,63.6,8,21,14,7,14,39,41,0,"https://fbref.com/en/players/217875a4/Sebastian-Walukiewicz"
"3217","Joseph Aidoo_2020",2020,"Celta Vigo","La Liga","Joseph Aidoo","GHA","DF","23",1995,27.8,43,27,30,11,2,13,27,48.1,14,31,14,17,45,88,124,3,"https://fbref.com/en/players/18abe173/Joseph-Aidoo"
"3218","Sergio Álvarez_2020",2020,"Celta Vigo","La Liga","Sergio Álvarez","ESP","GK","32",1986,2,0,0,0,0,0,0,0,NA,0,0,0,0,0,0,1,0,"https://fbref.com/en/players/8875b8c9/Sergio-Alvarez"
"3219","Néstor Araujo_2020",2020,"Celta Vigo","La Liga","Néstor Araujo","MEX","DF","27",1991,32.1,44,27,35,8,1,22,36,61.1,14,26,18,8,52,96,142,0,"https://fbref.com/en/players/27a013f7/Nestor-Araujo"
"3220","Iago Aspas_2020",2020,"Celta Vigo","La Liga","Iago Aspas","ESP","FW","31",1987,36.2,29,19,7,9,13,12,45,26.7,33,16,1,15,22,51,7,0,"https://fbref.com/en/players/7dcf86f6/Iago-Aspas"
"3221","Fran Beltrán_2020",2020,"Celta Vigo","La Liga","Fran Beltrán","ESP","MF","20",1999,20.3,31,19,15,12,4,11,35,31.4,24,14,1,13,14,45,17,0,"https://fbref.com/en/players/ed5c5fa3/Fran-Beltran"
"3222","Sergio Bermejo_2020",2020,"Celta Vigo","La Liga","Sergio Bermejo","ESP","MF,FW","21",1997,0.1,0,0,0,0,0,0,0,NA,0,0,0,0,0,0,0,0,"https://fbref.com/en/players/d166c007/Sergio-Bermejo"
"3223","Rubén Blanco_2020",2020,"Celta Vigo","La Liga","Rubén Blanco","ESP","GK","24",1995,32.9,1,1,1,0,0,1,1,100,0,0,0,0,0,1,14,1,"https://fbref.com/en/players/967f34d3/Ruben-Blanco"
"3224","Filip Bradarić_2020",2020,"Celta Vigo","La Liga","Filip Bradarić","CRO","MF","27",1992,7.8,12,9,5,5,2,3,8,37.5,5,12,3,9,17,29,19,0,"https://fbref.com/en/players/605873e1/Filip-Bradaric"
"3225","Pape Cheikh Diop_2020",2020,"Celta Vigo","La Liga","Pape Cheikh Diop","SEN","MF","21",1997,6.7,10,4,6,3,1,2,12,16.7,10,4,2,2,5,15,3,0,"https://fbref.com/en/players/873ce3a2/Pape-Cheikh-Diop"
"3226","David Costas_2020",2020,"Celta Vigo","La Liga","David Costas","ESP","DF","24",1995,3.8,4,3,3,1,0,2,4,50,2,3,3,0,8,12,12,0,"https://fbref.com/en/players/545e2f01/David-Costas"
"3227","Gabriel Fernández_2020",2020,"Celta Vigo","La Liga","Gabriel Fernández","URU","FW,MF","25",1994,6.2,1,0,0,1,0,1,3,33.3,2,5,1,4,2,3,2,0,"https://fbref.com/en/players/36c5f77b/Gabriel-Fernandez"
"3228","Juan Hernández_2020",2020,"Celta Vigo","La Liga","Juan Hernández","ESP","FW,MF","24",1994,1,0,0,0,0,0,0,0,NA,0,0,0,0,1,1,0,0,"https://fbref.com/en/players/1fc3c3d7/Juan-Hernandez"
"3229","Jacobo_2020",2020,"Celta Vigo","La Liga","Jacobo","ESP","DF,MF","22",1997,0.9,3,3,2,1,0,1,1,100,0,0,0,0,0,3,2,0,"https://fbref.com/en/players/09e81276/Jacobo"
"3230","David Juncà_2020",2020,"Celta Vigo","La Liga","David Juncà","ESP","DF","25",1993,2.9,6,5,4,1,1,2,3,66.7,1,4,1,3,2,8,3,0,"https://fbref.com/en/players/de7d40d6/David-Junca"
"3231","Stanislav Lobotka_2020",2020,"Celta Vigo","La Liga","Stanislav Lobotka","SVK","MF","24",1994,15.4,19,11,13,5,1,4,19,21.1,15,8,2,6,8,27,7,0,"https://fbref.com/en/players/e1cbb531/Stanislav-Lobotka"
"3232","Losada_2020",2020,"Celta Vigo","La Liga","Losada","ESP","MF,FW","17",2001,0.1,0,0,0,0,0,0,0,NA,0,0,0,0,0,0,0,0,"https://fbref.com/en/players/41521385/Losada"
"3233","Hugo Mallo_2020",2020,"Celta Vigo","La Liga","Hugo Mallo","ESP","DF","28",1991,21.8,62,42,44,16,2,27,48,56.3,21,24,8,16,22,84,97,1,"https://fbref.com/en/players/cb574619/Hugo-Mallo"
"3234","Brais Méndez_2020",2020,"Celta Vigo","La Liga","Brais Méndez","ESP","MF,FW","22",1997,16.4,26,11,14,9,3,12,39,30.8,27,20,0,20,12,38,23,1,"https://fbref.com/en/players/c9e39d91/Brais-Mendez"
"3235","Santi Mina_2020",2020,"Celta Vigo","La Liga","Santi Mina","ESP","FW,MF","23",1995,21.6,13,8,8,5,0,5,38,13.2,33,19,2,17,10,23,27,0,"https://fbref.com/en/players/0b90bb97/Santi-Mina"
"3236","Jeison Murillo_2020",2020,"Celta Vigo","La Liga","Jeison Murillo","COL","DF","27",1992,17,37,20,30,6,1,18,27,66.7,9,13,9,4,20,57,74,2,"https://fbref.com/en/players/b233e8e4/Jeison-Murillo"
"3237","Nolito_2020",2020,"Celta Vigo","La Liga","Nolito","ESP","MF,FW","32",1986,3.6,7,5,5,2,0,3,8,37.5,5,4,1,3,1,8,4,0,"https://fbref.com/en/players/b2d0ec1b/Nolito"
"3238","Lucas Olaza_2020",2020,"Celta Vigo","La Liga","Lucas Olaza","URU","DF","25",1994,34.9,56,39,36,17,3,39,59,66.1,20,37,10,27,31,87,60,1,"https://fbref.com/en/players/4cee5954/Lucas-Olaza"
"3239","Rafinha_2020",2020,"Celta Vigo","La Liga","Rafinha","BRA","MF","26",1993,23.5,71,37,29,37,5,20,62,32.3,42,37,4,33,33,104,25,0,"https://fbref.com/en/players/0c2ac3cb/Rafinha"
"3240","Jorge Sáenz_2020",2020,"Celta Vigo","La Liga","Jorge Sáenz","ESP","DF","22",1996,4.1,6,1,4,2,0,3,5,60,2,5,2,3,10,16,15,0,"https://fbref.com/en/players/bfca375c/Jorge-Saenz"
"3241","Pione Sisto_2020",2020,"Celta Vigo","La Liga","Pione Sisto","DEN","FW,MF","24",1995,9.9,17,8,5,6,6,4,19,21.1,15,18,0,18,6,23,4,1,"https://fbref.com/en/players/fd9c4805/Pione-Sisto"
"3242","Fyodor Smolov_2020",2020,"Celta Vigo","La Liga","Fyodor Smolov","RUS","FW","29",1990,8.3,2,1,0,2,0,1,9,11.1,8,6,0,6,7,9,9,0,"https://fbref.com/en/players/cbbfa2e7/Fyodor-Smolov"
"3243","Denis Suárez_2020",2020,"Celta Vigo","La Liga","Denis Suárez","ESP","MF,FW","25",1994,18.1,22,15,14,7,1,10,37,27,27,9,1,8,14,36,12,1,"https://fbref.com/en/players/12c50af5/Denis-Suarez"
"3244","Kevin Vázquez_2020",2020,"Celta Vigo","La Liga","Kevin Vázquez","ESP","DF","26",1993,14.7,26,15,16,6,4,15,28,53.6,13,18,1,17,26,52,28,0,"https://fbref.com/en/players/ee923664/Kevin-Vazquez"
"3245","Iván Villar_2020",2020,"Celta Vigo","La Liga","Iván Villar","ESP","GK","22",1997,3.1,0,0,0,0,0,0,0,NA,0,0,0,0,0,0,5,0,"https://fbref.com/en/players/cde52ef5/Ivan-Villar"
"3246","Okay Yokuşlu_2020",2020,"Celta Vigo","La Liga","Okay Yokuşlu","TUR","MF","25",1994,21.9,41,27,18,21,2,20,42,47.6,22,12,5,7,28,69,71,1,"https://fbref.com/en/players/e49ce451/Okay-Yokuslu"
"3247","Tammy Abraham_2020",2020,"Chelsea","Premier League","Tammy Abraham","ENG","FW","21",1997,24.6,8,4,2,5,1,3,14,21.4,11,20,2,18,6,14,27,0,"https://fbref.com/en/players/f586779e/Tammy-Abraham"
"3248","Marcos Alonso_2020",2020,"Chelsea","Premier League","Marcos Alonso","ESP","DF","28",1990,15.9,28,16,20,6,2,14,33,42.4,19,18,2,16,20,48,32,0,"https://fbref.com/en/players/f4290206/Marcos-Alonso"
"3249","Faustino Anjorin_2020",2020,"Chelsea","Premier League","Faustino Anjorin","ENG","FW","17",2001,0.2,0,0,0,0,0,0,0,NA,0,1,0,1,0,0,0,0,"https://fbref.com/en/players/b105919e/Faustino-Anjorin"
"3250","Kepa Arrizabalaga_2020",2020,"Chelsea","Premier League","Kepa Arrizabalaga","ESP","GK","24",1994,33,1,1,1,0,0,1,2,50,1,0,0,0,1,2,7,2,"https://fbref.com/en/players/28d596a0/Kepa-Arrizabalaga"
"3251","César Azpilicueta_2020",2020,"Chelsea","Premier League","César Azpilicueta","ESP","DF","29",1989,35.9,86,56,40,32,14,35,69,50.7,34,56,21,35,67,153,94,0,"https://fbref.com/en/players/53cad200/Cesar-Azpilicueta"
"3252","Ross Barkley_2020",2020,"Chelsea","Premier League","Ross Barkley","ENG","MF","25",1993,12.3,16,9,6,6,4,5,18,27.8,13,7,2,5,7,23,7,0,"https://fbref.com/en/players/3a24769f/Ross-Barkley"
"3253","Michy Batshuayi_2020",2020,"Chelsea","Premier League","Michy Batshuayi","BEL","FW","25",1993,2.7,4,1,2,2,0,0,5,0,5,1,1,0,0,4,1,0,"https://fbref.com/en/players/2973d8ff/Michy-Batshuayi"
"3254","Armando Broja_2020",2020,"Chelsea","Premier League","Armando Broja","ALB","FW","17",2001,0.1,0,0,0,0,0,0,0,NA,0,0,0,0,0,0,0,0,"https://fbref.com/en/players/97220da2/Armando-Broja"
"3255","Willy Caballero_2020",2020,"Chelsea","Premier League","Willy Caballero","ARG","GK","37",1981,5,0,0,0,0,0,0,0,NA,0,0,0,0,0,0,3,0,"https://fbref.com/en/players/a179d516/Willy-Caballero"
"3256","Andreas Christensen_2020",2020,"Chelsea","Premier League","Andreas Christensen","DEN","DF","23",1996,19.5,38,21,25,12,1,15,21,71.4,6,12,8,4,29,67,56,0,"https://fbref.com/en/players/1cb49278/Andreas-Christensen"
"3257","Billy Gilmour_2020",2020,"Chelsea","Premier League","Billy Gilmour","SCO","MF","18",2001,2.2,5,2,3,2,0,2,4,50,2,2,0,2,3,8,3,1,"https://fbref.com/en/players/df10e27c/Billy-Gilmour"
"3258","Olivier Giroud_2020",2020,"Chelsea","Premier League","Olivier Giroud","FRA","FW","32",1986,11,8,3,2,5,1,1,11,9.1,10,14,1,13,2,10,13,0,"https://fbref.com/en/players/16ceb862/Olivier-Giroud"
"3259","Callum Hudson-Odoi_2020",2020,"Chelsea","Premier League","Callum Hudson-Odoi","ENG","FW,MF","18",2000,9.6,10,4,4,5,1,1,7,14.3,6,9,0,9,5,15,4,1,"https://fbref.com/en/players/15f3ec41/Callum-Hudson-Odoi"
"3260","Reece James_2020",2020,"Chelsea","Premier League","Reece James","ENG","DF","19",1999,16.8,36,23,18,14,4,11,29,37.9,18,19,8,11,22,58,28,0,"https://fbref.com/en/players/1265a93a/Reece-James"
"3261","Jorginho_2020",2020,"Chelsea","Premier League","Jorginho","ITA","MF","27",1991,26.4,66,40,24,34,8,35,91,38.5,56,30,5,25,64,130,27,2,"https://fbref.com/en/players/45db685d/Jorginho"
"3262","N'Golo Kanté_2020",2020,"Chelsea","Premier League","N'Golo Kanté","FRA","MF","28",1991,19.2,44,20,22,14,8,17,36,47.2,19,29,5,24,44,88,32,2,"https://fbref.com/en/players/b9fbae28/NGolo-Kante"
"3263","Mateo Kovačić_2020",2020,"Chelsea","Premier League","Mateo Kovačić","CRO","MF","25",1994,23,63,38,29,32,2,26,65,40,39,15,1,14,22,85,16,1,"https://fbref.com/en/players/79c0821a/Mateo-Kovacic"
"3264","Tariq Lamptey_2020",2020,"Chelsea","Premier League","Tariq Lamptey","GHA","DF","18",2000,0.4,2,2,1,1,0,2,2,100,0,0,0,0,0,2,0,0,"https://fbref.com/en/players/f4e433d4/Tariq-Lamptey"
"3265","Ruben Loftus-Cheek_2020",2020,"Chelsea","Premier League","Ruben Loftus-Cheek","ENG","MF,FW","23",1996,2.3,0,0,0,0,0,0,2,0,2,1,1,0,2,2,2,0,"https://fbref.com/en/players/e97fd090/Ruben-Loftus-Cheek"
"3266","Mason Mount_2020",2020,"Chelsea","Premier League","Mason Mount","ENG","MF,FW","20",1999,31.9,37,17,8,19,10,9,42,21.4,33,25,3,22,16,53,18,0,"https://fbref.com/en/players/9674002f/Mason-Mount"
"3267","Emerson Palmieri_2020",2020,"Chelsea","Premier League","Emerson Palmieri","ITA","DF","24",1994,11.4,23,12,8,11,4,10,15,66.7,5,13,1,12,18,41,19,0,"https://fbref.com/en/players/e0bc6fdc/Emerson-Palmieri"
"3268","Pedro_2020",2020,"Chelsea","Premier League","Pedro","ESP","FW,MF","32",1987,7.3,15,7,5,9,1,3,15,20,12,9,0,9,9,24,1,0,"https://fbref.com/en/players/3ca7254a/Pedro"
"3269","Christian Pulisic_2020",2020,"Chelsea","Premier League","Christian Pulisic","USA","FW","20",1998,19.1,23,11,13,4,6,7,24,29.2,17,15,0,15,6,29,11,0,"https://fbref.com/en/players/1bf33a9a/Christian-Pulisic"
"3270","Antonio Rüdiger_2020",2020,"Chelsea","Premier League","Antonio Rüdiger","GER","DF","26",1993,19,28,18,19,7,2,16,25,64,9,15,9,6,16,44,59,1,"https://fbref.com/en/players/18b896d6/Antonio-Rudiger"
"3271","Fikayo Tomori_2020",2020,"Chelsea","Premier League","Fikayo Tomori","ENG","DF","21",1997,14.3,29,16,21,8,0,10,15,66.7,5,13,7,6,22,51,48,2,"https://fbref.com/en/players/7edfbb8a/Fikayo-Tomori"
"3272","Willian_2020",2020,"Chelsea","Premier League","Willian","BRA","FW,MF","30",1988,28.9,45,27,14,24,7,14,43,32.6,29,15,0,15,20,65,7,0,"https://fbref.com/en/players/8b9ebd03/Willian"
"3273","Kurt Zouma_2020",2020,"Chelsea","Premier League","Kurt Zouma","FRA","DF","24",1994,26,23,14,17,6,0,9,16,56.3,7,22,14,8,58,81,116,2,"https://fbref.com/en/players/ce4246f5/Kurt-Zouma"
"3274","Patrick van Aanholt_2020",2020,"Crystal Palace","Premier League","Patrick van Aanholt","NED","DF","28",1990,27.9,43,23,31,10,2,23,50,46,27,31,9,22,45,88,52,1,"https://fbref.com/en/players/5f09991f/Patrick-van-Aanholt"
"3275","Jordan Ayew_2020",2020,"Crystal Palace","Premier League","Jordan Ayew","GHA","FW","27",1991,35,48,30,10,22,16,17,49,34.7,32,29,4,25,15,63,21,0,"https://fbref.com/en/players/da052c14/Jordan-Ayew"
"3276","Christian Benteke_2020",2020,"Crystal Palace","Premier League","Christian Benteke","BEL","FW","28",1990,14,9,5,1,6,2,0,10,0,10,11,4,7,4,13,28,1,"https://fbref.com/en/players/ab070c55/Christian-Benteke"
"3277","Gary Cahill_2020",2020,"Crystal Palace","Premier League","Gary Cahill","ENG","DF","33",1985,24.1,15,8,11,4,0,7,15,46.7,8,34,25,9,18,33,114,1,"https://fbref.com/en/players/7914b9fe/Gary-Cahill"
"3278","Víctor Camarasa_2020",2020,"Crystal Palace","Premier League","Víctor Camarasa","ESP","FW","25",1994,0.1,0,0,0,0,0,0,0,NA,0,0,0,0,0,0,0,0,"https://fbref.com/en/players/b2d03887/Victor-Camarasa"
"3279","Scott Dann_2020",2020,"Crystal Palace","Premier League","Scott Dann","ENG","DF","32",1987,14.1,8,4,7,1,0,8,14,57.1,6,9,7,2,14,22,67,0,"https://fbref.com/en/players/52105203/Scott-Dann"
"3280","Vicente Guaita_2020",2020,"Crystal Palace","Premier League","Vicente Guaita","ESP","GK","32",1987,35,1,1,1,0,0,1,2,50,1,0,0,0,0,1,18,3,"https://fbref.com/en/players/ab13a5aa/Vicente-Guaita"
"3281","Wayne Hennessey_2020",2020,"Crystal Palace","Premier League","Wayne Hennessey","WAL","GK","32",1987,3,0,0,0,0,0,0,0,NA,0,0,0,0,1,1,3,1,"https://fbref.com/en/players/76eca7e2/Wayne-Hennessey"
"3282","Martin Kelly_2020",2020,"Crystal Palace","Premier League","Martin Kelly","ENG","DF","29",1990,17.2,23,18,19,4,0,14,31,45.2,17,18,10,8,16,39,86,1,"https://fbref.com/en/players/d7492450/Martin-Kelly"
"3283","Cheikhou Kouyaté_2020",2020,"Crystal Palace","Premier League","Cheikhou Kouyaté","SEN","MF,DF","29",1989,28.1,67,32,43,20,4,26,48,54.2,22,35,11,24,43,110,58,1,"https://fbref.com/en/players/8d3c902d/Cheikhou-Kouyate"
"3284","James McArthur_2020",2020,"Crystal Palace","Premier League","James McArthur","SCO","MF","31",1987,34.3,88,51,43,34,11,37,106,34.9,69,69,19,50,60,148,56,0,"https://fbref.com/en/players/cee31595/James-McArthur"
"3285","James McCarthy_2020",2020,"Crystal Palace","Premier League","James McCarthy","IRL","MF","28",1990,18.7,82,47,36,36,10,40,76,52.6,36,24,5,19,24,106,11,0,"https://fbref.com/en/players/64b08de7/James-McCarthy"
"3286","Max Meyer_2020",2020,"Crystal Palace","Premier League","Max Meyer","GER","MF,FW","23",1995,7.3,19,11,10,9,0,8,18,44.4,10,6,1,5,7,26,4,0,"https://fbref.com/en/players/eba42d2b/Max-Meyer"
"3287","Luka Milivojević_2020",2020,"Crystal Palace","Premier League","Luka Milivojević","SRB","MF","28",1991,27.9,61,32,32,25,4,35,84,41.7,49,30,7,23,42,103,39,4,"https://fbref.com/en/players/2ce2508a/Luka-Milivojevic"
"3288","Tyrick Mitchell_2020",2020,"Crystal Palace","Premier League","Tyrick Mitchell","ENG","DF","19",1999,2.2,5,2,2,2,1,1,7,14.3,6,2,0,2,2,7,3,0,"https://fbref.com/en/players/5cbd1eb0/Tyrick-Mitchell"
"3289","Brandon Pierrick_2020",2020,"Crystal Palace","Premier League","Brandon Pierrick","ENG","MF,FW","17",2001,0.2,0,0,0,0,0,0,0,NA,0,0,0,0,0,0,1,0,"https://fbref.com/en/players/9a526299/Brandon-Pierrick"
"3290","Jaïro Riedewald_2020",2020,"Crystal Palace","Premier League","Jaïro Riedewald","NED","DF,MF","22",1996,8.5,14,10,4,10,0,7,11,63.6,4,7,2,5,17,31,23,1,"https://fbref.com/en/players/7a1f2c08/Jairo-Riedewald"
"3291","Mamadou Sakho_2020",2020,"Crystal Palace","Premier League","Mamadou Sakho","FRA","DF","29",1990,10.3,7,5,5,1,1,2,5,40,3,12,5,7,20,27,46,2,"https://fbref.com/en/players/87935cf3/Mamadou-Sakho"
"3292","Jeffrey Schlupp_2020",2020,"Crystal Palace","Premier League","Jeffrey Schlupp","GHA","FW,MF","26",1992,11.5,18,9,10,7,1,6,16,37.5,10,11,3,8,13,31,15,0,"https://fbref.com/en/players/3312f911/Jeffrey-Schlupp"
"3293","James Tomkins_2020",2020,"Crystal Palace","Premier League","James Tomkins","ENG","DF","30",1989,17.6,29,17,21,8,0,18,25,72,7,17,15,2,21,50,103,0,"https://fbref.com/en/players/e7ca0439/James-Tomkins"
"3294","Cenk Tosun_2020",2020,"Crystal Palace","Premier League","Cenk Tosun","TUR","FW","28",1991,2,2,2,2,0,0,0,2,0,2,0,0,0,0,2,1,0,"https://fbref.com/en/players/9a104dee/Cenk-Tosun"
"3295","Andros Townsend_2020",2020,"Crystal Palace","Premier League","Andros Townsend","ENG","FW,MF","28",1991,14.4,34,21,12,17,5,15,37,40.5,22,18,0,18,15,49,10,1,"https://fbref.com/en/players/b28bbd58/Andros-Townsend"
"3296","Joel Ward_2020",2020,"Crystal Palace","Premier League","Joel Ward","ENG","DF","29",1989,26.5,69,42,48,16,5,39,56,69.6,17,13,6,7,48,117,93,1,"https://fbref.com/en/players/8a7ff278/Joel-Ward"
"3297","Connor Wickham_2020",2020,"Crystal Palace","Premier League","Connor Wickham","ENG","FW,MF","26",1993,1.1,1,1,1,0,0,0,0,NA,0,1,0,1,1,2,0,0,"https://fbref.com/en/players/41cc19c2/Connor-Wickham"
"3298","Wilfried Zaha_2020",2020,"Crystal Palace","Premier League","Wilfried Zaha","CIV","FW,MF","26",1992,36.4,43,19,18,12,13,12,49,24.5,37,22,2,20,18,61,4,0,"https://fbref.com/en/players/b2bc3b1f/Wilfried-Zaha"
"3299","Nayef Aguerd_2020",2020,"Dijon","Ligue 1","Nayef Aguerd","MAR","DF","23",1996,10.6,13,9,7,5,1,8,12,66.7,4,11,11,0,18,31,54,0,"https://fbref.com/en/players/288e1e13/Nayef-Aguerd"
"3300","Rúnar Alex Rúnarsson_2020",2020,"Dijon","Ligue 1","Rúnar Alex Rúnarsson","ISL","GK","24",1995,10,0,0,0,0,0,0,2,0,2,0,0,0,0,0,3,3,"https://fbref.com/en/players/8fa8f8d2/Runar-Alex-Runarsson"
"3301","Mickaël Alphonse_2020",2020,"Dijon","Ligue 1","Mickaël Alphonse","GLP","DF","30",1989,15.3,39,25,26,12,1,23,37,62.2,14,19,3,16,17,56,64,0,"https://fbref.com/en/players/0a63446f/Mickael-Alphonse"
"3302","Romain Amalfitano_2020",2020,"Dijon","Ligue 1","Romain Amalfitano","FRA","MF","29",1989,18.8,43,27,18,21,4,21,61,34.4,40,23,9,14,36,79,14,2,"https://fbref.com/en/players/d7bf3d19/Romain-Amalfitano"
"3303","Florent Balmont_2020",2020,"Dijon","Ligue 1","Florent Balmont","FRA","MF","39",1980,4.5,12,6,5,7,0,7,12,58.3,5,6,0,6,1,13,3,0,"https://fbref.com/en/players/4e7bfc23/Florent-Balmont"
"3304","Yassine Benzia_2020",2020,"Dijon","Ligue 1","Yassine Benzia","ALG","MF","24",1994,1.9,3,2,2,1,0,1,6,16.7,5,4,2,2,3,6,1,0,"https://fbref.com/en/players/6fbde63a/Yassine-Benzia"
"3305","Jhonder Cádiz_2020",2020,"Dijon","Ligue 1","Jhonder Cádiz","VEN","FW,MF","24",1995,8.9,16,8,6,7,3,3,7,42.9,4,4,2,2,1,17,9,0,"https://fbref.com/en/players/e8edfdc9/Jhonder-Cadiz"
"3306","Fouad Chafik_2020",2020,"Dijon","Ligue 1","Fouad Chafik","MAR","DF","32",1986,17,32,21,22,7,3,17,36,47.2,19,12,5,7,26,58,36,0,"https://fbref.com/en/players/edd1466a/Fouad-Chafik"
"3307","Mounir Chouiar_2020",2020,"Dijon","Ligue 1","Mounir Chouiar","FRA","MF,FW","20",1999,16.7,36,23,13,18,5,12,42,28.6,30,8,0,8,13,49,13,0,"https://fbref.com/en/players/45c1c326/Mounir-Chouiar"
"3308","Senou Coulibaly_2020",2020,"Dijon","Ligue 1","Senou Coulibaly","MLI","DF","24",1994,7.4,14,7,11,3,0,2,4,50,2,11,10,1,10,24,44,1,"https://fbref.com/en/players/67b7357e/Senou-Coulibaly"
"3309","Bruno Ecuele Manga_2020",2020,"Dijon","Ligue 1","Bruno Ecuele Manga","GAB","DF","31",1988,28,22,15,17,5,0,9,20,45,11,34,23,11,37,59,112,2,"https://fbref.com/en/players/72a0fb65/Bruno-Ecuele-Manga"
"3310","Alfred Gomis_2020",2020,"Dijon","Ligue 1","Alfred Gomis","SEN","GK","25",1993,18,1,0,1,0,0,1,2,50,1,2,0,2,0,1,14,2,"https://fbref.com/en/players/cecbce23/Alfred-Gomis"
"3311","Didier Ibrahim Ndong_2020",2020,"Dijon","Ligue 1","Didier Ibrahim Ndong","GAB","MF","25",1994,26.5,62,35,30,31,1,30,59,50.8,29,27,6,21,49,111,31,0,"https://fbref.com/en/players/885b7aa7/Didier-Ibrahim-Ndong"
"3312","Benjamin Jeannot_2020",2020,"Dijon","Ligue 1","Benjamin Jeannot","FRA","MF,FW","27",1992,1.9,2,1,0,1,1,0,4,0,4,2,0,2,2,4,4,0,"https://fbref.com/en/players/2e52206e/Benjamin-Jeannot"
"3313","Jules Keita_2020",2020,"Dijon","Ligue 1","Jules Keita","GUI","MF,FW","21",1998,1.8,4,3,2,1,1,1,6,16.7,5,1,0,1,3,7,0,0,"https://fbref.com/en/players/8c955557/Jules-Keita"
"3314","Wesley Lautoa_2020",2020,"Dijon","Ligue 1","Wesley Lautoa","NCL","MF,DF","31",1987,20.8,54,29,24,28,2,28,63,44.4,35,31,16,15,42,96,48,2,"https://fbref.com/en/players/6e5b5a45/Wesley-Lautoa"
"3315","Enzo Loiodice_2020",2020,"Dijon","Ligue 1","Enzo Loiodice","FRA","MF","18",2000,2.1,6,4,1,4,1,1,3,33.3,2,2,0,2,2,8,1,0,"https://fbref.com/en/players/6bca20fe/Enzo-Loiodice"
"3316","Jordan Marié_2020",2020,"Dijon","Ligue 1","Jordan Marié","FRA","MF,FW","27",1991,2.2,7,5,4,3,0,4,9,44.4,5,3,1,2,4,11,2,0,"https://fbref.com/en/players/0d2158d5/Jordan-Marie"
"3317","Stephy Mavididi_2020",2020,"Dijon","Ligue 1","Stephy Mavididi","ENG","FW,MF","21",1998,15.5,18,11,7,8,3,10,26,38.5,16,11,0,11,7,25,5,0,"https://fbref.com/en/players/30144daa/Stephy-Mavididi"
"3318","Hamza Mendyl_2020",2020,"Dijon","Ligue 1","Hamza Mendyl","MAR","DF","21",1997,16,49,32,31,14,4,29,46,63,17,16,4,12,23,72,47,0,"https://fbref.com/en/players/f99fe221/Hamza-Mendyl"
"3319","Muzinga Ngonda_2020",2020,"Dijon","Ligue 1","Muzinga Ngonda","COD","DF","24",1994,6,15,6,10,3,2,7,10,70,3,5,4,1,11,26,23,0,"https://fbref.com/en/players/b748968d/Muzinga-Ngonda"
"3320","Ahmad Ngouyamsa_2020",2020,"Dijon","Ligue 1","Ahmad Ngouyamsa","CMR","DF","18",2000,0.6,1,0,1,0,0,0,3,0,3,1,1,0,1,2,5,0,"https://fbref.com/en/players/8413ceb1/Ahmad-Ngouyamsa"
"3321","Rayan Philippe_2020",2020,"Dijon","Ligue 1","Rayan Philippe","FRA","FW","18",2000,0.3,0,0,0,0,0,0,1,0,1,0,0,0,1,1,1,1,"https://fbref.com/en/players/a046fc35/Rayan-Philippe"
"3322","Mama Samba Baldé_2020",2020,"Dijon","Ligue 1","Mama Samba Baldé","GNB","FW,MF","23",1995,18.6,24,13,9,8,7,7,30,23.3,23,17,0,17,7,31,24,0,"https://fbref.com/en/players/fb14aa28/Mama-Samba-Balde"
"3323","Frédéric Sammaritano_2020",2020,"Dijon","Ligue 1","Frédéric Sammaritano","FRA","MF,FW","33",1986,5.8,9,7,4,4,1,4,11,36.4,7,6,1,5,2,11,3,1,"https://fbref.com/en/players/8802c1d5/Frederic-Sammaritano"
"3324","Matheus Pereira da Silva_2020",2020,"Dijon","Ligue 1","Matheus Pereira da Silva","BRA","MF,FW","21",1998,5.2,10,6,1,6,3,4,10,40,6,11,0,11,6,16,5,0,"https://fbref.com/en/players/bef22bc4/Matheus-Pereira-da-Silva"
"3325","Bryan Soumaré_2020",2020,"Dijon","Ligue 1","Bryan Soumaré","FRA","MF,FW","20",1999,4.3,12,1,6,5,1,6,9,66.7,3,1,0,1,2,14,1,0,"https://fbref.com/en/players/85e2d218/Bryan-Soumare"
"3326","Júlio Tavares_2020",2020,"Dijon","Ligue 1","Júlio Tavares","CPV","FW","30",1988,22.2,12,8,1,6,5,4,17,23.5,13,9,2,7,8,20,29,0,"https://fbref.com/en/players/d520120b/Julio-Tavares"
"3327","Manuel Akanji_2020",2020,"Dortmund","Bundesliga","Manuel Akanji","SUI","DF","24",1995,25.7,38,21,23,14,1,12,20,60,8,20,11,9,30,68,61,2,"https://fbref.com/en/players/89ac64a6/Manuel-Akanji"
"3328","Paco Alcácer_2020",2020,"Dortmund","Bundesliga","Paco Alcácer","ESP","FW","25",1993,5.9,2,2,0,2,0,1,5,20,4,4,1,3,2,4,3,0,"https://fbref.com/en/players/a7a9d95a/Paco-Alcacer"
"3329","Leonardo Balerdi_2020",2020,"Dortmund","Bundesliga","Leonardo Balerdi","ARG","DF,MF","20",1999,1.5,2,1,1,1,0,2,2,100,0,0,0,0,4,6,3,0,"https://fbref.com/en/players/7c3ed041/Leonardo-Balerdi"
"3330","Julian Brandt_2020",2020,"Dortmund","Bundesliga","Julian Brandt","GER","MF,FW","23",1996,24.5,48,33,15,21,12,25,55,45.5,30,35,2,33,16,64,10,1,"https://fbref.com/en/players/a167537f/Julian-Brandt"
"3331","Jacob Bruun Larsen_2020",2020,"Dortmund","Bundesliga","Jacob Bruun Larsen","DEN","FW","20",1998,0.8,0,0,0,0,0,0,0,NA,0,0,0,0,0,0,0,0,"https://fbref.com/en/players/4e204552/Jacob-Bruun-Larsen"
"3332","Roman Bürki_2020",2020,"Dortmund","Bundesliga","Roman Bürki","SUI","GK","28",1990,30.8,2,2,2,0,0,2,3,66.7,1,1,0,1,2,4,13,1,"https://fbref.com/en/players/9d12e142/Roman-Burki"
"3333","Emre Can_2020",2020,"Dortmund","Bundesliga","Emre Can","GER","MF,DF","25",1994,10.6,19,12,11,7,1,5,12,41.7,7,14,6,8,19,38,15,0,"https://fbref.com/en/players/a65ce836/Emre-Can"
"3334","Mahmoud Dahoud_2020",2020,"Dortmund","Bundesliga","Mahmoud Dahoud","GER","MF","23",1996,6.2,10,6,4,4,2,6,18,33.3,12,8,2,6,8,18,4,0,"https://fbref.com/en/players/db4ed67b/Mahmoud-Dahoud"
"3335","Thomas Delaney_2020",2020,"Dortmund","Bundesliga","Thomas Delaney","DEN","MF","27",1991,9.2,22,10,10,11,1,9,15,60,6,16,7,9,26,48,26,0,"https://fbref.com/en/players/fe641c1a/Thomas-Delaney"
"3336","Mario Götze_2020",2020,"Dortmund","Bundesliga","Mario Götze","GER","FW","27",1992,5.8,10,7,0,6,4,3,12,25,9,3,0,3,2,12,1,0,"https://fbref.com/en/players/9efa1d25/Mario-Gotze"
"3337","Raphaël Guerreiro_2020",2020,"Dortmund","Bundesliga","Raphaël Guerreiro","POR","DF,MF","25",1993,25.9,44,24,18,21,5,20,32,62.5,12,27,3,24,42,86,26,0,"https://fbref.com/en/players/048a1cbc/Raphael-Guerreiro"
"3338","Erling Haaland_2020",2020,"Dortmund","Bundesliga","Erling Haaland","NOR","FW","19",2000,11.8,4,2,1,0,3,0,4,0,4,7,4,3,4,8,4,0,"https://fbref.com/en/players/1f44ac21/Erling-Haaland"
"3339","Achraf Hakimi_2020",2020,"Dortmund","Bundesliga","Achraf Hakimi","MAR","DF,MF","20",1998,30.2,60,41,38,14,8,27,64,42.2,37,26,2,24,30,90,27,2,"https://fbref.com/en/players/e42d61c7/Achraf-Hakimi"
"3340","Thorgan Hazard_2020",2020,"Dortmund","Bundesliga","Thorgan Hazard","BEL","FW,MF","26",1993,26.4,40,27,17,14,9,12,50,24,38,29,0,29,13,53,2,1,"https://fbref.com/en/players/50871bcc/Thorgan-Hazard"
"3341","Marwin Hitz_2020",2020,"Dortmund","Bundesliga","Marwin Hitz","SUI","GK","31",1987,3.2,0,0,0,0,0,0,0,NA,0,0,0,0,0,0,0,0,"https://fbref.com/en/players/2e7ff968/Marwin-Hitz"
"3342","Mats Hummels_2020",2020,"Dortmund","Bundesliga","Mats Hummels","GER","DF","30",1988,28.7,57,30,30,26,1,20,38,52.6,18,41,18,23,59,116,110,1,"https://fbref.com/en/players/05d548d8/Mats-Hummels"
"3343","Mateu Morey_2020",2020,"Dortmund","Bundesliga","Mateu Morey","ESP","DF,MF","19",2000,2.2,7,3,2,4,1,4,10,40,6,4,0,4,5,12,3,0,"https://fbref.com/en/players/5fd5e542/Mateu-Morey"
"3344","Łukasz Piszczek_2020",2020,"Dortmund","Bundesliga","Łukasz Piszczek","POL","DF","34",1985,23.4,45,32,27,16,2,28,50,56,22,27,11,16,26,71,47,1,"https://fbref.com/en/players/fe2db476/Lukasz-Piszczek"
"3345","Tobias Raschl_2020",2020,"Dortmund","Bundesliga","Tobias Raschl","GER","MF","19",2000,0.3,0,0,0,0,0,0,1,0,1,1,0,1,0,0,0,0,"https://fbref.com/en/players/bd992863/Tobias-Raschl"
"3346","Marco Reus_2020",2020,"Dortmund","Bundesliga","Marco Reus","GER","MF,FW","30",1989,16.6,26,16,5,11,10,3,19,15.8,16,17,2,15,9,35,11,0,"https://fbref.com/en/players/36a3ff67/Marco-Reus"
"3347","Gio Reyna_2020",2020,"Dortmund","Bundesliga","Gio Reyna","USA","MF,FW","16",2002,3.9,6,2,1,5,0,1,4,25,3,3,0,3,0,6,2,0,"https://fbref.com/en/players/7fa4e703/Gio-Reyna"
"3348","Jadon Sancho_2020",2020,"Dortmund","Bundesliga","Jadon Sancho","ENG","FW,MF","19",2000,25.4,14,11,6,6,2,8,24,33.3,16,8,0,8,14,28,6,0,"https://fbref.com/en/players/dbf053da/Jadon-Sancho"
"3349","Marcel Schmelzer_2020",2020,"Dortmund","Bundesliga","Marcel Schmelzer","GER","DF","31",1988,0.7,2,1,1,1,0,1,1,100,0,0,0,0,1,3,2,0,"https://fbref.com/en/players/89565ac5/Marcel-Schmelzer"
"3350","Nico Schulz_2020",2020,"Dortmund","Bundesliga","Nico Schulz","GER","DF,MF","26",1993,6.6,11,7,3,6,2,8,13,61.5,5,14,4,10,9,20,9,0,"https://fbref.com/en/players/fa274d97/Nico-Schulz"
"3351","Julian Weigl_2020",2020,"Dortmund","Bundesliga","Julian Weigl","GER","MF,DF","23",1995,11.3,16,9,12,3,1,9,16,56.3,7,10,0,10,8,24,21,0,"https://fbref.com/en/players/346d51d9/Julian-Weigl"
"3352","Axel Witsel_2020",2020,"Dortmund","Bundesliga","Axel Witsel","BEL","MF","30",1989,24.9,28,20,10,17,1,14,33,42.4,19,26,7,19,31,59,19,1,"https://fbref.com/en/players/5dfc6ad5/Axel-Witsel"
"3353","Dan-Axel Zagadou_2020",2020,"Dortmund","Bundesliga","Dan-Axel Zagadou","FRA","DF","20",1999,10.9,16,10,12,4,0,6,8,75,2,12,8,4,15,31,38,0,"https://fbref.com/en/players/a4effc55/Dan-Axel-Zagadou"
"3354","Opoku Ampomah_2020",2020,"Düsseldorf","Bundesliga","Opoku Ampomah","GHA","FW,MF","23",1996,5.6,9,4,3,4,2,3,12,25,9,3,0,3,4,13,5,0,"https://fbref.com/en/players/e7199efb/Opoku-Ampomah"
"3355","Kaan Ayhan_2020",2020,"Düsseldorf","Bundesliga","Kaan Ayhan","TUR","DF","24",1994,30.3,38,25,26,11,1,20,37,54.1,17,28,15,13,45,83,72,1,"https://fbref.com/en/players/2200181e/Kaan-Ayhan"
"3356","Lewis Baker_2020",2020,"Düsseldorf","Bundesliga","Lewis Baker","ENG","MF","24",1995,6.1,8,5,6,2,0,2,10,20,8,5,2,3,2,10,5,0,"https://fbref.com/en/players/1b278bf5/Lewis-Baker"
"3357","Aymen Barkok_2020",2020,"Düsseldorf","Bundesliga","Aymen Barkok","MAR","FW,MF","21",1998,0.9,1,1,0,0,1,0,2,0,2,2,0,2,3,4,1,0,"https://fbref.com/en/players/a2a85828/Aymen-Barkok"
"3358","Valon Berisha_2020",2020,"Düsseldorf","Bundesliga","Valon Berisha","KVX","MF","26",1993,10.5,14,9,3,8,3,6,21,28.6,15,4,1,3,9,23,8,0,"https://fbref.com/en/players/d5575935/Valon-Berisha"
"3359","Adam Bodzek_2020",2020,"Düsseldorf","Bundesliga","Adam Bodzek","GER","MF","33",1985,22.4,42,26,21,20,1,14,46,30.4,32,34,11,23,25,67,39,0,"https://fbref.com/en/players/bb8a42fa/Adam-Bodzek"
"3360","Robin Bormuth_2020",2020,"Düsseldorf","Bundesliga","Robin Bormuth","GER","DF","23",1995,2,2,1,2,0,0,2,3,66.7,1,6,5,1,0,2,12,0,"https://fbref.com/en/players/d728acae/Robin-Bormuth"
"3361","Oliver Fink_2020",2020,"Düsseldorf","Bundesliga","Oliver Fink","GER","MF,FW","37",1982,7.5,21,12,7,11,3,5,16,31.3,11,12,1,11,15,36,7,0,"https://fbref.com/en/players/316162b6/Oliver-Fink"
"3362","Niko Gießelmann_2020",2020,"Düsseldorf","Bundesliga","Niko Gießelmann","GER","DF","27",1991,22.9,46,31,31,11,4,22,45,48.9,23,23,6,17,27,73,55,1,"https://fbref.com/en/players/7242b495/Niko-Giesselmann"
"3363","Rouwen Hennings_2020",2020,"Düsseldorf","Bundesliga","Rouwen Hennings","GER","FW","31",1987,27.3,11,5,2,7,2,3,18,16.7,15,12,0,12,2,13,33,0,"https://fbref.com/en/players/17611373/Rouwen-Hennings"
"3364","André Hoffmann_2020",2020,"Düsseldorf","Bundesliga","André Hoffmann","GER","DF","26",1993,27,48,22,30,18,0,16,50,32,34,22,9,13,56,104,90,0,"https://fbref.com/en/players/34b306a1/Andre-Hoffmann"
"3365","Mathias Jørgensen_2020",2020,"Düsseldorf","Bundesliga","Mathias Jørgensen","DEN","DF","29",1990,5.5,4,3,3,1,0,2,4,50,2,7,3,4,13,17,33,0,"https://fbref.com/en/players/0db5d2c8/Mathias-Jorgensen"
"3366","Kenan Karaman_2020",2020,"Düsseldorf","Bundesliga","Kenan Karaman","TUR","FW,MF","25",1994,15,11,5,2,5,4,4,9,44.4,5,9,4,5,2,13,7,0,"https://fbref.com/en/players/8f0f2230/Kenan-Karaman"
"3367","Florian Kastenmeier_2020",2020,"Düsseldorf","Bundesliga","Florian Kastenmeier","GER","GK","22",1997,17,1,1,1,0,0,0,0,NA,0,0,0,0,2,3,3,1,"https://fbref.com/en/players/dc2e4736/Florian-Kastenmeier"
"3368","Dawid Kownacki_2020",2020,"Düsseldorf","Bundesliga","Dawid Kownacki","POL","FW,MF","22",1997,12.1,13,8,5,7,1,9,20,45,11,13,2,11,6,19,8,0,"https://fbref.com/en/players/be5e1c4c/Dawid-Kownacki"
"3369","Alfredo Morales_2020",2020,"Düsseldorf","Bundesliga","Alfredo Morales","USA","MF","29",1990,19.2,31,15,11,16,4,11,35,31.4,24,17,6,11,18,49,37,0,"https://fbref.com/en/players/ff45add5/Alfredo-Morales"
"3370","Kasim Nuhu_2020",2020,"Düsseldorf","Bundesliga","Kasim Nuhu","GHA","DF","24",1995,11.1,14,7,12,1,1,9,19,47.4,10,16,12,4,25,39,54,0,"https://fbref.com/en/players/93a50d2c/Kasim-Nuhu"
"3371","Kelvin Ofori_2020",2020,"Düsseldorf","Bundesliga","Kelvin Ofori","GHA","MF","18",2001,0.4,0,0,0,0,0,0,0,NA,0,0,0,0,0,0,0,0,"https://fbref.com/en/players/1151fb6e/Kelvin-Ofori"
"3372","Thomas Pledl_2020",2020,"Düsseldorf","Bundesliga","Thomas Pledl","GER","MF,FW","25",1994,1,4,2,2,2,0,0,1,0,1,0,0,0,0,4,1,0,"https://fbref.com/en/players/1748c9f7/Thomas-Pledl"
"3373","Steven Skrzybski_2020",2020,"Düsseldorf","Bundesliga","Steven Skrzybski","GER","FW,MF","26",1992,5.9,4,4,2,1,1,0,16,0,16,10,0,10,10,14,4,0,"https://fbref.com/en/players/58ce23e5/Steven-Skrzybski"
"3374","Marcel Sobottka_2020",2020,"Düsseldorf","Bundesliga","Marcel Sobottka","GER","MF","25",1994,7.8,15,10,6,8,1,4,13,30.8,9,9,1,8,9,24,12,0,"https://fbref.com/en/players/664590fa/Marcel-Sobottka"
"3375","Zack Steffen_2020",2020,"Düsseldorf","Bundesliga","Zack Steffen","USA","GK","24",1995,17,0,0,0,0,0,0,0,NA,0,0,0,0,0,0,5,4,"https://fbref.com/en/players/42130443/Zack-Steffen"
"3376","Kevin Stöger_2020",2020,"Düsseldorf","Bundesliga","Kevin Stöger","AUT","MF","25",1993,14.1,21,15,10,7,4,6,24,25,18,24,2,22,26,47,7,1,"https://fbref.com/en/players/e5649a78/Kevin-Stoger"
"3377","Markus Suttner_2020",2020,"Düsseldorf","Bundesliga","Markus Suttner","AUT","DF","32",1987,14.9,21,16,11,9,1,11,24,45.8,13,22,7,15,13,34,33,0,"https://fbref.com/en/players/7391c2d9/Markus-Suttner"
"3378","Bernard Tekpetey_2020",2020,"Düsseldorf","Bundesliga","Bernard Tekpetey","GHA","FW,MF","21",1997,5,4,4,1,2,1,0,2,0,2,5,0,5,2,6,0,0,"https://fbref.com/en/players/7bf8ad6c/Bernard-Tekpetey"
"3379","Erik Thommy_2020",2020,"Düsseldorf","Bundesliga","Erik Thommy","GER","MF,FW","24",1994,25.1,40,23,16,16,8,15,39,38.5,24,23,2,21,16,56,20,1,"https://fbref.com/en/players/df8e7b62/Erik-Thommy"
"3380","Jean Zimmer_2020",2020,"Düsseldorf","Bundesliga","Jean Zimmer","GER","DF,FW","25",1993,8,11,6,5,5,1,5,10,50,5,3,1,2,3,14,0,0,"https://fbref.com/en/players/912e63b5/Jean-Zimmer"
"3381","Matthias Zimmermann_2020",2020,"Düsseldorf","Bundesliga","Matthias Zimmermann","GER","DF,MF","27",1992,32.5,62,47,26,27,9,31,64,48.4,33,41,15,26,43,105,59,0,"https://fbref.com/en/players/e199d5b0/Matthias-Zimmermann"
"3382","Sergio Álvarez_2020",2020,"Eibar","La Liga","Sergio Álvarez","ESP","MF,DF","27",1992,12.7,37,22,11,24,2,8,24,33.3,16,16,2,14,17,54,26,1,"https://fbref.com/en/players/88d91621/Sergio-Alvarez"
"3383","José Ángel_2020",2020,"Eibar","La Liga","José Ángel","ESP","DF","29",1989,26.2,54,31,26,25,3,26,43,60.5,17,23,7,16,33,87,61,1,"https://fbref.com/en/players/3024e383/Jose-Angel"
"3384","Anaitz Arbilla_2020",2020,"Eibar","La Liga","Anaitz Arbilla","ESP","DF","32",1987,22.3,33,20,23,8,2,16,34,47.1,18,20,4,16,29,62,82,0,"https://fbref.com/en/players/850c0a0d/Anaitz-Arbilla"
"3385","Miguel Atienza_2020",2020,"Eibar","La Liga","Miguel Atienza","ESP","MF","20",1999,0.3,1,1,0,1,0,1,2,50,1,1,1,0,2,3,1,0,"https://fbref.com/en/players/12eda7be/Miguel-Atienza"
"3386","Pedro Bigas_2020",2020,"Eibar","La Liga","Pedro Bigas","ESP","DF","28",1990,19.7,18,9,11,7,0,9,19,47.4,10,16,10,6,36,54,82,0,"https://fbref.com/en/players/697295b1/Pedro-Bigas"
"3387","Pablo de Blasis_2020",2020,"Eibar","La Liga","Pablo de Blasis","ARG","DF,MF","31",1988,17.8,41,32,22,13,6,30,63,47.6,33,13,0,13,24,65,21,0,"https://fbref.com/en/players/9ab48bde/Pablo-de-Blasis"
"3388","Esteban Burgos_2020",2020,"Eibar","La Liga","Esteban Burgos","ARG","DF","27",1992,12.4,11,9,9,2,0,5,9,55.6,4,11,6,5,17,28,66,2,"https://fbref.com/en/players/40449bbd/Esteban-Burgos"
"3389","Charles_2020",2020,"Eibar","La Liga","Charles","BRA","FW","35",1984,14.5,10,5,0,6,4,4,22,18.2,18,7,2,5,7,17,6,0,"https://fbref.com/en/players/c4b8bcf4/Charles"
"3390","Rober Correa_2020",2020,"Eibar","La Liga","Rober Correa","ESP","DF","26",1992,10.3,13,6,8,3,2,6,10,60,4,6,4,2,16,29,31,0,"https://fbref.com/en/players/46bd3a5b/Rober-Correa"
"3391","Sebastián Cristóforo_2020",2020,"Eibar","La Liga","Sebastián Cristóforo","URU","MF","25",1993,9.7,35,19,11,14,10,13,32,40.6,19,25,3,22,8,43,2,0,"https://fbref.com/en/players/3c05c659/Sebastian-Cristoforo"
"3392","Papakouli Diop_2020",2020,"Eibar","La Liga","Papakouli Diop","SEN","MF","33",1986,25,39,26,13,22,4,18,42,42.9,24,24,7,17,34,73,38,0,"https://fbref.com/en/players/7329018e/Papakouli-Diop"
"3393","Marko Dmitrović_2020",2020,"Eibar","La Liga","Marko Dmitrović","SRB","GK","27",1992,35,3,2,3,0,0,3,5,60,2,1,0,1,3,6,24,0,"https://fbref.com/en/players/ac295d9e/Marko-Dmitrovic"
"3394","Sergi Enrich_2020",2020,"Eibar","La Liga","Sergi Enrich","ESP","FW","29",1990,20.7,17,6,4,8,5,4,21,19,17,16,2,14,9,26,12,0,"https://fbref.com/en/players/bb4b1242/Sergi-Enrich"
"3395","Gonzalo Escalante_2020",2020,"Eibar","La Liga","Gonzalo Escalante","ARG","MF","26",1993,18.6,41,22,15,17,9,24,41,58.5,17,22,4,18,29,70,14,0,"https://fbref.com/en/players/3f79a1c8/Gonzalo-Escalante"
"3396","Edu Expósito_2020",2020,"Eibar","La Liga","Edu Expósito","ESP","MF","22",1996,25.7,52,28,12,31,9,18,49,36.7,31,20,6,14,31,83,18,1,"https://fbref.com/en/players/283c7121/Edu-Exposito"
"3397","Takashi Inui_2020",2020,"Eibar","La Liga","Takashi Inui","JPN","MF,FW","31",1988,21.8,20,10,7,8,5,11,34,32.4,23,23,4,19,18,38,12,0,"https://fbref.com/en/players/61bd33d0/Takashi-Inui"
"3398","Kike_2020",2020,"Eibar","La Liga","Kike","ESP","FW","29",1989,19.6,13,7,0,5,8,4,12,33.3,8,15,1,14,1,14,9,0,"https://fbref.com/en/players/e897d8ba/Kike"
"3399","Pedro León_2020",2020,"Eibar","La Liga","Pedro León","ESP","MF,FW","32",1986,21.1,28,20,8,9,11,12,25,48,13,18,1,17,19,47,7,0,"https://fbref.com/en/players/d66b9872/Pedro-Leon"
"3400","Miguel Marí_2020",2020,"Eibar","La Liga","Miguel Marí","ESP","MF","22",1997,0.1,0,0,0,0,0,0,0,NA,0,0,0,0,0,0,0,0,"https://fbref.com/en/players/d70a3661/Miguel-Mari"
"3401","Paulo Oliveira_2020",2020,"Eibar","La Liga","Paulo Oliveira","POR","DF","27",1992,23.2,31,19,22,8,1,18,30,60,12,23,13,10,42,73,107,1,"https://fbref.com/en/players/a8fbae1d/Paulo-Oliveira"
"3402","Fabián Orellana_2020",2020,"Eibar","La Liga","Fabián Orellana","CHI","MF,FW","33",1986,26.6,29,18,10,6,13,14,52,26.9,38,9,0,9,20,49,2,0,"https://fbref.com/en/players/c90977db/Fabian-Orellana"
"3403","Quique_2020",2020,"Eibar","La Liga","Quique","ESP","FW,MF","29",1990,5.4,2,1,1,0,1,0,0,NA,0,3,0,3,0,2,3,0,"https://fbref.com/en/players/c966fce1/Quique"
"3404","Iván Ramis_2020",2020,"Eibar","La Liga","Iván Ramis","ESP","DF","34",1984,5.1,3,2,2,1,0,1,4,25,3,2,0,2,4,7,23,2,"https://fbref.com/en/players/d2be40f2/Ivan-Ramis"
"3405","Rafa Soares_2020",2020,"Eibar","La Liga","Rafa Soares","POR","DF","24",1995,4.8,6,5,5,0,1,5,11,45.5,6,1,0,1,2,8,6,0,"https://fbref.com/en/players/062fc2e6/Rafa-Soares"
"3406","Álvaro Tejero_2020",2020,"Eibar","La Liga","Álvaro Tejero","ESP","DF","23",1996,16.1,30,18,17,10,3,14,23,60.9,9,17,4,13,28,58,38,0,"https://fbref.com/en/players/868ce848/Alvaro-Tejero"
"3407","Yoel_2020",2020,"Eibar","La Liga","Yoel","ESP","GK","30",1988,3,0,0,0,0,0,0,0,NA,0,0,0,0,1,1,1,0,"https://fbref.com/en/players/61bb7498/Yoel"
"3408","David Abraham_2020",2020,"Eint Frankfurt","Bundesliga","David Abraham","ARG","DF","33",1986,18.8,21,14,16,4,1,15,32,46.9,17,27,11,16,25,46,61,1,"https://fbref.com/en/players/565bf0da/David-Abraham"
"3409","Timothy Chandler_2020",2020,"Eint Frankfurt","Bundesliga","Timothy Chandler","USA","DF,MF","29",1990,13.6,22,10,9,8,5,9,16,56.3,7,9,4,5,13,35,21,0,"https://fbref.com/en/players/b3b7f5a6/Timothy-Chandler"
"3410","Danny da Costa_2020",2020,"Eint Frankfurt","Bundesliga","Danny da Costa","GER","DF,FW","26",1993,15.4,26,17,14,8,4,6,16,37.5,10,16,1,15,15,41,26,0,"https://fbref.com/en/players/5ddb8f9f/Danny-da-Costa"
"3411","Bas Dost_2020",2020,"Eint Frankfurt","Bundesliga","Bas Dost","NED","FW","30",1989,16.4,11,7,1,7,3,3,7,42.9,4,6,2,4,5,16,22,0,"https://fbref.com/en/players/dc90cfbe/Bas-Dost"
"3412","Erik Durm_2020",2020,"Eint Frankfurt","Bundesliga","Erik Durm","GER","DF,FW","27",1992,5.7,13,6,9,2,2,9,17,52.9,8,11,2,9,3,16,11,0,"https://fbref.com/en/players/cf623c78/Erik-Durm"
"3413","Simon Falette_2020",2020,"Eint Frankfurt","Bundesliga","Simon Falette","GUI","DF","27",1992,1,0,0,0,0,0,0,1,0,1,3,3,0,3,3,5,0,"https://fbref.com/en/players/b82880c6/Simon-Falette"
"3414","Gelson Fernandes_2020",2020,"Eint Frankfurt","Bundesliga","Gelson Fernandes","SUI","MF","32",1986,8.6,30,18,13,17,0,7,21,33.3,14,11,3,8,16,46,9,2,"https://fbref.com/en/players/8e58987d/Gelson-Fernandes"
"3415","Mijat Gaćinović_2020",2020,"Eint Frankfurt","Bundesliga","Mijat Gaćinović","SRB","MF,FW","24",1995,11.6,19,11,7,8,4,6,25,24,19,26,2,24,15,34,6,0,"https://fbref.com/en/players/16daec92/Mijat-Gacinovic"
"3416","Jonathan de Guzmán_2020",2020,"Eint Frankfurt","Bundesliga","Jonathan de Guzmán","NED","MF","31",1987,1,1,1,0,1,0,1,7,14.3,6,2,0,2,1,2,0,0,"https://fbref.com/en/players/1bcca8b8/Jonathan-de-Guzman"
"3417","Makoto Hasebe_2020",2020,"Eint Frankfurt","Bundesliga","Makoto Hasebe","JPN","DF,MF","35",1984,21.9,28,20,16,9,3,18,39,46.2,21,38,10,28,26,54,38,0,"https://fbref.com/en/players/9ab16552/Makoto-Hasebe"
"3418","Martin Hinteregger_2020",2020,"Eint Frankfurt","Bundesliga","Martin Hinteregger","AUT","DF","26",1992,30.2,66,51,33,30,3,28,57,49.1,29,41,21,20,36,102,96,0,"https://fbref.com/en/players/080440a4/Martin-Hinteregger"
"3419","Stefan Ilsanker_2020",2020,"Eint Frankfurt","Bundesliga","Stefan Ilsanker","AUT","DF,MF","30",1989,9.3,23,15,16,7,0,10,23,43.5,13,8,1,7,19,42,26,0,"https://fbref.com/en/players/8494acc4/Stefan-Ilsanker"
"3420","Dejan Joveljić_2020",2020,"Eint Frankfurt","Bundesliga","Dejan Joveljić","SRB","FW","19",1999,1.7,2,2,1,1,0,0,1,0,1,0,0,0,0,2,1,0,"https://fbref.com/en/players/95a24690/Dejan-Joveljic"
"3421","Daichi Kamada_2020",2020,"Eint Frankfurt","Bundesliga","Daichi Kamada","JPN","MF,FW","22",1996,21.9,29,20,7,17,5,8,42,19,34,16,1,15,10,39,6,0,"https://fbref.com/en/players/15b287da/Daichi-Kamada"
"3422","Dominik Kohr_2020",2020,"Eint Frankfurt","Bundesliga","Dominik Kohr","GER","MF","25",1994,16.1,44,35,15,25,4,18,53,34,35,31,11,20,30,74,16,0,"https://fbref.com/en/players/0fbecd11/Dominik-Kohr"
"3423","Filip Kostić_2020",2020,"Eint Frankfurt","Bundesliga","Filip Kostić","SRB","DF,FW","26",1992,32.9,59,38,30,20,9,22,59,37.3,37,45,2,43,23,82,16,0,"https://fbref.com/en/players/b1cd37e6/Filip-Kostic"
"3424","Obite N'Dicka_2020",2020,"Eint Frankfurt","Bundesliga","Obite N'Dicka","FRA","DF","19",1999,19.1,27,13,13,11,3,15,28,53.6,13,28,6,22,29,56,57,0,"https://fbref.com/en/players/441197b8/Obite-NDicka"
"3425","Gonçalo Paciência_2020",2020,"Eint Frankfurt","Bundesliga","Gonçalo Paciência","POR","FW","24",1994,14.3,9,5,1,4,4,3,13,23.1,10,9,1,8,1,10,11,0,"https://fbref.com/en/players/962e54cb/Goncalo-Paciencia"
"3426","Ante Rebić_2020",2020,"Eint Frankfurt","Bundesliga","Ante Rebić","CRO","FW,MF","25",1993,1,1,0,0,1,0,0,0,NA,0,0,0,0,0,1,1,0,"https://fbref.com/en/players/536cebe5/Ante-Rebic"
"3427","Sebastian Rode_2020",2020,"Eint Frankfurt","Bundesliga","Sebastian Rode","GER","MF","28",1990,21.5,58,33,27,27,4,17,59,28.8,42,32,5,27,34,92,13,0,"https://fbref.com/en/players/e12b0b5b/Sebastian-Rode"
"3428","Frederik Rønnow_2020",2020,"Eint Frankfurt","Bundesliga","Frederik Rønnow","DEN","GK","26",1992,9,0,0,0,0,0,0,1,0,1,0,0,0,0,0,1,0,"https://fbref.com/en/players/a70b8345/Frederik-Ronnow"
"3429","André Silva_2020",2020,"Eint Frankfurt","Bundesliga","André Silva","POR","FW","23",1995,17.5,7,2,0,5,2,2,14,14.3,12,9,0,9,8,15,4,0,"https://fbref.com/en/players/3effaa34/Andre-Silva"
"3430","Djibril Sow_2020",2020,"Eint Frankfurt","Bundesliga","Djibril Sow","SUI","MF","22",1997,19.4,56,33,26,17,13,16,47,34,31,15,3,12,30,86,9,0,"https://fbref.com/en/players/4c6facae/Djibril-Sow"
"3431","Lucas Torró_2020",2020,"Eint Frankfurt","Bundesliga","Lucas Torró","ESP","MF","25",1994,3.7,12,7,6,6,0,8,16,50,8,2,1,1,8,20,3,0,"https://fbref.com/en/players/0e4fef6e/Lucas-Torro"
"3432","Almamy Touré_2020",2020,"Eint Frankfurt","Bundesliga","Almamy Touré","MLI","DF","23",1996,16.6,32,19,18,11,3,11,22,50,11,18,7,11,23,55,54,1,"https://fbref.com/en/players/c8c60119/Almamy-Toure"
"3433","Kevin Trapp_2020",2020,"Eint Frankfurt","Bundesliga","Kevin Trapp","GER","GK","29",1990,22,0,0,0,0,0,0,1,0,1,0,0,0,3,3,5,0,"https://fbref.com/en/players/ce17b5eb/Kevin-Trapp"
"3434","Felix Wiedwald_2020",2020,"Eint Frankfurt","Bundesliga","Felix Wiedwald","GER","GK","29",1990,3,0,0,0,0,0,0,0,NA,0,0,0,0,0,0,2,1,"https://fbref.com/en/players/e2d34771/Felix-Wiedwald"
"3435","Leandro Cabrera_2020",2020,"Espanyol","La Liga","Leandro Cabrera","URU","DF","28",1991,17,27,11,17,9,1,17,28,60.7,11,19,12,7,21,48,78,1,"https://fbref.com/en/players/69cbc8b6/Leandro-Cabrera"
"3436","Fernando Calero_2020",2020,"Espanyol","La Liga","Fernando Calero","ESP","DF","23",1995,11.6,14,9,10,4,0,7,15,46.7,8,13,5,8,8,22,42,1,"https://fbref.com/en/players/41b3069f/Fernando-Calero"
"3437","Jonathan Calleri_2020",2020,"Espanyol","La Liga","Jonathan Calleri","ARG","FW","25",1993,20.1,12,8,6,4,2,3,24,12.5,21,11,3,8,7,19,22,0,"https://fbref.com/en/players/6922f806/Jonathan-Calleri"
"3438","Víctor Campuzano_2020",2020,"Espanyol","La Liga","Víctor Campuzano","ESP","FW","22",1997,9.7,12,9,1,6,5,3,19,15.8,16,8,0,8,2,14,4,0,"https://fbref.com/en/players/06983922/Victor-Campuzano"
"3439","Sébastien Corchia_2020",2020,"Espanyol","La Liga","Sébastien Corchia","FRA","DF","28",1990,3,2,1,2,0,0,2,4,50,2,5,2,3,5,7,8,0,"https://fbref.com/en/players/0e7ccfc4/Sebastien-Corchia"
"3440","Sergi Darder_2020",2020,"Espanyol","La Liga","Sergi Darder","ESP","MF","25",1993,29.5,47,23,11,26,10,17,58,29.3,41,30,1,29,24,71,23,1,"https://fbref.com/en/players/070a3904/Sergi-Darder"
"3441","Adri Embarba_2020",2020,"Espanyol","La Liga","Adri Embarba","ESP","MF,FW","27",1992,15.2,37,22,16,16,5,16,33,48.5,17,28,4,24,16,53,11,0,"https://fbref.com/en/players/db8f0eba/Adri-Embarba"
"3442","Bernardo Espinosa_2020",2020,"Espanyol","La Liga","Bernardo Espinosa","COL","DF","30",1989,25.1,24,16,18,4,2,16,28,57.1,12,19,11,8,24,48,108,2,"https://fbref.com/en/players/4242011c/Bernardo-Espinosa"
"3443","Facundo Ferreyra_2020",2020,"Espanyol","La Liga","Facundo Ferreyra","ARG","FW,MF","28",1991,6.4,9,4,4,5,0,3,10,30,7,4,0,4,2,11,5,0,"https://fbref.com/en/players/b39a793e/Facundo-Ferreyra"
"3444","Esteban Granero_2020",2020,"Espanyol","La Liga","Esteban Granero","ESP","MF","32",1987,5.3,10,4,5,3,2,5,11,45.5,6,3,2,1,2,12,5,0,"https://fbref.com/en/players/1b17ed86/Esteban-Granero"
"3445","Ander Iturraspe_2020",2020,"Espanyol","La Liga","Ander Iturraspe","ESP","MF","30",1989,2.7,2,0,1,1,0,2,5,40,3,0,0,0,1,3,7,0,"https://fbref.com/en/players/6dce77a5/Ander-Iturraspe"
"3446","Wu Lei_2020",2020,"Espanyol","La Liga","Wu Lei","CHN","FW,MF","27",1991,19.1,13,8,5,6,2,4,38,10.5,34,32,1,31,15,28,19,1,"https://fbref.com/en/players/e3fabb0a/Wu-Lei"
"3447","David López_2020",2020,"Espanyol","La Liga","David López","ESP","DF,MF","29",1989,27.3,38,20,15,20,3,13,41,31.7,28,28,13,15,35,73,63,3,"https://fbref.com/en/players/f03f284b/David-Lopez"
"3448","Diego López_2020",2020,"Espanyol","La Liga","Diego López","ESP","GK","37",1981,35.9,2,2,2,0,0,1,2,50,1,0,0,0,2,4,8,1,"https://fbref.com/en/players/73683fa9/Diego-Lopez"
"3449","Javi López_2020",2020,"Espanyol","La Liga","Javi López","ESP","DF","33",1986,15.4,47,34,23,18,6,19,40,47.5,21,12,6,6,21,68,38,2,"https://fbref.com/en/players/ffad706e/Javi-Lopez"
"3450","Lluis López_2020",2020,"Espanyol","La Liga","Lluis López","ESP","DF","22",1997,3.3,4,2,3,1,0,2,2,100,0,4,0,4,1,5,6,1,"https://fbref.com/en/players/a685f013/Lluis-Lopez"
"3451","Pol Lozano_2020",2020,"Espanyol","La Liga","Pol Lozano","ESP","MF","19",1999,1.9,5,3,3,2,0,3,7,42.9,4,3,0,3,1,6,2,0,"https://fbref.com/en/players/ea610f00/Pol-Lozano"
"3452","Óscar Melendo_2020",2020,"Espanyol","La Liga","Óscar Melendo","ESP","MF,FW","21",1997,12.4,10,4,4,4,2,4,12,33.3,8,7,2,5,2,12,3,0,"https://fbref.com/en/players/379652be/Oscar-Melendo"
"3453","Naldo_2020",2020,"Espanyol","La Liga","Naldo","BRA","DF","30",1988,14.8,24,13,15,9,0,7,15,46.7,8,11,7,4,21,45,50,1,"https://fbref.com/en/players/a2609621/Naldo"
"3454","Oier Olazábal_2020",2020,"Espanyol","La Liga","Oier Olazábal","ESP","GK","29",1989,2,0,0,0,0,0,0,0,NA,0,1,0,1,0,0,0,0,"https://fbref.com/en/players/b5bdf144/Oier-Olazabal"
"3455","Pedrosa_2020",2020,"Espanyol","La Liga","Pedrosa","ESP","DF,MF","21",1998,12.1,19,13,8,9,2,7,25,28,18,12,1,11,11,30,32,0,"https://fbref.com/en/players/112521d1/Pedrosa"
"3456","Victor Perea_2020",2020,"Espanyol","La Liga","Victor Perea","ESP","DF,FW","19",2000,14.1,13,5,8,4,1,7,20,35,13,10,0,10,21,34,31,0,"https://fbref.com/en/players/b7de5bad/Victor-Perea"
"3457","Pablo Piatti_2020",2020,"Espanyol","La Liga","Pablo Piatti","ARG","DF,MF","30",1989,0.6,2,2,1,1,0,1,2,50,1,1,0,1,0,2,1,0,"https://fbref.com/en/players/48e89655/Pablo-Piatti"
"3458","Pipa_2020",2020,"Espanyol","La Liga","Pipa","ESP","DF,FW","21",1998,5.3,9,8,5,4,0,4,6,66.7,2,8,0,8,6,15,17,0,"https://fbref.com/en/players/10f1cd17/Pipa"
"3459","Nico Ribaudo_2020",2020,"Espanyol","La Liga","Nico Ribaudo","ESP","FW,MF","18",2001,2,3,1,1,0,2,2,6,33.3,4,1,0,1,1,4,0,0,"https://fbref.com/en/players/ce8039aa/Nico-Ribaudo"
"3460","Marc Roca_2020",2020,"Espanyol","La Liga","Marc Roca","ESP","MF","22",1996,33.4,82,52,29,44,9,29,82,35.4,53,28,10,18,31,113,53,2,"https://fbref.com/en/players/da27e268/Marc-Roca"
"3461","Víctor Sánchez_2020",2020,"Espanyol","La Liga","Víctor Sánchez","ESP","MF","31",1987,18.8,66,36,36,23,7,30,71,42.3,41,31,8,23,27,93,23,1,"https://fbref.com/en/players/ad4d0985/Victor-Sanchez"
"3462","Kévin Soni_2020",2020,"Espanyol","La Liga","Kévin Soni","CMR","FW","21",1998,0,0,0,0,0,0,0,0,NA,0,0,0,0,0,0,0,0,"https://fbref.com/en/players/6435143e/Kevin-Soni"
"3463","Raúl de Tomás_2020",2020,"Espanyol","La Liga","Raúl de Tomás","ESP","FW","24",1994,11.9,9,7,3,4,2,4,13,30.8,9,8,1,7,10,19,4,0,"https://fbref.com/en/players/02ef8778/Raul-de-Tomas"
"3464","Matías Vargas_2020",2020,"Espanyol","La Liga","Matías Vargas","ARG","FW,MF","22",1997,11.4,13,5,7,3,3,4,23,17.4,19,12,2,10,3,16,5,0,"https://fbref.com/en/players/ce82f116/Matias-Vargas"
"3465","Dídac Vilà_2020",2020,"Espanyol","La Liga","Dídac Vilà","ESP","DF","30",1989,27.7,73,42,44,23,6,25,61,41,36,31,5,26,40,113,63,0,"https://fbref.com/en/players/bad38a94/Didac-Vila"
"3466","Leighton Baines_2020",2020,"Everton","Premier League","Leighton Baines","ENG","DF","34",1984,4.5,10,6,6,2,2,8,10,80,2,5,2,3,5,15,14,0,"https://fbref.com/en/players/b18095b6/Leighton-Baines"
"3467","Bernard_2020",2020,"Everton","Premier League","Bernard","BRA","MF,FW","26",1992,14.2,32,22,12,14,6,13,44,29.5,31,22,2,20,16,48,7,0,"https://fbref.com/en/players/ab4b3e35/Bernard"
"3468","Jarrad Branthwaite_2020",2020,"Everton","Premier League","Jarrad Branthwaite","ENG","DF","17",2002,3.3,8,7,5,3,0,3,5,60,2,6,3,3,2,10,12,0,"https://fbref.com/en/players/c1949191/Jarrad-Branthwaite"
"3469","Dominic Calvert-Lewin_2020",2020,"Everton","Premier League","Dominic Calvert-Lewin","ENG","FW","22",1997,29.2,7,5,1,4,2,1,10,10,9,15,2,13,6,13,36,0,"https://fbref.com/en/players/59e6e5bf/Dominic-Calvert-Lewin"
"3470","Séamus Coleman_2020",2020,"Everton","Premier League","Séamus Coleman","IRL","DF","30",1988,20.4,42,31,24,14,4,19,25,76,6,21,9,12,24,66,43,1,"https://fbref.com/en/players/0420d84f/Seamus-Coleman"
"3471","Tom Davies_2020",2020,"Everton","Premier League","Tom Davies","ENG","MF","21",1998,22.5,38,17,12,22,4,17,55,30.9,38,12,4,8,35,73,28,0,"https://fbref.com/en/players/9228b07c/Tom-Davies"
"3472","Fabian Delph_2020",2020,"Everton","Premier League","Fabian Delph","ENG","MF","29",1989,13.2,26,12,10,13,3,9,22,40.9,13,12,3,9,15,41,19,1,"https://fbref.com/en/players/111c3236/Fabian-Delph"
"3473","Lucas Digne_2020",2020,"Everton","Premier League","Lucas Digne","FRA","DF","26",1993,33.7,73,49,49,19,5,33,68,48.5,35,39,10,29,42,115,108,0,"https://fbref.com/en/players/1b84dbe1/Lucas-Digne"
"3474","Jean-Philippe Gbamin_2020",2020,"Everton","Premier League","Jean-Philippe Gbamin","CIV","MF","23",1995,1.5,4,3,1,1,2,1,2,50,1,1,0,1,1,5,4,0,"https://fbref.com/en/players/6bd603db/Jean-Philippe-Gbamin"
"3475","André Gomes_2020",2020,"Everton","Premier League","André Gomes","POR","MF","26",1993,16.2,22,15,7,11,4,8,62,12.9,54,20,3,17,7,29,7,0,"https://fbref.com/en/players/1961b2aa/Andre-Gomes"
"3476","Anthony Gordon_2020",2020,"Everton","Premier League","Anthony Gordon","ENG","MF,FW","18",2001,4.9,11,7,5,6,0,5,15,33.3,10,6,2,4,8,19,4,0,"https://fbref.com/en/players/2bd83368/Anthony-Gordon"
"3477","Mason Holgate_2020",2020,"Everton","Premier League","Mason Holgate","ENG","DF","22",1996,22.8,44,26,30,13,1,21,31,67.7,10,26,13,13,34,78,97,0,"https://fbref.com/en/players/d0042ab9/Mason-Holgate"
"3478","Alex Iwobi_2020",2020,"Everton","Premier League","Alex Iwobi","NGA","MF,FW","23",1996,17.7,25,17,8,15,2,12,33,36.4,21,18,2,16,14,39,10,1,"https://fbref.com/en/players/6ca5ec4b/Alex-Iwobi"
"3479","Moise Kean_2020",2020,"Everton","Premier League","Moise Kean","ITA","FW","19",2000,9.5,6,6,5,1,0,0,0,NA,0,4,0,4,5,11,1,1,"https://fbref.com/en/players/3d50bcdb/Moise-Kean"
"3480","Michael Keane_2020",2020,"Everton","Premier League","Michael Keane","ENG","DF","26",1993,28.4,31,16,18,12,1,14,24,58.3,10,35,28,7,44,75,152,0,"https://fbref.com/en/players/c5b7c315/Michael-Keane"
"3481","Yerry Mina_2020",2020,"Everton","Premier League","Yerry Mina","COL","DF","24",1994,25.4,39,22,25,12,2,18,24,75,6,20,14,6,28,67,102,1,"https://fbref.com/en/players/6d5701f2/Yerry-Mina"
"3482","Oumar Niasse_2020",2020,"Everton","Premier League","Oumar Niasse","SEN","FW","29",1990,0.2,4,0,0,2,2,0,0,NA,0,0,0,0,1,5,0,0,"https://fbref.com/en/players/af721f98/Oumar-Niasse"
"3483","Jordan Pickford_2020",2020,"Everton","Premier League","Jordan Pickford","ENG","GK","25",1994,38,0,0,0,0,0,0,4,0,4,0,0,0,3,3,12,6,"https://fbref.com/en/players/4806ec67/Jordan-Pickford"
"3484","Richarlison_2020",2020,"Everton","Premier League","Richarlison","BRA","FW,MF","22",1997,34.1,70,47,28,28,14,27,56,48.2,29,34,4,30,12,82,42,0,"https://fbref.com/en/players/fa031b34/Richarlison"
"3485","Morgan Schneiderlin_2020",2020,"Everton","Premier League","Morgan Schneiderlin","FRA","MF","29",1989,11.1,31,22,13,16,2,8,24,33.3,16,13,3,10,21,52,20,1,"https://fbref.com/en/players/51b41c5c/Morgan-Schneiderlin"
"3486","Djibril Sidibé_2020",2020,"Everton","Premier League","Djibril Sidibé","FRA","DF,MF","27",1992,20.3,83,44,48,25,10,43,72,59.7,29,19,3,16,40,123,41,0,"https://fbref.com/en/players/4c5b714f/Djibril-Sidibe"
"3487","Gylfi Sigurðsson_2020",2020,"Everton","Premier League","Gylfi Sigurðsson","ISL","MF","29",1989,28.4,50,26,15,24,11,19,70,27.1,51,30,4,26,37,87,17,1,"https://fbref.com/en/players/76dd1480/Gylfi-Sigurdsson"
"3488","Cenk Tosun_2020",2020,"Everton","Premier League","Cenk Tosun","TUR","FW","28",1991,3.2,2,0,0,0,2,0,1,0,1,1,0,1,0,2,1,0,"https://fbref.com/en/players/9a104dee/Cenk-Tosun"
"3489","Theo Walcott_2020",2020,"Everton","Premier League","Theo Walcott","ENG","MF,FW","30",1989,14.3,13,8,6,5,2,3,15,20,12,13,0,13,8,21,1,0,"https://fbref.com/en/players/1ecb65be/Theo-Walcott"
"3490","Kevin Agudelo_2020",2020,"Fiorentina","Serie A","Kevin Agudelo","COL","MF,FW","20",1998,0.7,2,1,0,1,1,0,1,0,1,1,0,1,1,3,0,0,"https://fbref.com/en/players/46fa7204/Kevin-Agudelo"
"3491","Milan Badelj_2020",2020,"Fiorentina","Serie A","Milan Badelj","CRO","MF","30",1989,17.6,29,17,10,16,3,15,50,30,35,21,3,18,45,74,34,1,"https://fbref.com/en/players/e8c930bb/Milan-Badelj"
"3492","Marco Benassi_2020",2020,"Fiorentina","Serie A","Marco Benassi","ITA","MF","24",1994,10.9,18,12,9,5,4,10,24,41.7,14,11,1,10,4,22,9,0,"https://fbref.com/en/players/0000acda/Marco-Benassi"
"3493","Kevin-Prince Boateng_2020",2020,"Fiorentina","Serie A","Kevin-Prince Boateng","GHA","FW","32",1987,6.7,3,1,0,2,1,2,8,25,6,3,0,3,1,4,7,0,"https://fbref.com/en/players/f4ec4fd0/Kevin-Prince-Boateng"
"3494","Federico Brancolini_2020",2020,"Fiorentina","Serie A","Federico Brancolini","ITA","GK","18",2001,0.1,0,0,0,0,0,0,0,NA,0,0,0,0,0,0,0,0,"https://fbref.com/en/players/d4890c25/Federico-Brancolini"
"3495","Martín Cáceres_2020",2020,"Fiorentina","Serie A","Martín Cáceres","URU","DF","32",1987,26.2,47,31,34,11,2,16,34,47.1,18,29,13,16,31,78,74,2,"https://fbref.com/en/players/e94d79e3/Martin-Caceres"
"3496","Gaetano Castrovilli_2020",2020,"Fiorentina","Serie A","Gaetano Castrovilli","ITA","MF","22",1997,29.7,59,31,25,23,11,18,53,34,35,29,2,27,15,74,31,1,"https://fbref.com/en/players/0728bebe/Gaetano-Castrovilli"
"3497","Federico Ceccherini_2020",2020,"Fiorentina","Serie A","Federico Ceccherini","ITA","DF","27",1992,9.3,14,8,11,3,0,10,10,100,0,9,5,4,13,27,37,1,"https://fbref.com/en/players/d9624b51/Federico-Ceccherini"
"3498","Federico Chiesa_2020",2020,"Fiorentina","Serie A","Federico Chiesa","ITA","FW,DF","21",1997,29.3,38,22,13,15,10,10,52,19.2,42,19,0,19,6,44,6,0,"https://fbref.com/en/players/b0f7e36c/Federico-Chiesa"
"3499","Sebastián Cristóforo_2020",2020,"Fiorentina","Serie A","Sebastián Cristóforo","URU","MF","25",1993,1,5,5,2,2,1,1,5,20,4,2,1,1,1,6,0,0,"https://fbref.com/en/players/3c05c659/Sebastian-Cristoforo"
"3500","Patrick Cutrone_2020",2020,"Fiorentina","Serie A","Patrick Cutrone","ITA","FW","21",1998,9.3,4,2,2,1,1,1,15,6.7,14,6,1,5,2,6,6,0,"https://fbref.com/en/players/a4fe8cda/Patrick-Cutrone"
"3501","Christian Dalle Mura_2020",2020,"Fiorentina","Serie A","Christian Dalle Mura","ITA","FW","17",2002,0,0,0,0,0,0,0,0,NA,0,0,0,0,0,0,0,0,"https://fbref.com/en/players/f32df091/Christian-Dalle-Mura"
"3502","Bartłomiej Drągowski_2020",2020,"Fiorentina","Serie A","Bartłomiej Drągowski","POL","GK","21",1997,31,0,0,0,0,0,0,1,0,1,0,0,0,3,3,8,1,"https://fbref.com/en/players/085e71a7/Bartlomiej-Dragowski"
"3503","Alfred Duncan_2020",2020,"Fiorentina","Serie A","Alfred Duncan","GHA","MF","26",1993,9.9,12,9,11,1,0,2,19,10.5,17,4,0,4,5,17,12,0,"https://fbref.com/en/players/528492ea/Alfred-Duncan"
"3504","Valentin Eysseric_2020",2020,"Fiorentina","Serie A","Valentin Eysseric","FRA","FW,MF","27",1992,0.5,0,0,0,0,0,0,0,NA,0,1,0,1,0,0,0,0,"https://fbref.com/en/players/ae82fa48/Valentin-Eysseric"
"3505","Rachid Ghezzal_2020",2020,"Fiorentina","Serie A","Rachid Ghezzal","ALG","MF,FW","27",1992,9.2,27,15,14,10,3,10,33,30.3,23,6,0,6,11,38,9,0,"https://fbref.com/en/players/dc3a9a0d/Rachid-Ghezzal"
"3506","Dalbert Henrique_2020",2020,"Fiorentina","Serie A","Dalbert Henrique","BRA","DF,MF","25",1993,27.6,52,25,35,12,5,18,51,35.3,33,34,4,30,19,71,65,0,"https://fbref.com/en/players/f45f9427/Dalbert-Henrique"
"3507","Igor_2020",2020,"Fiorentina","Serie A","Igor","BRA","DF","21",1998,6.8,12,10,8,2,2,6,7,85.7,1,10,4,6,7,19,16,0,"https://fbref.com/en/players/a4e85758/Igor"
"3508","Christian Kouamé_2020",2020,"Fiorentina","Serie A","Christian Kouamé","CIV","FW,MF","21",1997,3.3,3,2,0,3,0,0,1,0,1,5,1,4,1,4,1,0,"https://fbref.com/en/players/58e933d2/Christian-Kouame"
"3509","Pol Lirola_2020",2020,"Fiorentina","Serie A","Pol Lirola","ESP","DF","21",1997,29.4,34,20,18,10,6,21,38,55.3,17,16,4,12,26,60,52,0,"https://fbref.com/en/players/ff800ed8/Pol-Lirola"
"3510","Nikola Milenković_2020",2020,"Fiorentina","Serie A","Nikola Milenković","SRB","DF","21",1997,36.2,46,25,30,16,0,11,31,35.5,20,39,21,18,29,75,129,1,"https://fbref.com/en/players/bee704fc/Nikola-Milenkovic"
"3511","Maximiliano Olivera_2020",2020,"Fiorentina","Serie A","Maximiliano Olivera","URU","MF","27",1992,0.1,1,0,1,0,0,0,0,NA,0,0,0,0,0,1,0,0,"https://fbref.com/en/players/32a33c68/Maximiliano-Olivera"
"3512","Pedro_2020",2020,"Fiorentina","Serie A","Pedro","BRA","FW","22",1997,0.7,1,1,0,0,1,0,0,NA,0,1,0,1,0,1,0,0,"https://fbref.com/en/players/1ab6fad3/Pedro"
"3513","Germán Pezzella_2020",2020,"Fiorentina","Serie A","Germán Pezzella","ARG","DF","28",1991,31.4,36,18,26,9,1,14,32,43.8,18,31,20,11,55,91,134,1,"https://fbref.com/en/players/8c725b43/German-Pezzella"
"3514","Erick Pulgar_2020",2020,"Fiorentina","Serie A","Erick Pulgar","CHI","MF","25",1994,32.8,73,46,25,41,7,22,96,22.9,74,45,15,30,49,122,53,1,"https://fbref.com/en/players/4611e028/Erick-Pulgar"
"3515","Luca Ranieri_2020",2020,"Fiorentina","Serie A","Luca Ranieri","ITA","DF","20",1999,2.6,2,2,2,0,0,2,3,66.7,1,1,0,1,2,4,7,0,"https://fbref.com/en/players/8c63fae5/Luca-Ranieri"
"3516","Franck Ribéry_2020",2020,"Fiorentina","Serie A","Franck Ribéry","FRA","FW","36",1983,15.7,20,14,7,10,3,4,20,20,16,9,0,9,3,23,3,0,"https://fbref.com/en/players/f61c7c4e/Franck-Ribery"
"3517","Riccardo Sottil_2020",2020,"Fiorentina","Serie A","Riccardo Sottil","ITA","FW,DF","20",1999,5.7,6,4,4,2,0,3,10,30,7,4,0,4,0,6,0,0,"https://fbref.com/en/players/94816803/Riccardo-Sottil"
"3518","Pietro Terracciano_2020",2020,"Fiorentina","Serie A","Pietro Terracciano","ITA","GK","29",1990,6.9,0,0,0,0,0,0,0,NA,0,0,0,0,0,0,4,0,"https://fbref.com/en/players/e1b0a70d/Pietro-Terracciano"
"3519","Aleksa Terzić_2020",2020,"Fiorentina","Serie A","Aleksa Terzić","SRB","MF","19",1999,0.1,0,0,0,0,0,0,0,NA,0,0,0,0,0,0,0,0,"https://fbref.com/en/players/3ef0a2d7/Aleksa-Terzic"
"3520","Lorenzo Venuti_2020",2020,"Fiorentina","Serie A","Lorenzo Venuti","ITA","DF,MF","24",1995,9.5,20,10,12,6,2,13,19,68.4,6,5,1,4,11,31,15,0,"https://fbref.com/en/players/983ff2c7/Lorenzo-Venuti"
"3521","Dušan Vlahović_2020",2020,"Fiorentina","Serie A","Dušan Vlahović","SRB","FW","19",2000,16.7,6,2,1,4,1,4,13,30.8,9,5,2,3,7,13,6,0,"https://fbref.com/en/players/79443529/Dusan-Vlahovic"
"3522","Szymon Żurkowski_2020",2020,"Fiorentina","Serie A","Szymon Żurkowski","POL","MF","21",1997,0.1,1,0,0,0,1,0,2,0,2,0,0,0,0,1,1,0,"https://fbref.com/en/players/4e1d5e59/Szymon-Zurkowski"
"3523","Amir Abrashi_2020",2020,"Freiburg","Bundesliga","Amir Abrashi","ALB","MF","29",1990,7.4,16,8,7,8,1,10,19,52.6,9,18,3,15,7,23,16,2,"https://fbref.com/en/players/1c08a3c8/Amir-Abrashi"
"3524","Brandon Borrello_2020",2020,"Freiburg","Bundesliga","Brandon Borrello","AUS","MF,FW","24",1995,3.3,10,4,6,4,0,4,10,40,6,7,1,6,1,11,1,0,"https://fbref.com/en/players/b4d90315/Brandon-Borrello"
"3525","Kwon Chang-hoon_2020",2020,"Freiburg","Bundesliga","Kwon Chang-hoon","KOR","MF,FW","25",1994,7.5,7,4,2,3,2,1,10,10,9,5,1,4,7,14,14,0,"https://fbref.com/en/players/7961f7aa/Kwon-Chang-hoon"
"3526","Mark Flekken_2020",2020,"Freiburg","Bundesliga","Mark Flekken","NED","GK","26",1993,10,0,0,0,0,0,0,1,0,1,0,0,0,0,0,2,2,"https://fbref.com/en/players/a92ab7be/Mark-Flekken"
"3527","Mike Frantz_2020",2020,"Freiburg","Bundesliga","Mike Frantz","GER","MF","32",1986,3.9,4,2,1,3,0,2,9,22.2,7,5,3,2,1,5,4,0,"https://fbref.com/en/players/482b70ad/Mike-Frantz"
"3528","Jérôme Gondorf_2020",2020,"Freiburg","Bundesliga","Jérôme Gondorf","GER","MF","31",1988,1.3,9,6,7,1,1,3,6,50,3,3,2,1,0,9,2,0,"https://fbref.com/en/players/49ffe0f2/Jerome-Gondorf"
"3529","Vincenzo Grifo_2020",2020,"Freiburg","Bundesliga","Vincenzo Grifo","ITA","MF,FW","26",1993,18,15,10,9,3,3,6,25,24,19,13,1,12,14,29,18,1,"https://fbref.com/en/players/54e4866f/Vincenzo-Grifo"
"3530","Manuel Gulde_2020",2020,"Freiburg","Bundesliga","Manuel Gulde","GER","DF","28",1991,15.2,28,16,17,9,2,15,24,62.5,9,23,13,10,22,50,80,1,"https://fbref.com/en/players/25ab9c9c/Manuel-Gulde"
"3531","Christian Günter_2020",2020,"Freiburg","Bundesliga","Christian Günter","GER","DF","26",1993,33.7,25,11,17,7,1,12,35,34.3,23,29,13,16,14,39,40,0,"https://fbref.com/en/players/8593f88c/Christian-Gunter"
"3532","Janik Haberer_2020",2020,"Freiburg","Bundesliga","Janik Haberer","GER","MF,FW","25",1994,19.1,26,18,8,14,4,12,45,26.7,33,25,4,21,25,51,23,0,"https://fbref.com/en/players/70dcf94d/Janik-Haberer"
"3533","Dominique Heintz_2020",2020,"Freiburg","Bundesliga","Dominique Heintz","GER","DF","25",1993,27,47,30,40,6,1,17,43,39.5,26,38,25,13,41,88,131,1,"https://fbref.com/en/players/699fb8db/Dominique-Heintz"
"3534","Nicolas Höfler_2020",2020,"Freiburg","Bundesliga","Nicolas Höfler","GER","MF","29",1990,30.9,65,40,31,28,6,22,64,34.4,42,58,18,40,71,136,59,3,"https://fbref.com/en/players/5d8e331f/Nicolas-Hofler"
"3535","Lucas Höler_2020",2020,"Freiburg","Bundesliga","Lucas Höler","GER","FW,MF","25",1994,27.6,35,15,11,16,8,11,46,23.9,35,30,9,21,12,47,38,0,"https://fbref.com/en/players/ca618d23/Lucas-Holer"
"3536","Gian-Luca Itter_2020",2020,"Freiburg","Bundesliga","Gian-Luca Itter","GER","DF,MF","20",1999,0.4,1,1,1,0,0,1,1,100,0,0,0,0,1,2,4,0,"https://fbref.com/en/players/e6c15f6e/Gian-Luca-Itter"
"3537","Yannik Keitel_2020",2020,"Freiburg","Bundesliga","Yannik Keitel","GER","MF","19",2000,1.9,2,1,1,1,0,0,6,0,6,3,1,2,4,6,4,0,"https://fbref.com/en/players/d2c580ce/Yannik-Keitel"
"3538","Robin Koch_2020",2020,"Freiburg","Bundesliga","Robin Koch","GER","DF,MF","23",1996,30.1,34,20,20,13,1,11,26,42.3,15,30,22,8,45,79,94,4,"https://fbref.com/en/players/ea6bc03a/Robin-Koch"
"3539","Lukas Kübler_2020",2020,"Freiburg","Bundesliga","Lukas Kübler","GER","DF","26",1992,2.3,1,1,0,1,0,1,5,20,4,2,0,2,1,2,6,0,"https://fbref.com/en/players/2a29eb9b/Lukas-Kubler"
"3540","Philipp Lienhart_2020",2020,"Freiburg","Bundesliga","Philipp Lienhart","AUT","DF","23",1996,20.2,11,4,10,1,0,6,13,46.2,7,24,17,7,28,39,86,0,"https://fbref.com/en/players/302527b2/Philipp-Lienhart"
"3541","Nils Petersen_2020",2020,"Freiburg","Bundesliga","Nils Petersen","GER","FW,MF","30",1988,27.1,19,14,7,9,3,10,28,35.7,18,32,6,26,10,29,67,0,"https://fbref.com/en/players/f93e6e94/Nils-Petersen"
"3542","Roland Sallai_2020",2020,"Freiburg","Bundesliga","Roland Sallai","HUN","MF,FW","22",1997,12.9,17,10,4,9,4,7,20,35,13,12,2,10,7,24,4,0,"https://fbref.com/en/players/bf075f6b/Roland-Sallai"
"3543","Nico Schlotterbeck_2020",2020,"Freiburg","Bundesliga","Nico Schlotterbeck","GER","DF","19",1999,4.1,6,3,4,2,0,2,5,40,3,7,5,2,3,9,20,1,"https://fbref.com/en/players/34e12499/Nico-Schlotterbeck"
"3544","Jonathan Schmid_2020",2020,"Freiburg","Bundesliga","Jonathan Schmid","FRA","DF","29",1990,31.5,42,27,19,19,4,19,37,51.4,18,23,8,15,35,77,84,0,"https://fbref.com/en/players/088ca1bd/Jonathan-Schmid"
"3545","Alexander Schwolow_2020",2020,"Freiburg","Bundesliga","Alexander Schwolow","GER","GK","27",1992,23.2,0,0,0,0,0,0,0,NA,0,2,0,2,1,1,8,3,"https://fbref.com/en/players/0d55d942/Alexander-Schwolow"
"3546","Lino Tempelmann_2020",2020,"Freiburg","Bundesliga","Lino Tempelmann","GER","MF","20",1999,0.4,1,0,1,0,0,1,1,100,0,1,1,0,0,1,0,0,"https://fbref.com/en/players/4e3a947f/Lino-Tempelmann"
"3547","Niclas Thiede_2020",2020,"Freiburg","Bundesliga","Niclas Thiede","GER","GK","20",1999,0.8,0,0,0,0,0,0,0,NA,0,0,0,0,0,0,1,0,"https://fbref.com/en/players/cac55e10/Niclas-Thiede"
"3548","Luca Waldschmidt_2020",2020,"Freiburg","Bundesliga","Luca Waldschmidt","GER","FW,MF","23",1996,14.1,10,7,3,5,2,2,18,11.1,16,11,2,9,4,14,4,0,"https://fbref.com/en/players/e5a35ae9/Luca-Waldschmidt"
"3549","Kevin Agudelo_2020",2020,"Genoa","Serie A","Kevin Agudelo","COL","MF,FW","20",1998,7.4,23,14,9,12,2,10,20,50,10,12,1,11,6,29,2,0,"https://fbref.com/en/players/46fa7204/Kevin-Agudelo"
"3550","Peter Ankersen_2020",2020,"Genoa","Serie A","Peter Ankersen","DEN","DF","28",1990,11.8,16,4,7,7,2,4,13,30.8,9,19,5,14,9,25,25,1,"https://fbref.com/en/players/df525574/Peter-Ankersen"
"3551","Antonio Barreca_2020",2020,"Genoa","Serie A","Antonio Barreca","ITA","DF,FW","24",1995,12.2,10,7,5,3,2,4,5,80,1,12,7,5,1,11,22,0,"https://fbref.com/en/players/6a189491/Antonio-Barreca"
"3552","Valon Behrami_2020",2020,"Genoa","Serie A","Valon Behrami","SUI","MF","34",1985,12.3,34,26,13,17,4,8,32,25,24,25,10,15,9,43,16,0,"https://fbref.com/en/players/d3d758d8/Valon-Behrami"
"3553","Davide Biraschi_2020",2020,"Genoa","Serie A","Davide Biraschi","ITA","DF","25",1994,21.9,32,17,17,13,2,15,26,57.7,11,22,12,10,34,66,69,0,"https://fbref.com/en/players/64cd167d/Davide-Biraschi"
"3554","Francesco Cassata_2020",2020,"Genoa","Serie A","Francesco Cassata","ITA","MF","22",1997,16.2,20,10,12,5,3,9,30,30,21,12,2,10,11,31,11,0,"https://fbref.com/en/players/96960855/Francesco-Cassata"
"3555","Denilho Cleonise_2020",2020,"Genoa","Serie A","Denilho Cleonise","NED","FW","17",2001,0.5,1,0,1,0,0,0,0,NA,0,0,0,0,1,2,0,0,"https://fbref.com/en/players/91c9de34/Denilho-Cleonise"
"3556","Domenico Criscito_2020",2020,"Genoa","Serie A","Domenico Criscito","ITA","DF","32",1986,22.8,53,33,34,12,7,24,56,42.9,32,25,13,12,53,106,81,1,"https://fbref.com/en/players/35dd6d80/Domenico-Criscito"
"3557","Mattia Destro_2020",2020,"Genoa","Serie A","Mattia Destro","ITA","FW,MF","28",1991,1.7,0,0,0,0,0,0,0,NA,0,0,0,0,0,0,1,0,"https://fbref.com/en/players/d7d32194/Mattia-Destro"
"3558","Iago Falque_2020",2020,"Genoa","Serie A","Iago Falque","ESP","MF","29",1990,5.8,7,3,1,4,2,4,8,50,4,7,0,7,1,8,4,0,"https://fbref.com/en/players/440c84ed/Iago-Falque"
"3559","Andrea Favilli_2020",2020,"Genoa","Serie A","Andrea Favilli","ITA","FW","22",1997,7.3,8,7,2,3,3,4,11,36.4,7,5,1,4,0,8,7,0,"https://fbref.com/en/players/44510fde/Andrea-Favilli"
"3560","Paolo Ghiglione_2020",2020,"Genoa","Serie A","Paolo Ghiglione","ITA","DF,FW","22",1997,19.1,31,16,15,13,3,18,35,51.4,17,17,2,15,9,40,42,1,"https://fbref.com/en/players/71dc23da/Paolo-Ghiglione"
"3561","Edoardo Goldaniga_2020",2020,"Genoa","Serie A","Edoardo Goldaniga","ITA","DF","25",1993,8.7,4,3,3,1,0,2,5,40,3,11,6,5,18,22,25,1,"https://fbref.com/en/players/4b029b31/Edoardo-Goldaniga"
"3562","Sinan Gümüş_2020",2020,"Genoa","Serie A","Sinan Gümüş","TUR","FW,MF","25",1994,1.1,0,0,0,0,0,0,4,0,4,0,0,0,0,0,1,0,"https://fbref.com/en/players/ac1f056e/Sinan-Gumus"
"3563","Filip Jagiełło_2020",2020,"Genoa","Serie A","Filip Jagiełło","POL","MF","21",1997,6.1,7,2,0,3,4,3,7,42.9,4,4,0,4,5,12,4,0,"https://fbref.com/en/players/4cdcbc14/Filip-Jagiello"
"3564","Christian Kouamé_2020",2020,"Genoa","Serie A","Christian Kouamé","CIV","FW","21",1997,10.2,2,1,0,1,1,0,8,0,8,8,2,6,1,3,13,0,"https://fbref.com/en/players/58e933d2/Christian-Kouame"
"3565","Lukas Lerager_2020",2020,"Genoa","Serie A","Lukas Lerager","DEN","MF","26",1993,15.4,29,19,13,12,4,10,34,29.4,24,20,5,15,8,37,15,1,"https://fbref.com/en/players/1b82f8df/Lukas-Lerager"
"3566","Andrea Masiello_2020",2020,"Genoa","Serie A","Andrea Masiello","ITA","DF","33",1986,14.7,26,15,17,8,1,16,32,50,16,8,2,6,26,52,55,2,"https://fbref.com/en/players/e0314d87/Andrea-Masiello"
"3567","Marko Pajač_2020",2020,"Genoa","Serie A","Marko Pajač","CRO","DF,FW","26",1993,8.4,8,4,4,3,1,7,16,43.8,9,6,0,6,8,16,9,0,"https://fbref.com/en/players/5df4ef30/Marko-Pajac"
"3568","Goran Pandev_2020",2020,"Genoa","Serie A","Goran Pandev","MKD","FW,MF","36",1983,18.7,12,8,2,7,3,3,25,12,22,4,1,3,0,12,5,1,"https://fbref.com/en/players/d711d04f/Goran-Pandev"
"3569","Mattia Perin_2020",2020,"Genoa","Serie A","Mattia Perin","ITA","GK","26",1992,21,1,1,1,0,0,1,1,100,0,1,0,1,0,1,5,1,"https://fbref.com/en/players/4c62d0c8/Mattia-Perin"
"3570","Andrea Pinamonti_2020",2020,"Genoa","Serie A","Andrea Pinamonti","ITA","FW","20",1999,24.8,19,12,1,7,11,5,25,20,20,19,2,17,9,28,25,0,"https://fbref.com/en/players/08aa9cd1/Andrea-Pinamonti"
"3571","Ivan Radovanović_2020",2020,"Genoa","Serie A","Ivan Radovanović","SRB","MF","30",1988,14.6,27,14,18,9,0,10,26,38.5,16,17,3,14,8,35,39,0,"https://fbref.com/en/players/023937a9/Ivan-Radovanovic"
"3572","Ionuț Radu_2020",2020,"Genoa","Serie A","Ionuț Radu","ROU","GK","22",1997,17,0,0,0,0,0,0,2,0,2,0,0,0,1,1,7,1,"https://fbref.com/en/players/67f649be/Ionut-Radu"
"3573","Cristian Romero_2020",2020,"Genoa","Serie A","Cristian Romero","ARG","DF","21",1998,28.6,52,35,36,12,4,12,41,29.3,29,59,33,26,75,127,116,2,"https://fbref.com/en/players/a3d94a58/Cristian-Romero"
"3574","Rômulo_2020",2020,"Genoa","Serie A","Rômulo","ITA","DF","32",1987,0.2,2,1,1,1,0,0,0,NA,0,0,0,0,0,2,1,0,"https://fbref.com/en/players/07abb358/Romulo"
"3575","Nicolò Rovella_2020",2020,"Genoa","Serie A","Nicolò Rovella","ITA","MF","17",2001,1.2,0,0,0,0,0,0,1,0,1,0,0,0,4,4,0,0,"https://fbref.com/en/players/e58cbfd5/Nicolo-Rovella"
"3576","Antonio Sanabria_2020",2020,"Genoa","Serie A","Antonio Sanabria","PAR","FW","23",1996,15.4,14,11,2,7,5,3,14,21.4,11,13,1,12,5,19,12,1,"https://fbref.com/en/players/0a447501/Antonio-Sanabria"
"3577","Riccardo Saponara_2020",2020,"Genoa","Serie A","Riccardo Saponara","ITA","MF,FW","27",1991,1.9,4,3,2,2,0,0,2,0,2,2,1,1,0,4,2,0,"https://fbref.com/en/players/3bb7af3b/Riccardo-Saponara"
"3578","Lasse Schöne_2020",2020,"Genoa","Serie A","Lasse Schöne","DEN","MF","33",1986,27,42,26,16,22,4,15,48,31.3,33,22,6,16,37,79,25,2,"https://fbref.com/en/players/c3a8bcd8/Lasse-Schone"
"3579","Adama Soumaoro_2020",2020,"Genoa","Serie A","Adama Soumaoro","FRA","DF","27",1992,7.1,3,2,3,0,0,1,3,33.3,2,12,12,0,11,14,32,0,"https://fbref.com/en/players/7b075c75/Adama-Soumaoro"
"3580","Stefano Sturaro_2020",2020,"Genoa","Serie A","Stefano Sturaro","ITA","MF","26",1993,13.9,38,22,14,19,5,15,39,38.5,24,16,4,12,10,48,26,1,"https://fbref.com/en/players/2334478a/Stefano-Sturaro"
"3581","Jawad El Yamiq_2020",2020,"Genoa","Serie A","Jawad El Yamiq","MAR","DF","27",1992,2.2,3,2,3,0,0,1,4,25,3,3,2,1,1,4,3,0,"https://fbref.com/en/players/f6f6b6e8/Jawad-El-Yamiq"
"3582","Cristián Zapata_2020",2020,"Genoa","Serie A","Cristián Zapata","COL","DF","32",1986,19.1,23,17,16,7,0,8,16,50,8,29,17,12,24,47,75,0,"https://fbref.com/en/players/b1deecf8/Cristian-Zapata"
"3583","Amath_2020",2020,"Getafe","La Liga","Amath","SEN","MF","23",1996,0.7,2,1,1,1,0,0,5,0,5,2,0,2,0,2,0,0,"https://fbref.com/en/players/f3b1d9a2/Amath"
"3584","Vitorino Antunes_2020",2020,"Getafe","La Liga","Vitorino Antunes","POR","MF","32",1987,0.1,0,0,0,0,0,0,0,NA,0,0,0,0,0,0,1,0,"https://fbref.com/en/players/3e4f735d/Vitorino-Antunes"
"3585","Mauro Arambarri_2020",2020,"Getafe","La Liga","Mauro Arambarri","URU","MF","23",1995,34.1,72,33,24,40,8,31,69,44.9,38,52,5,47,43,115,40,2,"https://fbref.com/en/players/58afe001/Mauro-Arambarri"
"3586","Markel Bergara_2020",2020,"Getafe","La Liga","Markel Bergara","ESP","MF","33",1986,0.8,0,0,0,0,0,0,0,NA,0,0,0,0,0,0,2,0,"https://fbref.com/en/players/04a65a8f/Markel-Bergara"
"3587","Erick Cabaco_2020",2020,"Getafe","La Liga","Erick Cabaco","URU","DF","24",1995,3,3,2,1,2,0,0,3,0,3,1,1,0,3,6,11,0,"https://fbref.com/en/players/e7ab4179/Erick-Cabaco"
"3588","Leandro Cabrera_2020",2020,"Getafe","La Liga","Leandro Cabrera","URU","DF","28",1991,17,10,6,5,5,0,5,12,41.7,7,10,4,6,21,31,66,0,"https://fbref.com/en/players/69cbc8b6/Leandro-Cabrera"
"3589","Chema_2020",2020,"Getafe","La Liga","Chema","ESP","DF","27",1992,3.4,4,3,1,3,0,1,2,50,1,1,0,1,5,9,12,0,"https://fbref.com/en/players/7f203b54/Chema"
"3590","Marc Cucurella_2020",2020,"Getafe","La Liga","Marc Cucurella","ESP","MF,DF","21",1998,36,74,51,23,38,13,24,76,31.6,52,58,8,50,36,110,28,1,"https://fbref.com/en/players/1daec722/Marc-Cucurella"
"3591","Deyverson_2020",2020,"Getafe","La Liga","Deyverson","BRA","FW","28",1991,2.3,0,0,0,0,0,0,1,0,1,2,1,1,0,0,5,0,"https://fbref.com/en/players/2e5e846d/Deyverson"
"3592","Djené_2020",2020,"Getafe","La Liga","Djené","TOG","DF","27",1991,34,42,32,27,15,0,17,30,56.7,13,20,7,13,34,76,105,1,"https://fbref.com/en/players/a4971d84/Djene"
"3593","Hugo Duro_2020",2020,"Getafe","La Liga","Hugo Duro","ESP","FW,MF","19",1999,4.2,6,5,2,2,2,4,8,50,4,3,0,3,1,7,3,0,"https://fbref.com/en/players/37e103f8/Hugo-Duro"
"3594","Oghenekaro Etebo_2020",2020,"Getafe","La Liga","Oghenekaro Etebo","NGA","MF","23",1995,6.4,12,4,5,7,0,7,12,58.3,5,10,1,9,11,23,4,1,"https://fbref.com/en/players/b579e83d/Oghenekaro-Etebo"
"3595","Xabier Etxeita_2020",2020,"Getafe","La Liga","Xabier Etxeita","ESP","DF","31",1987,16.1,20,11,11,9,0,12,23,52.2,11,9,5,4,17,37,68,0,"https://fbref.com/en/players/4a895384/Xabier-Etxeita"
"3596","Fayçal Fajr_2020",2020,"Getafe","La Liga","Fayçal Fajr","MAR","MF","30",1988,4.5,1,1,0,1,0,0,3,0,3,4,0,4,4,5,1,0,"https://fbref.com/en/players/79135368/Faycal-Fajr"
"3597","Enric Gallego_2020",2020,"Getafe","La Liga","Enric Gallego","ESP","FW","32",1986,1.8,3,1,1,1,1,2,4,50,2,2,0,2,2,5,1,0,"https://fbref.com/en/players/82e9b89d/Enric-Gallego"
"3598","Raúl García_2020",2020,"Getafe","La Liga","Raúl García","ESP","DF","30",1989,2.7,5,3,2,3,0,3,6,50,3,3,1,2,4,9,10,0,"https://fbref.com/en/players/1a317a1b/Raul-Garcia"
"3599","Bruno González_2020",2020,"Getafe","La Liga","Bruno González","ESP","DF","29",1990,2,3,2,3,0,0,1,1,100,0,2,0,2,0,3,3,0,"https://fbref.com/en/players/f11fe861/Bruno-Gonzalez"
"3600","Jason_2020",2020,"Getafe","La Liga","Jason","ESP","MF","25",1994,13.1,29,20,8,16,5,15,33,45.5,18,18,3,15,18,47,9,0,"https://fbref.com/en/players/9038c2a1/Jason"
"3601","Kenedy_2020",2020,"Getafe","La Liga","Kenedy","BRA","MF","23",1996,6.5,9,5,3,3,3,2,5,40,3,10,0,10,11,20,4,0,"https://fbref.com/en/players/5eebbfdf/Kenedy"
"3602","Nemanja Maksimović_2020",2020,"Getafe","La Liga","Nemanja Maksimović","SRB","MF","24",1995,32.2,49,28,12,31,6,10,44,22.7,34,37,7,30,56,105,30,1,"https://fbref.com/en/players/00b28772/Nemanja-Maksimovic"
"3603","Jaime Mata_2020",2020,"Getafe","La Liga","Jaime Mata","ESP","FW","30",1988,30.5,21,13,3,11,7,3,20,15,17,16,1,15,7,28,15,0,"https://fbref.com/en/players/02319ad7/Jaime-Mata"
"3604","Jorge Molina_2020",2020,"Getafe","La Liga","Jorge Molina","ESP","FW","37",1982,21,8,2,0,4,4,0,12,0,12,13,2,11,4,12,18,0,"https://fbref.com/en/players/43f71e77/Jorge-Molina"
"3605","Allan Nyom_2020",2020,"Getafe","La Liga","Allan Nyom","CMR","DF,MF","31",1988,26.9,45,25,26,15,4,20,37,54.1,17,24,5,19,14,59,50,1,"https://fbref.com/en/players/97572117/Allan-Nyom"
"3606","Mathías Olivera_2020",2020,"Getafe","La Liga","Mathías Olivera","URU","DF","21",1997,20.8,64,40,34,16,14,27,45,60,18,32,3,29,23,87,44,0,"https://fbref.com/en/players/41c12f75/Mathias-Olivera"
"3607","Francisco Portillo_2020",2020,"Getafe","La Liga","Francisco Portillo","ESP","MF","29",1990,4.2,11,6,3,6,2,4,12,33.3,8,2,0,2,2,13,3,0,"https://fbref.com/en/players/8e010ff4/Francisco-Portillo"
"3608","Florent Poulolo_2020",2020,"Getafe","La Liga","Florent Poulolo","MTQ","DF","22",1997,0,0,0,0,0,0,0,0,NA,0,0,0,0,0,0,1,0,"https://fbref.com/en/players/07129f3c/Florent-Poulolo"
"3609","Ángel Rodríguez_2020",2020,"Getafe","La Liga","Ángel Rodríguez","ESP","FW","32",1987,15.6,14,8,2,8,4,2,18,11.1,16,10,1,9,3,17,10,0,"https://fbref.com/en/players/8cfc2f69/Angel-Rodriguez"
"3610","David Soria_2020",2020,"Getafe","La Liga","David Soria","ESP","GK","26",1993,38,2,1,2,0,0,2,4,50,2,0,0,0,3,5,17,5,"https://fbref.com/en/players/8f8c6934/David-Soria"
"3611","Damián Suárez_2020",2020,"Getafe","La Liga","Damián Suárez","URU","DF","31",1988,28.8,62,32,32,21,9,38,72,52.8,34,25,2,23,27,89,41,0,"https://fbref.com/en/players/ba5004e1/Damian-Suarez"
"3612","David Timor_2020",2020,"Getafe","La Liga","David Timor","ESP","MF,DF","29",1989,10.5,9,6,4,5,0,5,16,31.3,11,8,3,5,18,27,23,0,"https://fbref.com/en/players/174651c8/David-Timor"
"3613","Ramon Azeez_2020",2020,"Granada","La Liga","Ramon Azeez","NGA","MF","26",1992,15.1,11,8,2,8,1,7,19,36.8,12,8,2,6,19,30,11,1,"https://fbref.com/en/players/0cc474e7/Ramon-Azeez"
"3614","Gil Bastião Dias_2020",2020,"Granada","La Liga","Gil Bastião Dias","POR","MF,DF","22",1996,4,19,14,10,6,3,7,17,41.2,10,4,1,3,3,22,7,0,"https://fbref.com/en/players/e61bdd69/Gil-Bastiao-Dias"
"3615","Yan Brice Eteki_2020",2020,"Granada","La Liga","Yan Brice Eteki","CMR","MF","21",1997,16.7,37,21,14,18,5,15,31,48.4,16,17,4,13,24,61,20,1,"https://fbref.com/en/players/3d688b46/Yan-Brice-Eteki"
"3616","Antonio Cortés_2020",2020,"Granada","La Liga","Antonio Cortés","ESP","FW,MF","19",2000,2,1,1,0,1,0,0,1,0,1,0,0,0,0,1,2,0,"https://fbref.com/en/players/31a1288d/Antonio-Cortes"
"3617","Víctor Díaz_2020",2020,"Granada","La Liga","Víctor Díaz","ESP","DF","31",1988,32,74,43,38,31,5,31,60,51.7,29,53,23,30,48,122,94,1,"https://fbref.com/en/players/3624ce4c/Victor-Diaz"
"3618","Domingos Duarte_2020",2020,"Granada","La Liga","Domingos Duarte","POR","DF","24",1995,34.3,30,19,24,5,1,11,20,55,9,34,24,10,34,64,153,1,"https://fbref.com/en/players/93090f69/Domingos-Duarte"
"3619","Aarón Escandell_2020",2020,"Granada","La Liga","Aarón Escandell","ESP","GK","23",1995,3,1,1,1,0,0,1,1,100,0,0,0,0,0,1,0,0,"https://fbref.com/en/players/67669ce7/Aaron-Escandell"
"3620","Carlos Fernández_2020",2020,"Granada","La Liga","Carlos Fernández","ESP","FW,MF","23",1996,24.5,24,15,7,11,6,3,32,9.4,29,25,2,23,11,35,30,0,"https://fbref.com/en/players/e08647d6/Carlos-Fernandez"
"3621","Dimitri Foulquier_2020",2020,"Granada","La Liga","Dimitri Foulquier","FRA","DF,MF","26",1993,12.4,25,11,13,9,3,11,20,55,9,8,3,5,16,41,32,0,"https://fbref.com/en/players/45e17712/Dimitri-Foulquier"
"3622","Maxime Gonalons_2020",2020,"Granada","La Liga","Maxime Gonalons","FRA","MF","30",1989,16.7,62,38,25,35,2,22,54,40.7,32,27,3,24,20,82,20,1,"https://fbref.com/en/players/b8c1de25/Maxime-Gonalons"
"3623","Yangel Herrera_2020",2020,"Granada","La Liga","Yangel Herrera","VEN","MF","21",1998,26.3,88,49,25,53,10,36,80,45,44,38,9,29,34,122,28,0,"https://fbref.com/en/players/e778654a/Yangel-Herrera"
"3624","İsmail Köybaşı_2020",2020,"Granada","La Liga","İsmail Köybaşı","TUR","DF,FW","30",1989,2.6,4,4,3,1,0,0,2,0,2,4,0,4,5,9,2,0,"https://fbref.com/en/players/58640e66/Ismail-Koybasi"
"3625","Darwin Machís_2020",2020,"Granada","La Liga","Darwin Machís","VEN","FW,MF","26",1993,23.7,23,13,11,8,4,8,23,34.8,15,22,4,18,31,54,9,0,"https://fbref.com/en/players/ed6ea4d9/Darwin-Machis"
"3626","Álex Martínez_2020",2020,"Granada","La Liga","Álex Martínez","ESP","DF","28",1990,0.2,0,0,0,0,0,0,0,NA,0,0,0,0,0,0,0,0,"https://fbref.com/en/players/e1c805cf/Alex-Martinez"
"3627","José Martínez_2020",2020,"Granada","La Liga","José Martínez","ESP","DF","26",1993,13.2,21,16,12,8,1,14,25,56,11,6,4,2,18,39,46,0,"https://fbref.com/en/players/8e049cbd/Jose-Martinez"
"3628","Ángel Montoro_2020",2020,"Granada","La Liga","Ángel Montoro","ESP","MF","31",1988,10.8,19,8,8,9,2,3,13,23.1,10,10,1,9,13,32,15,0,"https://fbref.com/en/players/719384c1/Angel-Montoro"
"3629","Carlos Neva_2020",2020,"Granada","La Liga","Carlos Neva","ESP","DF","23",1996,24.5,16,11,12,3,1,9,21,42.9,12,15,2,13,28,44,60,0,"https://fbref.com/en/players/8d47bb39/Carlos-Neva"
"3630","Antonio Puertas_2020",2020,"Granada","La Liga","Antonio Puertas","ESP","FW,MF","27",1992,28.5,37,24,8,18,11,16,53,30.2,37,21,3,18,12,49,21,0,"https://fbref.com/en/players/c77a8043/Antonio-Puertas"
"3631","Quini_2020",2020,"Granada","La Liga","Quini","ESP","DF","29",1989,8,25,14,16,7,2,13,22,59.1,9,5,1,4,10,35,14,0,"https://fbref.com/en/players/7a538238/Quini"
"3632","Adrián Ramos_2020",2020,"Granada","La Liga","Adrián Ramos","COL","FW,MF","33",1986,2.5,6,2,0,2,4,2,3,66.7,1,2,0,2,1,7,1,0,"https://fbref.com/en/players/c693cf7c/Adrian-Ramos"
"3633","Mario Rodriguez_2020",2020,"Granada","La Liga","Mario Rodriguez","ESP","MF","22",1997,0,0,0,0,0,0,0,0,NA,0,0,0,0,0,0,0,0,"https://fbref.com/en/players/a5cdedc7/Mario-Rodriguez"
"3634","Germán Sánchez_2020",2020,"Granada","La Liga","Germán Sánchez","ESP","DF","32",1986,25.5,16,10,12,4,0,6,16,37.5,10,29,23,6,33,49,115,2,"https://fbref.com/en/players/ea9b2ef9/German-Sanchez"
"3635","Rui Silva_2020",2020,"Granada","La Liga","Rui Silva","POR","GK","25",1994,35,2,1,2,0,0,2,2,100,0,0,0,0,2,4,22,3,"https://fbref.com/en/players/ea83bfa6/Rui-Silva"
"3636","Roberto Soldado_2020",2020,"Granada","La Liga","Roberto Soldado","ESP","FW","34",1985,26.1,16,9,2,7,7,7,24,29.2,17,16,4,12,4,20,16,0,"https://fbref.com/en/players/9d66fbe3/Roberto-Soldado"
"3637","Álvaro Vadillo_2020",2020,"Granada","La Liga","Álvaro Vadillo","ESP","FW,MF","24",1994,13.5,16,11,6,8,2,9,16,56.3,7,12,0,12,7,23,2,0,"https://fbref.com/en/players/61b62b33/Alvaro-Vadillo"
"3638","Jesús Vallejo_2020",2020,"Granada","La Liga","Jesús Vallejo","ESP","DF","22",1997,7,6,5,4,2,0,3,4,75,1,7,4,3,5,11,28,0,"https://fbref.com/en/players/c2111b45/Jesus-Vallejo"
"3639","Fede Vico_2020",2020,"Granada","La Liga","Fede Vico","ESP","MF,FW","25",1994,9.7,5,1,2,3,0,2,11,18.2,9,12,1,11,5,10,2,0,"https://fbref.com/en/players/f681a8ef/Fede-Vico"
"3640","Claud Adjapong_2020",2020,"Hellas Verona","Serie A","Claud Adjapong","ITA","DF","21",1998,2.6,5,3,4,1,0,2,3,66.7,1,4,3,1,3,8,7,0,"https://fbref.com/en/players/ce5b170a/Claud-Adjapong"
"3641","Emmanuel Agyemang-Badu_2020",2020,"Hellas Verona","Serie A","Emmanuel Agyemang-Badu","GHA","MF","28",1990,2.6,1,1,0,1,0,1,2,50,1,2,2,0,1,2,6,0,"https://fbref.com/en/players/fe0b8f0e/Emmanuel-Agyemang-Badu"
"3642","Sofyan Amrabat_2020",2020,"Hellas Verona","Serie A","Sofyan Amrabat","MAR","MF","22",1996,32.4,58,36,26,21,11,26,55,47.3,29,29,10,19,31,89,15,1,"https://fbref.com/en/players/5a2cb25d/Sofyan-Amrabat"
"3643","Salvatore Bocchetti_2020",2020,"Hellas Verona","Serie A","Salvatore Bocchetti","ITA","DF","32",1986,3.4,5,3,3,2,0,2,3,66.7,1,2,2,0,17,22,23,0,"https://fbref.com/en/players/faa1b07d/Salvatore-Bocchetti"
"3644","Fabio Borini_2020",2020,"Hellas Verona","Serie A","Fabio Borini","ITA","MF,FW","28",1991,9,2,1,2,0,0,0,4,0,4,3,0,3,13,15,6,0,"https://fbref.com/en/players/ef5b337e/Fabio-Borini"
"3645","Andrea Danzi_2020",2020,"Hellas Verona","Serie A","Andrea Danzi","ITA","MF","20",1999,0,0,0,0,0,0,0,0,NA,0,0,0,0,0,0,0,0,"https://fbref.com/en/players/263b855a/Andrea-Danzi"
"3646","Paweł Dawidowicz_2020",2020,"Hellas Verona","Serie A","Paweł Dawidowicz","POL","DF","24",1995,7.7,15,12,11,4,0,5,11,45.5,6,6,5,1,12,27,26,0,"https://fbref.com/en/players/16bb656a/Pawel-Dawidowicz"
"3647","Samuel Di Carmine_2020",2020,"Hellas Verona","Serie A","Samuel Di Carmine","ITA","FW,MF","30",1988,14.4,2,1,0,0,2,0,8,0,8,3,0,3,1,3,10,0,"https://fbref.com/en/players/ef94dc2f/Samuel-Di-Carmine"
"3648","Federico Dimarco_2020",2020,"Hellas Verona","Serie A","Federico Dimarco","ITA","DF","21",1997,5.8,11,5,4,4,3,6,10,60,4,3,2,1,4,15,11,0,"https://fbref.com/en/players/970b8574/Federico-Dimarco"
"3649","Alan Empereur_2020",2020,"Hellas Verona","Serie A","Alan Empereur","BRA","DF","25",1994,9.5,16,8,11,4,1,6,10,60,4,19,12,7,22,38,36,0,"https://fbref.com/en/players/825b8997/Alan-Empereur"
"3650","Valentin Eysseric_2020",2020,"Hellas Verona","Serie A","Valentin Eysseric","FRA","MF,FW","27",1992,3.9,4,4,1,2,1,0,4,0,4,3,0,3,1,5,2,0,"https://fbref.com/en/players/ae82fa48/Valentin-Eysseric"
"3651","Davide Faraoni_2020",2020,"Hellas Verona","Serie A","Davide Faraoni","ITA","DF","27",1991,35.9,67,37,43,19,5,30,67,44.8,37,50,15,35,36,103,115,0,"https://fbref.com/en/players/aae9d04a/Davide-Faraoni"
"3652","Lucas Felippe_2020",2020,"Hellas Verona","Serie A","Lucas Felippe","BRA","MF,DF","19",2000,0.3,1,1,1,0,0,1,1,100,0,0,0,0,0,1,0,0,"https://fbref.com/en/players/85e51909/Lucas-Felippe"
"3653","Koray Günter_2020",2020,"Hellas Verona","Serie A","Koray Günter","GER","DF","24",1994,30.4,39,25,22,15,2,19,29,65.5,10,45,39,6,55,94,131,1,"https://fbref.com/en/players/f1f1f238/Koray-Gunter"
"3654","Liam Henderson_2020",2020,"Hellas Verona","Serie A","Liam Henderson","SCO","MF","23",1996,2.2,3,2,0,3,0,2,3,66.7,1,1,0,1,0,3,4,0,"https://fbref.com/en/players/d7918b13/Liam-Henderson"
"3655","Marash Kumbulla_2020",2020,"Hellas Verona","Serie A","Marash Kumbulla","ALB","DF","19",2000,21.7,40,24,21,17,2,19,36,52.8,17,33,24,9,50,90,86,3,"https://fbref.com/en/players/a40819d9/Marash-Kumbulla"
"3656","Darko Lazović_2020",2020,"Hellas Verona","Serie A","Darko Lazović","SRB","DF","28",1990,36,26,16,14,8,4,14,27,51.9,13,15,4,11,23,49,53,0,"https://fbref.com/en/players/5128bde4/Darko-Lazovic"
"3657","Matteo Lovato_2020",2020,"Hellas Verona","Serie A","Matteo Lovato","ITA","DF","19",2000,0.1,0,0,0,0,0,0,0,NA,0,0,0,0,0,0,1,0,"https://fbref.com/en/players/5fa57166/Matteo-Lovato"
"3658","Giampaolo Pazzini_2020",2020,"Hellas Verona","Serie A","Giampaolo Pazzini","ITA","FW,MF","34",1984,3.4,1,0,0,1,0,0,4,0,4,2,0,2,1,2,4,0,"https://fbref.com/en/players/6ca663b4/Giampaolo-Pazzini"
"3659","Matteo Pessina_2020",2020,"Hellas Verona","Serie A","Matteo Pessina","ITA","MF","22",1997,27.7,35,21,9,20,6,12,33,36.4,21,28,8,20,25,60,40,2,"https://fbref.com/en/players/780e3631/Matteo-Pessina"
"3660","Boris Radunović_2020",2020,"Hellas Verona","Serie A","Boris Radunović","SRB","GK","23",1996,3,0,0,0,0,0,0,0,NA,0,0,0,0,0,0,1,0,"https://fbref.com/en/players/0dfce079/Boris-Radunovic"
"3661","Amir Rrahmani_2020",2020,"Hellas Verona","Serie A","Amir Rrahmani","KVX","DF","25",1994,35.9,50,31,26,19,5,26,46,56.5,20,50,31,19,30,80,151,1,"https://fbref.com/en/players/4b3e1a38/Amir-Rrahmani"
"3662","Eddie Salcedo_2020",2020,"Hellas Verona","Serie A","Eddie Salcedo","ITA","FW,MF","17",2001,7.6,3,1,2,0,1,0,5,0,5,4,0,4,1,4,2,0,"https://fbref.com/en/players/0489bb30/Eddie-Salcedo"
"3663","Marco Silvestri_2020",2020,"Hellas Verona","Serie A","Marco Silvestri","ITA","GK","28",1991,35,1,0,1,0,0,1,2,50,1,0,0,0,4,5,11,1,"https://fbref.com/en/players/0d422df7/Marco-Silvestri"
"3664","Mariusz Stępiński_2020",2020,"Hellas Verona","Serie A","Mariusz Stępiński","POL","FW,MF","24",1995,7.8,5,3,2,1,2,1,2,50,1,3,1,2,1,6,7,0,"https://fbref.com/en/players/7b536033/Mariusz-Stepinski"
"3665","Gennaro Tutino_2020",2020,"Hellas Verona","Serie A","Gennaro Tutino","ITA","FW,MF","22",1996,2.5,0,0,0,0,0,0,0,NA,0,0,0,0,2,2,1,0,"https://fbref.com/en/players/8b303bcb/Gennaro-Tutino"
"3666","Miguel Veloso_2020",2020,"Hellas Verona","Serie A","Miguel Veloso","POR","MF","33",1986,31.2,52,29,20,28,4,18,60,30,42,36,12,24,32,84,46,1,"https://fbref.com/en/players/ab1ca213/Miguel-Veloso"
"3667","Valerio Verre_2020",2020,"Hellas Verona","Serie A","Valerio Verre","ITA","MF,FW","25",1994,19.7,25,15,4,11,10,9,23,39.1,14,5,0,5,13,38,9,0,"https://fbref.com/en/players/33ecf462/Valerio-Verre"
"3668","Luigi Vitale_2020",2020,"Hellas Verona","Serie A","Luigi Vitale","ITA","DF","31",1987,0.5,1,0,0,1,0,0,0,NA,0,1,0,1,0,1,0,0,"https://fbref.com/en/players/fe479e17/Luigi-Vitale"
"3669","Mattia Zaccagni_2020",2020,"Hellas Verona","Serie A","Mattia Zaccagni","ITA","MF,FW","24",1995,23.5,20,11,10,5,5,3,15,20,12,14,3,11,20,40,21,0,"https://fbref.com/en/players/d85c238b/Mattia-Zaccagni"
"3670","Santiago Ascacíbar_2020",2020,"Hertha BSC","Bundesliga","Santiago Ascacíbar","ARG","MF","22",1997,7,26,13,15,11,0,11,28,39.3,17,13,2,11,16,42,13,0,"https://fbref.com/en/players/e26fcca3/Santiago-Ascacibar"
"3671","Dedryck Boyata_2020",2020,"Hertha BSC","Bundesliga","Dedryck Boyata","BEL","DF","28",1990,27.1,24,18,17,5,2,4,12,33.3,8,39,32,7,62,86,158,1,"https://fbref.com/en/players/7c473e12/Dedryck-Boyata"
"3672","Per Ciljan Skjelbred_2020",2020,"Hertha BSC","Bundesliga","Per Ciljan Skjelbred","NOR","MF","32",1987,18.1,50,30,18,29,3,17,41,41.5,24,14,3,11,23,73,17,0,"https://fbref.com/en/players/ecab64a0/Per-Ciljan-Skjelbred"
"3673","Matheus Cunha_2020",2020,"Hertha BSC","Bundesliga","Matheus Cunha","BRA","FW,MF","20",1999,8.3,10,5,6,4,0,4,11,36.4,7,11,1,10,10,20,1,0,"https://fbref.com/en/players/dc62b55d/Matheus-Cunha"
"3674","Vladimír Darida_2020",2020,"Hertha BSC","Bundesliga","Vladimír Darida","CZE","MF","28",1990,25.1,50,27,14,31,5,11,48,22.9,37,44,7,37,27,77,19,2,"https://fbref.com/en/players/3eb0f2df/Vladimir-Darida"
"3675","Javairô Dilrosun_2020",2020,"Hertha BSC","Bundesliga","Javairô Dilrosun","NED","MF,FW","21",1998,14.5,15,8,11,1,3,5,13,38.5,8,20,0,20,18,33,10,0,"https://fbref.com/en/players/34a0f5ff/Javairo-Dilrosun"
"3676","Ondrej Duda_2020",2020,"Hertha BSC","Bundesliga","Ondrej Duda","SVK","MF","24",1994,5,6,4,1,2,3,1,10,10,9,3,1,2,5,11,5,0,"https://fbref.com/en/players/79ca3e23/Ondrej-Duda"
"3677","Alexander Esswein_2020",2020,"Hertha BSC","Bundesliga","Alexander Esswein","GER","FW,MF","29",1990,2.4,6,4,4,2,0,3,8,37.5,5,8,1,7,7,13,7,1,"https://fbref.com/en/players/b48215cd/Alexander-Esswein"
"3678","Marko Grujić_2020",2020,"Hertha BSC","Bundesliga","Marko Grujić","SRB","MF","23",1996,26.8,56,34,21,30,5,19,63,30.2,44,43,9,34,22,78,69,0,"https://fbref.com/en/players/8b8e759d/Marko-Grujic"
"3679","Vedad Ibišević_2020",2020,"Hertha BSC","Bundesliga","Vedad Ibišević","BIH","FW","34",1984,14,4,3,0,1,3,0,3,0,3,4,0,4,1,5,15,0,"https://fbref.com/en/players/c3fd9887/Vedad-Ibisevic"
"3680","Rune Jarstein_2020",2020,"Hertha BSC","Bundesliga","Rune Jarstein","NOR","GK","34",1984,28.3,4,1,4,0,0,2,3,66.7,1,0,0,0,1,5,11,3,"https://fbref.com/en/players/27d2618c/Rune-Jarstein"
"3681","Salomon Kalou_2020",2020,"Hertha BSC","Bundesliga","Salomon Kalou","CIV","FW,MF","33",1985,1.6,1,0,1,0,0,0,2,0,2,2,0,2,0,1,1,0,"https://fbref.com/en/players/2042d931/Salomon-Kalou"
"3682","Lukas Klünter_2020",2020,"Hertha BSC","Bundesliga","Lukas Klünter","GER","DF","23",1996,20.9,44,31,26,16,2,20,30,66.7,10,16,4,12,27,71,61,1,"https://fbref.com/en/players/92948149/Lukas-Klunter"
"3683","Pascal Köpke_2020",2020,"Hertha BSC","Bundesliga","Pascal Köpke","GER","FW","23",1995,1.3,0,0,0,0,0,0,0,NA,0,0,0,0,0,0,0,0,"https://fbref.com/en/players/3861d9cc/Pascal-Kopke"
"3684","Thomas Kraft_2020",2020,"Hertha BSC","Bundesliga","Thomas Kraft","GER","GK","31",1988,4,0,0,0,0,0,0,0,NA,0,0,0,0,1,1,0,0,"https://fbref.com/en/players/bb25c778/Thomas-Kraft"
"3685","Mathew Leckie_2020",2020,"Hertha BSC","Bundesliga","Mathew Leckie","AUS","DF,FW","28",1991,2.2,3,1,1,2,0,2,3,66.7,1,6,0,6,2,5,2,1,"https://fbref.com/en/players/b93b7882/Mathew-Leckie"
"3686","Eduard Löwen_2020",2020,"Hertha BSC","Bundesliga","Eduard Löwen","GER","MF","22",1997,3.5,9,6,3,6,0,5,11,45.5,6,2,1,1,7,16,2,0,"https://fbref.com/en/players/70678132/Eduard-Lowen"
"3687","Dodi Lukebakio_2020",2020,"Hertha BSC","Bundesliga","Dodi Lukebakio","BEL","FW,MF","21",1997,22.6,25,18,13,8,4,10,28,35.7,18,22,4,18,10,35,14,0,"https://fbref.com/en/players/0c61c77c/Dodi-Lukebakio"
"3688","Arne Maier_2020",2020,"Hertha BSC","Bundesliga","Arne Maier","GER","MF","20",1999,5.9,9,7,6,1,2,1,10,10,9,5,0,5,7,16,2,1,"https://fbref.com/en/players/ab700320/Arne-Maier"
"3689","Maximilian Mittelstädt_2020",2020,"Hertha BSC","Bundesliga","Maximilian Mittelstädt","GER","DF,FW","22",1997,21,61,38,31,25,5,26,54,48.1,28,38,6,32,53,114,64,0,"https://fbref.com/en/players/88d4144a/Maximilian-Mittelstadt"
"3690","Jessic Ngankam_2020",2020,"Hertha BSC","Bundesliga","Jessic Ngankam","GER","FW,MF","19",2000,0.9,2,2,1,1,0,2,2,100,0,2,0,2,0,2,1,0,"https://fbref.com/en/players/bc249af8/Jessic-Ngankam"
"3691","Peter Pekarík_2020",2020,"Hertha BSC","Bundesliga","Peter Pekarík","SVK","DF,FW","32",1986,8.5,14,7,7,3,4,8,20,40,12,11,4,7,7,21,31,0,"https://fbref.com/en/players/c18d22f5/Peter-Pekarik"
"3692","Krzysztof Piątek_2020",2020,"Hertha BSC","Bundesliga","Krzysztof Piątek","POL","FW","24",1995,10.1,5,4,1,1,3,0,11,0,11,7,0,7,5,10,3,0,"https://fbref.com/en/players/17f3620a/Krzysztof-Piatek"
"3693","Marvin Plattenhardt_2020",2020,"Hertha BSC","Bundesliga","Marvin Plattenhardt","GER","DF","27",1992,15.5,18,12,13,4,1,12,17,70.6,5,18,7,11,11,29,47,0,"https://fbref.com/en/players/f7aa75bd/Marvin-Plattenhardt"
"3694","Daishawn Redan_2020",2020,"Hertha BSC","Bundesliga","Daishawn Redan","NED","MF","18",2001,0.2,0,0,0,0,0,0,1,0,1,0,0,0,0,0,0,0,"https://fbref.com/en/players/16b4260e/Daishawn-Redan"
"3695","Karim Rekik_2020",2020,"Hertha BSC","Bundesliga","Karim Rekik","NED","DF","24",1994,14,16,10,10,6,0,3,6,50,3,23,15,8,18,34,44,0,"https://fbref.com/en/players/3376a776/Karim-Rekik"
"3696","Lazar Samardzic_2020",2020,"Hertha BSC","Bundesliga","Lazar Samardzic","SRB","MF,FW","17",2002,0.4,4,4,2,2,0,1,4,25,3,2,1,1,0,4,0,0,"https://fbref.com/en/players/217c93a1/Lazar-Samardzic"
"3697","Davie Selke_2020",2020,"Hertha BSC","Bundesliga","Davie Selke","GER","FW","24",1995,10.7,6,3,2,2,2,4,7,57.1,3,7,1,6,1,7,11,0,"https://fbref.com/en/players/1238a3f9/Davie-Selke"
"3698","Dennis Smarsch_2020",2020,"Hertha BSC","Bundesliga","Dennis Smarsch","GER","GK","20",1999,1.7,0,0,0,0,0,0,0,NA,0,0,0,0,0,0,1,0,"https://fbref.com/en/players/45f6f52b/Dennis-Smarsch"
"3699","Niklas Stark_2020",2020,"Hertha BSC","Bundesliga","Niklas Stark","GER","DF","24",1995,19.2,36,20,24,10,2,9,21,42.9,12,27,12,15,21,57,97,2,"https://fbref.com/en/players/aad48be9/Niklas-Stark"
"3700","Jordan Torunarigha_2020",2020,"Hertha BSC","Bundesliga","Jordan Torunarigha","GER","DF","21",1997,16.2,32,19,21,11,0,18,27,66.7,9,33,18,15,31,63,75,0,"https://fbref.com/en/players/f86cabbd/Jordan-Torunarigha"
"3701","Marius Wolf_2020",2020,"Hertha BSC","Bundesliga","Marius Wolf","GER","FW,MF","24",1995,15.7,19,11,9,7,3,10,27,37,17,14,1,13,17,36,13,0,"https://fbref.com/en/players/fa661778/Marius-Wolf"
"3702","Sargis Adamyan_2020",2020,"Hoffenheim","Bundesliga","Sargis Adamyan","ARM","FW,MF","26",1993,8.3,11,7,3,6,2,3,21,14.3,18,8,1,7,2,13,4,0,"https://fbref.com/en/players/22919e97/Sargis-Adamyan"
"3703","Kevin Akpoguma_2020",2020,"Hoffenheim","Bundesliga","Kevin Akpoguma","NGA","DF","24",1995,12.7,24,16,20,4,0,13,24,54.2,11,21,11,10,13,37,48,0,"https://fbref.com/en/players/6ec6fde0/Kevin-Akpoguma"
"3704","Oliver Baumann_2020",2020,"Hoffenheim","Bundesliga","Oliver Baumann","GER","GK","29",1990,30,0,0,0,0,0,0,0,NA,0,1,0,1,3,3,15,0,"https://fbref.com/en/players/47064058/Oliver-Baumann"
"3705","Christoph Baumgartner_2020",2020,"Hoffenheim","Bundesliga","Christoph Baumgartner","AUT","MF,FW","19",1999,16.6,32,17,15,16,1,10,37,27,27,25,1,24,8,40,13,0,"https://fbref.com/en/players/437f2b00/Christoph-Baumgartner"
"3706","Ihlas Bebou_2020",2020,"Hoffenheim","Bundesliga","Ihlas Bebou","TOG","FW,MF","25",1994,23.4,27,15,9,13,5,8,23,34.8,15,25,4,21,11,38,25,0,"https://fbref.com/en/players/a53b661f/Ihlas-Bebou"
"3707","Maximilian Beier_2020",2020,"Hoffenheim","Bundesliga","Maximilian Beier","GER","FW","16",2002,1.2,5,2,0,1,4,1,2,50,1,2,0,2,0,5,0,0,"https://fbref.com/en/players/5db45ee5/Maximilian-Beier"
"3708","Ishak Belfodil_2020",2020,"Hoffenheim","Bundesliga","Ishak Belfodil","ALG","FW,MF","27",1992,3,0,0,0,0,0,0,1,0,1,0,0,0,0,0,2,0,"https://fbref.com/en/players/ff182fdc/Ishak-Belfodil"
"3709","Ermin Bičakčić_2020",2020,"Hoffenheim","Bundesliga","Ermin Bičakčić","BIH","DF","29",1990,13.1,7,3,5,2,0,4,11,36.4,7,14,8,6,25,32,64,2,"https://fbref.com/en/players/7aac47fe/Ermin-Bicakcic"
"3710","Leonardo Bittencourt_2020",2020,"Hoffenheim","Bundesliga","Leonardo Bittencourt","GER","MF","25",1993,0,1,1,0,0,1,0,0,NA,0,0,0,0,0,1,0,0,"https://fbref.com/en/players/dc62fbee/Leonardo-Bittencourt"
"3711","Melayro Bogarde_2020",2020,"Hoffenheim","Bundesliga","Melayro Bogarde","NED","DF","17",2002,0.6,2,1,2,0,0,2,2,100,0,0,0,0,0,2,3,0,"https://fbref.com/en/players/1fda91b3/Melayro-Bogarde"
"3712","Jacob Bruun Larsen_2020",2020,"Hoffenheim","Bundesliga","Jacob Bruun Larsen","DEN","FW,MF","20",1998,4.3,3,2,3,0,0,3,8,37.5,5,3,0,3,3,6,1,0,"https://fbref.com/en/players/4e204552/Jacob-Bruun-Larsen"
"3713","Moanes Dabbur_2020",2020,"Hoffenheim","Bundesliga","Moanes Dabbur","ISR","FW","27",1992,8.5,8,5,1,3,4,3,10,30,7,6,2,4,4,12,1,0,"https://fbref.com/en/players/eac044ad/Moanes-Dabbur"
"3714","Ilay Elmkies_2020",2020,"Hoffenheim","Bundesliga","Ilay Elmkies","ISR","MF","19",2000,0,1,1,1,0,0,0,0,NA,0,0,0,0,0,1,0,0,"https://fbref.com/en/players/6cb0211b/Ilay-Elmkies"
"3715","Dennis Geiger_2020",2020,"Hoffenheim","Bundesliga","Dennis Geiger","GER","MF","21",1998,12.6,12,5,4,6,2,2,16,12.5,14,9,2,7,6,18,4,0,"https://fbref.com/en/players/37f606f0/Dennis-Geiger"
"3716","Vincenzo Grifo_2020",2020,"Hoffenheim","Bundesliga","Vincenzo Grifo","ITA","MF","26",1993,0.2,0,0,0,0,0,0,0,NA,0,0,0,0,0,0,0,0,"https://fbref.com/en/players/54e4866f/Vincenzo-Grifo"
"3717","Florian Grillitsch_2020",2020,"Hoffenheim","Bundesliga","Florian Grillitsch","AUT","MF,DF","23",1995,26.8,59,29,34,24,1,29,61,47.5,32,33,6,27,49,108,41,1,"https://fbref.com/en/players/ffbbc83b/Florian-Grillitsch"
"3718","Benjamin Hübner_2020",2020,"Hoffenheim","Bundesliga","Benjamin Hübner","GER","DF","30",1989,23,42,26,33,9,0,23,45,51.1,22,18,13,5,30,72,98,2,"https://fbref.com/en/players/99de6b6f/Benjamin-Hubner"
"3719","Pavel Kadeřábek_2020",2020,"Hoffenheim","Bundesliga","Pavel Kadeřábek","CZE","DF,FW","27",1992,27.5,32,22,17,13,2,13,30,43.3,17,29,7,22,27,59,55,1,"https://fbref.com/en/players/79c90e45/Pavel-Kaderabek"
"3720","Andrej Kramarić_2020",2020,"Hoffenheim","Bundesliga","Andrej Kramarić","CRO","FW,MF","28",1991,15.8,2,1,1,0,1,1,7,14.3,6,6,0,6,3,5,4,0,"https://fbref.com/en/players/603cb947/Andrej-Kramaric"
"3721","Jürgen Locadia_2020",2020,"Hoffenheim","Bundesliga","Jürgen Locadia","NED","FW","25",1993,5.9,5,4,0,4,1,1,4,25,3,1,0,1,0,5,3,0,"https://fbref.com/en/players/6cc47ae1/Jurgen-Locadia"
"3722","Håvard Nordtveit_2020",2020,"Hoffenheim","Bundesliga","Håvard Nordtveit","NOR","DF","29",1990,7.8,4,1,3,1,0,3,7,42.9,4,17,12,5,13,17,45,0,"https://fbref.com/en/players/6cafd68d/Havard-Nordtveit"
"3723","Philipp Pentke_2020",2020,"Hoffenheim","Bundesliga","Philipp Pentke","GER","GK","34",1985,4,0,0,0,0,0,0,0,NA,0,0,0,0,0,0,2,0,"https://fbref.com/en/players/c41f7379/Philipp-Pentke"
"3724","Stefan Posch_2020",2020,"Hoffenheim","Bundesliga","Stefan Posch","AUT","DF","22",1997,25.6,63,34,35,27,1,35,63,55.6,28,57,25,32,40,103,101,1,"https://fbref.com/en/players/7f609bfc/Stefan-Posch"
"3725","Lucas Ribeiro_2020",2020,"Hoffenheim","Bundesliga","Lucas Ribeiro","BRA","MF","20",1999,0.7,1,0,1,0,0,0,3,0,3,1,0,1,1,2,1,0,"https://fbref.com/en/players/607d64c6/Lucas-Ribeiro"
"3726","Sebastian Rudy_2020",2020,"Hoffenheim","Bundesliga","Sebastian Rudy","GER","MF,DF","29",1990,30.4,73,49,31,29,13,28,75,37.3,47,26,5,21,27,100,38,0,"https://fbref.com/en/players/80f36c88/Sebastian-Rudy"
"3727","Lukas Rupp_2020",2020,"Hoffenheim","Bundesliga","Lukas Rupp","GER","MF","28",1991,3.8,9,4,3,5,1,3,6,50,3,5,0,5,5,14,3,0,"https://fbref.com/en/players/3faa1780/Lukas-Rupp"
"3728","Diadie Samassékou_2020",2020,"Hoffenheim","Bundesliga","Diadie Samassékou","MLI","MF","23",1996,14.6,37,18,14,17,6,12,34,35.3,22,25,8,17,40,77,27,1,"https://fbref.com/en/players/08593525/Diadie-Samassekou"
"3729","Robert Skov_2020",2020,"Hoffenheim","Bundesliga","Robert Skov","DEN","DF,FW","23",1996,29,41,28,30,9,2,26,50,52,24,26,6,20,20,61,40,0,"https://fbref.com/en/players/ff98492b/Robert-Skov"
"3730","Kostas Stafylidis_2020",2020,"Hoffenheim","Bundesliga","Kostas Stafylidis","GRE","DF","25",1993,4.4,10,3,7,2,1,4,10,40,6,10,3,7,2,12,17,0,"https://fbref.com/en/players/861e0116/Kostas-Stafylidis"
"3731","Kevin Vogt_2020",2020,"Hoffenheim","Bundesliga","Kevin Vogt","GER","DF","27",1991,10.7,7,5,4,3,0,3,9,33.3,6,12,6,6,8,15,52,1,"https://fbref.com/en/players/1d8e9add/Kevin-Vogt"
"3732","Steven Zuber_2020",2020,"Hoffenheim","Bundesliga","Steven Zuber","SUI","DF,FW","27",1991,8.3,11,10,7,2,2,9,19,47.4,10,4,1,3,9,20,12,0,"https://fbref.com/en/players/b6a6e0a7/Steven-Zuber"
"3733","Lucien Agoume_2020",2020,"Inter","Serie A","Lucien Agoume","FRA","MF","17",2002,0.8,3,2,0,2,1,0,0,NA,0,3,1,2,0,3,0,0,"https://fbref.com/en/players/8bc8829a/Lucien-Agoume"
"3734","Kwadwo Asamoah_2020",2020,"Inter","Serie A","Kwadwo Asamoah","GHA","DF,FW","30",1988,7.1,10,8,4,5,1,6,14,42.9,8,8,1,7,9,19,13,0,"https://fbref.com/en/players/089550f5/Kwadwo-Asamoah"
"3735","Nicolò Barella_2020",2020,"Inter","Serie A","Nicolò Barella","ITA","MF","22",1997,22.4,36,21,14,15,7,8,37,21.6,29,20,5,15,14,50,14,0,"https://fbref.com/en/players/6928979a/Nicolo-Barella"
"3736","Alessandro Bastoni_2020",2020,"Inter","Serie A","Alessandro Bastoni","ITA","DF","20",1999,21.3,32,17,14,11,7,15,24,62.5,9,18,9,9,26,58,54,0,"https://fbref.com/en/players/75b86fb3/Alessandro-Bastoni"
"3737","Cristiano Biraghi_2020",2020,"Inter","Serie A","Cristiano Biraghi","ITA","DF","26",1992,17.5,22,6,10,8,4,10,24,41.7,14,21,7,14,13,35,41,0,"https://fbref.com/en/players/9e1577aa/Cristiano-Biraghi"
"3738","Marcelo Brozović_2020",2020,"Inter","Serie A","Marcelo Brozović","CRO","MF","26",1992,30,67,35,26,31,10,19,71,26.8,52,26,9,17,46,113,46,2,"https://fbref.com/en/players/33b8d077/Marcelo-Brozovic"
"3739","Antonio Candreva_2020",2020,"Inter","Serie A","Antonio Candreva","ITA","DF","32",1987,22.1,11,6,9,1,1,7,29,24.1,22,26,10,16,14,25,33,1,"https://fbref.com/en/players/356c9002/Antonio-Candreva"
"3740","Danilo D'Ambrosio_2020",2020,"Inter","Serie A","Danilo D'Ambrosio","ITA","DF","30",1988,15.6,30,16,16,12,2,16,33,48.5,17,15,4,11,14,44,25,0,"https://fbref.com/en/players/44eb9093/Danilo-DAmbrosio"
"3741","Federico Dimarco_2020",2020,"Inter","Serie A","Federico Dimarco","ITA","DF","21",1997,0.3,1,0,0,1,0,0,0,NA,0,0,0,0,1,2,1,0,"https://fbref.com/en/players/970b8574/Federico-Dimarco"
"3742","Christian Eriksen_2020",2020,"Inter","Serie A","Christian Eriksen","DEN","MF","27",1992,7.8,11,6,2,8,1,5,20,25,15,3,0,3,0,11,0,0,"https://fbref.com/en/players/980522ec/Christian-Eriksen"
"3743","Sebastiano Esposito_2020",2020,"Inter","Serie A","Sebastiano Esposito","ITA","FW","17",2002,2.2,3,2,0,2,1,0,5,0,5,3,0,3,3,6,1,0,"https://fbref.com/en/players/7ff93107/Sebastiano-Esposito"
"3744","Roberto Gagliardini_2020",2020,"Inter","Serie A","Roberto Gagliardini","ITA","MF","25",1994,20,38,19,12,18,8,14,41,34.1,27,28,8,20,30,68,20,1,"https://fbref.com/en/players/ce30bfc8/Roberto-Gagliardini"
"3745","Diego Godín_2020",2020,"Inter","Serie A","Diego Godín","URU","DF","33",1986,18.1,38,29,19,16,3,18,32,56.3,14,17,7,10,45,83,60,1,"https://fbref.com/en/players/fc4f85b1/Diego-Godin"
"3746","Samir Handanović_2020",2020,"Inter","Serie A","Samir Handanović","SVN","GK","35",1984,35,1,1,1,0,0,0,1,0,1,0,0,0,0,1,8,3,"https://fbref.com/en/players/74419746/Samir-Handanovic"
"3747","Valentino Lazaro_2020",2020,"Inter","Serie A","Valentino Lazaro","AUT","DF","23",1996,3.6,6,5,3,2,1,4,8,50,4,5,0,5,1,7,8,1,"https://fbref.com/en/players/016ff750/Valentino-Lazaro"
"3748","Romelu Lukaku_2020",2020,"Inter","Serie A","Romelu Lukaku","BEL","FW","26",1993,33.1,13,7,4,7,2,3,10,30,7,14,6,8,1,14,28,0,"https://fbref.com/en/players/5eae500a/Romelu-Lukaku"
"3749","Lautaro Martínez_2020",2020,"Inter","Serie A","Lautaro Martínez","ARG","FW","21",1997,27.2,22,7,2,8,12,4,34,11.8,30,30,2,28,15,37,11,0,"https://fbref.com/en/players/f7036e1c/Lautaro-Martinez"
"3750","Victor Moses_2020",2020,"Inter","Serie A","Victor Moses","NGA","DF","28",1990,4.7,4,3,1,2,1,2,8,25,6,4,0,4,0,4,4,0,"https://fbref.com/en/players/e726e11e/Victor-Moses"
"3751","Daniele Padelli_2020",2020,"Inter","Serie A","Daniele Padelli","ITA","GK","33",1985,3,0,0,0,0,0,0,0,NA,0,0,0,0,0,0,1,1,"https://fbref.com/en/players/cf1c23d8/Daniele-Padelli"
"3752","Lorenzo Pirola_2020",2020,"Inter","Serie A","Lorenzo Pirola","ITA","DF","17",2002,0.1,0,0,0,0,0,0,0,NA,0,0,0,0,1,1,0,0,"https://fbref.com/en/players/caec77da/Lorenzo-Pirola"
"3753","Matteo Politano_2020",2020,"Inter","Serie A","Matteo Politano","ITA","FW,MF","25",1993,2.9,0,0,0,0,0,0,2,0,2,1,0,1,0,0,1,0,"https://fbref.com/en/players/5e861944/Matteo-Politano"
"3754","Andrea Ranocchia_2020",2020,"Inter","Serie A","Andrea Ranocchia","ITA","DF","31",1988,5.8,17,10,10,7,0,5,8,62.5,3,11,6,5,8,25,18,0,"https://fbref.com/en/players/539230cf/Andrea-Ranocchia"
"3755","Alexis Sánchez_2020",2020,"Inter","Serie A","Alexis Sánchez","CHI","FW","30",1988,10.3,9,7,1,4,4,5,13,38.5,8,7,0,7,3,12,1,0,"https://fbref.com/en/players/2c0f8e9e/Alexis-Sanchez"
"3756","Stefano Sensi_2020",2020,"Inter","Serie A","Stefano Sensi","ITA","MF","23",1995,8,18,10,10,7,1,6,22,27.3,16,15,1,14,9,27,4,0,"https://fbref.com/en/players/b70bde8f/Stefano-Sensi"
"3757","Milan Škriniar_2020",2020,"Inter","Serie A","Milan Škriniar","SVK","DF","24",1995,29.2,39,20,24,14,1,14,33,42.4,19,19,11,8,28,67,85,1,"https://fbref.com/en/players/30f5ffa9/Milan-Skriniar"
"3758","Borja Valero_2020",2020,"Inter","Serie A","Borja Valero","ESP","MF","34",1985,10.3,18,7,9,3,6,6,24,25,18,12,3,9,8,26,9,0,"https://fbref.com/en/players/0e21fc3c/Borja-Valero"
"3759","Matías Vecino_2020",2020,"Inter","Serie A","Matías Vecino","URU","MF","27",1991,14.2,31,20,14,11,6,9,36,25,27,20,3,17,15,46,26,0,"https://fbref.com/en/players/44ac04e9/Matias-Vecino"
"3760","Stefan de Vrij_2020",2020,"Inter","Serie A","Stefan de Vrij","NED","DF","27",1992,31.4,33,18,20,12,1,14,27,51.9,13,34,24,10,52,85,121,1,"https://fbref.com/en/players/d0d8dd44/Stefan-de-Vrij"
"3761","Ashley Young_2020",2020,"Inter","Serie A","Ashley Young","ENG","DF","34",1985,13.2,11,5,3,5,3,6,19,31.6,13,11,3,8,14,25,24,0,"https://fbref.com/en/players/be927d03/Ashley-Young"
"3762","Rodrigo Bentancur_2020",2020,"Juventus","Serie A","Rodrigo Bentancur","URU","MF","22",1997,24.4,58,32,27,18,13,31,66,47,35,44,9,35,32,90,34,1,"https://fbref.com/en/players/3b8674e6/Rodrigo-Bentancur"
"3763","Federico Bernardeschi_2020",2020,"Juventus","Serie A","Federico Bernardeschi","ITA","MF,FW","25",1994,17.5,13,5,4,5,4,5,25,20,20,11,0,11,13,26,12,1,"https://fbref.com/en/players/ee93c1a9/Federico-Bernardeschi"
"3764","Leonardo Bonucci_2020",2020,"Juventus","Serie A","Leonardo Bonucci","ITA","DF","32",1987,34.2,28,17,18,8,2,12,17,70.6,5,32,29,3,31,59,94,2,"https://fbref.com/en/players/52ec54d0/Leonardo-Bonucci"
"3765","Gianluigi Buffon_2020",2020,"Juventus","Serie A","Gianluigi Buffon","ITA","GK","41",1978,9,0,0,0,0,0,0,0,NA,0,0,0,0,0,0,3,1,"https://fbref.com/en/players/e40d028b/Gianluigi-Buffon"
"3766","Emre Can_2020",2020,"Juventus","Serie A","Emre Can","GER","MF","25",1994,3.2,10,7,5,3,2,3,10,30,7,4,0,4,2,12,3,0,"https://fbref.com/en/players/a65ce836/Emre-Can"
"3767","Giorgio Chiellini_2020",2020,"Juventus","Serie A","Giorgio Chiellini","ITA","DF","34",1984,2.2,3,0,3,0,0,1,1,100,0,2,2,0,1,4,9,0,"https://fbref.com/en/players/e85fb9b8/Giorgio-Chiellini"
"3768","Douglas Costa_2020",2020,"Juventus","Serie A","Douglas Costa","BRA","FW,MF","28",1990,8.9,2,1,1,1,0,1,12,8.3,11,7,0,7,5,7,5,0,"https://fbref.com/en/players/4fa7cb9b/Douglas-Costa"
"3769","Juan Cuadrado_2020",2020,"Juventus","Serie A","Juan Cuadrado","COL","DF,FW","31",1988,29.5,67,43,32,28,7,35,62,56.5,27,22,8,14,35,102,47,0,"https://fbref.com/en/players/0ab1f153/Juan-Cuadrado"
"3770","Danilo_2020",2020,"Juventus","Serie A","Danilo","BRA","DF","28",1991,16,30,20,16,12,2,18,30,60,12,12,3,9,26,56,44,0,"https://fbref.com/en/players/94b2001f/Danilo"
"3771","Mattia De Sciglio_2020",2020,"Juventus","Serie A","Mattia De Sciglio","ITA","DF","26",1992,5.2,10,8,6,4,0,6,14,42.9,8,5,2,3,8,18,18,1,"https://fbref.com/en/players/ae4e2852/Mattia-De-Sciglio"
"3772","Merih Demiral_2020",2020,"Juventus","Serie A","Merih Demiral","TUR","DF","21",1998,4.6,8,7,5,3,0,1,3,33.3,2,4,3,1,4,12,16,1,"https://fbref.com/en/players/e3cceee6/Merih-Demiral"
"3773","Paulo Dybala_2020",2020,"Juventus","Serie A","Paulo Dybala","ARG","FW,MF","25",1993,23.9,19,10,6,9,4,9,39,23.1,30,15,0,15,13,32,3,0,"https://fbref.com/en/players/e0921a4f/Paulo-Dybala"
"3774","Gianluca Frabotta_2020",2020,"Juventus","Serie A","Gianluca Frabotta","ITA","DF","20",1999,1,3,1,0,2,1,2,2,100,0,2,0,2,1,4,2,0,"https://fbref.com/en/players/d80b1835/Gianluca-Frabotta"
"3775","Gonzalo Higuaín_2020",2020,"Juventus","Serie A","Gonzalo Higuaín","ARG","FW","31",1987,20.7,13,7,2,6,5,4,31,12.9,27,12,0,12,6,19,14,0,"https://fbref.com/en/players/8a08491a/Gonzalo-Higuain"
"3776","Sami Khedira_2020",2020,"Juventus","Serie A","Sami Khedira","GER","MF","32",1987,7.6,14,7,3,8,3,4,19,21.1,15,12,1,11,3,17,13,0,"https://fbref.com/en/players/38ac43d3/Sami-Khedira"
"3777","Matthijs de Ligt_2020",2020,"Juventus","Serie A","Matthijs de Ligt","NED","DF","19",1999,27.2,25,15,14,10,1,13,23,56.5,10,30,23,7,25,50,101,2,"https://fbref.com/en/players/d6e53a3a/Matthijs-de-Ligt"
"3778","Blaise Matuidi_2020",2020,"Juventus","Serie A","Blaise Matuidi","FRA","MF","32",1987,24.9,48,27,13,27,8,13,34,38.2,21,35,6,29,22,70,16,0,"https://fbref.com/en/players/c0cddebe/Blaise-Matuidi"
"3779","Simone Muratore_2020",2020,"Juventus","Serie A","Simone Muratore","ITA","MF","21",1998,1.8,2,0,0,1,1,1,3,33.3,2,1,0,1,3,5,0,0,"https://fbref.com/en/players/04989945/Simone-Muratore"
"3780","Marco Olivieri_2020",2020,"Juventus","Serie A","Marco Olivieri","ITA","FW","20",1999,0.3,1,1,1,0,0,1,2,50,1,0,0,0,0,1,0,0,"https://fbref.com/en/players/f5ba8903/Marco-Olivieri"
"3781","Daouda Peeters_2020",2020,"Juventus","Serie A","Daouda Peeters","BEL","MF","20",1999,0.2,1,0,0,1,0,1,1,100,0,0,0,0,0,1,0,0,"https://fbref.com/en/players/e83f8ebb/Daouda-Peeters"
"3782","Carlo Pinsoglio_2020",2020,"Juventus","Serie A","Carlo Pinsoglio","ITA","GK","29",1990,0.2,0,0,0,0,0,0,0,NA,0,0,0,0,0,0,0,0,"https://fbref.com/en/players/f6a06749/Carlo-Pinsoglio"
"3783","Miralem Pjanić_2020",2020,"Juventus","Serie A","Miralem Pjanić","BIH","MF","29",1990,25.3,46,21,16,23,7,21,63,33.3,42,29,12,17,32,78,30,0,"https://fbref.com/en/players/ad6df2d5/Miralem-Pjanic"
"3784","Adrien Rabiot_2020",2020,"Juventus","Serie A","Adrien Rabiot","FRA","MF","24",1995,21.2,47,31,16,19,12,15,41,36.6,26,36,6,30,32,79,19,0,"https://fbref.com/en/players/8794e251/Adrien-Rabiot"
"3785","Aaron Ramsey_2020",2020,"Juventus","Serie A","Aaron Ramsey","WAL","MF","28",1990,11.7,20,15,6,8,6,6,24,25,18,18,3,15,11,31,12,0,"https://fbref.com/en/players/ef619b0b/Aaron-Ramsey"
"3786","Cristiano Ronaldo_2020",2020,"Juventus","Serie A","Cristiano Ronaldo","POR","FW","34",1985,32.4,14,10,3,3,8,4,20,20,16,10,3,7,6,20,21,1,"https://fbref.com/en/players/dea698d9/Cristiano-Ronaldo"
"3787","Daniele Rugani_2020",2020,"Juventus","Serie A","Daniele Rugani","ITA","DF","25",1994,7.7,8,6,4,4,0,4,5,80,1,4,4,0,11,19,18,0,"https://fbref.com/en/players/14b8fcdf/Daniele-Rugani"
"3788","Alex Sandro_2020",2020,"Juventus","Serie A","Alex Sandro","BRA","DF","28",1991,26.5,44,26,23,14,7,12,33,36.4,21,26,6,20,47,91,46,3,"https://fbref.com/en/players/0d82903c/Alex-Sandro"
"3789","Wojciech Szczęsny_2020",2020,"Juventus","Serie A","Wojciech Szczęsny","POL","GK","29",1990,28.8,0,0,0,0,0,0,0,NA,0,0,0,0,1,1,10,1,"https://fbref.com/en/players/01b8a2b2/Wojciech-Szczesny"
"3790","Giacomo Vrioni_2020",2020,"Juventus","Serie A","Giacomo Vrioni","ALB","FW","20",1998,0.1,0,0,0,0,0,0,0,NA,0,0,0,0,0,0,0,0,"https://fbref.com/en/players/bf4d31d3/Giacomo-Vrioni"
"3791","Luca Zanimacchia_2020",2020,"Juventus","Serie A","Luca Zanimacchia","ITA","FW,MF","21",1998,1.3,5,1,1,2,2,1,2,50,1,1,0,1,0,5,0,0,"https://fbref.com/en/players/5e834dce/Luca-Zanimacchia"
"3792","Matthias Bader_2020",2020,"Köln","Bundesliga","Matthias Bader","GER","DF","22",1997,0.1,1,1,1,0,0,1,2,50,1,0,0,0,0,1,1,0,"https://fbref.com/en/players/3489184e/Matthias-Bader"
"3793","Sebastiaan Bornauw_2020",2020,"Köln","Bundesliga","Sebastiaan Bornauw","BEL","DF","20",1999,27.2,37,24,24,12,1,20,39,51.3,19,32,12,20,42,79,99,0,"https://fbref.com/en/players/01834aa0/Sebastiaan-Bornauw"
"3794","Darko Churlinov_2020",2020,"Köln","Bundesliga","Darko Churlinov","MKD","MF","19",2000,0.2,1,1,1,0,0,1,2,50,1,0,0,0,1,2,0,0,"https://fbref.com/en/players/c6608135/Darko-Churlinov"
"3795","Christian Clemens_2020",2020,"Köln","Bundesliga","Christian Clemens","GER","FW","27",1991,0.2,0,0,0,0,0,0,0,NA,0,1,1,0,0,0,0,0,"https://fbref.com/en/players/612cb8d3/Christian-Clemens"
"3796","Jhon Córdoba_2020",2020,"Köln","Bundesliga","Jhon Córdoba","COL","FW","26",1993,22.2,9,6,1,5,3,3,13,23.1,10,19,1,18,5,14,17,0,"https://fbref.com/en/players/9f381d8b/Jhon-Cordoba"
"3797","Rafael Czichos_2020",2020,"Köln","Bundesliga","Rafael Czichos","GER","DF","29",1990,24.5,43,34,26,16,1,22,45,48.9,23,24,13,11,35,78,110,1,"https://fbref.com/en/players/b0a0698b/Rafael-Czichos"
"3798","Dominick Drexler_2020",2020,"Köln","Bundesliga","Dominick Drexler","GER","MF,FW","29",1990,17.6,34,25,12,19,3,8,32,25,24,11,5,6,26,60,11,0,"https://fbref.com/en/players/809940aa/Dominick-Drexler"
"3799","Kingsley Ehizibue_2020",2020,"Köln","Bundesliga","Kingsley Ehizibue","NED","DF","24",1995,25.9,79,53,44,30,5,33,53,62.3,20,28,8,20,39,118,79,1,"https://fbref.com/en/players/76b2817e/Kingsley-Ehizibue"
"3800","Jonas Hector_2020",2020,"Köln","Bundesliga","Jonas Hector","GER","MF,DF","29",1990,27,76,49,37,34,5,24,75,32,51,44,10,34,46,122,38,1,"https://fbref.com/en/players/c2009df3/Jonas-Hector"
"3801","Marco Höger_2020",2020,"Köln","Bundesliga","Marco Höger","GER","MF","29",1989,7.5,10,6,4,5,1,6,16,37.5,10,14,4,10,6,16,15,0,"https://fbref.com/en/players/4114f306/Marco-Hoger"
"3802","Timo Horn_2020",2020,"Köln","Bundesliga","Timo Horn","GER","GK","26",1993,34,0,0,0,0,0,0,5,0,5,0,0,0,2,2,15,1,"https://fbref.com/en/players/3cd9e95a/Timo-Horn"
"3803","Ismail Jakobs_2020",2020,"Köln","Bundesliga","Ismail Jakobs","SEN","FW,DF","19",1999,18.6,34,23,18,9,7,10,23,43.5,13,25,3,22,24,58,30,0,"https://fbref.com/en/players/a0415710/Ismail-Jakobs"
"3804","Florian Kainz_2020",2020,"Köln","Bundesliga","Florian Kainz","AUT","FW,MF","26",1992,17.3,21,13,12,6,3,15,33,45.5,18,26,2,24,13,34,11,0,"https://fbref.com/en/players/94c18565/Florian-Kainz"
"3805","Noah Katterbach_2020",2020,"Köln","Bundesliga","Noah Katterbach","GER","DF","18",2001,14.6,29,23,21,8,0,11,28,39.3,17,12,1,11,29,58,26,0,"https://fbref.com/en/players/e27de4fa/Noah-Katterbach"
"3806","Toni Leistner_2020",2020,"Köln","Bundesliga","Toni Leistner","GER","DF","28",1990,11.2,19,12,10,9,0,5,13,38.5,8,16,7,9,32,51,57,0,"https://fbref.com/en/players/364445b2/Toni-Leistner"
"3807","Tim Lemperle_2020",2020,"Köln","Bundesliga","Tim Lemperle","GER","MF","17",2002,0.2,0,0,0,0,0,0,0,NA,0,0,0,0,0,0,0,0,"https://fbref.com/en/players/792ffa71/Tim-Lemperle"
"3808","Jorge Meré_2020",2020,"Köln","Bundesliga","Jorge Meré","ESP","DF","22",1997,6.9,6,5,2,4,0,1,2,50,1,13,11,2,14,20,30,0,"https://fbref.com/en/players/9f979eb2/Jorge-Mere"
"3809","Anthony Modeste_2020",2020,"Köln","Bundesliga","Anthony Modeste","FRA","FW","31",1988,12.6,10,5,1,5,4,1,10,10,9,5,3,2,0,10,19,0,"https://fbref.com/en/players/34e4343c/Anthony-Modeste"
"3810","Elvis Rexhbeçaj_2020",2020,"Köln","Bundesliga","Elvis Rexhbeçaj","GER","MF","21",1997,6.9,16,12,9,5,2,5,13,38.5,8,7,0,7,3,19,4,0,"https://fbref.com/en/players/1ae836b1/Elvis-Rexhbecaj"
"3811","Marcel Risse_2020",2020,"Köln","Bundesliga","Marcel Risse","GER","MF,FW","29",1989,1.5,3,2,3,0,0,1,1,100,0,1,0,1,1,4,1,0,"https://fbref.com/en/players/140afefb/Marcel-Risse"
"3812","Louis Schaub_2020",2020,"Köln","Bundesliga","Louis Schaub","AUT","MF","24",1994,6.9,15,12,2,9,4,5,14,35.7,9,10,1,9,3,18,2,0,"https://fbref.com/en/players/b50ec54b/Louis-Schaub"
"3813","Kingsley Schindler_2020",2020,"Köln","Bundesliga","Kingsley Schindler","GHA","FW,MF","26",1993,9.4,8,5,3,5,0,4,12,33.3,8,6,1,5,6,14,17,0,"https://fbref.com/en/players/bd527260/Kingsley-Schindler"
"3814","Benno Schmitz_2020",2020,"Köln","Bundesliga","Benno Schmitz","GER","DF","24",1994,12.9,28,17,13,11,4,16,36,44.4,20,11,1,10,16,44,27,0,"https://fbref.com/en/players/ad00b1a8/Benno-Schmitz"
"3815","Ellyes Skhiri_2020",2020,"Köln","Bundesliga","Ellyes Skhiri","TUN","MF","24",1995,29.7,74,52,30,37,7,29,77,37.7,48,47,9,38,67,141,33,0,"https://fbref.com/en/players/c2211709/Ellyes-Skhiri"
"3816","Lasse Sobiech_2020",2020,"Köln","Bundesliga","Lasse Sobiech","GER","DF","28",1991,1,1,0,0,0,1,0,0,NA,0,0,0,0,4,5,6,0,"https://fbref.com/en/players/c46607bf/Lasse-Sobiech"
"3817","Simon Terodde_2020",2020,"Köln","Bundesliga","Simon Terodde","GER","FW","31",1988,9,8,5,4,3,1,3,13,23.1,10,14,3,11,2,10,14,0,"https://fbref.com/en/players/863ff1ee/Simon-Terodde"
"3818","Jan Thielmann_2020",2020,"Köln","Bundesliga","Jan Thielmann","GER","FW,MF","17",2002,6.2,9,6,2,6,1,5,12,41.7,7,8,0,8,8,17,6,0,"https://fbref.com/en/players/fd53759d/Jan-Thielmann"
"3819","Mark Uth_2020",2020,"Köln","Bundesliga","Mark Uth","GER","MF,FW","27",1991,12.9,19,12,4,10,5,9,32,28.1,23,15,0,15,7,26,3,0,"https://fbref.com/en/players/a3ddb1b9/Mark-Uth"
"3820","Birger Verstraete_2020",2020,"Köln","Bundesliga","Birger Verstraete","BEL","MF","25",1994,7.4,20,11,9,10,1,11,21,52.4,10,8,1,7,4,24,10,1,"https://fbref.com/en/players/28eaa0f3/Birger-Verstraete"
"3821","Francesco Acerbi_2020",2020,"Lazio","Serie A","Francesco Acerbi","ITA","DF","31",1988,35.1,59,29,42,12,5,14,20,70,6,40,27,13,42,101,109,1,"https://fbref.com/en/players/b96b595c/Francesco-Acerbi"
"3822","Bobby Adekanye_2020",2020,"Lazio","Serie A","Bobby Adekanye","NED","FW","20",1999,2.1,3,2,0,3,0,0,5,0,5,0,0,0,2,5,1,0,"https://fbref.com/en/players/3ed84b2c/Bobby-Adekanye"
"3823","Luis Alberto_2020",2020,"Lazio","Serie A","Luis Alberto","ESP","MF","26",1992,34.6,50,30,21,19,10,27,82,32.9,55,32,1,31,21,71,9,1,"https://fbref.com/en/players/5294a83f/Luis-Alberto"
"3824","Djavan Anderson_2020",2020,"Lazio","Serie A","Djavan Anderson","NED","FW,DF","24",1995,1.9,0,0,0,0,0,0,0,NA,0,1,0,1,3,3,3,0,"https://fbref.com/en/players/ca241ad3/Djavan-Anderson"
"3825","Nicolò Armini_2020",2020,"Lazio","Serie A","Nicolò Armini","ITA","DF","18",2001,0,1,1,1,0,0,1,1,100,0,0,0,0,0,1,1,0,"https://fbref.com/en/players/2f7407fa/Nicolo-Armini"
"3826","Bastos_2020",2020,"Lazio","Serie A","Bastos","ANG","DF","28",1991,8.5,9,5,6,3,0,4,11,36.4,7,13,8,5,13,22,26,0,"https://fbref.com/en/players/c01c66d9/Bastos"
"3827","Valon Berisha_2020",2020,"Lazio","Serie A","Valon Berisha","KVX","MF","26",1993,0.4,1,1,0,1,0,1,2,50,1,0,0,0,0,1,1,0,"https://fbref.com/en/players/d5575935/Valon-Berisha"
"3828","Felipe Caicedo_2020",2020,"Lazio","Serie A","Felipe Caicedo","ECU","FW","30",1988,15.6,17,10,4,7,6,2,11,18.2,9,9,1,8,4,21,2,0,"https://fbref.com/en/players/93b891d1/Felipe-Caicedo"
"3829","Danilo Cataldi_2020",2020,"Lazio","Serie A","Danilo Cataldi","ITA","MF","24",1994,6.6,17,11,10,5,2,10,20,50,10,7,1,6,13,30,10,0,"https://fbref.com/en/players/ba3d3bea/Danilo-Cataldi"
"3830","Joaquín Correa_2020",2020,"Lazio","Serie A","Joaquín Correa","ARG","FW","24",1994,22.2,13,7,3,7,3,5,24,20.8,19,5,1,4,7,20,10,0,"https://fbref.com/en/players/45b9b619/Joaquin-Correa"
"3831","Luca Falbo_2020",2020,"Lazio","Serie A","Luca Falbo","ITA","DF","19",2000,0,0,0,0,0,0,0,0,NA,0,0,0,0,0,0,0,0,"https://fbref.com/en/players/ca8fa0c0/Luca-Falbo"
"3832","Luiz Felipe_2020",2020,"Lazio","Serie A","Luiz Felipe","ITA","DF","22",1997,22.5,42,24,24,15,3,19,32,59.4,13,39,30,9,41,83,69,2,"https://fbref.com/en/players/15d0c248/Luiz-Felipe"
"3833","Ciro Immobile_2020",2020,"Lazio","Serie A","Ciro Immobile","ITA","FW","29",1990,35.2,8,6,2,4,2,0,24,0,24,10,2,8,11,19,7,0,"https://fbref.com/en/players/4431aed2/Ciro-Immobile"
"3834","Jony_2020",2020,"Lazio","Serie A","Jony","ESP","DF,FW","28",1991,13.1,13,9,7,4,2,5,23,21.7,18,11,2,9,14,27,17,0,"https://fbref.com/en/players/244f57b9/Jony"
"3835","Manuel Lazzari_2020",2020,"Lazio","Serie A","Manuel Lazzari","ITA","DF","25",1993,28.3,20,11,10,7,3,10,31,32.3,21,11,1,10,8,28,34,0,"https://fbref.com/en/players/02caf6e0/Manuel-Lazzari"
"3836","Lucas Leiva_2020",2020,"Lazio","Serie A","Lucas Leiva","BRA","MF","32",1987,20.1,60,35,25,31,4,28,72,38.9,44,29,6,23,47,107,34,1,"https://fbref.com/en/players/4c78b5ed/Lucas-Leiva"
"3837","Anderson Lima_2020",2020,"Lazio","Serie A","Anderson Lima","BRA","MF,DF","19",1999,0.7,4,0,3,1,0,1,1,100,0,4,0,4,0,4,0,0,"https://fbref.com/en/players/59be3a74/Anderson-Lima"
"3838","Jordan Lukaku_2020",2020,"Lazio","Serie A","Jordan Lukaku","BEL","DF","25",1994,4.4,4,2,1,1,2,2,4,50,2,2,1,1,0,4,9,0,"https://fbref.com/en/players/0cd0e21b/Jordan-Lukaku"
"3839","Senad Lulić_2020",2020,"Lazio","Serie A","Senad Lulić","BIH","DF","33",1986,17.5,21,13,10,7,4,11,41,26.8,30,20,4,16,21,42,28,1,"https://fbref.com/en/players/7fd58fe3/Senad-Lulic"
"3840","Adam Marušić_2020",2020,"Lazio","Serie A","Adam Marušić","MNE","DF","26",1992,10.5,11,6,7,4,0,4,11,36.4,7,14,2,12,14,25,16,0,"https://fbref.com/en/players/d4535821/Adam-Marusic"
"3841","Sergej Milinković-Savić_2020",2020,"Lazio","Serie A","Sergej Milinković-Savić","SRB","MF","24",1995,33.7,60,35,25,24,11,15,79,19,64,67,16,51,37,97,60,1,"https://fbref.com/en/players/4e6dbac4/Sergej-Milinkovic-Savic"
"3842","Raúl Moro_2020",2020,"Lazio","Serie A","Raúl Moro","ESP","FW","16",2002,0,0,0,0,0,0,0,0,NA,0,0,0,0,0,0,0,0,"https://fbref.com/en/players/919dd4b1/Raul-Moro"
"3843","Marco Parolo_2020",2020,"Lazio","Serie A","Marco Parolo","ITA","MF","34",1985,18.9,54,26,19,27,8,18,46,39.1,28,44,15,29,26,80,49,0,"https://fbref.com/en/players/ed5886d2/Marco-Parolo"
"3844","Patric_2020",2020,"Lazio","Serie A","Patric","ESP","DF","26",1993,18.6,34,20,24,7,3,18,25,72,7,19,9,10,15,49,45,0,"https://fbref.com/en/players/f7223718/Patric"
"3845","Ștefan Radu_2020",2020,"Lazio","Serie A","Ștefan Radu","ROU","DF","32",1986,25.6,43,25,24,15,4,28,43,65.1,15,19,9,10,34,77,85,0,"https://fbref.com/en/players/53de807a/Stefan-Radu"
"3846","Thomas Strakosha_2020",2020,"Lazio","Serie A","Thomas Strakosha","ALB","GK","24",1995,38,0,0,0,0,0,0,1,0,1,0,0,0,0,0,7,2,"https://fbref.com/en/players/339fe0e8/Thomas-Strakosha"
"3847","Denis Vavro_2020",2020,"Lazio","Serie A","Denis Vavro","SVK","DF","23",1996,3.6,3,3,2,1,0,1,3,33.3,2,8,6,2,5,8,10,0,"https://fbref.com/en/players/08990838/Denis-Vavro"
"3848","Khouma Babacar_2020",2020,"Lecce","Serie A","Khouma Babacar","SEN","FW","26",1993,15.8,12,8,2,6,4,1,7,14.3,6,12,3,9,3,15,34,0,"https://fbref.com/en/players/422ec08a/Khouma-Babacar"
"3849","Antonín Barák_2020",2020,"Lecce","Serie A","Antonín Barák","CZE","MF","24",1994,15.2,19,10,9,10,0,6,24,25,18,18,1,17,9,28,20,2,"https://fbref.com/en/players/01efac19/Antonin-Barak"
"3850","Romario Benzar_2020",2020,"Lecce","Serie A","Romario Benzar","ROU","DF","27",1992,1.1,2,2,1,1,0,2,3,66.7,1,1,0,1,0,2,2,0,"https://fbref.com/en/players/2e3596d1/Romario-Benzar"
"3851","Marco Calderoni_2020",2020,"Lecce","Serie A","Marco Calderoni","ITA","DF","30",1989,22.9,38,25,22,13,3,20,39,51.3,19,27,10,17,37,75,54,1,"https://fbref.com/en/players/652811aa/Marco-Calderoni"
"3852","Alessandro Deiola_2020",2020,"Lecce","Serie A","Alessandro Deiola","ITA","MF","23",1995,8,16,9,9,7,0,9,24,37.5,15,12,4,8,8,24,14,1,"https://fbref.com/en/players/7f267d66/Alessandro-Deiola"
"3853","Cristian Dell'Orco_2020",2020,"Lecce","Serie A","Cristian Dell'Orco","ITA","DF","25",1994,11.2,22,12,14,7,1,8,14,57.1,6,11,7,4,16,38,33,0,"https://fbref.com/en/players/b0243215/Cristian-DellOrco"
"3854","Giulio Donati_2020",2020,"Lecce","Serie A","Giulio Donati","ITA","DF","29",1990,19.6,32,21,22,8,2,15,28,53.6,13,19,10,9,25,57,42,0,"https://fbref.com/en/players/22051fbe/Giulio-Donati"
"3855","Edgaras Dubickas_2020",2020,"Lecce","Serie A","Edgaras Dubickas","LTU","DF","21",1998,0,0,0,0,0,0,0,0,NA,0,0,0,0,0,0,0,0,"https://fbref.com/en/players/c59f90b0/Edgaras-Dubickas"
"3856","Filippo Falco_2020",2020,"Lecce","Serie A","Filippo Falco","ITA","FW,MF","27",1992,22.4,13,7,4,5,4,5,18,27.8,13,11,1,10,2,15,1,0,"https://fbref.com/en/players/e23f56c1/Filippo-Falco"
"3857","Diego Farias_2020",2020,"Lecce","Serie A","Diego Farias","BRA","MF,FW","29",1990,9.2,9,6,3,5,1,5,18,27.8,13,7,0,7,4,13,4,0,"https://fbref.com/en/players/157d29b6/Diego-Farias"
"3858","Gabriel_2020",2020,"Lecce","Serie A","Gabriel","BRA","GK","26",1992,33.3,2,1,2,0,0,2,3,66.7,1,0,0,0,0,2,11,10,"https://fbref.com/en/players/f93ed0df/Gabriel"
"3859","Giannelli Imbula_2020",2020,"Lecce","Serie A","Giannelli Imbula","COD","MF","26",1992,1.4,2,0,2,0,0,0,1,0,1,4,1,3,2,4,0,0,"https://fbref.com/en/players/b86fe156/Giannelli-Imbula"
"3860","Andrea La Mantia_2020",2020,"Lecce","Serie A","Andrea La Mantia","ITA","FW","28",1991,6.1,1,0,1,0,0,1,5,20,4,3,0,3,7,8,11,0,"https://fbref.com/en/players/c375dfa5/Andrea-La-Mantia"
"3861","Gianluca Lapadula_2020",2020,"Lecce","Serie A","Gianluca Lapadula","PER","FW","29",1990,19.8,15,8,6,8,1,5,16,31.3,11,2,0,2,1,16,14,0,"https://fbref.com/en/players/2ead2809/Gianluca-Lapadula"
"3862","Fabio Lucioni_2020",2020,"Lecce","Serie A","Fabio Lucioni","ITA","DF","31",1987,34.8,29,13,20,9,0,14,32,43.8,18,48,38,10,36,65,169,5,"https://fbref.com/en/players/8efa621b/Fabio-Lucioni"
"3863","Žan Majer_2020",2020,"Lecce","Serie A","Žan Majer","SVN","MF","27",1992,18.5,39,18,19,12,8,17,56,30.4,39,27,6,21,26,65,18,1,"https://fbref.com/en/players/bf13975c/Zan-Majer"
"3864","Marco Mancosu_2020",2020,"Lecce","Serie A","Marco Mancosu","ITA","MF,FW","30",1988,27.1,32,18,11,16,5,10,46,21.7,36,34,9,25,16,48,15,1,"https://fbref.com/en/players/2c3a6c21/Marco-Mancosu"
"3865","Biagio Meccariello_2020",2020,"Lecce","Serie A","Biagio Meccariello","ITA","DF","28",1991,8.5,23,13,15,6,2,12,29,41.4,17,14,2,12,10,33,25,0,"https://fbref.com/en/players/1eeeff8a/Biagio-Meccariello"
"3866","Ilario Monterisi_2020",2020,"Lecce","Serie A","Ilario Monterisi","ITA","DF","17",2001,0,0,0,0,0,0,0,0,NA,0,0,0,0,0,0,0,0,"https://fbref.com/en/players/31b252fc/Ilario-Monterisi"
"3867","Nehuén Paz_2020",2020,"Lecce","Serie A","Nehuén Paz","ARG","DF","26",1993,9.4,14,5,11,3,0,10,12,83.3,2,12,6,6,20,34,38,1,"https://fbref.com/en/players/42b1a58a/Nehuen-Paz"
"3868","Jacopo Petriccione_2020",2020,"Lecce","Serie A","Jacopo Petriccione","ITA","MF","24",1995,23.8,38,20,29,9,0,15,57,26.3,42,20,7,13,28,66,25,2,"https://fbref.com/en/players/909bce7f/Jacopo-Petriccione"
"3869","Davide Riccardi_2020",2020,"Lecce","Serie A","Davide Riccardi","ITA","DF","23",1996,0.2,0,0,0,0,0,0,1,0,1,0,0,0,0,0,1,0,"https://fbref.com/en/players/7b4b9221/Davide-Riccardi"
"3870","Andrea Rispoli_2020",2020,"Lecce","Serie A","Andrea Rispoli","ITA","DF","30",1988,21.2,24,18,14,9,1,15,30,50,15,28,7,21,32,56,62,1,"https://fbref.com/en/players/39ee6cb6/Andrea-Rispoli"
"3871","Luca Rossettini_2020",2020,"Lecce","Serie A","Luca Rossettini","ITA","DF","34",1985,25.1,25,14,18,7,0,17,34,50,17,31,22,9,35,60,126,1,"https://fbref.com/en/players/47a500ae/Luca-Rossettini"
"3872","Riccardo Saponara_2020",2020,"Lecce","Serie A","Riccardo Saponara","ITA","MF,FW","27",1991,10.5,12,8,4,8,0,6,13,46.2,7,2,0,2,5,17,7,0,"https://fbref.com/en/players/3bb7af3b/Riccardo-Saponara"
"3873","Yevhen Shakhov_2020",2020,"Lecce","Serie A","Yevhen Shakhov","UKR","MF,FW","28",1990,12.1,28,16,12,13,3,8,27,29.6,19,11,3,8,14,42,9,1,"https://fbref.com/en/players/ff764de3/Yevhen-Shakhov"
"3874","Andrea Tabanelli_2020",2020,"Lecce","Serie A","Andrea Tabanelli","ITA","MF","29",1990,10.7,22,13,10,9,3,8,28,28.6,20,13,2,11,11,33,19,0,"https://fbref.com/en/players/b59e02da/Andrea-Tabanelli"
"3875","Panagiotis Tachtsidis_2020",2020,"Lecce","Serie A","Panagiotis Tachtsidis","GRE","MF","28",1991,22.3,52,27,26,20,6,20,56,35.7,36,27,11,16,35,87,32,2,"https://fbref.com/en/players/e26bd2f4/Panagiotis-Tachtsidis"
"3876","Brayan Vera_2020",2020,"Lecce","Serie A","Brayan Vera","COL","DF,FW","20",1999,1.7,4,1,2,1,1,3,7,42.9,4,1,0,1,1,5,4,0,"https://fbref.com/en/players/80c718dd/Brayan-Vera"
"3877","Mauro Vigorito_2020",2020,"Lecce","Serie A","Mauro Vigorito","ITA","GK","29",1990,4.7,0,0,0,0,0,0,0,NA,0,0,0,0,0,0,3,1,"https://fbref.com/en/players/582a251c/Mauro-Vigorito"
"3878","Ibrahim Amadou_2020",2020,"Leganés","La Liga","Ibrahim Amadou","FRA","MF","26",1993,8.6,16,9,5,9,2,4,11,36.4,7,5,0,5,12,28,6,0,"https://fbref.com/en/players/9260926b/Ibrahim-Amadou"
"3879","Miguel Ángel Guerrero_2020",2020,"Leganés","La Liga","Miguel Ángel Guerrero","ESP","FW","29",1990,8.8,1,0,0,1,0,1,10,10,9,4,0,4,2,3,4,0,"https://fbref.com/en/players/b35db3f6/Miguel-Angel-Guerrero"
"3880","José Arnaiz_2020",2020,"Leganés","La Liga","José Arnaiz","ESP","MF","24",1995,3.7,3,0,1,2,0,2,5,40,3,4,0,4,2,5,1,0,"https://fbref.com/en/players/46e07328/Jose-Arnaiz"
"3881","Roger Assalé_2020",2020,"Leganés","La Liga","Roger Assalé","CIV","FW,MF","25",1993,5.9,3,2,1,0,2,1,9,11.1,8,8,0,8,0,3,1,0,"https://fbref.com/en/players/5d5219b1/Roger-Assale"
"3882","Javier Avilés_2020",2020,"Leganés","La Liga","Javier Avilés","ESP","MF,FW","21",1997,2,9,7,2,7,0,2,4,50,2,3,0,3,3,12,1,0,"https://fbref.com/en/players/53ddba36/Javier-Aviles"
"3883","Chidozie Awaziem_2020",2020,"Leganés","La Liga","Chidozie Awaziem","NGA","DF","22",1997,22.2,34,22,29,5,0,16,27,59.3,11,26,15,11,28,62,73,1,"https://fbref.com/en/players/70d8e84c/Chidozie-Awaziem"
"3884","Martin Braithwaite_2020",2020,"Leganés","La Liga","Martin Braithwaite","DEN","FW,MF","28",1991,21.5,13,7,4,5,4,4,12,33.3,8,10,2,8,4,17,9,0,"https://fbref.com/en/players/fd771f95/Martin-Braithwaite"
"3885","Unai Bustinza_2020",2020,"Leganés","La Liga","Unai Bustinza","ESP","DF","27",1992,29.8,66,40,40,19,7,32,53,60.4,21,30,9,21,65,131,77,0,"https://fbref.com/en/players/f3112790/Unai-Bustinza"
"3886","Guido Carrillo_2020",2020,"Leganés","La Liga","Guido Carrillo","ARG","FW","28",1991,13.5,13,10,3,6,4,2,14,14.3,12,9,1,8,3,16,22,0,"https://fbref.com/en/players/8f898ba8/Guido-Carrillo"
"3887","Iván Cuéllar_2020",2020,"Leganés","La Liga","Iván Cuéllar","ESP","GK","35",1984,27,0,0,0,0,0,0,2,0,2,0,0,0,0,0,28,2,"https://fbref.com/en/players/75751c99/Ivan-Cuellar"
"3888","Youssef En-Nesyri_2020",2020,"Leganés","La Liga","Youssef En-Nesyri","MAR","FW","22",1997,15.4,9,7,1,2,6,3,17,17.6,14,15,2,13,5,14,22,0,"https://fbref.com/en/players/04e17fd5/Youssef-En-Nesyri"
"3889","Javier Eraso_2020",2020,"Leganés","La Liga","Javier Eraso","ESP","MF","29",1990,9.1,11,5,4,5,2,5,15,33.3,10,5,0,5,7,18,5,0,"https://fbref.com/en/players/aec0fb6f/Javier-Eraso"
"3890","Manuel Garrido_2020",2020,"Leganés","La Liga","Manuel Garrido","ESP","FW","18",2000,1.3,0,0,0,0,0,0,6,0,6,3,1,2,1,1,0,0,"https://fbref.com/en/players/f814eccb/Manuel-Garrido"
"3891","Bryan Gil_2020",2020,"Leganés","La Liga","Bryan Gil","ESP","MF,FW","18",2001,6.2,8,4,3,4,1,1,8,12.5,7,6,0,6,3,11,1,0,"https://fbref.com/en/players/7b5ab7f2/Bryan-Gil"
"3892","Sabin Merino_2020",2020,"Leganés","La Liga","Sabin Merino","ESP","FW","27",1992,0.9,0,0,0,0,0,0,0,NA,0,0,0,0,0,0,0,0,"https://fbref.com/en/players/1d5f96d9/Sabin-Merino"
"3893","Roque Mesa_2020",2020,"Leganés","La Liga","Roque Mesa","ESP","MF","30",1989,22.4,40,21,17,18,5,13,44,29.5,31,13,4,9,11,51,8,0,"https://fbref.com/en/players/7c4243d4/Roque-Mesa"
"3894","Marc Navarro_2020",2020,"Leganés","La Liga","Marc Navarro","ESP","FW,DF","24",1995,2.4,3,3,2,1,0,1,1,100,0,2,1,1,0,3,3,0,"https://fbref.com/en/players/c2846353/Marc-Navarro"
"3895","Kenneth Omeruo_2020",2020,"Leganés","La Liga","Kenneth Omeruo","NGA","DF","25",1993,20.8,28,17,25,3,0,11,18,61.1,7,21,12,9,36,64,112,2,"https://fbref.com/en/players/0f0aa5b4/Kenneth-Omeruo"
"3896","Rubén Pérez_2020",2020,"Leganés","La Liga","Rubén Pérez","ESP","MF","30",1989,24.4,50,27,21,23,6,16,47,34,31,21,4,17,38,88,33,0,"https://fbref.com/en/players/3c7bc9bd/Ruben-Perez"
"3897","Recio_2020",2020,"Leganés","La Liga","Recio","ESP","MF","28",1991,17.4,30,19,13,12,5,10,40,25,30,14,3,11,22,52,9,0,"https://fbref.com/en/players/54073b28/Recio"
"3898","Cristian Rivera_2020",2020,"Leganés","La Liga","Cristian Rivera","ESP","MF","22",1997,3.5,6,4,3,2,1,2,4,50,2,4,3,1,4,10,7,0,"https://fbref.com/en/players/8ef81d2d/Cristian-Rivera"
"3899","Kévin Rodrigues_2020",2020,"Leganés","La Liga","Kévin Rodrigues","POR","DF,MF","25",1994,21.5,56,31,31,17,8,25,46,54.3,21,30,3,27,31,87,26,1,"https://fbref.com/en/players/f1bed920/Kevin-Rodrigues"
"3900","Óscar Rodríguez Arnaiz_2020",2020,"Leganés","La Liga","Óscar Rodríguez Arnaiz","ESP","MF,FW","21",1998,21.3,23,10,11,7,5,13,41,31.7,28,19,0,19,14,37,13,0,"https://fbref.com/en/players/19709006/Oscar-Rodriguez-Arnaiz"
"3901","Roberto Rosales_2020",2020,"Leganés","La Liga","Roberto Rosales","VEN","DF","30",1988,20.8,42,23,23,17,2,19,43,44.2,24,17,4,13,30,72,48,0,"https://fbref.com/en/players/81069528/Roberto-Rosales"
"3902","Aitor Ruibal_2020",2020,"Leganés","La Liga","Aitor Ruibal","ESP","DF,MF","23",1996,13.6,27,17,14,11,2,16,39,41,23,18,1,17,8,35,11,0,"https://fbref.com/en/players/a55d8df5/Aitor-Ruibal"
"3903","Jonathan Silva_2020",2020,"Leganés","La Liga","Jonathan Silva","ARG","DF","25",1994,30.9,60,34,32,22,6,27,52,51.9,25,12,4,8,34,94,46,0,"https://fbref.com/en/players/f2308b33/Jonathan-Silva"
"3904","Dimitris Siovas_2020",2020,"Leganés","La Liga","Dimitris Siovas","GRE","DF","30",1988,21.3,42,31,24,15,3,19,28,67.9,9,14,1,13,46,88,69,0,"https://fbref.com/en/players/92d38e6c/Dimitris-Siovas"
"3905","Juan Soriano_2020",2020,"Leganés","La Liga","Juan Soriano","ESP","GK","21",1997,11,0,0,0,0,0,0,0,NA,0,0,0,0,0,0,1,1,"https://fbref.com/en/players/5512b1a9/Juan-Soriano"
"3906","Rodrigo Tarín_2020",2020,"Leganés","La Liga","Rodrigo Tarín","ESP","DF","23",1996,10.6,10,7,8,2,0,9,14,64.3,5,7,3,4,9,19,51,0,"https://fbref.com/en/players/a03c82b2/Rodrigo-Tarin"
"3907","Marc Albrighton_2020",2020,"Leicester City","Premier League","Marc Albrighton","ENG","MF,DF","29",1989,9.6,24,17,10,13,1,9,30,30,21,19,2,17,10,34,8,0,"https://fbref.com/en/players/b827d5b3/Marc-Albrighton"
"3908","Harvey Barnes_2020",2020,"Leicester City","Premier League","Harvey Barnes","ENG","MF,FW","21",1997,23.1,16,11,7,7,2,5,23,21.7,18,13,3,10,8,24,6,1,"https://fbref.com/en/players/3ea50f67/Harvey-Barnes"
"3909","Ryan Bennett_2020",2020,"Leicester City","Premier League","Ryan Bennett","ENG","DF","29",1990,3.7,5,4,3,2,0,4,6,66.7,2,3,1,2,7,12,8,0,"https://fbref.com/en/players/0bad4516/Ryan-Bennett"
"3910","Ben Chilwell_2020",2020,"Leicester City","Premier League","Ben Chilwell","ENG","DF","22",1996,26.4,43,26,28,13,2,23,52,44.2,29,30,6,24,28,71,68,2,"https://fbref.com/en/players/d2424d1b/Ben-Chilwell"
"3911","Hamza Choudhury_2020",2020,"Leicester City","Premier League","Hamza Choudhury","ENG","MF","21",1997,9.9,17,8,7,8,2,3,25,12,22,15,6,9,24,41,13,0,"https://fbref.com/en/players/7d2d3329/Hamza-Choudhury"
"3912","Jonny Evans_2020",2020,"Leicester City","Premier League","Jonny Evans","NIR","DF","31",1988,37.6,48,34,33,14,1,28,39,71.8,11,33,18,15,57,105,174,4,"https://fbref.com/en/players/f8fcd2a5/Jonny-Evans"
"3913","Christian Fuchs_2020",2020,"Leicester City","Premier League","Christian Fuchs","AUT","DF","33",1986,8.6,14,9,8,6,0,8,19,42.1,11,8,3,5,17,31,33,1,"https://fbref.com/en/players/a67a09fb/Christian-Fuchs"
"3914","Demarai Gray_2020",2020,"Leicester City","Premier League","Demarai Gray","JAM","MF,FW","23",1996,6.9,12,6,6,6,0,6,12,50,6,7,0,7,5,17,4,0,"https://fbref.com/en/players/4468ec10/Demarai-Gray"
"3915","George Hirst_2020",2020,"Leicester City","Premier League","George Hirst","ENG","MF,DF","20",1999,0.1,0,0,0,0,0,0,0,NA,0,0,0,0,0,0,0,0,"https://fbref.com/en/players/78e87179/George-Hirst"
"3916","Kelechi Iheanacho_2020",2020,"Leicester City","Premier League","Kelechi Iheanacho","NGA","FW","22",1996,10.7,3,1,1,2,0,1,9,11.1,8,8,1,7,3,6,8,0,"https://fbref.com/en/players/c92e1a31/Kelechi-Iheanacho"
"3917","Matty James_2020",2020,"Leicester City","Premier League","Matty James","ENG","MF","28",1991,0.1,0,0,0,0,0,0,0,NA,0,0,0,0,0,0,0,0,"https://fbref.com/en/players/ebd0a048/Matty-James"
"3918","James Justin_2020",2020,"Leicester City","Premier League","James Justin","ENG","DF,MF","21",1998,11.2,36,17,22,14,0,15,25,60,10,15,7,8,11,47,30,0,"https://fbref.com/en/players/fb614c44/James-Justin"
"3919","James Maddison_2020",2020,"Leicester City","Premier League","James Maddison","ENG","MF","22",1996,29.2,59,30,13,31,15,23,68,33.8,45,16,0,16,9,68,7,1,"https://fbref.com/en/players/ee38d9c5/James-Maddison"
"3920","Nampalys Mendy_2020",2020,"Leicester City","Premier League","Nampalys Mendy","SEN","MF","27",1992,3.2,7,5,4,1,2,4,5,80,1,4,1,3,6,13,6,0,"https://fbref.com/en/players/1598599e/Nampalys-Mendy"
"3921","Wes Morgan_2020",2020,"Leicester City","Premier League","Wes Morgan","JAM","DF","35",1984,4.8,4,1,3,1,0,0,3,0,3,5,3,2,7,11,19,0,"https://fbref.com/en/players/80c31c97/Wes-Morgan"
"3922","Wilfred Ndidi_2020",2020,"Leicester City","Premier League","Wilfred Ndidi","NGA","MF","22",1996,29.7,128,67,56,61,11,45,91,49.5,46,52,6,46,80,208,69,3,"https://fbref.com/en/players/6b47c5db/Wilfred-Ndidi"
"3923","Ricardo Pereira_2020",2020,"Leicester City","Premier League","Ricardo Pereira","POR","DF","25",1993,28,119,68,65,36,18,53,106,50,53,38,6,32,49,168,86,0,"https://fbref.com/en/players/75a72a99/Ricardo-Pereira"
"3924","Ayoze Pérez_2020",2020,"Leicester City","Premier League","Ayoze Pérez","ESP","MF,FW","26",1993,22.3,45,28,14,26,5,8,54,14.8,46,33,1,32,14,59,9,1,"https://fbref.com/en/players/819aa8e7/Ayoze-Perez"
"3925","Dennis Praet_2020",2020,"Leicester City","Premier League","Dennis Praet","BEL","MF","25",1994,12.6,33,18,8,21,4,9,29,31,20,19,1,18,17,50,12,0,"https://fbref.com/en/players/86695068/Dennis-Praet"
"3926","Kasper Schmeichel_2020",2020,"Leicester City","Premier League","Kasper Schmeichel","DEN","GK","32",1986,38,1,1,1,0,0,1,2,50,1,0,0,0,1,2,4,2,"https://fbref.com/en/players/53af52f3/Kasper-Schmeichel"
"3927","Çağlar Söyüncü_2020",2020,"Leicester City","Premier League","Çağlar Söyüncü","TUR","DF","23",1996,33.7,60,40,41,18,1,27,46,58.7,19,35,19,16,43,103,156,1,"https://fbref.com/en/players/21166ff4/Caglar-Soyuncu"
"3928","Luke Thomas_2020",2020,"Leicester City","Premier League","Luke Thomas","ENG","MF,DF","18",2001,3,1,0,0,1,0,0,3,0,3,2,0,2,3,4,7,0,"https://fbref.com/en/players/fc027d02/Luke-Thomas"
"3929","Youri Tielemans_2020",2020,"Leicester City","Premier League","Youri Tielemans","BEL","MF","22",1997,31.4,52,29,17,30,5,24,74,32.4,50,43,4,39,22,74,18,0,"https://fbref.com/en/players/56f7a928/Youri-Tielemans"
"3930","Jamie Vardy_2020",2020,"Leicester City","Premier League","Jamie Vardy","ENG","FW","32",1987,33.7,15,12,0,9,6,2,4,50,2,22,4,18,2,17,22,0,"https://fbref.com/en/players/45963054/Jamie-Vardy"
"3931","Enis Bardhi_2020",2020,"Levante","La Liga","Enis Bardhi","MKD","MF","24",1995,23.5,24,11,7,15,2,8,35,22.9,27,15,4,11,15,39,19,0,"https://fbref.com/en/players/cac2537b/Enis-Bardhi"
"3932","Alejandro Blesa_2020",2020,"Levante","La Liga","Alejandro Blesa","ESP","MF","17",2002,0,0,0,0,0,0,0,1,0,1,0,0,0,0,0,0,0,"https://fbref.com/en/players/d2ed99b4/Alejandro-Blesa"
"3933","Erick Cabaco_2020",2020,"Levante","La Liga","Erick Cabaco","URU","DF","24",1995,9,12,9,9,3,0,4,6,66.7,2,12,7,5,12,24,50,1,"https://fbref.com/en/players/e7ab4179/Erick-Cabaco"
"3934","José Campaña_2020",2020,"Levante","La Liga","José Campaña","ESP","MF","26",1993,35.1,38,25,15,13,10,13,53,24.5,40,30,5,25,44,82,42,2,"https://fbref.com/en/players/61220da2/Jose-Campana"
"3935","Carlos Clerc_2020",2020,"Levante","La Liga","Carlos Clerc","ESP","DF","27",1992,20.5,28,16,14,13,1,12,20,60,8,22,9,13,22,50,61,0,"https://fbref.com/en/players/33a61a52/Carlos-Clerc"
"3936","Coke_2020",2020,"Levante","La Liga","Coke","ESP","DF","32",1987,11,25,18,14,8,3,14,30,46.7,16,9,2,7,13,38,19,0,"https://fbref.com/en/players/6d8f8441/Coke"
"3937","Óscar Duarte_2020",2020,"Levante","La Liga","Óscar Duarte","CRC","DF","30",1989,5.4,12,3,11,1,0,3,4,75,1,7,6,1,6,18,29,0,"https://fbref.com/en/players/aa0ac32d/Oscar-Duarte"
"3938","Eliseo Falcon_2020",2020,"Levante","La Liga","Eliseo Falcon","ESP","DF","22",1997,0.8,0,0,0,0,0,0,0,NA,0,0,0,0,0,0,2,0,"https://fbref.com/en/players/904cd50d/Eliseo-Falcon"
"3939","Aitor Fernández_2020",2020,"Levante","La Liga","Aitor Fernández","ESP","GK","28",1991,36,1,1,1,0,0,1,1,100,0,0,0,0,2,3,18,3,"https://fbref.com/en/players/a01c3d54/Aitor-Fernandez"
"3940","Hernâni Fortes_2020",2020,"Levante","La Liga","Hernâni Fortes","POR","MF,FW","27",1991,7.3,5,2,4,0,1,1,3,33.3,2,3,0,3,4,9,9,0,"https://fbref.com/en/players/2327c29e/Hernani-Fortes"
"3941","Bruno González_2020",2020,"Levante","La Liga","Bruno González","ESP","DF","29",1990,5.1,10,8,7,2,1,2,4,50,2,7,4,3,2,12,32,0,"https://fbref.com/en/players/f11fe861/Bruno-Gonzalez"
"3942","Gonzalo_2020",2020,"Levante","La Liga","Gonzalo","ESP","DF","22",1997,0.1,1,0,0,1,0,0,0,NA,0,0,0,0,0,1,0,0,"https://fbref.com/en/players/cca05da8/Gonzalo"
"3943","Giorgi Kochorashvili_2020",2020,"Levante","La Liga","Giorgi Kochorashvili","GEO","MF","20",1999,0,0,0,0,0,0,0,0,NA,0,0,0,0,0,0,0,0,"https://fbref.com/en/players/3da1b6ed/Giorgi-Kochorashvili"
"3944","Sergio León_2020",2020,"Levante","La Liga","Sergio León","ESP","FW","30",1989,7.5,3,3,0,3,0,2,4,50,2,3,0,3,1,4,2,0,"https://fbref.com/en/players/0a0cc13c/Sergio-Leon"
"3945","José Luis Morales_2020",2020,"Levante","La Liga","José Luis Morales","ESP","FW,MF","32",1987,28,17,8,5,9,3,6,34,17.6,28,14,1,13,6,23,5,1,"https://fbref.com/en/players/4a478107/Jose-Luis-Morales"
"3946","Roger Martí_2020",2020,"Levante","La Liga","Roger Martí","ESP","FW","28",1991,25.2,18,11,8,7,3,7,29,24.1,22,14,0,14,6,24,17,0,"https://fbref.com/en/players/0ae4e09a/Roger-Marti"
"3947","Pablo Martínez_2020",2020,"Levante","La Liga","Pablo Martínez","ESP","MF","21",1998,0.4,2,0,1,1,0,0,1,0,1,0,0,0,0,2,2,0,"https://fbref.com/en/players/ecc77652/Pablo-Martinez"
"3948","Borja Mayoral_2020",2020,"Levante","La Liga","Borja Mayoral","ESP","FW","22",1997,23.8,12,3,4,6,2,2,13,15.4,11,11,0,11,4,16,6,0,"https://fbref.com/en/players/64e8ed6d/Borja-Mayoral"
"3949","Gonzalo Melero_2020",2020,"Levante","La Liga","Gonzalo Melero","ESP","MF","25",1994,13.7,20,13,9,9,2,7,27,25.9,20,12,3,9,9,29,15,1,"https://fbref.com/en/players/3902e91b/Gonzalo-Melero"
"3950","Jorge Miramón_2020",2020,"Levante","La Liga","Jorge Miramón","ESP","DF","30",1989,27,52,27,35,13,4,26,45,57.8,19,30,8,22,46,98,61,1,"https://fbref.com/en/players/7f4c7c9f/Jorge-Miramon"
"3951","Joan Monterde_2020",2020,"Levante","La Liga","Joan Monterde","ESP","MF","21",1997,0.1,0,0,0,0,0,0,0,NA,0,0,0,0,0,0,0,0,"https://fbref.com/en/players/0ff67313/Joan-Monterde"
"3952","Sergio Postigo_2020",2020,"Levante","La Liga","Sergio Postigo","ESP","DF","30",1988,26.4,32,15,23,7,2,11,18,61.1,7,24,15,9,34,66,132,1,"https://fbref.com/en/players/474ecac8/Sergio-Postigo"
"3953","Nemanja Radoja_2020",2020,"Levante","La Liga","Nemanja Radoja","SRB","MF","26",1993,22.1,43,19,27,16,0,15,46,32.6,31,21,4,17,23,66,24,0,"https://fbref.com/en/players/b5dd3469/Nemanja-Radoja"
"3954","Rober_2020",2020,"Levante","La Liga","Rober","ESP","DF","24",1995,2.1,3,1,2,0,1,2,2,100,0,0,0,0,3,6,2,0,"https://fbref.com/en/players/c00097d2/Rober"
"3955","Rubén Rochina_2020",2020,"Levante","La Liga","Rubén Rochina","ESP","MF","28",1991,20.8,41,26,22,9,10,19,52,36.5,33,16,0,16,12,53,19,1,"https://fbref.com/en/players/ecd8c01e/Ruben-Rochina"
"3956","Toño_2020",2020,"Levante","La Liga","Toño","ESP","DF","29",1989,17.7,26,19,18,7,1,15,28,53.6,13,11,3,8,13,39,34,1,"https://fbref.com/en/players/d4ef9ac5/Tono"
"3957","Koke Vegas_2020",2020,"Levante","La Liga","Koke Vegas","ESP","GK","23",1995,2,0,0,0,0,0,0,1,0,1,0,0,0,0,0,3,0,"https://fbref.com/en/players/bfb15d99/Koke-Vegas"
"3958","Rúben Vezo_2020",2020,"Levante","La Liga","Rúben Vezo","POR","DF","25",1994,29,41,24,28,13,0,19,35,54.3,16,37,29,8,42,83,144,2,"https://fbref.com/en/players/c67cd65c/Ruben-Vezo"
"3959","Nikola Vukčević_2020",2020,"Levante","La Liga","Nikola Vukčević","MNE","MF","27",1991,17.4,41,26,17,17,7,15,40,37.5,25,19,7,12,12,53,16,0,"https://fbref.com/en/players/4442fbcd/Nikola-Vukcevic"
"3960","Lucas Alario_2020",2020,"Leverkusen","Bundesliga","Lucas Alario","ARG","FW","26",1992,13,6,3,0,4,2,1,8,12.5,7,12,2,10,1,7,9,0,"https://fbref.com/en/players/834d0be5/Lucas-Alario"
"3961","Nadiem Amiri_2020",2020,"Leverkusen","Bundesliga","Nadiem Amiri","GER","MF,FW","22",1996,20.6,26,16,7,15,4,16,34,47.1,18,12,2,10,14,40,8,1,"https://fbref.com/en/players/555d5edd/Nadiem-Amiri"
"3962","Charles Aránguiz_2020",2020,"Leverkusen","Bundesliga","Charles Aránguiz","CHI","MF","30",1989,23.5,56,37,19,29,8,27,74,36.5,47,27,6,21,22,78,21,1,"https://fbref.com/en/players/56413b1f/Charles-Aranguiz"
"3963","Leon Bailey_2020",2020,"Leverkusen","Bundesliga","Leon Bailey","JAM","FW,MF","21",1997,12.1,6,3,1,5,0,6,16,37.5,10,9,0,9,8,14,3,0,"https://fbref.com/en/players/3a233281/Leon-Bailey"
"3964","Julian Baumgartlinger_2020",2020,"Leverkusen","Bundesliga","Julian Baumgartlinger","AUT","MF","31",1988,19.9,42,21,15,21,6,18,42,42.9,24,37,4,33,20,62,16,1,"https://fbref.com/en/players/69374ff5/Julian-Baumgartlinger"
"3965","Karim Bellarabi_2020",2020,"Leverkusen","Bundesliga","Karim Bellarabi","GER","FW,DF","29",1990,15.8,19,11,9,7,3,9,28,32.1,19,16,0,16,10,29,4,0,"https://fbref.com/en/players/bee0bab1/Karim-Bellarabi"
"3966","Lars Bender_2020",2020,"Leverkusen","Bundesliga","Lars Bender","GER","DF,MF","30",1989,15.3,42,26,17,20,5,19,38,50,19,32,6,26,24,66,30,0,"https://fbref.com/en/players/c50281a0/Lars-Bender"
"3967","Sven Bender_2020",2020,"Leverkusen","Bundesliga","Sven Bender","GER","DF","30",1989,30.3,53,34,29,17,7,23,48,47.9,25,42,13,29,67,120,88,2,"https://fbref.com/en/players/070ec0b1/Sven-Bender"
"3968","Kerem Demirbay_2020",2020,"Leverkusen","Bundesliga","Kerem Demirbay","GER","MF","26",1993,17.5,35,19,10,21,4,12,31,38.7,19,19,5,14,22,57,7,1,"https://fbref.com/en/players/54b4dc4e/Kerem-Demirbay"
"3969","Moussa Diaby_2020",2020,"Leverkusen","Bundesliga","Moussa Diaby","FRA","FW,MF","20",1999,19.7,10,8,3,7,0,5,15,33.3,10,6,0,6,9,19,4,0,"https://fbref.com/en/players/aeed5c06/Moussa-Diaby"
"3970","Aleksandar Dragović_2020",2020,"Leverkusen","Bundesliga","Aleksandar Dragović","AUT","DF","28",1991,11.4,18,11,11,6,1,10,21,47.6,11,9,3,6,15,33,39,0,"https://fbref.com/en/players/6fd8a334/Aleksandar-Dragovic"
"3971","Kai Havertz_2020",2020,"Leverkusen","Bundesliga","Kai Havertz","GER","MF,FW","20",1999,27.3,21,15,5,10,6,6,39,15.4,33,22,0,22,2,23,22,0,"https://fbref.com/en/players/fed7cb61/Kai-Havertz"
"3972","Lukáš Hrádecký_2020",2020,"Leverkusen","Bundesliga","Lukáš Hrádecký","FIN","GK","29",1989,34,0,0,0,0,0,0,1,0,1,0,0,0,2,2,19,2,"https://fbref.com/en/players/ad3389d5/Lukas-Hradecky"
"3973","Exequiel Palacios_2020",2020,"Leverkusen","Bundesliga","Exequiel Palacios","ARG","MF","20",1998,2,8,7,4,4,0,2,5,40,3,2,0,2,1,9,0,0,"https://fbref.com/en/players/e82adcab/Exequiel-Palacios"
"3974","Paulinho_2020",2020,"Leverkusen","Bundesliga","Paulinho","BRA","MF,FW","19",2000,3.4,4,3,3,1,0,1,2,50,1,5,1,4,1,5,0,0,"https://fbref.com/en/players/53070b63/Paulinho"
"3975","Joel Pohjanpalo_2020",2020,"Leverkusen","Bundesliga","Joel Pohjanpalo","FIN","MF","24",1994,0,0,0,0,0,0,0,0,NA,0,0,0,0,0,0,0,0,"https://fbref.com/en/players/ea003d07/Joel-Pohjanpalo"
"3976","Panagiotis Retsos_2020",2020,"Leverkusen","Bundesliga","Panagiotis Retsos","GRE","DF","20",1998,1.3,6,3,4,2,0,1,4,25,3,2,0,2,2,8,2,0,"https://fbref.com/en/players/4bd00a50/Panagiotis-Retsos"
"3977","Daley Sinkgraven_2020",2020,"Leverkusen","Bundesliga","Daley Sinkgraven","NED","DF,MF","24",1995,10.1,20,16,11,6,3,8,24,33.3,16,12,3,9,10,30,16,0,"https://fbref.com/en/players/73000a79/Daley-Sinkgraven"
"3978","Jonathan Tah_2020",2020,"Leverkusen","Bundesliga","Jonathan Tah","GER","DF","23",1996,23.2,36,26,23,11,2,18,29,62.1,11,25,13,12,27,63,98,2,"https://fbref.com/en/players/bd142efb/Jonathan-Tah"
"3979","Edmond Tapsoba_2020",2020,"Leverkusen","Bundesliga","Edmond Tapsoba","BFA","DF","20",1999,11.8,24,15,17,5,2,15,25,60,10,9,5,4,9,33,44,0,"https://fbref.com/en/players/a73c8f95/Edmond-Tapsoba"
"3980","Kevin Volland_2020",2020,"Leverkusen","Bundesliga","Kevin Volland","GER","FW","27",1992,22.7,16,6,5,6,5,5,16,31.3,11,14,2,12,5,21,7,0,"https://fbref.com/en/players/64f69877/Kevin-Volland"
"3981","Mitchell Weiser_2020",2020,"Leverkusen","Bundesliga","Mitchell Weiser","GER","DF,MF","25",1994,13,41,29,20,17,4,18,30,60,12,19,2,17,24,65,22,1,"https://fbref.com/en/players/30c220c3/Mitchell-Weiser"
"3982","Wendell_2020",2020,"Leverkusen","Bundesliga","Wendell","BRA","DF,MF","26",1993,21.1,64,42,26,26,12,41,66,62.1,25,30,4,26,36,100,36,0,"https://fbref.com/en/players/f9acca3a/Wendell"
"3983","Florian Wirtz_2020",2020,"Leverkusen","Bundesliga","Florian Wirtz","GER","FW","16",2003,4.1,4,2,0,4,0,2,4,50,2,4,0,4,2,6,1,0,"https://fbref.com/en/players/e7fcf289/Florian-Wirtz"
"3984","Benjamin André_2020",2020,"Lille","Ligue 1","Benjamin André","FRA","MF","28",1990,22.8,72,44,31,35,6,29,74,39.2,45,32,9,23,59,131,40,1,"https://fbref.com/en/players/ef9c1c95/Benjamin-Andre"
"3985","Luiz Araújo_2020",2020,"Lille","Ligue 1","Luiz Araújo","BRA","FW,MF","23",1996,9.2,20,11,3,8,9,5,31,16.1,26,14,0,14,4,24,6,0,"https://fbref.com/en/players/fa18c72e/Luiz-Araujo"
"3986","Jonathan Bamba_2020",2020,"Lille","Ligue 1","Jonathan Bamba","CIV","FW,MF","23",1996,21.5,12,6,5,5,2,7,29,24.1,22,19,3,16,16,28,8,2,"https://fbref.com/en/players/b2bd0f6c/Jonathan-Bamba"
"3987","Domagoj Bradarić_2020",2020,"Lille","Ligue 1","Domagoj Bradarić","CRO","DF","19",1999,15.8,28,11,9,17,2,12,27,44.4,15,16,3,13,22,50,28,0,"https://fbref.com/en/players/8bbe2df5/Domagoj-Bradaric"
"3988","Zeki Çelik_2020",2020,"Lille","Ligue 1","Zeki Çelik","TUR","DF","22",1997,23,53,28,18,28,7,27,60,45,33,24,4,20,26,79,39,0,"https://fbref.com/en/players/31a62dc7/Zeki-Celik"
"3989","Tiago Djaló_2020",2020,"Lille","Ligue 1","Tiago Djaló","POR","DF","19",2000,7.3,9,4,5,3,1,2,7,28.6,5,3,2,1,11,20,28,0,"https://fbref.com/en/players/b2336681/Tiago-Djalo"
"3990","Gabriel Dos Santos_2020",2020,"Lille","Ligue 1","Gabriel Dos Santos","BRA","DF","21",1997,23.2,41,29,27,11,3,15,22,68.2,7,27,18,9,22,63,86,2,"https://fbref.com/en/players/67ac5bb8/Gabriel-Dos-Santos"
"3991","José Fonte_2020",2020,"Lille","Ligue 1","José Fonte","POR","DF","35",1983,24.5,19,11,11,7,1,11,22,50,11,19,11,8,28,47,90,1,"https://fbref.com/en/players/90f87966/Jose-Fonte"
"3992","Nicolás Gaitán_2020",2020,"Lille","Ligue 1","Nicolás Gaitán","ARG","MF,FW","31",1988,0.6,1,0,0,1,0,1,1,100,0,1,0,1,0,1,1,0,"https://fbref.com/en/players/7ebfac0f/Nicolas-Gaitan"
"3993","Jonathan Ikone_2020",2020,"Lille","Ligue 1","Jonathan Ikone","FRA","MF,FW","21",1998,22.9,15,7,3,7,5,6,24,25,18,26,2,24,5,20,3,0,"https://fbref.com/en/players/42eaa028/Jonathan-Ikone"
"3994","Thiago Maia_2020",2020,"Lille","Ligue 1","Thiago Maia","BRA","MF","22",1997,0.5,4,4,1,3,0,0,1,0,1,0,0,0,1,5,1,0,"https://fbref.com/en/players/91e58f66/Thiago-Maia"
"3995","Mike Maignan_2020",2020,"Lille","Ligue 1","Mike Maignan","FRA","GK","24",1995,28,0,0,0,0,0,0,0,NA,0,0,0,0,2,2,5,0,"https://fbref.com/en/players/fcb38f57/Mike-Maignan"
"3996","Reinildo Mandava_2020",2020,"Lille","Ligue 1","Reinildo Mandava","MOZ","DF,MF","25",1994,12.3,37,21,23,11,3,25,41,61,16,16,1,15,19,56,20,0,"https://fbref.com/en/players/c20bdcd7/Reinildo-Mandava"
"3997","Cheikh Niasse_2020",2020,"Lille","Ligue 1","Cheikh Niasse","SEN","MF","19",2000,0.2,0,0,0,0,0,0,0,NA,0,0,0,0,0,0,0,0,"https://fbref.com/en/players/ff20acfe/Cheikh-Niasse"
"3998","Jean Onana_2020",2020,"Lille","Ligue 1","Jean Onana","CMR","MF","19",2000,0.9,0,0,0,0,0,0,2,0,2,1,0,1,1,1,0,0,"https://fbref.com/en/players/b5bb8188/Jean-Onana"
"3999","Victor Osimhen_2020",2020,"Lille","Ligue 1","Victor Osimhen","NGA","FW","20",1998,25.4,8,4,1,0,7,1,11,9.1,10,8,0,8,11,19,32,0,"https://fbref.com/en/players/8c90fd7a/Victor-Osimhen"
"4000","Abou Ouattara_2020",2020,"Lille","Ligue 1","Abou Ouattara","BFA","FW","19",1999,0.1,0,0,0,0,0,0,0,NA,0,0,0,0,0,0,1,0,"https://fbref.com/en/players/6578600f/Abou-Ouattara"
"4001","Jérémy Pied_2020",2020,"Lille","Ligue 1","Jérémy Pied","FRA","DF","30",1989,5,18,10,6,11,1,11,16,68.8,5,8,0,8,7,25,10,0,"https://fbref.com/en/players/a634b9d2/Jeremy-Pied"
"4002","Loïc Rémy_2020",2020,"Lille","Ligue 1","Loïc Rémy","FRA","FW","32",1987,10.7,4,1,0,3,1,0,4,0,4,1,1,0,0,4,7,0,"https://fbref.com/en/players/5c2da10f/Loic-Remy"
"4003","Renato Sanches_2020",2020,"Lille","Ligue 1","Renato Sanches","POR","MF,FW","21",1997,16.5,28,15,9,15,4,8,33,24.2,25,19,1,18,15,43,10,1,"https://fbref.com/en/players/032f894e/Renato-Sanches"
"4004","Adama Soumaoro_2020",2020,"Lille","Ligue 1","Adama Soumaoro","FRA","DF","27",1992,4.6,1,1,0,1,0,0,0,NA,0,6,5,1,4,5,17,0,"https://fbref.com/en/players/7b075c75/Adama-Soumaoro"
"4005","Boubakary Soumaré_2020",2020,"Lille","Ligue 1","Boubakary Soumaré","FRA","MF","20",1999,13.5,19,12,6,13,0,9,19,47.4,10,6,0,6,16,35,9,0,"https://fbref.com/en/players/ae59b359/Boubakary-Soumare"
"4006","Timothy Weah_2020",2020,"Lille","Ligue 1","Timothy Weah","USA","MF,FW","19",2000,0.9,0,0,0,0,0,0,1,0,1,0,0,0,0,0,1,0,"https://fbref.com/en/players/8eec784d/Timothy-Weah"
"4007","Xeka_2020",2020,"Lille","Ligue 1","Xeka","POR","MF","24",1994,7.9,18,10,3,13,2,9,29,31,20,11,1,10,4,22,7,1,"https://fbref.com/en/players/f3600c02/Xeka"
"4008","Yusuf Yazıcı_2020",2020,"Lille","Ligue 1","Yusuf Yazıcı","TUR","MF,FW","22",1997,9.4,17,8,2,11,4,5,13,38.5,8,6,1,5,5,22,1,1,"https://fbref.com/en/players/f5c8b425/Yusuf-Yazici"
"4009","Adrián_2020",2020,"Liverpool","Premier League","Adrián","ESP","GK","32",1987,9.7,1,1,1,0,0,1,1,100,0,0,0,0,0,1,8,3,"https://fbref.com/en/players/f76e6b4e/Adrian"
"4010","Trent Alexander-Arnold_2020",2020,"Liverpool","Premier League","Trent Alexander-Arnold","ENG","DF","20",1998,35.3,55,34,35,17,3,36,78,46.2,42,27,9,18,45,100,84,3,"https://fbref.com/en/players/cd1acf9d/Trent-Alexander-Arnold"
"4011","Alisson_2020",2020,"Liverpool","Premier League","Alisson","BRA","GK","26",1992,28.3,0,0,0,0,0,0,2,0,2,0,0,0,1,1,13,3,"https://fbref.com/en/players/7a2e46a8/Alisson"
"4012","Harvey Elliott_2020",2020,"Liverpool","Premier League","Harvey Elliott","ENG","DF","16",2003,0.1,0,0,0,0,0,0,0,NA,0,0,0,0,0,0,0,0,"https://fbref.com/en/players/c8387671/Harvey-Elliott"
"4013","Fabinho_2020",2020,"Liverpool","Premier League","Fabinho","BRA","MF","25",1993,23.1,62,35,20,35,7,26,67,38.8,41,25,2,23,34,96,19,1,"https://fbref.com/en/players/7f3b388c/Fabinho"
"4014","Roberto Firmino_2020",2020,"Liverpool","Premier League","Roberto Firmino","BRA","FW","27",1991,33.2,37,19,8,14,15,10,43,23.3,33,34,3,31,7,44,11,1,"https://fbref.com/en/players/4c370d81/Roberto-Firmino"
"4015","Joe Gomez_2020",2020,"Liverpool","Premier League","Joe Gomez","ENG","DF","22",1997,22.3,23,16,17,6,0,9,20,45,11,15,8,7,38,61,64,2,"https://fbref.com/en/players/7a11550b/Joe-Gomez"
"4016","Jordan Henderson_2020",2020,"Liverpool","Premier League","Jordan Henderson","ENG","MF","29",1990,24.9,63,41,18,33,12,22,55,40,33,22,4,18,30,93,21,2,"https://fbref.com/en/players/935e6b8f/Jordan-Henderson"
"4017","Curtis Jones_2020",2020,"Liverpool","Premier League","Curtis Jones","ENG","MF","18",2001,1.4,4,4,0,1,3,3,4,75,1,2,0,2,2,6,1,0,"https://fbref.com/en/players/4fb9c88f/Curtis-Jones"
"4018","Naby Keïta_2020",2020,"Liverpool","Premier League","Naby Keïta","GUI","MF","24",1995,9.1,30,14,8,16,6,11,26,42.3,15,18,0,18,10,40,4,0,"https://fbref.com/en/players/f25c8e3a/Naby-Keita"
"4019","Adam Lallana_2020",2020,"Liverpool","Premier League","Adam Lallana","ENG","MF,FW","31",1988,4.2,19,9,7,9,3,6,21,28.6,15,7,0,7,5,24,3,0,"https://fbref.com/en/players/99813635/Adam-Lallana"
"4020","Dejan Lovren_2020",2020,"Liverpool","Premier League","Dejan Lovren","CRO","DF","30",1989,8.6,13,8,10,3,0,7,12,58.3,5,9,6,3,10,23,42,0,"https://fbref.com/en/players/1a2935f6/Dejan-Lovren"
"4021","Sadio Mané_2020",2020,"Liverpool","Premier League","Sadio Mané","SEN","FW","27",1992,30.5,44,32,9,20,15,13,40,32.5,27,19,0,19,13,57,11,2,"https://fbref.com/en/players/c691bfe2/Sadio-Mane"
"4022","Joël Matip_2020",2020,"Liverpool","Premier League","Joël Matip","CMR","DF","27",1991,7.8,13,9,4,7,2,4,11,36.4,7,8,4,4,12,25,38,0,"https://fbref.com/en/players/b217ef29/Joel-Matip"
"4023","James Milner_2020",2020,"Liverpool","Premier League","James Milner","ENG","MF,DF","33",1986,10.4,16,10,3,10,3,6,26,23.1,20,12,3,9,7,23,17,1,"https://fbref.com/en/players/2f90f6b8/James-Milner"
"4024","Takumi Minamino_2020",2020,"Liverpool","Premier League","Takumi Minamino","JPN","FW,MF","24",1995,2.8,3,3,0,2,1,2,10,20,8,3,0,3,0,3,3,0,"https://fbref.com/en/players/f833a830/Takumi-Minamino"
"4025","Divock Origi_2020",2020,"Liverpool","Premier League","Divock Origi","BEL","FW","24",1995,8,12,9,2,5,5,4,9,44.4,5,2,0,2,4,16,5,0,"https://fbref.com/en/players/43a166b4/Divock-Origi"
"4026","Alex Oxlade-Chamberlain_2020",2020,"Liverpool","Premier League","Alex Oxlade-Chamberlain","ENG","MF,FW","25",1993,16.5,18,9,4,6,8,5,21,23.8,16,26,1,25,22,40,10,0,"https://fbref.com/en/players/38c7feef/Alex-Oxlade-Chamberlain"
"4027","Andrew Robertson_2020",2020,"Liverpool","Premier League","Andrew Robertson","SCO","DF","25",1994,34.6,54,31,17,25,12,27,61,44.3,34,29,7,22,38,92,72,1,"https://fbref.com/en/players/2e4f5f03/Andrew-Robertson"
"4028","Mohamed Salah_2020",2020,"Liverpool","Premier League","Mohamed Salah","EGY","FW","27",1992,32,16,6,1,4,11,5,22,22.7,17,3,1,2,8,24,2,1,"https://fbref.com/en/players/e342ad68/Mohamed-Salah"
"4029","Xherdan Shaqiri_2020",2020,"Liverpool","Premier League","Xherdan Shaqiri","SUI","FW,MF","27",1991,2.1,1,0,0,1,0,0,1,0,1,0,0,0,0,1,0,0,"https://fbref.com/en/players/6421ec64/Xherdan-Shaqiri"
"4030","Virgil van Dijk_2020",2020,"Liverpool","Premier League","Virgil van Dijk","NED","DF","28",1991,38,23,12,18,5,0,6,13,46.2,7,20,15,5,40,63,166,2,"https://fbref.com/en/players/e06683ca/Virgil-van-Dijk"
"4031","Georginio Wijnaldum_2020",2020,"Liverpool","Premier League","Georginio Wijnaldum","NED","MF","28",1990,32.6,38,20,12,21,5,10,40,25,30,18,4,14,17,55,34,3,"https://fbref.com/en/players/eb58eef0/Georginio-Wijnaldum"
"4032","Neco Williams_2020",2020,"Liverpool","Premier League","Neco Williams","WAL","DF","18",2001,2.6,5,3,1,3,1,4,5,80,1,3,1,2,9,14,6,0,"https://fbref.com/en/players/dd323728/Neco-Williams"
"4033","Joachim Andersen_2020",2020,"Lyon","Ligue 1","Joachim Andersen","DEN","DF","23",1996,17,17,9,15,2,0,7,19,36.8,12,16,12,4,10,27,74,2,"https://fbref.com/en/players/e34fc66d/Joachim-Andersen"
"4034","Houssem Aouar_2020",2020,"Lyon","Ligue 1","Houssem Aouar","ALG","MF,FW","21",1998,21.7,28,12,6,18,4,10,35,28.6,25,15,1,14,13,41,11,0,"https://fbref.com/en/players/a5db0bec/Houssem-Aouar"
"4035","Melvin Bard_2020",2020,"Lyon","Ligue 1","Melvin Bard","FRA","DF","18",2000,0.5,0,0,0,0,0,0,0,NA,0,0,0,0,1,1,0,0,"https://fbref.com/en/players/1ddbc7ca/Melvin-Bard"
"4036","Maxence Caqueret_2020",2020,"Lyon","Ligue 1","Maxence Caqueret","FRA","MF","19",2000,6.3,24,15,10,13,1,11,25,44,14,14,2,12,9,33,6,1,"https://fbref.com/en/players/f81ef10d/Maxence-Caqueret"
"4037","Rayan Cherki_2020",2020,"Lyon","Ligue 1","Rayan Cherki","FRA","MF,FW","15",2003,1.6,3,2,0,1,2,3,4,75,1,3,0,3,0,3,0,0,"https://fbref.com/en/players/b34c63a5/Rayan-Cherki"
"4038","Maxwel Cornet_2020",2020,"Lyon","Ligue 1","Maxwel Cornet","CIV","FW,DF","22",1996,14.8,30,19,18,8,4,13,23,56.5,10,16,1,15,21,51,19,1,"https://fbref.com/en/players/beb391dd/Maxwel-Cornet"
"4039","Moussa Dembélé_2020",2020,"Lyon","Ligue 1","Moussa Dembélé","FRA","FW","23",1996,24.3,12,7,2,5,5,4,14,28.6,10,14,3,11,5,17,31,0,"https://fbref.com/en/players/e7986081/Moussa-Dembele"
"4040","Jason Denayer_2020",2020,"Lyon","Ligue 1","Jason Denayer","BEL","DF","24",1995,23.7,17,13,12,5,0,10,14,71.4,4,32,29,3,20,37,83,0,"https://fbref.com/en/players/47af88b8/Jason-Denayer"
"4041","Leo Dubois_2020",2020,"Lyon","Ligue 1","Leo Dubois","FRA","DF","24",1994,15,32,23,20,9,3,13,22,59.1,9,12,4,8,18,50,34,1,"https://fbref.com/en/players/ff0ab48c/Leo-Dubois"
"4042","Amine Gouiri_2020",2020,"Lyon","Ligue 1","Amine Gouiri","FRA","FW","19",2000,0,0,0,0,0,0,0,0,NA,0,0,0,0,0,0,0,0,"https://fbref.com/en/players/aad56ca3/Amine-Gouiri"
"4043","Bruno Guimarães_2020",2020,"Lyon","Ligue 1","Bruno Guimarães","BRA","MF","21",1997,3,12,7,5,6,1,5,10,50,5,1,0,1,4,16,1,0,"https://fbref.com/en/players/82518f62/Bruno-Guimaraes"
"4044","Youssouf Koné_2020",2020,"Lyon","Ligue 1","Youssouf Koné","MLI","DF","24",1995,9.1,22,14,17,3,2,12,20,60,8,2,1,1,8,30,15,0,"https://fbref.com/en/players/e6eadfb8/Youssouf-Kone"
"4045","Anthony Lopes_2020",2020,"Lyon","Ligue 1","Anthony Lopes","POR","GK","28",1990,26,0,0,0,0,0,0,0,NA,0,0,0,0,1,1,11,0,"https://fbref.com/en/players/f00de885/Anthony-Lopes"
"4046","Jean Lucas_2020",2020,"Lyon","Ligue 1","Jean Lucas","BRA","MF","21",1998,2.2,16,7,8,5,3,2,9,22.2,7,2,2,0,2,18,0,0,"https://fbref.com/en/players/a99138af/Jean-Lucas"
"4047","Fernando Marçal_2020",2020,"Lyon","Ligue 1","Fernando Marçal","BRA","DF","30",1989,9.2,28,18,18,7,3,13,26,50,13,7,3,4,26,54,32,0,"https://fbref.com/en/players/9ae9eaea/Fernando-Marcal"
"4048","Marcelo_2020",2020,"Lyon","Ligue 1","Marcelo","BRA","DF","32",1987,16.7,27,18,18,8,1,16,23,69.6,7,12,11,1,22,49,77,0,"https://fbref.com/en/players/e3d0b0c4/Marcelo"
"4049","Memphis_2020",2020,"Lyon","Ligue 1","Memphis","NED","FW,MF","25",1994,11.3,4,3,2,0,2,0,5,0,5,0,0,0,2,6,2,0,"https://fbref.com/en/players/8f696594/Memphis"
"4050","Thiago Mendes_2020",2020,"Lyon","Ligue 1","Thiago Mendes","BRA","MF","27",1992,20.1,43,29,20,19,4,21,45,46.7,24,21,7,14,46,89,36,0,"https://fbref.com/en/players/c6e5d20f/Thiago-Mendes"
"4051","Rafael_2020",2020,"Lyon","Ligue 1","Rafael","BRA","DF","29",1990,7.8,24,16,12,8,4,10,18,55.6,8,6,3,3,10,34,14,0,"https://fbref.com/en/players/9a1f2e1c/Rafael"
"4052","Jeff Reine-Adélaïde_2020",2020,"Lyon","Ligue 1","Jeff Reine-Adélaïde","FRA","MF,FW","21",1998,8.7,10,8,3,3,4,5,13,38.5,8,3,1,2,7,17,4,0,"https://fbref.com/en/players/d504b3e1/Jeff-Reine-Adelaide"
"4053","Oumar Solet_2020",2020,"Lyon","Ligue 1","Oumar Solet","FRA","DF","19",2000,0.1,0,0,0,0,0,0,0,NA,0,1,1,0,0,0,1,0,"https://fbref.com/en/players/0670ee51/Oumar-Solet"
"4054","Ciprian Tătărușanu_2020",2020,"Lyon","Ligue 1","Ciprian Tătărușanu","ROU","GK","33",1986,2,0,0,0,0,0,0,0,NA,0,0,0,0,0,0,0,1,"https://fbref.com/en/players/b056e3da/Ciprian-Tatarusanu"
"4055","Martin Terrier_2020",2020,"Lyon","Ligue 1","Martin Terrier","FRA","FW,MF","22",1997,13.3,20,15,7,10,3,3,14,21.4,11,14,1,13,10,30,11,0,"https://fbref.com/en/players/5148dcc5/Martin-Terrier"
"4056","Kenny Tete_2020",2020,"Lyon","Ligue 1","Kenny Tete","NED","DF","23",1995,11.9,33,21,12,16,5,15,23,65.2,8,12,3,9,19,52,34,0,"https://fbref.com/en/players/77d7c96f/Kenny-Tete"
"4057","Karl Toko Ekambi_2020",2020,"Lyon","Ligue 1","Karl Toko Ekambi","CMR","FW,MF","26",1992,6,5,2,0,1,4,3,5,60,2,2,0,2,5,10,1,0,"https://fbref.com/en/players/5ceba7fc/Karl-Toko-Ekambi"
"4058","Lucas Tousart_2020",2020,"Lyon","Ligue 1","Lucas Tousart","FRA","MF","22",1997,19.6,58,32,19,34,5,17,56,30.4,39,19,7,12,31,89,27,1,"https://fbref.com/en/players/71ec39ef/Lucas-Tousart"
"4059","Bertrand Traoré_2020",2020,"Lyon","Ligue 1","Bertrand Traoré","BFA","FW,MF","23",1995,13.9,27,14,8,12,7,8,19,42.1,11,17,2,15,21,48,16,0,"https://fbref.com/en/players/c47541e0/Bertrand-Traore"
"4060","László Bénes_2020",2020,"M'Gladbach","Bundesliga","László Bénes","SVK","MF","21",1997,10,15,8,3,5,7,6,19,31.6,13,6,2,4,8,23,3,1,"https://fbref.com/en/players/fe888e39/Laszlo-Benes"
"4061","Keanan Bennetts_2020",2020,"M'Gladbach","Bundesliga","Keanan Bennetts","ENG","MF","20",1999,0,0,0,0,0,0,0,1,0,1,0,0,0,0,0,0,0,"https://fbref.com/en/players/f4c7c708/Keanan-Bennetts"
"4062","Ramy Bensebaini_2020",2020,"M'Gladbach","Bundesliga","Ramy Bensebaini","ALG","DF","24",1995,16.1,33,17,17,12,4,18,31,58.1,13,24,4,20,38,71,49,0,"https://fbref.com/en/players/378825c7/Ramy-Bensebaini"
"4063","Jordan Beyer_2020",2020,"M'Gladbach","Bundesliga","Jordan Beyer","GER","DF","19",2000,1.2,3,1,3,0,0,0,1,0,1,4,2,2,1,4,4,0,"https://fbref.com/en/players/9af1f9ff/Jordan-Beyer"
"4064","Mamadou Doucouré_2020",2020,"M'Gladbach","Bundesliga","Mamadou Doucouré","FRA","MF","21",1998,0,0,0,0,0,0,0,0,NA,0,0,0,0,0,0,0,0,"https://fbref.com/en/players/7bd5b8fd/Mamadou-Doucoure"
"4065","Nico Elvedi_2020",2020,"M'Gladbach","Bundesliga","Nico Elvedi","SUI","DF","22",1996,29.1,45,27,37,8,0,19,38,50,19,32,15,17,62,107,112,0,"https://fbref.com/en/players/48035304/Nico-Elvedi"
"4066","Breel Embolo_2020",2020,"M'Gladbach","Bundesliga","Breel Embolo","SUI","FW,MF","22",1997,17.2,22,11,2,15,5,4,15,26.7,11,12,1,11,8,30,5,0,"https://fbref.com/en/players/0b4f388a/Breel-Embolo"
"4067","Matthias Ginter_2020",2020,"M'Gladbach","Bundesliga","Matthias Ginter","GER","DF","25",1994,30.9,34,20,19,14,1,17,31,54.8,14,27,22,5,34,68,125,3,"https://fbref.com/en/players/f521b80a/Matthias-Ginter"
"4068","Patrick Herrmann_2020",2020,"M'Gladbach","Bundesliga","Patrick Herrmann","GER","FW,MF","28",1991,16.1,24,11,8,10,6,5,16,31.3,11,21,4,17,11,35,8,0,"https://fbref.com/en/players/dfb6490a/Patrick-Herrmann"
"4069","Jonas Hofmann_2020",2020,"M'Gladbach","Bundesliga","Jonas Hofmann","GER","MF,FW","27",1992,18.1,43,27,22,12,9,22,76,28.9,54,28,3,25,18,61,14,0,"https://fbref.com/en/players/2903a856/Jonas-Hofmann"
"4070","Tony Jantschke_2020",2020,"M'Gladbach","Bundesliga","Tony Jantschke","GER","DF","29",1990,11.2,33,21,23,10,0,15,24,62.5,9,20,11,9,27,60,48,0,"https://fbref.com/en/players/34b54da7/Tony-Jantschke"
"4071","Fabian Johnson_2020",2020,"M'Gladbach","Bundesliga","Fabian Johnson","USA","MF,DF","31",1987,3,5,3,2,2,1,2,4,50,2,4,1,3,2,7,3,0,"https://fbref.com/en/players/76e5da9d/Fabian-Johnson"
"4072","Christoph Kramer_2020",2020,"M'Gladbach","Bundesliga","Christoph Kramer","GER","MF","28",1991,16.3,45,29,19,21,5,19,49,38.8,30,22,3,19,14,59,19,0,"https://fbref.com/en/players/496aeede/Christoph-Kramer"
"4073","Stefan Lainer_2020",2020,"M'Gladbach","Bundesliga","Stefan Lainer","AUT","DF","26",1992,30.1,51,30,25,19,7,24,54,44.4,30,38,7,31,29,80,71,0,"https://fbref.com/en/players/4aea5077/Stefan-Lainer"
"4074","Torben Müsel_2020",2020,"M'Gladbach","Bundesliga","Torben Müsel","GER","FW","20",1999,0,0,0,0,0,0,0,0,NA,0,0,0,0,1,1,0,0,"https://fbref.com/en/players/d01b9ad6/Torben-Musel"
"4075","Florian Neuhaus_2020",2020,"M'Gladbach","Bundesliga","Florian Neuhaus","GER","MF","22",1997,26.2,42,23,13,22,7,12,54,22.2,42,24,4,20,27,69,8,0,"https://fbref.com/en/players/36a59ba4/Florian-Neuhaus"
"4076","Alassane Pléa_2020",2020,"M'Gladbach","Bundesliga","Alassane Pléa","FRA","FW","26",1993,23.8,16,7,5,6,5,8,28,28.6,20,21,2,19,9,25,7,0,"https://fbref.com/en/players/bc6bd723/Alassane-Plea"
"4077","Raffael_2020",2020,"M'Gladbach","Bundesliga","Raffael","BRA","MF,FW","34",1985,0.7,0,0,0,0,0,0,2,0,2,2,0,2,0,0,0,0,"https://fbref.com/en/players/791af558/Raffael"
"4078","Yann Sommer_2020",2020,"M'Gladbach","Bundesliga","Yann Sommer","SUI","GK","30",1988,34,0,0,0,0,0,0,1,0,1,0,0,0,1,1,11,6,"https://fbref.com/en/players/420c18a1/Yann-Sommer"
"4079","Lars Stindl_2020",2020,"M'Gladbach","Bundesliga","Lars Stindl","GER","MF,FW","30",1988,15.9,27,16,4,15,8,10,28,35.7,18,18,2,16,10,37,7,0,"https://fbref.com/en/players/7cd6badb/Lars-Stindl"
"4080","Tobias Strobl_2020",2020,"M'Gladbach","Bundesliga","Tobias Strobl","GER","MF,DF","29",1990,6.8,9,6,5,4,0,3,8,37.5,5,8,4,4,11,20,5,0,"https://fbref.com/en/players/17780d2b/Tobias-Strobl"
"4081","Marcus Thuram_2020",2020,"M'Gladbach","Bundesliga","Marcus Thuram","FRA","FW","21",1997,24.5,26,18,7,8,11,11,29,37.9,18,20,1,19,12,38,18,0,"https://fbref.com/en/players/6f8cd6d0/Marcus-Thuram"
"4082","Ibrahima Traoré_2020",2020,"M'Gladbach","Bundesliga","Ibrahima Traoré","GUI","FW,MF","31",1988,1.7,4,3,1,1,2,1,7,14.3,6,1,0,1,1,5,3,0,"https://fbref.com/en/players/096a77c4/Ibrahima-Traore"
"4083","Oscar Wendt_2020",2020,"M'Gladbach","Bundesliga","Oscar Wendt","SWE","DF","33",1985,18.7,26,14,16,8,2,12,31,38.7,19,27,6,21,20,46,45,0,"https://fbref.com/en/players/b69261a0/Oscar-Wendt"
"4084","Denis Zakaria_2020",2020,"M'Gladbach","Bundesliga","Denis Zakaria","SUI","MF,DF","22",1996,21.6,49,30,23,23,3,20,39,51.3,19,39,12,27,37,86,31,1,"https://fbref.com/en/players/384d58d9/Denis-Zakaria"
"4085","Taiwo Awoniyi_2020",2020,"Mainz 05","Bundesliga","Taiwo Awoniyi","NGA","FW,MF","21",1997,5.4,2,0,0,2,0,0,4,0,4,4,2,2,2,4,3,0,"https://fbref.com/en/players/e5478b87/Taiwo-Awoniyi"
"4086","Ridle Baku_2020",2020,"Mainz 05","Bundesliga","Ridle Baku","GER","DF,MF","21",1998,26.1,54,31,25,22,7,26,53,49.1,27,45,7,38,42,96,57,0,"https://fbref.com/en/players/442b56fa/Ridle-Baku"
"4087","Leandro Barreiro Martins_2020",2020,"Mainz 05","Bundesliga","Leandro Barreiro Martins","LUX","MF","19",2000,10.4,38,21,16,19,3,14,29,48.3,15,18,3,15,9,47,18,1,"https://fbref.com/en/players/00242b75/Leandro-Barreiro-Martins"
"4088","Jean-Paul Boëtius_2020",2020,"Mainz 05","Bundesliga","Jean-Paul Boëtius","NED","MF","25",1994,25.2,63,33,21,31,11,20,57,35.1,37,38,1,37,26,89,6,0,"https://fbref.com/en/players/635f2732/Jean-Paul-Boetius"
"4089","Daniel Brosinski_2020",2020,"Mainz 05","Bundesliga","Daniel Brosinski","GER","DF","31",1988,19,40,27,13,23,4,15,34,44.1,19,16,2,14,14,54,58,0,"https://fbref.com/en/players/a7813ac4/Daniel-Brosinski"
"4090","Jeffrey Bruma_2020",2020,"Mainz 05","Bundesliga","Jeffrey Bruma","NED","DF","27",1991,7.5,12,8,8,4,0,4,6,66.7,2,11,5,6,6,18,34,1,"https://fbref.com/en/players/fbffc4b1/Jeffrey-Bruma"
"4091","Jonathan Burkardt_2020",2020,"Mainz 05","Bundesliga","Jonathan Burkardt","GER","FW,MF","19",2000,2.8,9,4,2,5,2,3,8,37.5,5,6,1,5,0,9,1,0,"https://fbref.com/en/players/05f99a4a/Jonathan-Burkardt"
"4092","Ji Dong-won_2020",2020,"Mainz 05","Bundesliga","Ji Dong-won","KOR","FW,MF","28",1991,1.1,0,0,0,0,0,0,1,0,1,1,0,1,0,0,0,0,"https://fbref.com/en/players/7d841904/Ji-Dong-won"
"4093","Edimilson Fernandes_2020",2020,"Mainz 05","Bundesliga","Edimilson Fernandes","SUI","MF,DF","23",1996,16.5,33,20,12,15,6,15,33,45.5,18,17,9,8,32,65,47,1,"https://fbref.com/en/players/3bb625ac/Edimilson-Fernandes"
"4094","Alexander Hack_2020",2020,"Mainz 05","Bundesliga","Alexander Hack","GER","DF","25",1993,8.9,26,10,19,6,1,16,27,59.3,11,20,9,11,23,49,60,1,"https://fbref.com/en/players/a5ec3ede/Alexander-Hack"
"4095","Pierre Kunde_2020",2020,"Mainz 05","Bundesliga","Pierre Kunde","CMR","MF","24",1995,20.7,34,17,15,18,1,12,30,40,18,16,4,12,26,60,55,0,"https://fbref.com/en/players/9ceb7642/Pierre-Kunde"
"4096","Danny Latza_2020",2020,"Mainz 05","Bundesliga","Danny Latza","GER","MF","29",1989,15.3,33,19,15,17,1,16,49,32.7,33,22,5,17,17,50,24,0,"https://fbref.com/en/players/33b554b7/Danny-Latza"
"4097","Aarón Martín_2020",2020,"Mainz 05","Bundesliga","Aarón Martín","ESP","DF","22",1997,19.9,29,15,17,8,4,9,22,40.9,13,11,5,6,30,59,36,0,"https://fbref.com/en/players/2f3e911a/Aaron-Martin"
"4098","Jean-Philippe Mateta_2020",2020,"Mainz 05","Bundesliga","Jean-Philippe Mateta","FRA","FW","22",1997,11.7,2,2,0,2,0,0,6,0,6,3,2,1,1,3,11,0,"https://fbref.com/en/players/50e6dc35/Jean-Philippe-Mateta"
"4099","Alexandru Maxim_2020",2020,"Mainz 05","Bundesliga","Alexandru Maxim","ROU","MF,DF","29",1990,1.3,4,2,1,2,1,1,3,33.3,2,0,0,0,1,5,1,0,"https://fbref.com/en/players/61fc9685/Alexandru-Maxim"
"4100","Florian Müller_2020",2020,"Mainz 05","Bundesliga","Florian Müller","GER","GK","21",1997,12.5,0,0,0,0,0,0,0,NA,0,0,0,0,2,2,3,1,"https://fbref.com/en/players/cbac6ec9/Florian-Muller"
"4101","Phillipp Mwene_2020",2020,"Mainz 05","Bundesliga","Phillipp Mwene","AUT","DF","25",1994,3.5,11,5,9,2,0,7,12,58.3,5,10,1,9,3,14,11,0,"https://fbref.com/en/players/2ff76adc/Phillipp-Mwene"
"4102","Moussa Niakhate_2020",2020,"Mainz 05","Bundesliga","Moussa Niakhate","SEN","DF","23",1996,33,35,22,29,6,0,16,29,55.2,13,40,26,14,40,75,124,4,"https://fbref.com/en/players/00242715/Moussa-Niakhate"
"4103","Karim Onisiwo_2020",2020,"Mainz 05","Bundesliga","Karim Onisiwo","AUT","FW","27",1992,19.2,27,19,6,10,11,5,13,38.5,8,20,3,17,7,34,11,0,"https://fbref.com/en/players/f26834c7/Karim-Onisiwo"
"4104","Levin Öztunalı_2020",2020,"Mainz 05","Bundesliga","Levin Öztunalı","GER","MF,FW","23",1996,19.8,28,19,13,12,3,12,35,34.3,23,27,1,26,9,37,14,2,"https://fbref.com/en/players/66385c46/Levin-Oztunali"
"4105","Ronaël Pierre-Gabriel_2020",2020,"Mainz 05","Bundesliga","Ronaël Pierre-Gabriel","FRA","DF","21",1998,6.4,16,10,9,6,1,7,13,53.8,6,7,0,7,8,24,31,1,"https://fbref.com/en/players/64ba07c0/Ronael-Pierre-Gabriel"
"4106","Robin Quaison_2020",2020,"Mainz 05","Bundesliga","Robin Quaison","SWE","FW,MF","25",1993,28.9,25,17,15,7,3,11,32,34.4,21,27,5,22,11,36,8,0,"https://fbref.com/en/players/74c7c2db/Robin-Quaison"
"4107","Jerry St. Juste_2020",2020,"Mainz 05","Bundesliga","Jerry St. Juste","NED","DF","22",1996,23.5,46,25,34,10,2,14,34,41.2,20,35,19,16,52,98,86,1,"https://fbref.com/en/players/90339309/Jerry-St-Juste"
"4108","Ádám Szalai_2020",2020,"Mainz 05","Bundesliga","Ádám Szalai","HUN","FW","31",1987,12.7,8,4,0,6,2,1,11,9.1,10,9,0,9,2,10,14,0,"https://fbref.com/en/players/53e07d0b/Adam-Szalai"
"4109","Robin Zentner_2020",2020,"Mainz 05","Bundesliga","Robin Zentner","GER","GK","24",1994,21.5,1,1,1,0,0,1,1,100,0,0,0,0,0,1,11,0,"https://fbref.com/en/players/5c4bf6ba/Robin-Zentner"
"4110","Lumor Agbenyenu_2020",2020,"Mallorca","La Liga","Lumor Agbenyenu","GHA","DF","22",1996,20.1,31,21,19,9,3,16,35,45.7,19,13,2,11,21,52,66,1,"https://fbref.com/en/players/073b1b37/Lumor-Agbenyenu"
"4111","Álex Alegría_2020",2020,"Mallorca","La Liga","Álex Alegría","ESP","FW","26",1992,1.2,1,0,1,0,0,0,0,NA,0,2,0,2,0,1,0,0,"https://fbref.com/en/players/46166b49/Alex-Alegria"
"4112","Iddrisu Baba_2020",2020,"Mallorca","La Liga","Iddrisu Baba","GHA","MF","23",1996,32.3,59,37,26,29,4,20,70,28.6,50,31,8,23,39,98,42,0,"https://fbref.com/en/players/bfd381b3/Iddrisu-Baba"
"4113","Ante Budimir_2020",2020,"Mallorca","La Liga","Ante Budimir","CRO","FW","28",1991,30.7,31,15,4,22,5,7,29,24.1,22,21,4,17,8,39,29,0,"https://fbref.com/en/players/8f3565b3/Ante-Budimir"
"4114","Ariday Cabrera_2020",2020,"Mallorca","La Liga","Ariday Cabrera","ESP","MF","30",1988,0.4,1,1,1,0,0,0,1,0,1,2,0,2,0,1,0,0,"https://fbref.com/en/players/206b11c5/Ariday-Cabrera"
"4115","Xisco Campos_2020",2020,"Mallorca","La Liga","Xisco Campos","ESP","DF","37",1982,5.3,7,4,5,2,0,5,9,55.6,4,8,5,3,11,18,23,0,"https://fbref.com/en/players/bd3b9a9f/Xisco-Campos"
"4116","Pablo Chavarría_2020",2020,"Mallorca","La Liga","Pablo Chavarría","ARG","FW,MF","31",1988,2.3,1,1,0,1,0,0,4,0,4,1,1,0,1,2,2,0,"https://fbref.com/en/players/4207e578/Pablo-Chavarria"
"4117","Cucho_2020",2020,"Mallorca","La Liga","Cucho","COL","FW,MF","20",1999,16.5,15,8,6,8,1,6,21,28.6,15,14,1,13,10,25,15,0,"https://fbref.com/en/players/71b47ab9/Cucho"
"4118","Fabricio_2020",2020,"Mallorca","La Liga","Fabricio","ESP","GK","31",1987,1,0,0,0,0,0,0,0,NA,0,0,0,0,0,0,0,1,"https://fbref.com/en/players/af245161/Fabricio"
"4119","Aleix Febas_2020",2020,"Mallorca","La Liga","Aleix Febas","ESP","MF,FW","23",1996,18.8,36,24,13,19,4,12,36,33.3,24,15,0,15,17,53,6,0,"https://fbref.com/en/players/38126309/Aleix-Febas"
"4120","Fran Gámez_2020",2020,"Mallorca","La Liga","Fran Gámez","ESP","DF","28",1991,19.6,64,42,32,27,5,33,74,44.6,41,31,11,20,29,93,41,0,"https://fbref.com/en/players/2e3406ae/Fran-Gamez"
"4121","Lago Junior_2020",2020,"Mallorca","La Liga","Lago Junior","CIV","MF,FW","28",1990,24.3,32,19,12,11,9,12,29,41.4,17,23,5,18,14,46,25,0,"https://fbref.com/en/players/360d70f8/Lago-Junior"
"4122","Leonardo Koutris_2020",2020,"Mallorca","La Liga","Leonardo Koutris","GRE","DF","24",1995,1,1,1,0,0,1,1,2,50,1,1,1,0,1,2,6,0,"https://fbref.com/en/players/114b510e/Leonardo-Koutris"
"4123","Takefusa Kubo_2020",2020,"Mallorca","La Liga","Takefusa Kubo","JPN","MF,FW","18",2001,25.7,34,22,16,12,6,15,44,34.1,29,19,1,18,23,57,10,0,"https://fbref.com/en/players/16aa3654/Takefusa-Kubo"
"4124","Rafel Obrador_2020",2020,"Mallorca","La Liga","Rafel Obrador","ESP","DF","15",2004,0,0,0,0,0,0,0,1,0,1,0,0,0,0,0,1,0,"https://fbref.com/en/players/949c3655/Rafel-Obrador"
"4125","Miquel Parera_2020",2020,"Mallorca","La Liga","Miquel Parera","ESP","GK","23",1996,1,0,0,0,0,0,0,0,NA,0,0,0,0,0,0,0,0,"https://fbref.com/en/players/f9b42381/Miquel-Parera"
"4126","Marc Pedraza_2020",2020,"Mallorca","La Liga","Marc Pedraza","ESP","MF","32",1987,1.4,1,1,1,0,0,1,5,20,4,0,0,0,4,5,1,0,"https://fbref.com/en/players/ff8f26ef/Marc-Pedraza"
"4127","Alejandro Pozo Pozo_2020",2020,"Mallorca","La Liga","Alejandro Pozo Pozo","ESP","DF","20",1999,16.6,38,24,30,6,2,19,38,50,19,23,2,21,23,61,29,1,"https://fbref.com/en/players/3c16d927/Alejandro-Pozo-Pozo"
"4128","Abdón Prats_2020",2020,"Mallorca","La Liga","Abdón Prats","ESP","FW","26",1992,3.1,1,1,0,0,1,0,1,0,1,1,0,1,0,1,1,0,"https://fbref.com/en/players/d1b060e2/Abdon-Prats"
"4129","Baba Rahman_2020",2020,"Mallorca","La Liga","Baba Rahman","GHA","DF","25",1994,1.2,3,2,2,0,1,0,0,NA,0,2,1,1,1,4,2,0,"https://fbref.com/en/players/e4086af3/Baba-Rahman"
"4130","Antonio Raillo_2020",2020,"Mallorca","La Liga","Antonio Raillo","ESP","DF","27",1991,30.8,31,21,24,7,0,13,19,68.4,6,31,26,5,22,53,112,1,"https://fbref.com/en/players/b857bd29/Antonio-Raillo"
"4131","Manolo Reina_2020",2020,"Mallorca","La Liga","Manolo Reina","ESP","GK","34",1985,36,0,0,0,0,0,0,1,0,1,2,0,2,5,5,9,1,"https://fbref.com/en/players/605eb473/Manolo-Reina"
"4132","Dani Rodríguez_2020",2020,"Mallorca","La Liga","Dani Rodríguez","ESP","MF,FW","31",1988,33.8,59,32,24,28,7,18,61,29.5,43,35,3,32,38,97,27,1,"https://fbref.com/en/players/70f8e0bd/Dani-Rodriguez"
"4133","Luka Romero_2020",2020,"Mallorca","La Liga","Luka Romero","ARG","FW","14",2004,0.1,0,0,0,0,0,0,0,NA,0,0,0,0,0,0,0,0,"https://fbref.com/en/players/ca6edaa0/Luka-Romero"
"4134","Yannis Salibur_2020",2020,"Mallorca","La Liga","Yannis Salibur","FRA","MF,FW","28",1991,0.9,0,0,0,0,0,0,4,0,4,0,0,0,1,1,1,0,"https://fbref.com/en/players/bb4a42be/Yannis-Salibur"
"4135","Joan Sastre Vanrell_2020",2020,"Mallorca","La Liga","Joan Sastre Vanrell","ESP","DF","22",1997,15.1,30,17,26,3,1,17,39,43.6,22,8,2,6,23,53,27,1,"https://fbref.com/en/players/f9acf8bf/Joan-Sastre-Vanrell"
"4136","Aleksandar Sedlar_2020",2020,"Mallorca","La Liga","Aleksandar Sedlar","SRB","DF","27",1991,9,13,6,10,2,1,7,11,63.6,4,17,11,6,16,29,31,0,"https://fbref.com/en/players/a35134ae/Aleksandar-Sedlar"
"4137","Josep Señé_2020",2020,"Mallorca","La Liga","Josep Señé","ESP","MF","27",1991,1.7,2,1,2,0,0,2,5,40,3,2,1,1,0,2,2,0,"https://fbref.com/en/players/8fc259d7/Josep-Sene"
"4138","Salva Sevilla_2020",2020,"Mallorca","La Liga","Salva Sevilla","ESP","MF","35",1984,28.5,27,21,11,16,0,9,30,30,21,17,5,12,29,56,17,1,"https://fbref.com/en/players/75bd85ea/Salva-Sevilla"
"4139","Ki Sung-yueng_2020",2020,"Mallorca","La Liga","Ki Sung-yueng","KOR","MF","30",1989,0.1,0,0,0,0,0,0,1,0,1,0,0,0,0,0,0,0,"https://fbref.com/en/players/1d8c99b0/Ki-Sung-yueng"
"4140","Aleksandar Trajkovski_2020",2020,"Mallorca","La Liga","Aleksandar Trajkovski","MKD","MF,FW","26",1992,3.7,2,0,1,1,0,1,7,14.3,6,2,0,2,3,5,1,0,"https://fbref.com/en/players/84bba8b6/Aleksandar-Trajkovski"
"4141","Martin Valjent_2020",2020,"Mallorca","La Liga","Martin Valjent","SVK","DF","23",1995,35.4,25,17,14,10,1,13,25,52,12,39,27,12,37,62,146,1,"https://fbref.com/en/players/f2c6ac01/Martin-Valjent"
"4142","Sergio Agüero_2020",2020,"Manchester City","Premier League","Sergio Agüero","ARG","FW","31",1988,16.1,7,4,0,4,3,1,8,12.5,7,9,1,8,3,10,2,0,"https://fbref.com/en/players/4d034881/Sergio-Aguero"
"4143","Angeliño_2020",2020,"Manchester City","Premier League","Angeliño","ESP","DF","22",1997,4.7,5,2,3,1,1,5,7,71.4,2,1,0,1,9,14,15,0,"https://fbref.com/en/players/30941e96/Angelino"
"4144","Claudio Bravo_2020",2020,"Manchester City","Premier League","Claudio Bravo","CHI","GK","36",1983,3.9,0,0,0,0,0,0,0,NA,0,0,0,0,0,0,1,1,"https://fbref.com/en/players/10072610/Claudio-Bravo"
"4145","João Cancelo_2020",2020,"Manchester City","Premier League","João Cancelo","POR","DF","25",1994,13.4,40,24,21,12,7,24,40,60,16,9,2,7,21,61,18,0,"https://fbref.com/en/players/bd6351cd/Joao-Cancelo"
"4146","Kevin De Bruyne_2020",2020,"Manchester City","Premier League","Kevin De Bruyne","BEL","MF","28",1991,31,45,24,8,20,17,18,66,27.3,48,26,4,22,18,63,24,2,"https://fbref.com/en/players/e46012d4/Kevin-De-Bruyne"
"4147","Thomas Doyle_2020",2020,"Manchester City","Premier League","Thomas Doyle","ENG","MF","17",2001,0.2,0,0,0,0,0,0,1,0,1,0,0,0,0,0,0,0,"https://fbref.com/en/players/5526deb1/Thomas-Doyle"
"4148","Ederson_2020",2020,"Manchester City","Premier League","Ederson","BRA","GK","25",1993,34.1,2,2,2,0,0,2,5,40,3,0,0,0,3,5,16,6,"https://fbref.com/en/players/3bb7b8b4/Ederson"
"4149","Fernandinho_2020",2020,"Manchester City","Premier League","Fernandinho","BRA","DF","34",1985,26.6,50,35,32,16,2,29,48,60.4,19,28,16,12,25,75,82,0,"https://fbref.com/en/players/101da2b5/Fernandinho"
"4150","Phil Foden_2020",2020,"Manchester City","Premier League","Phil Foden","ENG","FW,MF","19",2000,10,14,10,4,6,4,6,19,31.6,13,5,0,5,6,20,2,0,"https://fbref.com/en/players/ed1e53f3/Phil-Foden"
"4151","Eric García_2020",2020,"Manchester City","Premier League","Eric García","ESP","DF","18",2001,8.8,6,1,4,2,0,5,9,55.6,4,2,0,2,18,24,33,0,"https://fbref.com/en/players/2bed3eab/Eric-Garcia"
"4152","İlkay Gündoğan_2020",2020,"Manchester City","Premier League","İlkay Gündoğan","GER","MF","28",1990,22.4,27,16,9,11,7,9,41,22,32,17,5,12,31,58,13,0,"https://fbref.com/en/players/819b3158/Ilkay-Gundogan"
"4153","Gabriel Jesus_2020",2020,"Manchester City","Premier League","Gabriel Jesus","BRA","FW","22",1997,22.6,17,10,4,5,8,7,25,28,18,26,1,25,11,28,6,0,"https://fbref.com/en/players/b66315ae/Gabriel-Jesus"
"4154","Aymeric Laporte_2020",2020,"Manchester City","Premier League","Aymeric Laporte","ESP","DF","25",1994,12.2,13,6,6,7,0,4,9,44.4,5,6,5,1,20,33,26,1,"https://fbref.com/en/players/119b9a8e/Aymeric-Laporte"
"4155","Riyad Mahrez_2020",2020,"Manchester City","Premier League","Riyad Mahrez","ALG","FW,MF","28",1991,21.6,28,14,11,9,8,11,38,28.9,27,31,1,30,18,46,8,2,"https://fbref.com/en/players/892d5bb1/Riyad-Mahrez"
"4156","Benjamin Mendy_2020",2020,"Manchester City","Premier League","Benjamin Mendy","FRA","DF","25",1994,16.6,18,15,7,7,4,9,27,33.3,18,10,2,8,16,34,21,3,"https://fbref.com/en/players/5271c8f1/Benjamin-Mendy"
"4157","Nicolás Otamendi_2020",2020,"Manchester City","Premier League","Nicolás Otamendi","ARG","DF","31",1988,19.1,28,14,21,6,1,16,33,48.5,17,15,9,6,21,49,76,2,"https://fbref.com/en/players/0d267745/Nicolas-Otamendi"
"4158","Rodri_2020",2020,"Manchester City","Premier League","Rodri","ESP","MF","23",1996,27.6,50,30,17,25,8,23,63,36.5,40,19,5,14,26,76,35,0,"https://fbref.com/en/players/6434f10d/Rodri"
"4159","Leroy Sané_2020",2020,"Manchester City","Premier League","Leroy Sané","GER","FW","23",1996,0.1,0,0,0,0,0,0,0,NA,0,0,0,0,0,0,0,0,"https://fbref.com/en/players/2b114be3/Leroy-Sane"
"4160","Bernardo Silva_2020",2020,"Manchester City","Premier League","Bernardo Silva","POR","FW,MF","24",1994,22.6,36,18,8,21,7,13,44,29.5,31,25,1,24,24,60,13,0,"https://fbref.com/en/players/3eb22ec9/Bernardo-Silva"
"4161","David Silva_2020",2020,"Manchester City","Premier League","David Silva","ESP","MF","33",1986,20.3,26,14,3,15,8,10,28,35.7,18,18,3,15,13,39,5,0,"https://fbref.com/en/players/e2716bd0/David-Silva"
"4162","Raheem Sterling_2020",2020,"Manchester City","Premier League","Raheem Sterling","ENG","FW","24",1994,29.5,27,15,8,10,9,6,28,21.4,22,16,2,14,15,42,4,0,"https://fbref.com/en/players/b400bde0/Raheem-Sterling"
"4163","John Stones_2020",2020,"Manchester City","Premier League","John Stones","ENG","DF","25",1994,12.5,16,10,8,7,1,3,5,60,2,5,3,2,9,25,32,2,"https://fbref.com/en/players/5eecec3d/John-Stones"
"4164","Kyle Walker_2020",2020,"Manchester City","Premier League","Kyle Walker","ENG","DF","29",1990,26.6,28,18,12,15,1,12,29,41.4,17,15,6,9,28,56,42,1,"https://fbref.com/en/players/86dd77d1/Kyle-Walker"
"4165","Oleksandr Zinchenko_2020",2020,"Manchester City","Premier League","Oleksandr Zinchenko","UKR","DF","22",1996,14.2,31,19,16,11,4,17,32,53.1,15,9,0,9,17,48,21,1,"https://fbref.com/en/players/51cf8561/Oleksandr-Zinchenko"
"4166","Eric Bailly_2020",2020,"Manchester Utd","Premier League","Eric Bailly","CIV","DF","25",1994,1.7,0,0,0,0,0,0,1,0,1,3,3,0,4,4,7,1,"https://fbref.com/en/players/a1232f4e/Eric-Bailly"
"4167","Tahith Chong_2020",2020,"Manchester Utd","Premier League","Tahith Chong","NED","FW,DF","19",1999,0.4,0,0,0,0,0,0,0,NA,0,0,0,0,0,0,0,0,"https://fbref.com/en/players/2696b6a9/Tahith-Chong"
"4168","Diogo Dalot_2020",2020,"Manchester Utd","Premier League","Diogo Dalot","POR","DF,MF","20",1999,0.7,3,2,3,0,0,3,4,75,1,1,0,1,2,5,1,0,"https://fbref.com/en/players/d9565625/Diogo-Dalot"
"4169","Bruno Fernandes_2020",2020,"Manchester Utd","Premier League","Bruno Fernandes","POR","MF","24",1994,13.2,22,12,9,9,4,5,38,13.2,33,6,0,6,11,33,16,0,"https://fbref.com/en/players/507c7bdf/Bruno-Fernandes"
"4170","Timothy Fosu-Mensah_2020",2020,"Manchester Utd","Premier League","Timothy Fosu-Mensah","NED","DF","21",1998,1.5,1,1,0,1,0,1,4,25,3,0,0,0,4,5,1,0,"https://fbref.com/en/players/a9142dc3/Timothy-Fosu-Mensah"
"4171","Fred_2020",2020,"Manchester Utd","Premier League","Fred","BRA","MF","26",1993,24,60,32,33,22,5,25,100,25,75,44,8,36,38,98,32,0,"https://fbref.com/en/players/b853e0ad/Fred"
"4172","James Garner_2020",2020,"Manchester Utd","Premier League","James Garner","ENG","MF","18",2001,0.1,0,0,0,0,0,0,1,0,1,0,0,0,0,0,1,0,"https://fbref.com/en/players/4e015693/James-Garner"
"4173","David de Gea_2020",2020,"Manchester Utd","Premier League","David de Gea","ESP","GK","28",1990,38,0,0,0,0,0,0,0,NA,0,0,0,0,0,0,7,4,"https://fbref.com/en/players/7ba6d84e/David-de-Gea"
"4174","Angel Gomes_2020",2020,"Manchester Utd","Premier League","Angel Gomes","ENG","MF","18",2000,0.2,0,0,0,0,0,0,0,NA,0,1,0,1,0,0,0,0,"https://fbref.com/en/players/645a3363/Angel-Gomes"
"4175","Mason Greenwood_2020",2020,"Manchester Utd","Premier League","Mason Greenwood","ENG","FW","17",2001,14.7,17,11,5,6,6,5,20,25,15,9,0,9,6,23,6,1,"https://fbref.com/en/players/58eee997/Mason-Greenwood"
"4176","Odion Ighalo_2020",2020,"Manchester Utd","Premier League","Odion Ighalo","NGA","FW","30",1989,1.1,2,2,0,2,0,1,3,33.3,2,1,1,0,0,2,0,0,"https://fbref.com/en/players/03622183/Odion-Ighalo"
"4177","Daniel James_2020",2020,"Manchester Utd","Premier League","Daniel James","WAL","FW","21",1997,25.4,20,10,5,10,5,7,45,15.6,38,23,4,19,7,27,12,0,"https://fbref.com/en/players/c931d9f9/Daniel-James"
"4178","Phil Jones_2020",2020,"Manchester Utd","Premier League","Phil Jones","ENG","DF","27",1992,1.5,2,2,1,1,0,1,1,100,0,2,0,2,2,4,9,1,"https://fbref.com/en/players/def899bd/Phil-Jones"
"4179","Victor Lindelöf_2020",2020,"Manchester Utd","Premier League","Victor Lindelöf","SWE","DF","25",1994,34.4,29,15,16,12,1,17,20,85,3,25,16,9,26,55,129,0,"https://fbref.com/en/players/f5deef4c/Victor-Lindelof"
"4180","Jesse Lingard_2020",2020,"Manchester Utd","Premier League","Jesse Lingard","ENG","MF,FW","26",1992,10.4,15,8,6,4,5,5,18,27.8,13,5,0,5,3,18,0,0,"https://fbref.com/en/players/810e3c74/Jesse-Lingard"
"4181","Harry Maguire_2020",2020,"Manchester Utd","Premier League","Harry Maguire","ENG","DF","26",1993,38,37,23,23,14,0,18,34,52.9,16,31,22,9,72,109,159,0,"https://fbref.com/en/players/d8931174/Harry-Maguire"
"4182","Anthony Martial_2020",2020,"Manchester Utd","Premier League","Anthony Martial","FRA","FW","23",1995,29.2,15,12,1,4,10,1,16,6.3,15,18,1,17,5,20,17,0,"https://fbref.com/en/players/8b788c01/Anthony-Martial"
"4183","Juan Mata_2020",2020,"Manchester Utd","Premier League","Juan Mata","ESP","MF,FW","31",1988,8.4,7,3,1,5,1,2,7,28.6,5,5,1,4,0,7,2,0,"https://fbref.com/en/players/29733c72/Juan-Mata"
"4184","Nemanja Matić_2020",2020,"Manchester Utd","Premier League","Nemanja Matić","SRB","MF","30",1988,17.6,46,24,23,19,4,20,43,46.5,23,21,8,13,22,68,28,1,"https://fbref.com/en/players/eb7822d7/Nemanja-Matic"
"4185","Scott McTominay_2020",2020,"Manchester Utd","Premier League","Scott McTominay","SCO","MF","22",1996,19.7,43,22,14,25,4,17,32,53.1,15,25,5,20,31,74,34,2,"https://fbref.com/en/players/d93c2511/Scott-McTominay"
"4186","Andreas Pereira_2020",2020,"Manchester Utd","Premier League","Andreas Pereira","BRA","MF,FW","23",1996,16.5,24,13,8,9,7,10,39,25.6,29,13,0,13,7,31,7,0,"https://fbref.com/en/players/6639e500/Andreas-Pereira"
"4187","Paul Pogba_2020",2020,"Manchester Utd","Premier League","Paul Pogba","FRA","MF","26",1993,13.4,20,9,8,8,4,8,16,50,8,12,4,8,7,27,10,2,"https://fbref.com/en/players/867239d3/Paul-Pogba"
"4188","Marcus Rashford_2020",2020,"Manchester Utd","Premier League","Marcus Rashford","ENG","FW","21",1997,29.4,13,9,1,6,6,9,23,39.1,14,23,0,23,10,23,19,0,"https://fbref.com/en/players/a1d5bd30/Marcus-Rashford"
"4189","Marcos Rojo_2020",2020,"Manchester Utd","Premier League","Marcos Rojo","ARG","DF","29",1990,1.4,3,1,2,1,0,1,2,50,1,2,1,1,0,3,6,0,"https://fbref.com/en/players/e0991c04/Marcos-Rojo"
"4190","Luke Shaw_2020",2020,"Manchester Utd","Premier League","Luke Shaw","ENG","DF","24",1995,19.3,34,18,19,11,4,19,33,57.6,14,26,6,20,24,58,56,1,"https://fbref.com/en/players/9c94165b/Luke-Shaw"
"4191","Axel Tuanzebe_2020",2020,"Manchester Utd","Premier League","Axel Tuanzebe","ENG","DF","21",1997,2.1,2,2,0,2,0,1,2,50,1,1,0,1,5,7,5,1,"https://fbref.com/en/players/2baec6ce/Axel-Tuanzebe"
"4192","Aaron Wan-Bissaka_2020",2020,"Manchester Utd","Premier League","Aaron Wan-Bissaka","ENG","DF","21",1997,34.1,129,80,71,50,8,64,86,74.4,22,46,13,33,66,195,83,0,"https://fbref.com/en/players/9e525177/Aaron-Wan-Bissaka"
"4193","Brandon Williams_2020",2020,"Manchester Utd","Premier League","Brandon Williams","ENG","DF","18",2000,11.2,21,15,11,6,4,9,29,31,20,9,4,5,16,37,27,0,"https://fbref.com/en/players/5e74d6c8/Brandon-Williams"
"4194","Ashley Young_2020",2020,"Manchester Utd","Premier League","Ashley Young","ENG","DF","34",1985,10.6,14,7,7,4,3,5,17,29.4,12,8,2,6,11,25,29,0,"https://fbref.com/en/players/be927d03/Ashley-Young"
"4195","Marley Aké_2020",2020,"Marseille","Ligue 1","Marley Aké","FRA","FW,MF","18",2001,1.1,2,2,1,1,0,1,3,33.3,2,0,0,0,1,3,1,0,"https://fbref.com/en/players/414e1f69/Marley-Ake"
"4196","Jordan Amavi_2020",2020,"Marseille","Ligue 1","Jordan Amavi","FRA","DF","25",1994,24,55,29,31,19,5,31,64,48.4,33,27,6,21,56,111,97,0,"https://fbref.com/en/players/22721b88/Jordan-Amavi"
"4197","Darío Benedetto_2020",2020,"Marseille","Ligue 1","Darío Benedetto","ARG","FW","29",1990,23.3,12,9,0,9,3,3,18,16.7,15,15,2,13,3,15,23,1,"https://fbref.com/en/players/bef0a7ac/Dario-Benedetto"
"4198","Duje Ćaleta-Car_2020",2020,"Marseille","Ligue 1","Duje Ćaleta-Car","CRO","DF","22",1996,21,29,15,17,11,1,18,26,69.2,8,17,6,11,26,55,98,0,"https://fbref.com/en/players/94f8d10c/Duje-Caleta-Car"
"4199","Florian Chabrolle_2020",2020,"Marseille","Ligue 1","Florian Chabrolle","FRA","MF","21",1998,0.2,0,0,0,0,0,0,0,NA,0,0,0,0,0,0,0,0,"https://fbref.com/en/players/5d9577aa/Florian-Chabrolle"
"4200","Valère Germain_2020",2020,"Marseille","Ligue 1","Valère Germain","FRA","FW","29",1990,15,22,12,6,11,5,6,31,19.4,25,16,3,13,8,30,26,0,"https://fbref.com/en/players/ea0ff634/Valere-Germain"
"4201","Álvaro González_2020",2020,"Marseille","Ligue 1","Álvaro González","ESP","DF","29",1990,18.1,19,13,14,4,1,9,13,69.2,4,7,4,3,18,37,65,0,"https://fbref.com/en/players/42dcf26d/Alvaro-Gonzalez"
"4202","Luiz Gustavo_2020",2020,"Marseille","Ligue 1","Luiz Gustavo","BRA","MF","32",1987,2.1,6,3,3,3,0,3,5,60,2,5,2,3,5,11,6,0,"https://fbref.com/en/players/82671804/Luiz-Gustavo"
"4203","Boubacar Kamara_2020",2020,"Marseille","Ligue 1","Boubacar Kamara","FRA","DF,MF","19",1999,23.8,67,34,37,27,3,27,57,47.4,30,27,14,13,34,101,53,1,"https://fbref.com/en/players/cc77354e/Boubacar-Kamara"
"4204","Saîf-Eddine Khaoui_2020",2020,"Marseille","Ligue 1","Saîf-Eddine Khaoui","TUN","MF,FW","24",1995,1.2,3,1,0,3,0,2,5,40,3,2,0,2,1,4,4,0,"https://fbref.com/en/players/796b1c41/Saif-Eddine-Khaoui"
"4205","Isaac Lihadji_2020",2020,"Marseille","Ligue 1","Isaac Lihadji","FRA","MF","17",2002,0.3,0,0,0,0,0,0,0,NA,0,0,0,0,0,0,0,0,"https://fbref.com/en/players/57a46f3f/Isaac-Lihadji"
"4206","Maxime Lopez_2020",2020,"Marseille","Ligue 1","Maxime Lopez","FRA","MF,FW","21",1997,12.3,16,10,5,8,3,4,26,15.4,22,8,2,6,8,24,1,0,"https://fbref.com/en/players/20094685/Maxime-Lopez"
"4207","Steve Mandanda_2020",2020,"Marseille","Ligue 1","Steve Mandanda","FRA","GK","34",1985,26.3,3,1,3,0,0,3,4,75,1,0,0,0,1,4,2,4,"https://fbref.com/en/players/1d2d5cc8/Steve-Mandanda"
"4208","Dimitri Payet_2020",2020,"Marseille","Ligue 1","Dimitri Payet","FRA","FW,MF","32",1987,21.4,22,12,8,8,6,10,26,38.5,16,8,1,7,8,30,12,0,"https://fbref.com/en/players/58ae47b2/Dimitri-Payet"
"4209","Yohann Pelé_2020",2020,"Marseille","Ligue 1","Yohann Pelé","FRA","GK","36",1982,1.7,0,0,0,0,0,0,0,NA,0,0,0,0,0,0,0,0,"https://fbref.com/en/players/76806215/Yohann-Pele"
"4210","Lucas Perrin_2020",2020,"Marseille","Ligue 1","Lucas Perrin","FRA","DF","20",1998,4,5,2,3,2,0,2,7,28.6,5,3,2,1,10,15,17,0,"https://fbref.com/en/players/49070d66/Lucas-Perrin"
"4211","Nemanja Radonjić_2020",2020,"Marseille","Ligue 1","Nemanja Radonjić","SRB","FW,MF","23",1996,9.8,10,3,4,3,3,6,17,35.3,11,7,0,7,2,12,7,0,"https://fbref.com/en/players/0630eb63/Nemanja-Radonjic"
"4212","Valentin Rongier_2020",2020,"Marseille","Ligue 1","Valentin Rongier","FRA","MF","24",1994,19.9,76,51,25,41,10,22,63,34.9,41,30,4,26,36,112,16,2,"https://fbref.com/en/players/ed45c4a5/Valentin-Rongier"
"4213","Hiroki Sakai_2020",2020,"Marseille","Ligue 1","Hiroki Sakai","JPN","DF","29",1990,18,57,36,26,24,7,25,40,62.5,15,20,5,15,23,80,34,1,"https://fbref.com/en/players/d63e2912/Hiroki-Sakai"
"4214","Morgan Sanson_2020",2020,"Marseille","Ligue 1","Morgan Sanson","FRA","MF","24",1994,24.1,60,28,20,29,11,13,52,25,39,39,5,34,23,83,9,0,"https://fbref.com/en/players/6e7f1353/Morgan-Sanson"
"4215","Bouna Sarr_2020",2020,"Marseille","Ligue 1","Bouna Sarr","SEN","DF,FW","27",1992,24,60,37,30,19,11,30,53,56.6,23,17,1,16,32,92,38,0,"https://fbref.com/en/players/1a4b9094/Bouna-Sarr"
"4216","Kevin Strootman_2020",2020,"Marseille","Ligue 1","Kevin Strootman","NED","MF","29",1990,15.7,39,27,13,23,3,20,49,40.8,29,16,1,15,17,56,24,0,"https://fbref.com/en/players/ef2e5e1a/Kevin-Strootman"
"4217","Florian Thauvin_2020",2020,"Marseille","Ligue 1","Florian Thauvin","FRA","FW","26",1993,0.2,1,0,0,1,0,0,1,0,1,0,0,0,0,1,0,0,"https://fbref.com/en/players/2b9fdeea/Florian-Thauvin"
"4218","Thierry Ambrose_2020",2020,"Metz","Ligue 1","Thierry Ambrose","GLP","FW","22",1997,6.1,7,5,2,2,3,2,7,28.6,5,3,0,3,3,10,3,0,"https://fbref.com/en/players/2945f4b7/Thierry-Ambrose"
"4219","Victorien Angban_2020",2020,"Metz","Ligue 1","Victorien Angban","CIV","MF","22",1996,11.4,23,18,11,11,1,11,24,45.8,13,9,2,7,8,31,5,0,"https://fbref.com/en/players/d8992b84/Victorien-Angban"
"4220","Farid Boulaya_2020",2020,"Metz","Ligue 1","Farid Boulaya","ALG","FW","26",1993,9.1,14,10,7,4,3,7,19,36.8,12,5,0,5,6,20,3,0,"https://fbref.com/en/players/a0791826/Farid-Boulaya"
"4221","John Boye_2020",2020,"Metz","Ligue 1","John Boye","GHA","DF","32",1987,23.5,30,19,25,5,0,19,32,59.4,13,31,18,13,31,61,116,0,"https://fbref.com/en/players/861227d2/John-Boye"
"4222","Dylan Bronn_2020",2020,"Metz","Ligue 1","Dylan Bronn","TUN","DF","24",1995,9,7,5,6,1,0,4,7,57.1,3,11,9,2,6,13,42,0,"https://fbref.com/en/players/edd81e2a/Dylan-Bronn"
"4223","Manuel Cabit_2020",2020,"Metz","Ligue 1","Manuel Cabit","MTQ","DF","26",1993,3,3,1,1,2,0,2,10,20,8,5,0,5,4,7,5,0,"https://fbref.com/en/players/38568467/Manuel-Cabit"
"4224","Fabien Centonze_2020",2020,"Metz","Ligue 1","Fabien Centonze","FRA","DF","23",1996,28,76,49,53,22,1,34,57,59.6,23,30,11,19,59,135,98,0,"https://fbref.com/en/players/3c6bbbab/Fabien-Centonze"
"4225","Renaud Cohade_2020",2020,"Metz","Ligue 1","Renaud Cohade","FRA","MF","34",1984,8.5,28,20,11,12,5,12,28,42.9,16,14,3,11,8,36,6,0,"https://fbref.com/en/players/4e7d66f8/Renaud-Cohade"
"4226","Thomas Delaine_2020",2020,"Metz","Ligue 1","Thomas Delaine","FRA","DF","27",1992,13.9,25,16,18,6,1,12,21,57.1,9,17,1,16,15,40,28,0,"https://fbref.com/en/players/8332db56/Thomas-Delaine"
"4227","Paul Delecroix_2020",2020,"Metz","Ligue 1","Paul Delecroix","GNB","GK","30",1988,1.5,0,0,0,0,0,0,0,NA,0,0,0,0,0,0,0,0,"https://fbref.com/en/players/2ee1b96b/Paul-Delecroix"
"4228","Habib Diallo_2020",2020,"Metz","Ligue 1","Habib Diallo","SEN","FW","24",1995,24.4,2,1,0,2,0,0,6,0,6,6,5,1,4,6,43,0,"https://fbref.com/en/players/6605d143/Habib-Diallo"
"4229","Mamadou Fofana_2020",2020,"Metz","Ligue 1","Mamadou Fofana","MLI","DF,MF","21",1998,17.6,57,35,38,15,4,21,41,51.2,20,22,10,12,22,79,61,1,"https://fbref.com/en/players/4c4ffacc/Mamadou-Fofana"
"4230","Marvin Gakpa_2020",2020,"Metz","Ligue 1","Marvin Gakpa","FRA","MF,FW","25",1993,5.2,10,6,3,4,3,4,8,50,4,3,0,3,5,15,1,0,"https://fbref.com/en/players/c1b16364/Marvin-Gakpa"
"4231","Habib Maïga_2020",2020,"Metz","Ligue 1","Habib Maïga","CIV","MF","23",1996,25.2,84,50,36,38,10,24,64,37.5,40,39,4,35,34,118,39,2,"https://fbref.com/en/players/e768de1f/Habib-Maiga"
"4232","Georges Mikautadze_2020",2020,"Metz","Ligue 1","Georges Mikautadze","GEO","FW","18",2000,0.1,1,0,0,0,1,0,0,NA,0,0,0,0,0,1,0,0,"https://fbref.com/en/players/4788cb6b/Georges-Mikautadze"
"4233","Kévin N'Doram_2020",2020,"Metz","Ligue 1","Kévin N'Doram","FRA","MF","23",1996,18.3,43,28,19,21,3,17,40,42.5,23,20,8,12,26,69,23,0,"https://fbref.com/en/players/e50623a0/Kevin-NDoram"
"4234","Papa Ndiaga Yade_2020",2020,"Metz","Ligue 1","Papa Ndiaga Yade","SEN","FW","19",2000,0,0,0,0,0,0,0,0,NA,0,0,0,0,0,0,0,0,"https://fbref.com/en/players/87e9c7cd/Papa-Ndiaga-Yade"
"4235","Opa Nguette_2020",2020,"Metz","Ligue 1","Opa Nguette","SEN","FW","25",1994,20.3,44,28,23,15,6,11,39,28.2,28,17,3,14,12,56,12,0,"https://fbref.com/en/players/75a63397/Opa-Nguette"
"4236","Ibrahima Niane_2020",2020,"Metz","Ligue 1","Ibrahima Niane","SEN","FW","20",1999,10.6,8,7,2,5,1,5,16,31.3,11,5,1,4,10,18,11,1,"https://fbref.com/en/players/46faabfa/Ibrahima-Niane"
"4237","Alexandre Oukidja_2020",2020,"Metz","Ligue 1","Alexandre Oukidja","ALG","GK","31",1988,26.5,0,0,0,0,0,0,1,0,1,1,0,1,0,0,15,1,"https://fbref.com/en/players/ae7d0ecd/Alexandre-Oukidja"
"4238","Vincent Pajot_2020",2020,"Metz","Ligue 1","Vincent Pajot","FRA","MF","28",1990,5.8,16,11,8,7,1,2,4,50,2,5,1,4,9,25,13,0,"https://fbref.com/en/players/f86ca403/Vincent-Pajot"
"4239","Stoppila Sunzu_2020",2020,"Metz","Ligue 1","Stoppila Sunzu","ZAM","DF","30",1989,15,16,8,12,4,0,10,15,66.7,5,22,15,7,24,40,63,0,"https://fbref.com/en/players/1bab7b66/Stoppila-Sunzu"
"4240","Adama Traoré_2020",2020,"Metz","Ligue 1","Adama Traoré","MLI","FW,MF","24",1995,11.2,3,1,1,2,0,3,12,25,9,7,2,5,3,6,5,0,"https://fbref.com/en/players/1a6f2a66/Adama-Traore"
"4241","Matthieu Udol_2020",2020,"Metz","Ligue 1","Matthieu Udol","FRA","DF","23",1996,12.2,29,19,19,8,2,13,24,54.2,11,21,4,17,23,52,43,0,"https://fbref.com/en/players/cc41f558/Matthieu-Udol"
"4242","Asmir Begović_2020",2020,"Milan","Serie A","Asmir Begović","BIH","GK","32",1987,1.4,0,0,0,0,0,0,0,NA,0,0,0,0,0,0,0,0,"https://fbref.com/en/players/7b4de647/Asmir-Begovic"
"4243","Ismaël Bennacer_2020",2020,"Milan","Serie A","Ismaël Bennacer","ALG","MF","21",1997,27.6,67,47,21,34,12,29,73,39.7,44,25,7,18,54,121,15,2,"https://fbref.com/en/players/db092d3b/Ismael-Bennacer"
"4244","Lucas Biglia_2020",2020,"Milan","Serie A","Lucas Biglia","ARG","MF","33",1986,7.6,13,7,7,6,0,4,15,26.7,11,12,4,8,7,20,10,1,"https://fbref.com/en/players/5710a281/Lucas-Biglia"
"4245","Giacomo Bonaventura_2020",2020,"Milan","Serie A","Giacomo Bonaventura","ITA","MF,FW","29",1989,14.9,16,9,5,6,5,5,17,29.4,12,8,3,5,7,23,10,0,"https://fbref.com/en/players/d995ed27/Giacomo-Bonaventura"
"4246","Fabio Borini_2020",2020,"Milan","Serie A","Fabio Borini","ITA","MF","28",1991,0.8,2,2,0,0,2,0,2,0,2,1,0,1,0,2,3,0,"https://fbref.com/en/players/ef5b337e/Fabio-Borini"
"4247","Marco Brescianini_2020",2020,"Milan","Serie A","Marco Brescianini","ITA","MF","19",2000,0.3,1,1,1,0,0,0,0,NA,0,0,0,0,2,3,0,0,"https://fbref.com/en/players/dfd56738/Marco-Brescianini"
"4248","Davide Calabria_2020",2020,"Milan","Serie A","Davide Calabria","ITA","DF","22",1996,18,52,33,28,22,2,17,41,41.5,24,23,5,18,21,73,47,1,"https://fbref.com/en/players/2146785a/Davide-Calabria"
"4249","Hakan Çalhanoğlu_2020",2020,"Milan","Serie A","Hakan Çalhanoğlu","TUR","MF,FW","25",1994,30,42,21,15,21,6,12,35,34.3,23,26,2,24,26,68,26,1,"https://fbref.com/en/players/cd0fa27b/Hakan-Calhanoglu"
"4250","Samu Castillejo_2020",2020,"Milan","Serie A","Samu Castillejo","ESP","FW,MF","24",1995,13.4,24,15,10,11,3,9,42,21.4,33,17,2,15,24,48,5,0,"https://fbref.com/en/players/130a7a3f/Samu-Castillejo"
"4251","Lorenzo Colombo_2020",2020,"Milan","Serie A","Lorenzo Colombo","ITA","FW","17",2002,0.1,0,0,0,0,0,0,0,NA,0,0,0,0,0,0,0,0,"https://fbref.com/en/players/04df29a5/Lorenzo-Colombo"
"4252","Andrea Conti_2020",2020,"Milan","Serie A","Andrea Conti","ITA","DF","25",1994,19.2,41,25,23,15,3,21,49,42.9,28,21,8,13,43,84,42,1,"https://fbref.com/en/players/8fef5412/Andrea-Conti"
"4253","Gianluigi Donnarumma_2020",2020,"Milan","Serie A","Gianluigi Donnarumma","ITA","GK","20",1999,35.6,1,0,1,0,0,1,2,50,1,0,0,0,3,4,25,7,"https://fbref.com/en/players/08f5afaa/Gianluigi-Donnarumma"
"4254","Léo Duarte_2020",2020,"Milan","Serie A","Léo Duarte","BRA","DF","23",1996,4.5,4,3,0,3,1,1,4,25,3,9,6,3,3,7,9,0,"https://fbref.com/en/players/73ddc40c/Leo-Duarte"
"4255","Matteo Gabbia_2020",2020,"Milan","Serie A","Matteo Gabbia","ITA","DF","19",1999,7.6,7,5,5,2,0,5,8,62.5,3,6,6,0,9,16,21,0,"https://fbref.com/en/players/c235e803/Matteo-Gabbia"
"4256","Theo Hernández_2020",2020,"Milan","Serie A","Theo Hernández","FRA","DF","21",1997,31.3,56,39,32,18,6,33,53,62.3,20,34,6,28,43,99,62,2,"https://fbref.com/en/players/d4c9725f/Theo-Hernandez"
"4257","Zlatan Ibrahimović_2020",2020,"Milan","Serie A","Zlatan Ibrahimović","SWE","FW","37",1981,15.1,5,1,0,2,3,1,13,7.7,12,4,3,1,5,10,21,0,"https://fbref.com/en/players/4cde5509/Zlatan-Ibrahimovic"
"4258","Franck Kessié_2020",2020,"Milan","Serie A","Franck Kessié","CIV","MF","22",1996,32.3,54,29,28,18,8,16,52,30.8,36,34,5,29,34,88,32,2,"https://fbref.com/en/players/05e19d6a/Franck-Kessie"
"4259","Simon Kjær_2020",2020,"Milan","Serie A","Simon Kjær","DEN","DF","30",1989,13.8,22,13,17,5,0,10,18,55.6,8,20,16,4,15,37,52,0,"https://fbref.com/en/players/8b8a56ce/Simon-Kjaer"
"4260","Rade Krunić_2020",2020,"Milan","Serie A","Rade Krunić","BIH","MF,FW","25",1993,6,16,8,8,5,3,9,16,56.3,7,5,0,5,9,25,5,0,"https://fbref.com/en/players/817c6964/Rade-Krunic"
"4261","Diego Laxalt_2020",2020,"Milan","Serie A","Diego Laxalt","URU","DF","26",1993,1.9,3,3,3,0,0,1,3,33.3,2,4,0,4,0,3,3,0,"https://fbref.com/en/players/f26e3c59/Diego-Laxalt"
"4262","Rafael Leão_2020",2020,"Milan","Serie A","Rafael Leão","POR","FW","20",1999,15.6,7,4,2,5,0,3,9,33.3,6,4,0,4,0,7,5,0,"https://fbref.com/en/players/20730eae/Rafael-Leao"
"4263","Daniel Maldini_2020",2020,"Milan","Serie A","Daniel Maldini","ITA","FW,MF","17",2001,0.3,0,0,0,0,0,0,2,0,2,1,0,1,1,1,0,0,"https://fbref.com/en/players/801831fe/Daniel-Maldini"
"4264","Mateo Musacchio_2020",2020,"Milan","Serie A","Mateo Musacchio","ARG","DF","28",1990,16.3,15,8,11,4,0,7,20,35,13,10,7,3,22,37,50,0,"https://fbref.com/en/players/91899ca8/Mateo-Musacchio"
"4265","Lucas Paquetá_2020",2020,"Milan","Serie A","Lucas Paquetá","BRA","MF,FW","21",1997,12.3,33,19,12,17,4,14,37,37.8,23,17,2,15,8,41,9,0,"https://fbref.com/en/players/9b6f7fd5/Lucas-Paqueta"
"4266","Krzysztof Piątek_2020",2020,"Milan","Serie A","Krzysztof Piątek","POL","FW","24",1995,13.1,9,4,0,7,2,3,11,27.3,8,5,2,3,3,12,10,0,"https://fbref.com/en/players/17f3620a/Krzysztof-Piatek"
"4267","Ante Rebić_2020",2020,"Milan","Serie A","Ante Rebić","CRO","FW,MF","25",1993,15.5,16,11,4,9,3,7,34,20.6,27,14,1,13,3,19,12,0,"https://fbref.com/en/players/536cebe5/Ante-Rebic"
"4268","Pepe Reina_2020",2020,"Milan","Serie A","Pepe Reina","ESP","GK","36",1982,1,0,0,0,0,0,0,0,NA,0,0,0,0,0,0,0,1,"https://fbref.com/en/players/e358587b/Pepe-Reina"
"4269","Ricardo Rodríguez_2020",2020,"Milan","Serie A","Ricardo Rodríguez","SUI","DF","26",1992,4.3,6,1,2,2,2,2,6,33.3,4,3,2,1,5,11,17,0,"https://fbref.com/en/players/7f78ad23/Ricardo-Rodriguez"
"4270","Alessio Romagnoli_2020",2020,"Milan","Serie A","Alessio Romagnoli","ITA","DF","24",1995,34.3,46,25,28,15,3,16,27,59.3,11,32,18,14,56,102,157,1,"https://fbref.com/en/players/3ead85f9/Alessio-Romagnoli"
"4271","Alexis Saelemaekers_2020",2020,"Milan","Serie A","Alexis Saelemaekers","BEL","FW,DF","20",1999,7.6,14,8,5,7,2,6,20,30,14,13,1,12,8,22,1,0,"https://fbref.com/en/players/ee251371/Alexis-Saelemaekers"
"4272","André Silva_2020",2020,"Milan","Serie A","André Silva","POR","FW","23",1995,0.7,2,1,0,0,2,0,1,0,1,0,0,0,0,2,0,0,"https://fbref.com/en/players/3effaa34/Andre-Silva"
"4273","Suso_2020",2020,"Milan","Serie A","Suso","ESP","FW,MF","25",1993,15.1,7,3,2,3,2,2,10,20,8,5,0,5,8,15,3,0,"https://fbref.com/en/players/4e219ad2/Suso"
"4274","Ruben Aguilar_2020",2020,"Monaco","Ligue 1","Ruben Aguilar","FRA","DF","26",1993,11.9,36,22,19,15,2,19,28,67.9,9,6,2,4,11,47,21,0,"https://fbref.com/en/players/3dd738a1/Ruben-Aguilar"
"4275","Jean-Kévin Augustin_2020",2020,"Monaco","Ligue 1","Jean-Kévin Augustin","FRA","FW","22",1997,3,3,0,1,2,0,1,6,16.7,5,2,0,2,3,6,0,0,"https://fbref.com/en/players/97bfa797/Jean-Kevin-Augustin"
"4276","Benoît Badiashile_2020",2020,"Monaco","Ligue 1","Benoît Badiashile","FRA","DF","18",2001,15.7,18,12,12,5,1,6,12,50,6,20,11,9,27,45,57,1,"https://fbref.com/en/players/06df8256/Benoit-Badiashile"
"4277","Tiemoué Bakayoko_2020",2020,"Monaco","Ligue 1","Tiemoué Bakayoko","FRA","MF","24",1994,19.1,48,24,16,27,5,29,54,53.7,25,12,4,8,29,77,17,0,"https://fbref.com/en/players/59bf127b/Tiemoue-Bakayoko"
"4278","Keita Baldé_2020",2020,"Monaco","Ligue 1","Keita Baldé","SEN","FW,MF","24",1995,9.5,6,5,1,1,4,3,9,33.3,6,4,1,3,2,8,7,1,"https://fbref.com/en/players/509a4ccb/Keita-Balde"
"4279","Fodé Ballo-Touré_2020",2020,"Monaco","Ligue 1","Fodé Ballo-Touré","SEN","DF","22",1997,18.7,36,25,21,11,4,17,32,53.1,15,10,1,9,24,60,45,0,"https://fbref.com/en/players/f449640d/Fode-Ballo-Toure"
"4280","Gil Bastião Dias_2020",2020,"Monaco","Ligue 1","Gil Bastião Dias","POR","DF,MF","22",1996,11.7,53,33,30,21,2,29,58,50,29,15,1,14,13,66,22,1,"https://fbref.com/en/players/e61bdd69/Gil-Bastiao-Dias"
"4281","Wissam Ben Yedder_2020",2020,"Monaco","Ligue 1","Wissam Ben Yedder","FRA","FW","28",1990,24,22,16,2,12,8,8,19,42.1,11,12,0,12,4,26,1,0,"https://fbref.com/en/players/942b4f90/Wissam-Ben-Yedder"
"4282","Gabriel Boschilia_2020",2020,"Monaco","Ligue 1","Gabriel Boschilia","BRA","MF,FW","23",1996,1.4,3,1,0,3,0,1,5,20,4,1,1,0,2,5,2,0,"https://fbref.com/en/players/e90af77c/Gabriel-Boschilia"
"4283","Cesc Fàbregas_2020",2020,"Monaco","Ligue 1","Cesc Fàbregas","ESP","MF","32",1987,10.3,11,4,6,3,2,6,29,20.7,23,8,1,7,7,18,3,0,"https://fbref.com/en/players/33508c78/Cesc-Fabregas"
"4284","Youssouf Fofana_2020",2020,"Monaco","Ligue 1","Youssouf Fofana","FRA","MF","20",1999,6.8,16,9,6,10,0,8,15,53.3,7,12,2,10,8,24,9,0,"https://fbref.com/en/players/822d51d7/Youssouf-Fofana"
"4285","Lyle Foster_2020",2020,"Monaco","Ligue 1","Lyle Foster","RSA","FW","18",2000,0.7,0,0,0,0,0,0,1,0,1,0,0,0,0,0,1,0,"https://fbref.com/en/players/f84a807c/Lyle-Foster"
"4286","Kamil Glik_2020",2020,"Monaco","Ligue 1","Kamil Glik","POL","DF","31",1988,23,26,14,15,11,0,13,21,61.9,8,23,17,6,27,53,118,0,"https://fbref.com/en/players/c6056d58/Kamil-Glik"
"4287","Aleksandr Golovin_2020",2020,"Monaco","Ligue 1","Aleksandr Golovin","RUS","MF","23",1996,22.9,49,27,17,26,6,14,69,20.3,55,28,0,28,31,80,22,0,"https://fbref.com/en/players/3708e9fa/Aleksandr-Golovin"
"4288","Benjamin Henrichs_2020",2020,"Monaco","Ligue 1","Benjamin Henrichs","GER","DF,MF","22",1997,9.9,26,20,16,9,1,14,33,42.4,19,19,4,15,14,40,18,0,"https://fbref.com/en/players/0a89e877/Benjamin-Henrichs"
"4289","Jemerson_2020",2020,"Monaco","Ligue 1","Jemerson","BRA","DF,MF","26",1992,11.7,28,17,13,14,1,10,21,47.6,11,8,3,5,16,44,24,0,"https://fbref.com/en/players/7cab69b5/Jemerson"
"4290","Stevan Jovetić_2020",2020,"Monaco","Ligue 1","Stevan Jovetić","MNE","FW,MF","29",1989,5.3,2,1,0,1,1,1,5,20,4,1,0,1,1,3,5,0,"https://fbref.com/en/players/f36c432f/Stevan-Jovetic"
"4291","Benjamin Lecomte_2020",2020,"Monaco","Ligue 1","Benjamin Lecomte","FRA","GK","28",1991,28,0,0,0,0,0,0,1,0,1,1,0,1,0,0,10,5,"https://fbref.com/en/players/2fa2a875/Benjamin-Lecomte"
"4292","Rony Lopes_2020",2020,"Monaco","Ligue 1","Rony Lopes","POR","FW","23",1995,0.9,1,0,0,1,0,0,0,NA,0,0,0,0,0,1,0,0,"https://fbref.com/en/players/7c2965bb/Rony-Lopes"
"4293","Guillermo Maripán_2020",2020,"Monaco","Ligue 1","Guillermo Maripán","CHI","DF","25",1994,19.5,42,26,28,13,1,24,41,58.5,17,30,13,17,25,67,69,2,"https://fbref.com/en/players/d9764034/Guillermo-Maripan"
"4294","Gelson Martins_2020",2020,"Monaco","Ligue 1","Gelson Martins","POR","DF,FW","24",1995,18.6,30,22,11,15,4,17,42,40.5,25,9,2,7,19,49,10,1,"https://fbref.com/en/players/3ef0fa48/Gelson-Martins"
"4295","Henry Onyekuru_2020",2020,"Monaco","Ligue 1","Henry Onyekuru","NGA","MF,FW","22",1997,1.8,1,1,1,0,0,0,0,NA,0,1,0,1,1,2,0,0,"https://fbref.com/en/players/e90dc1d5/Henry-Onyekuru"
"4296","Jonathan Panzo_2020",2020,"Monaco","Ligue 1","Jonathan Panzo","ENG","DF","18",2000,1.2,2,2,2,0,0,1,1,100,0,3,1,2,3,5,7,0,"https://fbref.com/en/players/c795c408/Jonathan-Panzo"
"4297","Adrien Silva_2020",2020,"Monaco","Ligue 1","Adrien Silva","POR","MF","30",1989,13.6,37,22,14,19,4,10,37,27,27,19,6,13,12,49,14,2,"https://fbref.com/en/players/d6f88a1d/Adrien-Silva"
"4298","Islam Slimani_2020",2020,"Monaco","Ligue 1","Islam Slimani","ALG","FW","31",1988,14.3,8,4,0,2,6,4,15,26.7,11,5,0,5,1,9,11,1,"https://fbref.com/en/players/ffec9769/Islam-Slimani"
"4299","Moussa Sylla_2020",2020,"Monaco","Ligue 1","Moussa Sylla","FRA","FW","19",1999,0.1,0,0,0,0,0,0,0,NA,0,0,0,0,0,0,0,0,"https://fbref.com/en/players/d8b97bb3/Moussa-Sylla"
"4300","Aurélien Tchouaméni_2020",2020,"Monaco","Ligue 1","Aurélien Tchouaméni","FRA","MF","19",2000,0.7,0,0,0,0,0,0,2,0,2,0,0,0,0,0,2,1,"https://fbref.com/en/players/4f255115/Aurelien-Tchouameni"
"4301","Adama Traoré_2020",2020,"Monaco","Ligue 1","Adama Traoré","MLI","MF","24",1995,0.3,0,0,0,0,0,0,0,NA,0,0,0,0,1,1,0,0,"https://fbref.com/en/players/1a6f2a66/Adama-Traore"
"4302","Bastian Badu_2020",2020,"Montpellier","Ligue 1","Bastian Badu","FRA","FW","19",2000,0.1,0,0,0,0,0,0,0,NA,0,0,0,0,0,0,0,0,"https://fbref.com/en/players/3deb2342/Bastian-Badu"
"4303","Dimitry Bertaud_2020",2020,"Montpellier","Ligue 1","Dimitry Bertaud","FRA","GK","21",1998,2.2,0,0,0,0,0,0,0,NA,0,0,0,0,0,0,0,0,"https://fbref.com/en/players/380a15e2/Dimitry-Bertaud"
"4304","Bilal Boutobba_2020",2020,"Montpellier","Ligue 1","Bilal Boutobba","FRA","MF","20",1998,0.1,0,0,0,0,0,0,1,0,1,0,0,0,0,0,0,0,"https://fbref.com/en/players/e8a65bc8/Bilal-Boutobba"
"4305","Souleymane Camara_2020",2020,"Montpellier","Ligue 1","Souleymane Camara","SEN","FW","36",1982,1.8,0,0,0,0,0,0,2,0,2,0,0,0,0,0,1,0,"https://fbref.com/en/players/c58270f8/Souleymane-Camara"
"4306","Matis Carvalho_2020",2020,"Montpellier","Ligue 1","Matis Carvalho","POR","GK","20",1999,0.8,0,0,0,0,0,0,1,0,1,0,0,0,0,0,1,0,"https://fbref.com/en/players/8608f269/Matis-Carvalho"
"4307","Joris Chotard_2020",2020,"Montpellier","Ligue 1","Joris Chotard","FRA","MF","17",2001,13.9,30,18,13,17,0,15,35,42.9,20,12,5,7,20,50,12,1,"https://fbref.com/en/players/7909ffa4/Joris-Chotard"
"4308","Daniel Congré_2020",2020,"Montpellier","Ligue 1","Daniel Congré","FRA","DF","34",1985,21.6,37,27,20,16,1,18,38,47.4,20,8,7,1,47,84,66,1,"https://fbref.com/en/players/3f5b4635/Daniel-Congre"
"4309","Nicolas Cozza_2020",2020,"Montpellier","Ligue 1","Nicolas Cozza","FRA","DF","20",1999,6.2,5,5,3,2,0,2,3,66.7,1,8,6,2,9,14,18,0,"https://fbref.com/en/players/8f325097/Nicolas-Cozza"
"4310","Andy Delort_2020",2020,"Montpellier","Ligue 1","Andy Delort","ALG","FW","27",1991,25.3,28,18,11,9,8,7,27,25.9,20,21,6,15,3,31,10,0,"https://fbref.com/en/players/d33c706e/Andy-Delort"
"4311","Keagan Dolly_2020",2020,"Montpellier","Ligue 1","Keagan Dolly","RSA","MF","26",1993,1.6,6,3,1,3,2,2,5,40,3,1,0,1,1,7,0,0,"https://fbref.com/en/players/ccb1c3af/Keagan-Dolly"
"4312","Jordan Ferri_2020",2020,"Montpellier","Ligue 1","Jordan Ferri","FRA","MF","27",1992,12.8,22,13,7,12,3,13,44,29.5,31,9,0,9,10,32,10,0,"https://fbref.com/en/players/375622c5/Jordan-Ferri"
"4313","Vitorino Hilton_2020",2020,"Montpellier","Ligue 1","Vitorino Hilton","BRA","DF","41",1977,27.9,27,17,20,7,0,13,28,46.4,15,22,18,4,49,76,121,1,"https://fbref.com/en/players/c4bbea9f/Vitorino-Hilton"
"4314","Yun Il-lok_2020",2020,"Montpellier","Ligue 1","Yun Il-lok","KOR","MF,FW","27",1992,1.3,1,1,0,1,0,0,4,0,4,0,0,0,0,1,0,0,"https://fbref.com/en/players/23bf644d/Yun-Il-lok"
"4315","Gaëtan Laborde_2020",2020,"Montpellier","Ligue 1","Gaëtan Laborde","FRA","FW","25",1994,24.9,21,12,4,10,7,9,38,23.7,29,21,0,21,7,28,32,1,"https://fbref.com/en/players/7cdda3bf/Gaetan-Laborde"
"4316","Damien Le Tallec_2020",2020,"Montpellier","Ligue 1","Damien Le Tallec","FRA","MF,DF","29",1990,27.3,52,27,20,28,4,24,69,34.8,45,38,18,20,38,90,59,0,"https://fbref.com/en/players/8f4d116f/Damien-Le-Tallec"
"4317","Pedro Mendes_2020",2020,"Montpellier","Ligue 1","Pedro Mendes","POR","DF","28",1990,15.3,28,17,15,13,0,15,24,62.5,9,19,12,7,28,56,42,1,"https://fbref.com/en/players/6690ef25/Pedro-Mendes"
"4318","Florent Mollet_2020",2020,"Montpellier","Ligue 1","Florent Mollet","FRA","MF,FW","27",1991,18.7,13,11,3,8,2,7,28,25,21,9,1,8,9,22,2,0,"https://fbref.com/en/players/7e82a78f/Florent-Mollet"
"4319","Ambroise Oyongo_2020",2020,"Montpellier","Ligue 1","Ambroise Oyongo","CMR","DF,FW","28",1991,20.2,25,10,16,6,3,16,28,57.1,12,8,0,8,17,42,35,0,"https://fbref.com/en/players/e3e05edf/Ambroise-Oyongo"
"4320","Mihailo Ristić_2020",2020,"Montpellier","Ligue 1","Mihailo Ristić","SRB","DF,MF","23",1995,9,18,14,7,11,0,9,20,45,11,7,2,5,7,25,18,0,"https://fbref.com/en/players/ea0aa7e0/Mihailo-Ristic"
"4321","Gerónimo Rulli_2020",2020,"Montpellier","Ligue 1","Gerónimo Rulli","ARG","GK","27",1992,25,3,1,3,0,0,3,4,75,1,1,0,1,2,5,9,1,"https://fbref.com/en/players/625c144a/Geronimo-Rulli"
"4322","Junior Sambia_2020",2020,"Montpellier","Ligue 1","Junior Sambia","FRA","DF,MF","22",1996,6.5,8,6,4,2,2,3,13,23.1,10,4,0,4,8,16,6,0,"https://fbref.com/en/players/24eb7ed6/Junior-Sambia"
"4323","Téji Savanier_2020",2020,"Montpellier","Ligue 1","Téji Savanier","FRA","MF","27",1991,16.9,52,39,16,30,6,25,77,32.5,52,10,0,10,35,87,21,1,"https://fbref.com/en/players/6bde367b/Teji-Savanier"
"4324","Petar Škuletić_2020",2020,"Montpellier","Ligue 1","Petar Škuletić","SRB","FW,MF","29",1990,1.2,6,4,2,2,2,2,4,50,2,0,0,0,0,6,1,0,"https://fbref.com/en/players/d9a66c60/Petar-Skuletic"
"4325","Arnaud Souquet_2020",2020,"Montpellier","Ligue 1","Arnaud Souquet","FRA","DF,FW","27",1992,22.4,62,40,45,13,4,30,67,44.8,37,20,6,14,17,79,44,0,"https://fbref.com/en/players/4e0afc5d/Arnaud-Souquet"
"4326","Mathías Suárez_2020",2020,"Montpellier","Ligue 1","Mathías Suárez","URU","DF","23",1996,0.7,2,2,2,0,0,2,3,66.7,1,0,0,0,1,3,3,0,"https://fbref.com/en/players/0c291a1a/Mathias-Suarez"
"4327","Thibaut Vargas_2020",2020,"Montpellier","Ligue 1","Thibaut Vargas","FRA","DF,MF","19",2000,1.7,3,1,3,0,0,2,5,40,3,1,1,0,0,3,3,0,"https://fbref.com/en/players/e9743d8a/Thibaut-Vargas"
"4328","Clément Vidal_2020",2020,"Montpellier","Ligue 1","Clément Vidal","FRA","DF","19",2000,1,0,0,0,0,0,0,2,0,2,1,1,0,0,0,6,0,"https://fbref.com/en/players/b2791a55/Clement-Vidal"
"4329","Mehdi Abeid_2020",2020,"Nantes","Ligue 1","Mehdi Abeid","ALG","MF","26",1992,20.2,55,29,18,32,5,20,53,37.7,33,16,3,13,23,78,8,1,"https://fbref.com/en/players/a4c3f7af/Mehdi-Abeid"
"4330","Dennis Appiah_2020",2020,"Nantes","Ligue 1","Dennis Appiah","FRA","DF","27",1992,17.8,58,35,32,20,6,28,52,53.8,24,9,3,6,23,81,34,0,"https://fbref.com/en/players/feb5d3ab/Dennis-Appiah"
"4331","Thomas Basila_2020",2020,"Nantes","Ligue 1","Thomas Basila","FRA","DF","20",1999,4.6,6,3,2,4,0,4,4,100,0,0,0,0,4,10,14,0,"https://fbref.com/en/players/65391fa7/Thomas-Basila"
"4332","Cristian Benavente_2020",2020,"Nantes","Ligue 1","Cristian Benavente","PER","MF,FW","25",1994,3.9,8,5,2,5,1,2,8,25,6,1,0,1,3,11,0,0,"https://fbref.com/en/players/3b5cd50d/Cristian-Benavente"
"4333","Ludovic Blas_2020",2020,"Nantes","Ligue 1","Ludovic Blas","FRA","FW,MF","21",1997,20.5,26,18,7,15,4,5,26,19.2,21,17,1,16,14,40,11,0,"https://fbref.com/en/players/6191093d/Ludovic-Blas"
"4334","Marcus Coco_2020",2020,"Nantes","Ligue 1","Marcus Coco","FRA","FW","23",1996,0.2,1,0,1,0,0,1,1,100,0,0,0,0,0,1,0,0,"https://fbref.com/en/players/3010aefb/Marcus-Coco"
"4335","Kalifa Coulibaly_2020",2020,"Nantes","Ligue 1","Kalifa Coulibaly","MLI","FW","27",1991,18,11,7,0,5,6,3,5,60,2,3,1,2,6,17,32,0,"https://fbref.com/en/players/9980269a/Kalifa-Coulibaly"
"4336","Renaud Emond_2020",2020,"Nantes","Ligue 1","Renaud Emond","BEL","FW","27",1991,3.2,3,1,0,2,1,1,5,20,4,0,0,0,0,3,7,0,"https://fbref.com/en/players/5c9ac7f0/Renaud-Emond"
"4337","Fábio_2020",2020,"Nantes","Ligue 1","Fábio","BRA","DF","29",1990,9.3,38,22,18,20,0,25,35,71.4,10,10,5,5,18,56,19,0,"https://fbref.com/en/players/bc7b4580/Fabio"
"4338","Andrei Girotto_2020",2020,"Nantes","Ligue 1","Andrei Girotto","BRA","DF","27",1992,24.2,76,53,45,29,2,39,71,54.9,32,32,17,15,34,110,111,1,"https://fbref.com/en/players/3befc2b6/Andrei-Girotto"
"4339","Josué Homawoo_2020",2020,"Nantes","Ligue 1","Josué Homawoo","FRA","DF","21",1997,0.5,6,2,3,3,0,2,2,100,0,3,2,1,2,8,2,0,"https://fbref.com/en/players/fa060e71/Josue-Homawoo"
"4340","Abdoul Kader Bamba_2020",2020,"Nantes","Ligue 1","Abdoul Kader Bamba","FRA","FW,MF","25",1994,16.3,19,15,5,9,5,9,30,30,21,8,2,6,16,35,8,0,"https://fbref.com/en/players/32f3d97e/Abdoul-Kader-Bamba"
"4341","Rene Krhin_2020",2020,"Nantes","Ligue 1","Rene Krhin","SVN","DF,MF","29",1990,3.6,4,3,1,3,0,2,2,100,0,1,0,1,6,10,17,0,"https://fbref.com/en/players/9a506145/Rene-Krhin"
"4342","Alban Lafont_2020",2020,"Nantes","Ligue 1","Alban Lafont","FRA","GK","20",1999,27,1,1,1,0,0,1,1,100,0,0,0,0,0,1,12,0,"https://fbref.com/en/players/4e7db402/Alban-Lafont"
"4343","Lucas Lima_2020",2020,"Nantes","Ligue 1","Lucas Lima","BRA","FW,DF","27",1991,3,7,2,4,3,0,2,5,40,3,2,0,2,1,8,3,0,"https://fbref.com/en/players/0f52f925/Lucas-Lima"
"4344","Anthony Limbombe_2020",2020,"Nantes","Ligue 1","Anthony Limbombe","BEL","FW,MF","25",1994,1.7,3,2,1,2,0,1,1,100,0,1,0,1,0,3,3,0,"https://fbref.com/en/players/ccee698e/Anthony-Limbombe"
"4345","Imran Louza_2020",2020,"Nantes","Ligue 1","Imran Louza","MAR","MF,FW","20",1999,22.3,53,27,18,27,8,19,46,41.3,27,18,2,16,17,70,7,0,"https://fbref.com/en/players/e1df6989/Imran-Louza"
"4346","Wesley Moustache_2020",2020,"Nantes","Ligue 1","Wesley Moustache","FRA","DF","20",1999,0.5,0,0,0,0,0,0,0,NA,0,1,0,1,0,0,2,0,"https://fbref.com/en/players/4c93a97f/Wesley-Moustache"
"4347","Samuel Moutoussamy_2020",2020,"Nantes","Ligue 1","Samuel Moutoussamy","COD","DF,MF","22",1996,5.8,4,1,2,1,1,2,7,28.6,5,2,0,2,4,8,7,0,"https://fbref.com/en/players/af0c835b/Samuel-Moutoussamy"
"4348","Nicolas Pallois_2020",2020,"Nantes","Ligue 1","Nicolas Pallois","FRA","DF","31",1987,21,47,36,28,17,2,31,55,56.4,24,18,13,5,40,87,77,1,"https://fbref.com/en/players/779847d6/Nicolas-Pallois"
"4349","Denis Petrić_2020",2020,"Nantes","Ligue 1","Denis Petrić","SRB","GK","31",1988,1,1,1,1,0,0,1,1,100,0,0,0,0,0,1,0,0,"https://fbref.com/en/players/dab1b8dc/Denis-Petric"
"4350","Percy Prado_2020",2020,"Nantes","Ligue 1","Percy Prado","PER","DF","23",1996,2.1,6,5,3,2,1,5,9,55.6,4,1,0,1,1,7,5,0,"https://fbref.com/en/players/9bb0b9f1/Percy-Prado"
"4351","Valentin Rongier_2020",2020,"Nantes","Ligue 1","Valentin Rongier","FRA","MF","24",1994,3,5,4,0,2,3,3,5,60,2,4,0,4,2,7,0,0,"https://fbref.com/en/players/ed45c4a5/Valentin-Rongier"
"4352","Roli Pereira de Sa_2020",2020,"Nantes","Ligue 1","Roli Pereira de Sa","FRA","MF","22",1996,0.1,0,0,0,0,0,0,0,NA,0,0,0,0,0,0,0,0,"https://fbref.com/en/players/60f58477/Roli-Pereira-de-Sa"
"4353","Moses Simon_2020",2020,"Nantes","Ligue 1","Moses Simon","NGA","FW,MF","24",1995,24.2,15,7,5,4,6,6,21,28.6,15,6,0,6,8,23,6,0,"https://fbref.com/en/players/5f3eaaf5/Moses-Simon"
"4354","Abdoulaye Touré_2020",2020,"Nantes","Ligue 1","Abdoulaye Touré","FRA","MF","25",1994,24.7,32,21,10,21,1,10,30,33.3,20,31,11,20,29,61,18,1,"https://fbref.com/en/players/ef7cd87a/Abdoulaye-Toure"
"4355","Charles Traore_2020",2020,"Nantes","Ligue 1","Charles Traore","MLI","DF","27",1992,19.3,48,35,27,19,2,36,61,59,25,21,4,17,39,87,64,0,"https://fbref.com/en/players/de488e56/Charles-Traore"
"4356","Molla Wagué_2020",2020,"Nantes","Ligue 1","Molla Wagué","MLI","DF","28",1991,7.6,15,12,11,4,0,7,7,100,0,10,8,2,15,30,42,0,"https://fbref.com/en/players/a440d8ca/Molla-Wague"
"4357","Elie Youan_2020",2020,"Nantes","Ligue 1","Elie Youan","FRA","FW,MF","20",1999,1.8,0,0,0,0,0,0,7,0,7,2,0,2,0,0,3,0,"https://fbref.com/en/players/698b37b8/Elie-Youan"
"4358","Allan_2020",2020,"Napoli","Serie A","Allan","BRA","MF","28",1991,14.2,50,27,20,21,9,18,54,33.3,36,19,3,16,16,66,11,1,"https://fbref.com/en/players/cc700722/Allan"
"4359","José Callejón_2020",2020,"Napoli","Serie A","José Callejón","ESP","FW,MF","32",1987,24.1,13,9,3,7,3,9,25,36,16,15,3,12,10,23,14,1,"https://fbref.com/en/players/78841da9/Jose-Callejon"
"4360","Diego Demme_2020",2020,"Napoli","Serie A","Diego Demme","GER","MF","27",1991,10,18,8,14,3,1,8,23,34.8,15,9,1,8,8,26,9,0,"https://fbref.com/en/players/dc3fa3b5/Diego-Demme"
"4361","Giovanni Di Lorenzo_2020",2020,"Napoli","Serie A","Giovanni Di Lorenzo","ITA","DF","25",1993,33,59,35,27,19,13,32,61,52.5,29,27,11,16,28,87,54,0,"https://fbref.com/en/players/230a2fac/Giovanni-Di-Lorenzo"
"4362","Elif Elmas_2020",2020,"Napoli","Serie A","Elif Elmas","MKD","MF","19",1999,12.6,16,7,5,6,5,5,20,25,15,11,1,10,11,27,4,0,"https://fbref.com/en/players/cf007308/Elif-Elmas"
"4363","Faouzi Ghoulam_2020",2020,"Napoli","Serie A","Faouzi Ghoulam","ALG","DF","28",1991,4.2,6,4,1,4,1,2,5,40,3,3,2,1,4,10,8,0,"https://fbref.com/en/players/c5adc293/Faouzi-Ghoulam"
"4364","Elseid Hysaj_2020",2020,"Napoli","Serie A","Elseid Hysaj","ALB","DF","25",1994,16.5,18,9,13,4,1,12,26,46.2,14,16,3,13,24,42,26,0,"https://fbref.com/en/players/2f3452eb/Elseid-Hysaj"
"4365","Lorenzo Insigne_2020",2020,"Napoli","Serie A","Lorenzo Insigne","ITA","FW,MF","28",1991,31.2,21,15,6,8,7,6,35,17.1,29,13,0,13,30,51,4,1,"https://fbref.com/en/players/2f557579/Lorenzo-Insigne"
"4366","Kalidou Koulibaly_2020",2020,"Napoli","Serie A","Kalidou Koulibaly","SEN","DF","28",1991,23.4,51,33,30,17,4,17,28,60.7,11,28,16,12,31,82,61,1,"https://fbref.com/en/players/da974c7b/Kalidou-Koulibaly"
"4367","Fernando Llorente_2020",2020,"Napoli","Serie A","Fernando Llorente","ESP","FW","34",1985,5.6,0,0,0,0,0,0,1,0,1,4,0,4,1,1,3,0,"https://fbref.com/en/players/82dbf623/Fernando-Llorente"
"4368","Stanislav Lobotka_2020",2020,"Napoli","Serie A","Stanislav Lobotka","SVK","MF","24",1994,8.4,11,9,3,5,3,5,12,41.7,7,3,1,2,9,20,2,0,"https://fbref.com/en/players/e1cbb531/Stanislav-Lobotka"
"4369","Hirving Lozano_2020",2020,"Napoli","Serie A","Hirving Lozano","MEX","FW,MF","24",1995,11.4,6,4,1,5,0,2,15,13.3,13,13,0,13,5,11,5,0,"https://fbref.com/en/players/a69e4806/Hirving-Lozano"
"4370","Sebastiano Luperto_2020",2020,"Napoli","Serie A","Sebastiano Luperto","ITA","DF","22",1996,5.9,12,9,7,3,2,6,9,66.7,3,5,3,2,6,18,16,0,"https://fbref.com/en/players/997fff07/Sebastiano-Luperto"
"4371","Nikola Maksimović_2020",2020,"Napoli","Serie A","Nikola Maksimović","SRB","DF","27",1991,20,35,24,21,14,0,10,21,47.6,11,19,11,8,30,65,64,1,"https://fbref.com/en/players/16b9d5cf/Nikola-Maksimovic"
"4372","Kévin Malcuit_2020",2020,"Napoli","Serie A","Kévin Malcuit","MAR","DF","28",1991,2.8,8,6,4,3,1,5,6,83.3,1,4,1,3,3,11,2,0,"https://fbref.com/en/players/d6a889ea/Kevin-Malcuit"
"4373","Kostas Manolas_2020",2020,"Napoli","Serie A","Kostas Manolas","GRE","DF","28",1991,24.2,23,15,13,10,0,10,17,58.8,7,19,14,5,25,48,76,1,"https://fbref.com/en/players/c707411f/Kostas-Manolas"
"4374","Alex Meret_2020",2020,"Napoli","Serie A","Alex Meret","ITA","GK","22",1997,21.7,0,0,0,0,0,0,2,0,2,1,0,1,1,1,7,2,"https://fbref.com/en/players/9413b19f/Alex-Meret"
"4375","Dries Mertens_2020",2020,"Napoli","Serie A","Dries Mertens","BEL","FW","32",1987,18.8,13,9,1,8,4,2,27,7.4,25,10,1,9,7,20,4,0,"https://fbref.com/en/players/89b2c8a9/Dries-Mertens"
"4376","Arkadiusz Milik_2020",2020,"Napoli","Serie A","Arkadiusz Milik","POL","FW","25",1994,19.4,12,5,4,1,7,3,11,27.3,8,11,1,10,2,14,12,0,"https://fbref.com/en/players/85613cf0/Arkadiusz-Milik"
"4377","David Ospina_2020",2020,"Napoli","Serie A","David Ospina","COL","GK","30",1988,16.3,0,0,0,0,0,0,0,NA,0,0,0,0,0,0,2,1,"https://fbref.com/en/players/82b1198a/David-Ospina"
"4378","Matteo Politano_2020",2020,"Napoli","Serie A","Matteo Politano","ITA","FW","25",1993,8.3,12,6,8,2,2,5,14,35.7,9,6,0,6,5,17,3,0,"https://fbref.com/en/players/5e861944/Matteo-Politano"
"4379","Mário Rui_2020",2020,"Napoli","Serie A","Mário Rui","POR","DF","28",1991,21.8,31,17,12,12,7,11,29,37.9,18,24,5,19,21,52,43,0,"https://fbref.com/en/players/0b5a292a/Mario-Rui"
"4380","Fabián Ruiz Peña_2020",2020,"Napoli","Serie A","Fabián Ruiz Peña","ESP","MF","23",1996,29.8,43,26,19,18,6,24,65,36.9,41,32,4,28,32,75,18,2,"https://fbref.com/en/players/c0c7ff58/Fabian-Ruiz-Pena"
"4381","Amin Younes_2020",2020,"Napoli","Serie A","Amin Younes","GER","FW,MF","25",1993,2,3,2,1,2,0,2,4,50,2,2,0,2,0,3,1,0,"https://fbref.com/en/players/228f73ae/Amin-Younes"
"4382","Piotr Zieliński_2020",2020,"Napoli","Serie A","Piotr Zieliński","POL","MF","25",1994,32.5,26,16,10,11,5,12,30,40,18,28,5,23,21,47,15,0,"https://fbref.com/en/players/a5296e55/Piotr-Zielinski"
"4383","Miguel Almirón_2020",2020,"Newcastle Utd","Premier League","Miguel Almirón","PAR","MF,FW","25",1994,33.6,60,39,32,20,8,19,52,36.5,33,25,1,24,31,91,25,0,"https://fbref.com/en/players/862a1c15/Miguel-Almiron"
"4384","Christian Atsu_2020",2020,"Newcastle Utd","Premier League","Christian Atsu","GHA","MF,FW","27",1992,8.3,10,8,5,5,0,5,14,35.7,9,19,0,19,5,15,9,0,"https://fbref.com/en/players/8816329f/Christian-Atsu"
"4385","Nabil Bentaleb_2020",2020,"Newcastle Utd","Premier League","Nabil Bentaleb","ALG","MF","24",1994,8.3,23,13,14,9,0,7,25,28,18,9,2,7,19,42,9,1,"https://fbref.com/en/players/3189f61a/Nabil-Bentaleb"
"4386","Andy Carroll_2020",2020,"Newcastle Utd","Premier League","Andy Carroll","ENG","FW","30",1989,7,5,3,3,2,0,2,8,25,6,2,1,1,2,7,24,1,"https://fbref.com/en/players/b581987a/Andy-Carroll"
"4387","Ciaran Clark_2020",2020,"Newcastle Utd","Premier League","Ciaran Clark","IRL","DF","29",1989,13.2,20,12,18,2,0,9,15,60,6,18,14,4,11,31,82,0,"https://fbref.com/en/players/2b91cf8e/Ciaran-Clark"
"4388","Martin Dúbravka_2020",2020,"Newcastle Utd","Premier League","Martin Dúbravka","SVK","GK","30",1989,38,1,1,1,0,0,1,2,50,1,2,0,2,1,2,17,5,"https://fbref.com/en/players/3a949a25/Martin-Dubravka"
"4389","Paul Dummett_2020",2020,"Newcastle Utd","Premier League","Paul Dummett","WAL","DF","27",1991,13.6,27,17,19,7,1,21,27,77.8,6,23,9,14,23,50,69,0,"https://fbref.com/en/players/3fe6bd8c/Paul-Dummett"
"4390","Federico Fernández_2020",2020,"Newcastle Utd","Premier League","Federico Fernández","ARG","DF","30",1989,29.1,42,25,30,10,2,23,46,50,23,41,28,13,24,66,190,2,"https://fbref.com/en/players/f25b010f/Federico-Fernandez"
"4391","Dwight Gayle_2020",2020,"Newcastle Utd","Premier League","Dwight Gayle","ENG","FW","28",1990,9.4,12,10,4,6,2,4,8,50,4,5,0,5,2,14,9,0,"https://fbref.com/en/players/e58a03c6/Dwight-Gayle"
"4392","Isaac Hayden_2020",2020,"Newcastle Utd","Premier League","Isaac Hayden","ENG","MF","24",1995,24.7,55,27,33,17,5,20,50,40,30,24,7,17,38,93,38,0,"https://fbref.com/en/players/c951a6df/Isaac-Hayden"
"4393","Joelinton_2020",2020,"Newcastle Utd","Premier League","Joelinton","BRA","FW","22",1996,29.8,34,20,7,22,5,9,32,28.1,23,32,6,26,11,45,30,0,"https://fbref.com/en/players/c17bfb65/Joelinton"
"4394","Emil Krafth_2020",2020,"Newcastle Utd","Premier League","Emil Krafth","SWE","DF","24",1994,11.3,18,12,15,2,1,9,20,45,11,11,8,3,8,26,45,0,"https://fbref.com/en/players/77cf6852/Emil-Krafth"
"4395","Jamaal Lascelles_2020",2020,"Newcastle Utd","Premier League","Jamaal Lascelles","ENG","DF","25",1993,23.1,14,3,10,4,0,4,9,44.4,5,23,20,3,28,42,116,1,"https://fbref.com/en/players/450ab6fc/Jamaal-Lascelles"
"4396","Valentino Lazaro_2020",2020,"Newcastle Utd","Premier League","Valentino Lazaro","AUT","DF,MF","23",1996,5.3,13,9,11,2,0,11,18,61.1,7,2,0,2,3,16,4,0,"https://fbref.com/en/players/016ff750/Valentino-Lazaro"
"4397","Florian Lejeune_2020",2020,"Newcastle Utd","Premier League","Florian Lejeune","FRA","DF","28",1991,4.9,8,2,6,2,0,4,7,57.1,3,6,2,4,10,18,15,2,"https://fbref.com/en/players/6eaed4eb/Florian-Lejeune"
"4398","Matthew Longstaff_2020",2020,"Newcastle Utd","Premier League","Matthew Longstaff","ENG","MF","19",2000,6.4,3,1,2,1,0,3,14,21.4,11,4,1,3,5,8,3,0,"https://fbref.com/en/players/c0027d2d/Matthew-Longstaff"
"4399","Sean Longstaff_2020",2020,"Newcastle Utd","Premier League","Sean Longstaff","ENG","MF","21",1997,15.3,35,19,17,16,2,20,50,40,30,23,5,18,19,54,20,2,"https://fbref.com/en/players/a2b105e0/Sean-Longstaff"
"4400","Javier Manquillo_2020",2020,"Newcastle Utd","Premier League","Javier Manquillo","ESP","DF","25",1994,17.8,39,26,27,8,4,24,38,63.2,14,14,2,12,18,57,56,0,"https://fbref.com/en/players/758dd7f0/Javier-Manquillo"
"4401","Yoshinori Mutō_2020",2020,"Newcastle Utd","Premier League","Yoshinori Mutō","JPN","MF,FW","27",1992,2.4,3,2,1,2,0,1,2,50,1,0,0,0,0,3,0,0,"https://fbref.com/en/players/5343eb4e/Yoshinori-Muto"
"4402","Matt Ritchie_2020",2020,"Newcastle Utd","Premier League","Matt Ritchie","SCO","DF,MF","29",1989,14.6,22,15,9,10,3,3,15,20,12,20,5,15,14,36,31,1,"https://fbref.com/en/players/71ef519e/Matt-Ritchie"
"4403","Danny Rose_2020",2020,"Newcastle Utd","Premier League","Danny Rose","ENG","DF","29",1990,9.6,21,12,11,8,2,12,21,57.1,9,11,4,7,10,31,14,1,"https://fbref.com/en/players/89d10e53/Danny-Rose"
"4404","Allan Saint-Maximin_2020",2020,"Newcastle Utd","Premier League","Allan Saint-Maximin","FRA","MF,FW","22",1997,20.7,13,8,7,4,2,4,18,22.2,14,5,2,3,9,22,6,0,"https://fbref.com/en/players/2b16cb1a/Allan-Saint-Maximin"
"4405","Fabian Schär_2020",2020,"Newcastle Utd","Premier League","Fabian Schär","SUI","DF,MF","27",1991,18.6,39,21,25,14,0,19,40,47.5,21,35,18,17,47,86,74,2,"https://fbref.com/en/players/c8aa95da/Fabian-Schar"
"4406","Jonjo Shelvey_2020",2020,"Newcastle Utd","Premier League","Jonjo Shelvey","ENG","MF","27",1992,23.5,29,19,17,12,0,11,42,26.2,31,14,5,9,23,52,38,0,"https://fbref.com/en/players/3727dd3c/Jonjo-Shelvey"
"4407","Ki Sung-yueng_2020",2020,"Newcastle Utd","Premier League","Ki Sung-yueng","KOR","MF","30",1989,1.5,1,1,0,1,0,1,3,33.3,2,1,0,1,3,4,2,0,"https://fbref.com/en/players/1d8c99b0/Ki-Sung-yueng"
"4408","Kelland Watts_2020",2020,"Newcastle Utd","Premier League","Kelland Watts","ENG","DF","19",1999,0.2,1,0,1,0,0,1,1,100,0,0,0,0,0,1,0,0,"https://fbref.com/en/players/603e4f0b/Kelland-Watts"
"4409","Jetro Willems_2020",2020,"Newcastle Utd","Premier League","Jetro Willems","NED","DF","25",1994,16.6,37,19,29,6,2,18,39,46.2,21,20,5,15,17,54,42,1,"https://fbref.com/en/players/9050ddc4/Jetro-Willems"
"4410","DeAndre Yedlin_2020",2020,"Newcastle Utd","Premier League","DeAndre Yedlin","USA","DF","26",1993,10.4,18,13,10,6,2,8,16,50,8,13,7,6,10,28,20,0,"https://fbref.com/en/players/ae0a7ddf/DeAndre-Yedlin"
"4411","Youcef Atal_2020",2020,"Nice","Ligue 1","Youcef Atal","ALG","FW,DF","23",1996,11.1,24,11,15,6,3,13,31,41.9,18,12,1,11,24,48,11,1,"https://fbref.com/en/players/6a827d8e/Youcef-Atal"
"4412","Danilo Barbosa_2020",2020,"Nice","Ligue 1","Danilo Barbosa","BRA","DF,MF","23",1996,12.5,28,21,17,9,2,13,29,44.8,16,21,6,15,20,48,38,0,"https://fbref.com/en/players/0557ff4f/Danilo-Barbosa"
"4413","Walter Benítez_2020",2020,"Nice","Ligue 1","Walter Benítez","ARG","GK","26",1993,26,1,1,1,0,0,1,3,33.3,2,0,0,0,0,1,8,0,"https://fbref.com/en/players/8a2248b4/Walter-Benitez"
"4414","Hicham Boudaoui_2020",2020,"Nice","Ligue 1","Hicham Boudaoui","ALG","MF,FW","19",1999,5.4,20,10,6,11,3,9,23,39.1,14,10,3,7,13,33,7,0,"https://fbref.com/en/players/f9d5908e/Hicham-Boudaoui"
"4415","Patrick Burner_2020",2020,"Nice","Ligue 1","Patrick Burner","MTQ","DF","23",1996,15.9,35,25,15,17,3,14,25,56,11,11,2,9,30,65,37,0,"https://fbref.com/en/players/8746d5d0/Patrick-Burner"
"4416","Ibrahim Cissé_2020",2020,"Nice","Ligue 1","Ibrahim Cissé","CIV","DF","20",1999,0.6,1,1,1,0,0,0,0,NA,0,0,0,0,0,1,6,0,"https://fbref.com/en/players/9cebd6ce/Ibrahim-Cisse"
"4417","Alexis Claude-Maurice_2020",2020,"Nice","Ligue 1","Alexis Claude-Maurice","FRA","FW,MF","21",1998,18.1,26,16,8,11,7,13,35,37.1,22,20,4,16,11,37,4,0,"https://fbref.com/en/players/741418c3/Alexis-Claude-Maurice"
"4418","Yannis Clementia_2020",2020,"Nice","Ligue 1","Yannis Clementia","MTQ","GK","22",1997,2,0,0,0,0,0,0,0,NA,0,0,0,0,0,0,0,0,"https://fbref.com/en/players/7800bdb8/Yannis-Clementia"
"4419","Racine Coly_2020",2020,"Nice","Ligue 1","Racine Coly","SEN","DF,FW","23",1995,7.2,21,13,15,5,1,9,17,52.9,8,5,0,5,12,33,23,0,"https://fbref.com/en/players/166a981d/Racine-Coly"
"4420","Wylan Cyprien_2020",2020,"Nice","Ligue 1","Wylan Cyprien","FRA","MF","24",1995,19.7,17,11,5,12,0,7,27,25.9,20,8,2,6,19,36,16,3,"https://fbref.com/en/players/3e092724/Wylan-Cyprien"
"4421","Dante_2020",2020,"Nice","Ligue 1","Dante","BRA","DF","35",1983,21,34,21,24,10,0,17,25,68,8,27,16,11,26,60,79,0,"https://fbref.com/en/players/fd2bc67d/Dante"
"4422","Kasper Dolberg_2020",2020,"Nice","Ligue 1","Kasper Dolberg","DEN","FW","21",1997,21,10,6,0,3,7,4,17,23.5,13,18,2,16,10,20,24,0,"https://fbref.com/en/players/cc83b74d/Kasper-Dolberg"
"4423","Riza Durmisi_2020",2020,"Nice","Ligue 1","Riza Durmisi","DEN","DF,MF","25",1994,1.8,1,1,1,0,0,0,0,NA,0,2,1,1,1,2,3,0,"https://fbref.com/en/players/e5cd9da6/Riza-Durmisi"
"4424","Ignatius Ganago_2020",2020,"Nice","Ligue 1","Ignatius Ganago","CMR","FW,MF","20",1999,13.8,10,6,4,3,3,3,18,16.7,15,8,1,7,4,14,13,0,"https://fbref.com/en/players/23c63b7f/Ignatius-Ganago"
"4425","Christophe Hérelle_2020",2020,"Nice","Ligue 1","Christophe Hérelle","MTQ","DF","26",1992,12.3,14,11,10,4,0,3,7,42.9,4,14,8,6,17,31,26,1,"https://fbref.com/en/players/3681cfff/Christophe-Herelle"
"4426","Mickaël Le Bihan_2020",2020,"Nice","Ligue 1","Mickaël Le Bihan","FRA","FW,DF","29",1990,1.1,0,0,0,0,0,0,2,0,2,0,0,0,0,0,2,0,"https://fbref.com/en/players/d512db65/Mickael-Le-Bihan"
"4427","Pierre Lees-Melou_2020",2020,"Nice","Ligue 1","Pierre Lees-Melou","FRA","MF","26",1993,25,63,27,34,21,8,31,88,35.2,57,38,12,26,32,95,43,0,"https://fbref.com/en/players/f5044e54/Pierre-Lees-Melou"
"4428","Gautier Lloris_2020",2020,"Nice","Ligue 1","Gautier Lloris","FRA","DF","24",1995,3,5,3,5,0,0,4,5,80,1,3,3,0,2,7,11,0,"https://fbref.com/en/players/ac89503b/Gautier-Lloris"
"4429","Arnaud Lusamba_2020",2020,"Nice","Ligue 1","Arnaud Lusamba","COD","MF,FW","22",1997,10.9,20,11,8,10,2,7,23,30.4,16,9,0,9,5,25,6,1,"https://fbref.com/en/players/54131505/Arnaud-Lusamba"
"4430","Myziane Maolida_2020",2020,"Nice","Ligue 1","Myziane Maolida","FRA","FW,MF","20",1999,7.5,14,10,5,6,3,5,12,41.7,7,8,0,8,3,17,3,0,"https://fbref.com/en/players/706a60e1/Myziane-Maolida"
"4431","Stanley N'Soki_2020",2020,"Nice","Ligue 1","Stanley N'Soki","FRA","DF","20",1999,14.1,40,29,24,16,0,23,42,54.8,19,14,6,8,32,72,37,0,"https://fbref.com/en/players/61590953/Stanley-NSoki"
"4432","Adam Ounas_2020",2020,"Nice","Ligue 1","Adam Ounas","ALG","FW,MF","22",1996,12.5,10,5,2,6,2,5,13,38.5,8,9,1,8,11,21,8,1,"https://fbref.com/en/players/ed90babd/Adam-Ounas"
"4433","Andy Pelmard_2020",2020,"Nice","Ligue 1","Andy Pelmard","FRA","DF","19",2000,8.5,22,14,13,9,0,9,11,81.8,2,12,4,8,15,37,28,1,"https://fbref.com/en/players/f18d7ab2/Andy-Pelmard"
"4434","Ihsan Sacko_2020",2020,"Nice","Ligue 1","Ihsan Sacko","FRA","FW","22",1997,1.6,1,1,1,0,0,0,1,0,1,0,0,0,0,1,0,0,"https://fbref.com/en/players/68a87d66/Ihsan-Sacko"
"4435","Malang Sarr_2020",2020,"Nice","Ligue 1","Malang Sarr","FRA","DF","20",1999,16.2,19,11,13,6,0,9,22,40.9,13,10,4,6,38,57,31,4,"https://fbref.com/en/players/4315f30d/Malang-Sarr"
"4436","Bassem Srarfi_2020",2020,"Nice","Ligue 1","Bassem Srarfi","TUN","FW,MF","22",1997,1.5,0,0,0,0,0,0,2,0,2,0,0,0,2,2,0,0,"https://fbref.com/en/players/84549a07/Bassem-Srarfi"
"4437","Eddy Sylvestre_2020",2020,"Nice","Ligue 1","Eddy Sylvestre","FRA","MF","19",1999,0.4,0,0,0,0,0,0,1,0,1,0,0,0,0,0,0,0,"https://fbref.com/en/players/ff3a6a60/Eddy-Sylvestre"
"4438","Adrien Tameze_2020",2020,"Nice","Ligue 1","Adrien Tameze","CMR","MF","25",1994,5.8,6,2,2,3,1,4,16,25,12,7,2,5,7,13,1,1,"https://fbref.com/en/players/8da74c05/Adrien-Tameze"
"4439","Khéphren Thuram_2020",2020,"Nice","Ligue 1","Khéphren Thuram","FRA","MF","18",2001,6.6,22,7,14,8,0,6,17,35.3,11,12,2,10,7,29,13,0,"https://fbref.com/en/players/7d9397f8/Khephren-Thuram"
"4440","Moussa Wagué_2020",2020,"Nice","Ligue 1","Moussa Wagué","SEN","DF,MF","20",1998,2.2,6,4,3,3,0,2,3,66.7,1,2,1,1,2,8,2,0,"https://fbref.com/en/players/808df563/Moussa-Wague"
"4441","Rémi Walter_2020",2020,"Nice","Ligue 1","Rémi Walter","FRA","MF","24",1995,0.6,1,1,0,1,0,1,1,100,0,0,0,0,0,1,0,0,"https://fbref.com/en/players/0984c5d5/Remi-Walter"
"4442","Max Aarons_2020",2020,"Norwich City","Premier League","Max Aarons","ENG","DF","19",2000,36,48,30,33,9,6,18,36,50,18,46,29,17,37,85,97,1,"https://fbref.com/en/players/774cf58b/Max-Aarons"
"4443","Ibrahim Amadou_2020",2020,"Norwich City","Premier League","Ibrahim Amadou","FRA","DF,MF","26",1993,8.4,18,11,9,8,1,3,11,27.3,8,8,5,3,16,34,55,1,"https://fbref.com/en/players/9260926b/Ibrahim-Amadou"
"4444","Emi Buendía_2020",2020,"Norwich City","Premier League","Emi Buendía","ARG","FW,MF","22",1996,27.4,82,39,57,21,4,38,118,32.2,80,58,5,53,23,105,32,2,"https://fbref.com/en/players/66b76d44/Emi-Buendia"
"4445","Sam Byram_2020",2020,"Norwich City","Premier League","Sam Byram","ENG","DF","25",1993,14.4,40,22,24,11,5,18,37,48.6,19,16,8,8,26,66,73,0,"https://fbref.com/en/players/1bf811d4/Sam-Byram"
"4446","Todd Cantwell_2020",2020,"Norwich City","Premier League","Todd Cantwell","ENG","FW,MF","21",1998,27.7,51,31,19,27,5,26,73,35.6,47,38,2,36,18,69,35,1,"https://fbref.com/en/players/f63d8a4b/Todd-Cantwell"
"4447","Josip Drmić_2020",2020,"Norwich City","Premier League","Josip Drmić","SUI","FW","26",1992,7.2,3,2,1,2,0,0,8,0,8,6,0,6,1,4,5,1,"https://fbref.com/en/players/15ea94de/Josip-Drmic"
"4448","Ondrej Duda_2020",2020,"Norwich City","Premier League","Ondrej Duda","SVK","MF","24",1994,8,18,11,9,6,3,7,16,43.8,9,10,2,8,6,24,8,0,"https://fbref.com/en/players/79ca3e23/Ondrej-Duda"
"4449","Ralf Fährmann_2020",2020,"Norwich City","Premier League","Ralf Fährmann","GER","GK","30",1988,0.2,0,0,0,0,0,0,0,NA,0,0,0,0,0,0,0,0,"https://fbref.com/en/players/1e43fad8/Ralf-Fahrmann"
"4450","Akin Famewo_2020",2020,"Norwich City","Premier League","Akin Famewo","ENG","MF","20",1998,0,0,0,0,0,0,0,0,NA,0,0,0,0,0,0,0,0,"https://fbref.com/en/players/9d9a71c1/Akin-Famewo"
"4451","Ben Godfrey_2020",2020,"Norwich City","Premier League","Ben Godfrey","ENG","DF","21",1998,29.4,22,14,18,3,1,10,18,55.6,8,41,37,4,25,47,152,3,"https://fbref.com/en/players/9f7c837d/Ben-Godfrey"
"4452","Grant Hanley_2020",2020,"Norwich City","Premier League","Grant Hanley","SCO","DF","27",1991,14,24,15,17,7,0,8,14,57.1,6,25,18,7,31,55,77,1,"https://fbref.com/en/players/e9254eec/Grant-Hanley"
"4453","Onel Hernández_2020",2020,"Norwich City","Premier League","Onel Hernández","CUB","FW,MF","26",1993,15.4,27,19,13,11,3,9,31,29,22,12,1,11,19,46,10,0,"https://fbref.com/en/players/007b39a5/Onel-Hernandez"
"4454","Adam Idah_2020",2020,"Norwich City","Premier League","Adam Idah","IRL","FW,MF","18",2001,2.5,2,2,1,0,1,2,3,66.7,1,4,0,4,0,2,1,0,"https://fbref.com/en/players/291e3ec3/Adam-Idah"
"4455","Timm Klose_2020",2020,"Norwich City","Premier League","Timm Klose","SUI","DF","31",1988,6.5,8,2,5,2,1,7,11,63.6,4,6,6,0,7,15,29,0,"https://fbref.com/en/players/5f1d07f6/Timm-Klose"
"4456","Tim Krul_2020",2020,"Norwich City","Premier League","Tim Krul","NED","GK","31",1988,36,0,0,0,0,0,0,1,0,1,2,0,2,1,1,13,1,"https://fbref.com/en/players/f23f9d20/Tim-Krul"
"4457","Moritz Leitner_2020",2020,"Norwich City","Premier League","Moritz Leitner","GER","MF","26",1992,7.6,16,9,8,7,1,9,25,36,16,14,4,10,9,25,10,1,"https://fbref.com/en/players/9460aaed/Moritz-Leitner"
"4458","Jamal Lewis_2020",2020,"Norwich City","Premier League","Jamal Lewis","NIR","DF","21",1998,25.6,51,35,42,6,3,22,36,61.1,14,27,12,15,25,76,68,0,"https://fbref.com/en/players/efb9215a/Jamal-Lewis"
"4459","Josh Martin_2020",2020,"Norwich City","Premier League","Josh Martin","ENG","FW,MF","17",2001,0.4,1,0,0,0,1,0,0,NA,0,1,0,1,1,2,0,0,"https://fbref.com/en/players/3f072a68/Josh-Martin"
"4460","Michael McGovern_2020",2020,"Norwich City","Premier League","Michael McGovern","NIR","GK","35",1984,1.8,0,0,0,0,0,0,0,NA,0,0,0,0,0,0,1,1,"https://fbref.com/en/players/51a19d04/Michael-McGovern"
"4461","Kenny McLean_2020",2020,"Norwich City","Premier League","Kenny McLean","SCO","MF","27",1992,33,44,29,20,18,6,14,42,33.3,28,32,7,25,38,82,67,2,"https://fbref.com/en/players/471f16b3/Kenny-McLean"
"4462","Teemu Pukki_2020",2020,"Norwich City","Premier League","Teemu Pukki","FIN","FW","29",1990,32.1,12,6,3,5,4,1,23,4.3,22,13,0,13,6,18,7,0,"https://fbref.com/en/players/0745b37d/Teemu-Pukki"
"4463","Patrick Roberts_2020",2020,"Norwich City","Premier League","Patrick Roberts","ENG","FW,MF","22",1997,0.3,0,0,0,0,0,0,0,NA,0,0,0,0,0,0,0,0,"https://fbref.com/en/players/59d93937/Patrick-Roberts"
"4464","Lukas Rupp_2020",2020,"Norwich City","Premier League","Lukas Rupp","GER","FW,MF","28",1991,7.7,15,9,7,5,3,5,17,29.4,12,11,0,11,15,30,4,0,"https://fbref.com/en/players/3faa1780/Lukas-Rupp"
"4465","Dennis Srbeny_2020",2020,"Norwich City","Premier League","Dennis Srbeny","GER","MF,FW","25",1994,0.5,5,5,3,2,0,1,3,33.3,2,1,0,1,0,5,1,0,"https://fbref.com/en/players/1fdec858/Dennis-Srbeny"
"4466","Marco Stiepermann_2020",2020,"Norwich City","Premier League","Marco Stiepermann","GER","MF","28",1991,13.1,20,8,8,9,3,5,21,23.8,16,11,3,8,5,25,16,0,"https://fbref.com/en/players/b606638c/Marco-Stiepermann"
"4467","Alexander Tettey_2020",2020,"Norwich City","Premier League","Alexander Tettey","NOR","MF,DF","33",1986,26,23,18,7,16,0,11,39,28.2,28,20,9,11,43,66,72,1,"https://fbref.com/en/players/75566759/Alexander-Tettey"
"4468","Jordan Thomas_2020",2020,"Norwich City","Premier League","Jordan Thomas","ENG","FW","18",2001,0,0,0,0,0,0,0,0,NA,0,0,0,0,0,0,0,0,"https://fbref.com/en/players/b547f08c/Jordan-Thomas"
"4469","Tom Trybull_2020",2020,"Norwich City","Premier League","Tom Trybull","GER","MF","26",1993,12.6,39,25,15,18,6,16,60,26.7,44,20,5,15,16,55,35,0,"https://fbref.com/en/players/552aa16c/Tom-Trybull"
"4470","Mario Vrančić_2020",2020,"Norwich City","Premier League","Mario Vrančić","BIH","MF","30",1989,7.1,27,16,14,11,2,16,27,59.3,11,9,0,9,10,37,4,2,"https://fbref.com/en/players/16fa6881/Mario-Vrancic"
"4471","Christoph Zimmermann_2020",2020,"Norwich City","Premier League","Christoph Zimmermann","GER","DF","26",1993,15.9,32,21,26,6,0,21,30,70,9,22,18,4,19,51,87,2,"https://fbref.com/en/players/2d5f03bf/Christoph-Zimmermann"
"4472","Sofiane Alakouch_2020",2020,"Nîmes","Ligue 1","Sofiane Alakouch","MAR","DF","21",1998,15.6,45,26,25,13,7,25,48,52.1,23,13,2,11,23,68,39,3,"https://fbref.com/en/players/5314e067/Sofiane-Alakouch"
"4473","Sami Ben Amar_2020",2020,"Nîmes","Ligue 1","Sami Ben Amar","MAR","FW","21",1998,0.2,1,1,0,0,1,1,1,100,0,1,0,1,1,2,0,0,"https://fbref.com/en/players/c05d65d1/Sami-Ben-Amar"
"4474","Yassine Benrahou_2020",2020,"Nîmes","Ligue 1","Yassine Benrahou","FRA","MF,FW","20",1999,8.5,13,8,3,3,7,5,16,31.3,11,1,0,1,2,15,0,0,"https://fbref.com/en/players/fbf76716/Yassine-Benrahou"
"4475","Paul Bernardoni_2020",2020,"Nîmes","Ligue 1","Paul Bernardoni","FRA","GK","22",1997,24.5,0,0,0,0,0,0,1,0,1,0,0,0,0,0,11,1,"https://fbref.com/en/players/28dabd43/Paul-Bernardoni"
"4476","Antonin Bobichon_2020",2020,"Nîmes","Ligue 1","Antonin Bobichon","FRA","MF","23",1995,2,4,3,1,3,0,3,3,100,0,1,0,1,1,5,0,0,"https://fbref.com/en/players/7d937aa1/Antonin-Bobichon"
"4477","Anthony Briançon_2020",2020,"Nîmes","Ligue 1","Anthony Briançon","FRA","DF","24",1994,19.3,29,19,20,9,0,17,34,50,17,22,16,6,39,68,80,0,"https://fbref.com/en/players/16324e1d/Anthony-Briancon"
"4478","Lucas Buadés_2020",2020,"Nîmes","Ligue 1","Lucas Buadés","FRA","MF,FW","21",1997,1.3,4,4,3,1,0,1,5,20,4,0,0,0,1,5,3,0,"https://fbref.com/en/players/f9921b7f/Lucas-Buades"
"4479","Lucas Deaux_2020",2020,"Nîmes","Ligue 1","Lucas Deaux","FRA","MF","30",1988,14.8,49,26,16,29,4,16,45,35.6,29,20,4,16,15,64,19,0,"https://fbref.com/en/players/44f8c299/Lucas-Deaux"
"4480","Kevin Denkey_2020",2020,"Nîmes","Ligue 1","Kevin Denkey","TOG","FW","18",2000,6.7,10,5,1,8,1,6,10,60,4,7,0,7,2,12,1,1,"https://fbref.com/en/players/0d3585b5/Kevin-Denkey"
"4481","Lucas Dias_2020",2020,"Nîmes","Ligue 1","Lucas Dias","FRA","GK","20",1999,3.5,1,1,1,0,0,1,1,100,0,0,0,0,0,1,2,0,"https://fbref.com/en/players/d83f8f69/Lucas-Dias"
"4482","Haris Duljević_2020",2020,"Nîmes","Ligue 1","Haris Duljević","BIH","FW,MF","25",1993,5.8,11,6,3,7,1,4,12,33.3,8,5,0,5,2,13,1,0,"https://fbref.com/en/players/9b6556d2/Haris-Duljevic"
"4483","Zinedine Ferhat_2020",2020,"Nîmes","Ligue 1","Zinedine Ferhat","ALG","FW,MF","26",1993,25,26,16,5,16,5,15,46,32.6,31,15,3,12,16,42,18,0,"https://fbref.com/en/players/005c0807/Zinedine-Ferhat"
"4484","Lamine Fomba_2020",2020,"Nîmes","Ligue 1","Lamine Fomba","FRA","MF","21",1998,15.3,65,31,20,37,8,21,43,48.8,22,29,4,25,25,90,11,1,"https://fbref.com/en/players/2145368f/Lamine-Fomba"
"4485","Moussa Koné_2020",2020,"Nîmes","Ligue 1","Moussa Koné","SEN","FW,MF","22",1996,1.6,2,0,1,1,0,1,3,33.3,2,1,0,1,1,3,0,0,"https://fbref.com/en/players/3ef68782/Moussa-Kone"
"4486","Loïck Landre_2020",2020,"Nîmes","Ligue 1","Loïck Landre","FRA","DF","27",1992,10.3,16,9,12,3,1,7,11,63.6,4,12,9,3,17,33,34,0,"https://fbref.com/en/players/08082af0/Loick-Landre"
"4487","Pablo Martinez_2020",2020,"Nîmes","Ligue 1","Pablo Martinez","FRA","DF","30",1989,26,42,21,26,15,1,21,40,52.5,19,34,22,12,58,100,97,0,"https://fbref.com/en/players/1ad8cb67/Pablo-Martinez"
"4488","Florian Miguel_2020",2020,"Nîmes","Ligue 1","Florian Miguel","FRA","DF","22",1996,22.8,51,25,27,20,4,31,52,59.6,21,19,4,15,33,84,32,0,"https://fbref.com/en/players/b66d1d8a/Florian-Miguel"
"4489","Gaëtan Paquiez_2020",2020,"Nîmes","Ligue 1","Gaëtan Paquiez","FRA","DF","25",1994,17,36,25,14,13,9,17,47,36.2,30,18,5,13,33,69,43,0,"https://fbref.com/en/players/475583ff/Gaetan-Paquiez"
"4490","Romain Philippoteaux_2020",2020,"Nîmes","Ligue 1","Romain Philippoteaux","FRA","FW,MF","31",1988,22.2,23,12,11,11,1,9,43,20.9,34,22,1,21,13,36,10,0,"https://fbref.com/en/players/f98b15f0/Romain-Philippoteaux"
"4491","Renaud Ripart_2020",2020,"Nîmes","Ligue 1","Renaud Ripart","FRA","FW,DF","26",1993,22.5,39,23,17,20,2,18,46,39.1,28,17,2,15,12,51,37,0,"https://fbref.com/en/players/beae3a73/Renaud-Ripart"
"4492","Nolan Roux_2020",2020,"Nîmes","Ligue 1","Nolan Roux","FRA","FW","31",1988,6.5,5,2,1,3,1,1,3,33.3,2,2,0,2,4,9,5,0,"https://fbref.com/en/players/3071a619/Nolan-Roux"
"4493","Théo Sainte-Luce_2020",2020,"Nîmes","Ligue 1","Théo Sainte-Luce","FRA","MF,DF","20",1998,0.2,0,0,0,0,0,0,0,NA,0,0,0,0,0,0,0,0,"https://fbref.com/en/players/93c942fb/Theo-Sainte-Luce"
"4494","Sidy Sarr_2020",2020,"Nîmes","Ligue 1","Sidy Sarr","SEN","MF","23",1996,12.9,35,18,15,16,4,11,34,32.4,23,13,3,10,15,50,18,0,"https://fbref.com/en/players/a0b65401/Sidy-Sarr"
"4495","Vlatko Stojanovski_2020",2020,"Nîmes","Ligue 1","Vlatko Stojanovski","MKD","FW","22",1997,1.4,3,3,0,3,0,1,1,100,0,0,0,0,0,3,1,0,"https://fbref.com/en/players/bb67bff1/Vlatko-Stojanovski"
"4496","Pierrick Valdivia_2020",2020,"Nîmes","Ligue 1","Pierrick Valdivia","FRA","MF","31",1988,0.8,1,1,0,0,1,0,1,0,1,0,0,0,0,1,0,0,"https://fbref.com/en/players/e562a02e/Pierrick-Valdivia"
"4497","Antoine Valerio_2020",2020,"Nîmes","Ligue 1","Antoine Valerio","FRA","MF","19",1999,1,1,1,0,1,0,0,2,0,2,2,0,2,3,4,1,0,"https://fbref.com/en/players/95981861/Antoine-Valerio"
"4498","Luca Valls_2020",2020,"Nîmes","Ligue 1","Luca Valls","FRA","MF","20",1998,0.1,1,0,1,0,0,1,1,100,0,1,0,1,0,1,0,0,"https://fbref.com/en/players/254c927d/Luca-Valls"
"4499","Theo Valls_2020",2020,"Nîmes","Ligue 1","Theo Valls","FRA","MF","23",1995,18.1,39,16,12,26,1,16,50,32,34,17,0,17,13,52,6,0,"https://fbref.com/en/players/c8090cb3/Theo-Valls"
"4500","José Arnaiz_2020",2020,"Osasuna","La Liga","José Arnaiz","ESP","FW,MF","24",1995,8.8,3,2,0,2,1,0,12,0,12,7,0,7,5,8,5,0,"https://fbref.com/en/players/46e07328/Jose-Arnaiz"
"4501","Ezequiel Ávila_2020",2020,"Osasuna","La Liga","Ezequiel Ávila","ARG","FW","25",1994,17.7,17,12,6,7,4,6,18,33.3,12,12,0,12,3,20,5,0,"https://fbref.com/en/players/253a06b9/Ezequiel-Avila"
"4502","Kike Barja_2020",2020,"Osasuna","La Liga","Kike Barja","ESP","MF,FW","22",1997,3.5,1,1,1,0,0,1,1,100,0,3,1,2,0,1,2,0,"https://fbref.com/en/players/aad53e64/Kike-Barja"
"4503","Brandon_2020",2020,"Osasuna","La Liga","Brandon","ESP","FW","24",1995,4.5,5,3,1,3,1,0,5,0,5,4,0,4,0,5,1,0,"https://fbref.com/en/players/3e016e5a/Brandon"
"4504","Darko Brašanac_2020",2020,"Osasuna","La Liga","Darko Brašanac","SRB","MF","27",1992,24.9,45,25,14,26,5,15,41,36.6,26,19,4,15,20,65,21,0,"https://fbref.com/en/players/4accb7e0/Darko-Brasanac"
"4505","Marc Cardona_2020",2020,"Osasuna","La Liga","Marc Cardona","ESP","FW","24",1995,7.8,1,0,0,1,0,0,8,0,8,3,1,2,2,3,2,0,"https://fbref.com/en/players/b92b456a/Marc-Cardona"
"4506","Pervis Estupiñán_2020",2020,"Osasuna","La Liga","Pervis Estupiñán","ECU","DF","21",1998,33.1,84,45,53,27,4,42,77,54.5,35,30,7,23,58,142,61,6,"https://fbref.com/en/players/d38fdf53/Pervis-Estupinan"
"4507","Enric Gallego_2020",2020,"Osasuna","La Liga","Enric Gallego","ESP","FW","32",1986,9.8,9,5,1,5,3,0,4,0,4,10,2,8,4,13,8,0,"https://fbref.com/en/players/82e9b89d/Enric-Gallego"
"4508","David García_2020",2020,"Osasuna","La Liga","David García","ESP","DF","25",1994,31,28,16,15,12,1,14,31,45.2,17,20,16,4,48,76,123,2,"https://fbref.com/en/players/3e42f707/David-Garcia"
"4509","Rubén García_2020",2020,"Osasuna","La Liga","Rubén García","ESP","MF,FW","26",1993,24.3,55,30,22,26,7,18,46,39.1,28,34,5,29,11,66,23,1,"https://fbref.com/en/players/5c96b017/Ruben-Garcia"
"4510","Unai García_2020",2020,"Osasuna","La Liga","Unai García","ESP","DF","27",1992,6,9,6,4,4,1,5,9,55.6,4,13,9,4,8,17,31,0,"https://fbref.com/en/players/4a633cfe/Unai-Garcia"
"4511","Aridane Hernández_2020",2020,"Osasuna","La Liga","Aridane Hernández","ESP","DF","30",1989,29,35,23,22,13,0,15,19,78.9,4,24,15,9,34,69,137,2,"https://fbref.com/en/players/132ac341/Aridane-Hernandez"
"4512","Sergio Herrera_2020",2020,"Osasuna","La Liga","Sergio Herrera","ESP","GK","26",1993,18.4,1,1,1,0,0,1,4,25,3,0,0,0,1,2,13,3,"https://fbref.com/en/players/a4995f48/Sergio-Herrera"
"4513","Robert Ibáñez_2020",2020,"Osasuna","La Liga","Robert Ibáñez","ESP","MF,FW","26",1993,6,13,8,4,5,4,7,20,35,13,7,0,7,5,18,5,0,"https://fbref.com/en/players/c7429db3/Robert-Ibanez"
"4514","Toni Lato_2020",2020,"Osasuna","La Liga","Toni Lato","ESP","DF,MF","21",1997,5.2,22,15,11,8,3,9,10,90,1,9,1,8,8,30,13,1,"https://fbref.com/en/players/8e088e04/Toni-Lato"
"4515","Lillo_2020",2020,"Osasuna","La Liga","Lillo","ESP","DF","30",1989,2.2,4,2,2,2,0,1,1,100,0,2,1,1,2,6,8,0,"https://fbref.com/en/players/476ca810/Lillo"
"4516","Adrián López_2020",2020,"Osasuna","La Liga","Adrián López","ESP","FW","31",1988,16,7,5,1,5,1,2,19,10.5,17,6,2,4,4,11,8,0,"https://fbref.com/en/players/88a359d4/Adrian-Lopez"
"4517","Javi Martínez_2020",2020,"Osasuna","La Liga","Javi Martínez","ESP","MF","19",1999,0.1,0,0,0,0,0,0,0,NA,0,0,0,0,0,0,1,0,"https://fbref.com/en/players/3672b352/Javi-Martinez"
"4518","Fran Mérida_2020",2020,"Osasuna","La Liga","Fran Mérida","ESP","MF","29",1990,12.9,27,15,11,10,6,9,27,33.3,18,15,4,11,25,52,10,0,"https://fbref.com/en/players/0e50f929/Fran-Merida"
"4519","Jon Moncayola_2020",2020,"Osasuna","La Liga","Jon Moncayola","ESP","MF,DF","21",1998,16.6,52,30,26,22,4,27,54,50,27,29,5,24,16,68,23,1,"https://fbref.com/en/players/9939e168/Jon-Moncayola"
"4520","Raúl Navas_2020",2020,"Osasuna","La Liga","Raúl Navas","ESP","DF","31",1988,7.9,10,5,4,6,0,4,13,30.8,9,10,4,6,18,28,30,0,"https://fbref.com/en/players/ad178594/Raul-Navas"
"4521","Aimar Oroz_2020",2020,"Osasuna","La Liga","Aimar Oroz","ESP","FW","17",2001,0.1,0,0,0,0,0,0,0,NA,0,1,0,1,0,0,0,0,"https://fbref.com/en/players/7c363088/Aimar-Oroz"
"4522","Luis Perea_2020",2020,"Osasuna","La Liga","Luis Perea","ESP","FW","21",1997,0.2,0,0,0,0,0,0,0,NA,0,0,0,0,0,0,1,0,"https://fbref.com/en/players/8dc6dbb3/Luis-Perea"
"4523","Iñigo Pérez_2020",2020,"Osasuna","La Liga","Iñigo Pérez","ESP","MF","31",1988,12,15,11,3,7,5,8,22,36.4,14,7,1,6,12,27,6,0,"https://fbref.com/en/players/bc61cc65/Inigo-Perez"
"4524","Juan Pérez_2020",2020,"Osasuna","La Liga","Juan Pérez","ESP","GK","23",1996,2,1,1,1,0,0,1,2,50,1,0,0,0,0,1,0,0,"https://fbref.com/en/players/8f29e08b/Juan-Perez"
"4525","Facundo Roncaglia_2020",2020,"Osasuna","La Liga","Facundo Roncaglia","ARG","DF","32",1987,14.2,24,20,12,10,2,11,20,55,9,18,3,15,22,46,46,0,"https://fbref.com/en/players/51e3954c/Facundo-Roncaglia"
"4526","Rubén_2020",2020,"Osasuna","La Liga","Rubén","ESP","GK","35",1984,17.6,1,1,1,0,0,1,1,100,0,0,0,0,0,1,9,1,"https://fbref.com/en/players/24279b8b/Ruben"
"4527","Oier Sanjurjo_2020",2020,"Osasuna","La Liga","Oier Sanjurjo","ESP","MF","33",1986,25.8,65,34,21,34,10,28,64,43.8,36,33,8,25,35,100,39,1,"https://fbref.com/en/players/466824fb/Oier-Sanjurjo"
"4528","Roberto Torres_2020",2020,"Osasuna","La Liga","Roberto Torres","ESP","MF,FW","30",1989,30.2,33,16,12,18,3,21,49,42.9,28,41,2,39,31,64,37,0,"https://fbref.com/en/players/d733aa38/Roberto-Torres"
"4529","Nacho Vidal_2020",2020,"Osasuna","La Liga","Nacho Vidal","ESP","DF","24",1995,25.9,45,29,26,13,6,21,38,55.3,17,24,6,18,44,89,70,1,"https://fbref.com/en/players/3a9c4b7b/Nacho-Vidal"
"4530","Juan Villar_2020",2020,"Osasuna","La Liga","Juan Villar","ESP","FW","31",1988,2.7,1,0,0,1,0,0,2,0,2,4,1,3,1,2,0,0,"https://fbref.com/en/players/c33ee247/Juan-Villar"
"4531","Christopher Antwi-Adjei_2020",2020,"Paderborn 07","Bundesliga","Christopher Antwi-Adjei","GHA","MF,FW","25",1994,27.4,25,16,13,9,3,9,33,27.3,24,29,2,27,15,40,14,0,"https://fbref.com/en/players/0a3f6cde/Christopher-Antwi-Adjei"
"4532","Jamilu Collins_2020",2020,"Paderborn 07","Bundesliga","Jamilu Collins","NGA","DF","24",1994,29.6,69,43,44,21,4,37,62,59.7,25,53,19,34,70,139,91,1,"https://fbref.com/en/players/33a95e0a/Jamilu-Collins"
"4533","Mohamed Dräger_2020",2020,"Paderborn 07","Bundesliga","Mohamed Dräger","TUN","DF","23",1996,16.2,32,21,22,8,2,14,33,42.4,19,17,5,12,18,50,39,0,"https://fbref.com/en/players/8954fddc/Mohamed-Drager"
"4534","Antony Evans_2020",2020,"Paderborn 07","Bundesliga","Antony Evans","ENG","MF,DF","20",1998,1.7,5,4,1,3,1,1,5,20,4,1,1,0,2,7,4,0,"https://fbref.com/en/players/cce7087c/Antony-Evans"
"4535","Samúel Friðjónsson_2020",2020,"Paderborn 07","Bundesliga","Samúel Friðjónsson","ISL","MF","23",1996,2.1,4,1,3,1,0,1,3,33.3,2,4,1,3,4,8,4,0,"https://fbref.com/en/players/55557b25/Samuel-Fridjonsson"
"4536","Klaus Gjasula_2020",2020,"Paderborn 07","Bundesliga","Klaus Gjasula","ALB","MF","29",1989,25.3,69,39,30,35,4,30,61,49.2,31,33,6,27,32,101,50,2,"https://fbref.com/en/players/431c837b/Klaus-Gjasula"
"4537","Babacar Guèye_2020",2020,"Paderborn 07","Bundesliga","Babacar Guèye","SEN","FW","24",1994,1.2,2,0,0,0,2,0,1,0,1,1,1,0,0,2,3,0,"https://fbref.com/en/players/4942dad3/Babacar-Gueye"
"4538","Gerrit Holtmann_2020",2020,"Paderborn 07","Bundesliga","Gerrit Holtmann","PHI","MF,DF","24",1995,11.8,24,14,14,6,4,15,37,40.5,22,21,1,20,6,30,8,0,"https://fbref.com/en/players/2979c05a/Gerrit-Holtmann"
"4539","Uwe Hünemeier_2020",2020,"Paderborn 07","Bundesliga","Uwe Hünemeier","GER","DF","33",1986,13.4,20,15,9,11,0,10,20,50,10,22,12,10,24,44,63,0,"https://fbref.com/en/players/f42456eb/Uwe-Hunemeier"
"4540","Jannik Huth_2020",2020,"Paderborn 07","Bundesliga","Jannik Huth","GER","GK","25",1994,6,0,0,0,0,0,0,1,0,1,0,0,0,0,0,2,0,"https://fbref.com/en/players/e8fd2e5b/Jannik-Huth"
"4541","Laurent Jans_2020",2020,"Paderborn 07","Bundesliga","Laurent Jans","LUX","DF","26",1992,17.5,42,25,30,8,4,22,48,45.8,26,25,10,15,19,61,49,1,"https://fbref.com/en/players/0fbb73c2/Laurent-Jans"
"4542","Dennis Jastrzembski_2020",2020,"Paderborn 07","Bundesliga","Dennis Jastrzembski","POL","MF,FW","19",2000,2,2,0,1,1,0,0,1,0,1,3,0,3,3,5,0,0,"https://fbref.com/en/players/6bba916f/Dennis-Jastrzembski"
"4543","Luca Kilian_2020",2020,"Paderborn 07","Bundesliga","Luca Kilian","GER","DF","19",1999,14,33,24,27,6,0,22,41,53.7,19,20,9,11,12,45,67,0,"https://fbref.com/en/players/610aa1e9/Luca-Kilian"
"4544","Jan Luca Rumpf_2020",2020,"Paderborn 07","Bundesliga","Jan Luca Rumpf","GER","DF","20",1999,1,0,0,0,0,0,0,0,NA,0,0,0,0,0,0,2,0,"https://fbref.com/en/players/3588d4fe/Jan-Luca-Rumpf"
"4545","Streli Mamba_2020",2020,"Paderborn 07","Bundesliga","Streli Mamba","GER","FW","25",1994,16.9,15,9,0,9,6,1,13,7.7,12,12,2,10,6,21,2,0,"https://fbref.com/en/players/625e41b1/Streli-Mamba"
"4546","Sven Michel_2020",2020,"Paderborn 07","Bundesliga","Sven Michel","GER","FW","29",1990,15.3,14,12,3,5,6,3,20,15,17,13,2,11,7,21,7,0,"https://fbref.com/en/players/1e274a0a/Sven-Michel"
"4547","Cauly Oliveira Souza_2020",2020,"Paderborn 07","Bundesliga","Cauly Oliveira Souza","BRA","MF,FW","23",1995,8,11,7,5,5,1,3,11,27.3,8,9,0,9,6,17,1,0,"https://fbref.com/en/players/2b53f7a5/Cauly-Oliveira-Souza"
"4548","Kai Pröger_2020",2020,"Paderborn 07","Bundesliga","Kai Pröger","GER","MF,FW","27",1992,23.1,43,22,21,17,5,17,58,29.3,41,34,6,28,14,57,20,1,"https://fbref.com/en/players/8a080a61/Kai-Proger"
"4549","Marlon Ritter_2020",2020,"Paderborn 07","Bundesliga","Marlon Ritter","GER","MF","24",1994,4.8,7,5,5,2,0,4,9,44.4,5,7,0,7,8,15,3,0,"https://fbref.com/en/players/ce2c51c0/Marlon-Ritter"
"4550","Abdelhamid Sabiri_2020",2020,"Paderborn 07","Bundesliga","Abdelhamid Sabiri","MAR","MF","22",1996,11.6,20,16,6,11,3,9,27,33.3,18,9,2,7,8,28,18,1,"https://fbref.com/en/players/4830e0af/Abdelhamid-Sabiri"
"4551","Sebastian Schonlau_2020",2020,"Paderborn 07","Bundesliga","Sebastian Schonlau","GER","DF","24",1994,23,64,43,50,14,0,41,66,62.1,25,36,15,21,40,104,138,1,"https://fbref.com/en/players/efd623db/Sebastian-Schonlau"
"4552","Khiry Shelton_2020",2020,"Paderborn 07","Bundesliga","Khiry Shelton","USA","FW","26",1993,0.4,1,1,1,0,0,0,0,NA,0,0,0,0,0,1,0,0,"https://fbref.com/en/players/f935709c/Khiry-Shelton"
"4553","Dennis Srbeny_2020",2020,"Paderborn 07","Bundesliga","Dennis Srbeny","GER","FW,MF","25",1994,12.4,11,6,4,4,3,5,18,27.8,13,11,1,10,3,14,9,0,"https://fbref.com/en/players/1fdec858/Dennis-Srbeny"
"4554","Christian Strohdiek_2020",2020,"Paderborn 07","Bundesliga","Christian Strohdiek","GER","DF","31",1988,15.1,26,22,21,5,0,20,42,47.6,22,16,10,6,25,51,92,0,"https://fbref.com/en/players/9c2394c9/Christian-Strohdiek"
"4555","Sebastian Vasiliadis_2020",2020,"Paderborn 07","Bundesliga","Sebastian Vasiliadis","GRE","MF","21",1997,31.2,73,45,34,31,8,28,81,34.6,53,47,6,41,34,107,50,0,"https://fbref.com/en/players/d3112d86/Sebastian-Vasiliadis"
"4556","Leopold Zingerle_2020",2020,"Paderborn 07","Bundesliga","Leopold Zingerle","GER","GK","25",1994,28,3,1,3,0,0,2,4,50,2,0,0,0,0,3,7,2,"https://fbref.com/en/players/bf9d9070/Leopold-Zingerle"
"4557","Ben Zolinski_2020",2020,"Paderborn 07","Bundesliga","Ben Zolinski","GER","FW,MF","27",1992,13.4,17,9,7,9,1,7,27,25.9,20,12,0,12,8,25,4,0,"https://fbref.com/en/players/4d50454e/Ben-Zolinski"
"4558","Adil Aouchiche_2020",2020,"Paris S-G","Ligue 1","Adil Aouchiche","FRA","MF","17",2002,0.7,3,2,1,2,0,2,4,50,2,3,0,3,0,3,0,0,"https://fbref.com/en/players/b94b8be1/Adil-Aouchiche"
"4559","Alphonse Areola_2020",2020,"Paris S-G","Ligue 1","Alphonse Areola","FRA","GK","26",1993,3,0,0,0,0,0,0,0,NA,0,0,0,0,0,0,1,1,"https://fbref.com/en/players/2f965a72/Alphonse-Areola"
"4560","Mitchel Bakker_2020",2020,"Paris S-G","Ligue 1","Mitchel Bakker","NED","DF","19",2000,1,2,2,1,1,0,1,1,100,0,0,0,0,0,2,2,0,"https://fbref.com/en/players/a8567629/Mitchel-Bakker"
"4561","Juan Bernat_2020",2020,"Paris S-G","Ligue 1","Juan Bernat","ESP","DF,MF","26",1993,15.4,42,27,19,16,7,20,51,39.2,31,13,1,12,10,52,26,0,"https://fbref.com/en/players/433dc9a2/Juan-Bernat"
"4562","Marcin Bułka_2020",2020,"Paris S-G","Ligue 1","Marcin Bułka","POL","GK","19",1999,1,0,0,0,0,0,0,0,NA,0,0,0,0,0,0,0,0,"https://fbref.com/en/players/db87a2c4/Marcin-Bulka"
"4563","Edinson Cavani_2020",2020,"Paris S-G","Ligue 1","Edinson Cavani","URU","FW","32",1987,6.7,5,1,0,2,3,0,3,0,3,7,0,7,1,6,2,0,"https://fbref.com/en/players/527f063d/Edinson-Cavani"
"4564","Colin Dagba_2020",2020,"Paris S-G","Ligue 1","Colin Dagba","FRA","DF","20",1998,7.4,10,4,2,4,4,5,9,55.6,4,6,1,5,6,16,9,0,"https://fbref.com/en/players/29c02c9f/Colin-Dagba"
"4565","Ángel Di María_2020",2020,"Paris S-G","Ligue 1","Ángel Di María","ARG","FW,MF","31",1988,22.2,17,12,2,8,7,4,34,11.8,30,14,3,11,11,28,1,3,"https://fbref.com/en/players/19cda00b/Angel-Di-Maria"
"4566","Abdou Diallo_2020",2020,"Paris S-G","Ligue 1","Abdou Diallo","SEN","DF","23",1996,13.3,20,11,9,10,1,8,14,57.1,6,9,5,4,10,30,32,0,"https://fbref.com/en/players/fc62f087/Abdou-Diallo"
"4567","Julian Draxler_2020",2020,"Paris S-G","Ligue 1","Julian Draxler","GER","MF","25",1993,7.6,13,10,2,9,2,7,15,46.7,8,7,1,6,10,23,1,0,"https://fbref.com/en/players/1a992676/Julian-Draxler"
"4568","Idrissa Gana Gueye_2020",2020,"Paris S-G","Ligue 1","Idrissa Gana Gueye","SEN","MF","29",1989,18.4,65,34,30,25,10,18,43,41.9,25,29,4,25,33,98,15,0,"https://fbref.com/en/players/72c812f3/Idrissa-Gana-Gueye"
"4569","Ander Herrera_2020",2020,"Paris S-G","Ligue 1","Ander Herrera","ESP","MF,DF","29",1989,6.1,19,11,9,9,1,5,14,35.7,9,10,2,8,6,25,4,0,"https://fbref.com/en/players/436a9dd0/Ander-Herrera"
"4570","Mauro Icardi_2020",2020,"Paris S-G","Ligue 1","Mauro Icardi","ARG","FW","26",1993,14.1,4,2,1,3,0,1,10,10,9,7,1,6,2,6,11,0,"https://fbref.com/en/players/43b78598/Mauro-Icardi"
"4571","Jesé_2020",2020,"Paris S-G","Ligue 1","Jesé","ESP","FW","26",1993,0,0,0,0,0,0,0,0,NA,0,0,0,0,0,0,0,0,"https://fbref.com/en/players/4a537185/Jese"
"4572","Thilo Kehrer_2020",2020,"Paris S-G","Ligue 1","Thilo Kehrer","GER","DF","22",1996,5.3,10,7,4,5,1,5,10,50,5,2,0,2,1,11,2,1,"https://fbref.com/en/players/51dbeea9/Thilo-Kehrer"
"4573","Presnel Kimpembe_2020",2020,"Paris S-G","Ligue 1","Presnel Kimpembe","FRA","DF","23",1995,13.6,33,25,25,8,0,14,20,70,6,7,3,4,21,54,33,1,"https://fbref.com/en/players/aef6e670/Presnel-Kimpembe"
"4574","Layvin Kurzawa_2020",2020,"Paris S-G","Ligue 1","Layvin Kurzawa","FRA","DF","26",1992,9.5,23,16,5,14,4,11,23,47.8,12,12,1,11,18,41,24,1,"https://fbref.com/en/players/41e7ef1c/Layvin-Kurzawa"
"4575","Marquinhos_2020",2020,"Paris S-G","Ligue 1","Marquinhos","BRA","MF,DF","25",1994,16.4,39,20,17,18,4,11,26,42.3,15,25,8,17,25,64,31,1,"https://fbref.com/en/players/d5f2f82b/Marquinhos"
"4576","Eric Maxim Choupo-Moting_2020",2020,"Paris S-G","Ligue 1","Eric Maxim Choupo-Moting","CMR","FW,MF","30",1989,5,12,9,3,4,5,4,8,50,4,3,0,3,1,13,3,0,"https://fbref.com/en/players/0e6bc38c/Eric-Maxim-Choupo-Moting"
"4577","Kylian Mbappé_2020",2020,"Paris S-G","Ligue 1","Kylian Mbappé","FRA","FW","20",1998,16.8,7,2,1,5,1,3,10,30,7,4,0,4,3,10,0,0,"https://fbref.com/en/players/42fd9c7f/Kylian-Mbappe"
"4578","Loïc Mbe Soh_2020",2020,"Paris S-G","Ligue 1","Loïc Mbe Soh","FRA","DF","18",2001,0.6,2,2,2,0,0,2,2,100,0,0,0,0,1,3,0,0,"https://fbref.com/en/players/8f534f8e/Loic-Mbe-Soh"
"4579","Thomas Meunier_2020",2020,"Paris S-G","Ligue 1","Thomas Meunier","BEL","DF","27",1991,13.8,27,21,9,12,6,16,26,61.5,10,17,5,12,18,45,19,1,"https://fbref.com/en/players/e162b013/Thomas-Meunier"
"4580","Keylor Navas_2020",2020,"Paris S-G","Ligue 1","Keylor Navas","CRC","GK","32",1986,21,0,0,0,0,0,0,0,NA,0,1,0,1,0,0,4,2,"https://fbref.com/en/players/ecada4fc/Keylor-Navas"
"4581","Neymar_2020",2020,"Paris S-G","Ligue 1","Neymar","BRA","MF,FW","27",1992,14.6,12,7,1,9,2,3,21,14.3,18,10,0,10,4,16,1,0,"https://fbref.com/en/players/69384e5d/Neymar"
"4582","Tanguy Nianzou_2020",2020,"Paris S-G","Ligue 1","Tanguy Nianzou","FRA","DF,MF","17",2002,5,2,1,0,1,1,1,3,33.3,2,4,2,2,3,5,6,0,"https://fbref.com/en/players/5853ac44/Tanguy-Nianzou"
"4583","Leandro Paredes_2020",2020,"Paris S-G","Ligue 1","Leandro Paredes","ARG","MF","25",1994,9,22,14,7,14,1,13,29,44.8,16,7,1,6,15,37,7,0,"https://fbref.com/en/players/dff153a4/Leandro-Paredes"
"4584","Sergio Rico_2020",2020,"Paris S-G","Ligue 1","Sergio Rico","ESP","GK","25",1993,2,0,0,0,0,0,0,0,NA,0,0,0,0,0,0,1,2,"https://fbref.com/en/players/5f0241b2/Sergio-Rico"
"4585","Pablo Sarabia_2020",2020,"Paris S-G","Ligue 1","Pablo Sarabia","ESP","FW,MF","27",1992,12.9,12,7,3,6,3,4,25,16,21,19,1,18,10,22,5,0,"https://fbref.com/en/players/9744ff80/Pablo-Sarabia"
"4586","Thiago Silva_2020",2020,"Paris S-G","Ligue 1","Thiago Silva","BRA","DF","34",1984,17.5,28,16,15,13,0,13,16,81.3,3,18,15,3,26,54,54,0,"https://fbref.com/en/players/86e7deaf/Thiago-Silva"
"4587","Marco Verratti_2020",2020,"Paris S-G","Ligue 1","Marco Verratti","ITA","MF","26",1992,16.5,54,32,22,22,10,20,56,35.7,36,23,3,20,19,73,9,0,"https://fbref.com/en/players/1467af0d/Marco-Verratti"
"4588","Arthur Zagre_2020",2020,"Paris S-G","Ligue 1","Arthur Zagre","FRA","MF","17",2001,0.3,1,0,1,0,0,0,0,NA,0,1,0,1,1,2,0,0,"https://fbref.com/en/players/3225654e/Arthur-Zagre"
"4589","Bruno Alves_2020",2020,"Parma","Serie A","Bruno Alves","POR","DF","37",1981,29.7,17,11,12,5,0,8,13,61.5,5,30,21,9,25,42,150,2,"https://fbref.com/en/players/585a73a8/Bruno-Alves"
"4590","Antonino Barillà_2020",2020,"Parma","Serie A","Antonino Barillà","ITA","MF","31",1988,18.8,43,31,22,19,2,16,45,35.6,29,26,8,18,17,60,32,0,"https://fbref.com/en/players/a64cbd35/Antonino-Barilla"
"4591","Gastón Brugman_2020",2020,"Parma","Serie A","Gastón Brugman","URU","MF","26",1992,16.2,47,24,25,15,7,19,46,41.3,27,33,15,18,27,74,19,2,"https://fbref.com/en/players/e947ee4a/Gaston-Brugman"
"4592","Gianluca Caprari_2020",2020,"Parma","Serie A","Gianluca Caprari","ITA","FW,MF","26",1993,6.5,1,1,0,1,0,0,5,0,5,7,2,5,4,5,2,0,"https://fbref.com/en/players/54e53b7e/Gianluca-Caprari"
"4593","Simone Colombi_2020",2020,"Parma","Serie A","Simone Colombi","ITA","GK","28",1991,4,0,0,0,0,0,0,0,NA,0,0,0,0,0,0,1,0,"https://fbref.com/en/players/72be9309/Simone-Colombi"
"4594","Andreas Cornelius_2020",2020,"Parma","Serie A","Andreas Cornelius","DEN","FW","26",1993,16.6,9,4,2,5,2,4,11,36.4,7,7,0,7,2,11,26,0,"https://fbref.com/en/players/c693347d/Andreas-Cornelius"
"4595","Matteo Darmian_2020",2020,"Parma","Serie A","Matteo Darmian","ITA","DF","29",1989,29.8,81,42,48,30,3,40,83,48.2,43,38,16,22,25,106,78,1,"https://fbref.com/en/players/96e0490d/Matteo-Darmian"
"4596","Kastriot Dermaku_2020",2020,"Parma","Serie A","Kastriot Dermaku","ALB","DF","27",1992,11.4,13,5,10,3,0,3,5,60,2,20,16,4,12,25,61,1,"https://fbref.com/en/players/2990c466/Kastriot-Dermaku"
"4597","Riccardo Gagliolo_2020",2020,"Parma","Serie A","Riccardo Gagliolo","SWE","DF","29",1990,28.9,57,32,37,12,8,30,60,50,30,35,18,17,53,110,100,0,"https://fbref.com/en/players/173061c0/Riccardo-Gagliolo"
"4598","Gervinho_2020",2020,"Parma","Serie A","Gervinho","CIV","FW","32",1987,25.2,12,6,5,6,1,6,17,35.3,11,4,0,4,5,17,3,0,"https://fbref.com/en/players/e468c053/Gervinho"
"4599","Alberto Grassi_2020",2020,"Parma","Serie A","Alberto Grassi","ITA","MF","24",1995,7.1,10,4,7,3,0,5,13,38.5,8,5,2,3,19,29,9,1,"https://fbref.com/en/players/6cc97b6a/Alberto-Grassi"
"4600","Hernani_2020",2020,"Parma","Serie A","Hernani","BRA","MF","25",1994,26.9,61,31,25,31,5,30,112,26.8,82,53,11,42,50,111,51,1,"https://fbref.com/en/players/6f5ead86/Hernani"
"4601","Simone Iacoponi_2020",2020,"Parma","Serie A","Simone Iacoponi","ITA","DF","32",1987,33.9,49,25,36,12,1,26,42,61.9,16,37,29,8,35,84,140,2,"https://fbref.com/en/players/63071a3f/Simone-Iacoponi"
"4602","Roberto Inglese_2020",2020,"Parma","Serie A","Roberto Inglese","ITA","FW","27",1991,8.5,9,6,2,2,5,2,10,20,8,8,2,6,2,11,1,0,"https://fbref.com/en/players/6c1f7328/Roberto-Inglese"
"4603","Yann Karamoh_2020",2020,"Parma","Serie A","Yann Karamoh","FRA","FW,MF","21",1998,6.4,10,7,5,4,1,3,9,33.3,6,5,0,5,2,12,3,0,"https://fbref.com/en/players/8b66d9cc/Yann-Karamoh"
"4604","Juraj Kucka_2020",2020,"Parma","Serie A","Juraj Kucka","SVK","MF,FW","32",1987,21.5,43,22,21,16,6,14,61,23,47,21,4,17,29,72,36,0,"https://fbref.com/en/players/5aaef9ef/Juraj-Kucka"
"4605","Dejan Kulusevski_2020",2020,"Parma","Serie A","Dejan Kulusevski","SWE","FW,MF","19",2000,32.6,41,21,10,24,7,19,64,29.7,45,25,1,24,23,64,17,0,"https://fbref.com/en/players/df3cda47/Dejan-Kulusevski"
"4606","Jasmin Kurtić_2020",2020,"Parma","Serie A","Jasmin Kurtić","SVN","MF,FW","30",1989,18.5,32,23,19,10,3,13,35,37.1,22,19,5,14,15,47,27,2,"https://fbref.com/en/players/144607cc/Jasmin-Kurtic"
"4607","Vincent Laurini_2020",2020,"Parma","Serie A","Vincent Laurini","FRA","DF","30",1989,9.8,26,22,11,11,4,14,18,77.8,4,10,3,7,11,37,29,0,"https://fbref.com/en/players/3535098b/Vincent-Laurini"
"4608","Giuseppe Pezzella_2020",2020,"Parma","Serie A","Giuseppe Pezzella","ITA","DF","21",1997,10.5,20,12,17,3,0,11,19,57.9,8,13,9,4,6,26,30,0,"https://fbref.com/en/players/149c5f5d/Giuseppe-Pezzella"
"4609","Vasco Regini_2020",2020,"Parma","Serie A","Vasco Regini","ITA","DF","28",1990,0.6,0,0,0,0,0,0,0,NA,0,0,0,0,0,0,3,0,"https://fbref.com/en/players/339c6ed4/Vasco-Regini"
"4610","Matteo Scozzarella_2020",2020,"Parma","Serie A","Matteo Scozzarella","ITA","MF","31",1988,10.2,23,15,8,13,2,14,29,48.3,15,19,14,5,27,50,28,0,"https://fbref.com/en/players/ea164f99/Matteo-Scozzarella"
"4611","Luigi Sepe_2020",2020,"Parma","Serie A","Luigi Sepe","ITA","GK","28",1991,34,1,0,1,0,0,1,2,50,1,0,0,0,0,1,6,2,"https://fbref.com/en/players/343f753a/Luigi-Sepe"
"4612","Luca Siligardi_2020",2020,"Parma","Serie A","Luca Siligardi","ITA","MF,FW","31",1988,3.7,6,2,3,2,1,4,8,50,4,3,0,3,3,9,5,0,"https://fbref.com/en/players/1cac99dc/Luca-Siligardi"
"4613","Mattia Sprocati_2020",2020,"Parma","Serie A","Mattia Sprocati","ITA","FW,MF","26",1993,6.6,4,2,3,1,0,0,1,0,1,5,1,4,2,6,2,0,"https://fbref.com/en/players/bdd0692f/Mattia-Sprocati"
"4614","Tyler Adams_2020",2020,"RB Leipzig","Bundesliga","Tyler Adams","USA","MF,DF","20",1999,10.6,22,15,13,8,1,12,25,48,13,16,1,15,14,36,14,0,"https://fbref.com/en/players/2b09d998/Tyler-Adams"
"4615","Ethan Ampadu_2020",2020,"RB Leipzig","Bundesliga","Ethan Ampadu","WAL","DF","18",2000,0.9,5,4,3,2,0,1,1,100,0,3,1,2,1,6,3,0,"https://fbref.com/en/players/10b9fa99/Ethan-Ampadu"
"4616","Angeliño_2020",2020,"RB Leipzig","Bundesliga","Angeliño","ESP","DF,FW","22",1997,12.2,15,9,7,5,3,5,15,33.3,10,14,1,13,19,34,24,0,"https://fbref.com/en/players/30941e96/Angelino"
"4617","Dennis Borkowski_2020",2020,"RB Leipzig","Bundesliga","Dennis Borkowski","GER","FW","17",2002,0.1,0,0,0,0,0,0,0,NA,0,0,0,0,0,0,0,0,"https://fbref.com/en/players/78b9e99c/Dennis-Borkowski"
"4618","Matheus Cunha_2020",2020,"RB Leipzig","Bundesliga","Matheus Cunha","BRA","FW,MF","20",1999,3.1,6,2,0,1,5,0,2,0,2,5,1,4,1,7,0,0,"https://fbref.com/en/players/dc62b55d/Matheus-Cunha"
"4619","Diego Demme_2020",2020,"RB Leipzig","Bundesliga","Diego Demme","GER","MF","27",1991,13.5,41,18,17,19,5,17,42,40.5,25,14,2,12,15,56,14,0,"https://fbref.com/en/players/dc3fa3b5/Diego-Demme"
"4620","Emil Forsberg_2020",2020,"RB Leipzig","Bundesliga","Emil Forsberg","SWE","MF","27",1991,12.7,16,10,5,8,3,6,26,23.1,20,15,0,15,5,21,3,0,"https://fbref.com/en/players/9a2e0ccc/Emil-Forsberg"
"4621","Péter Gulácsi_2020",2020,"RB Leipzig","Bundesliga","Péter Gulácsi","HUN","GK","29",1990,32,0,0,0,0,0,0,0,NA,0,0,0,0,1,1,18,6,"https://fbref.com/en/players/bcb2ccd8/Peter-Gulacsi"
"4622","Amadou Haidara_2020",2020,"RB Leipzig","Bundesliga","Amadou Haidara","MLI","MF","21",1998,8.4,26,16,7,17,2,10,24,41.7,14,14,2,12,8,34,10,1,"https://fbref.com/en/players/92432bc6/Amadou-Haidara"
"4623","Marcel Halstenberg_2020",2020,"RB Leipzig","Bundesliga","Marcel Halstenberg","GER","DF","27",1991,28,46,31,27,17,2,28,58,48.3,30,37,11,26,46,92,72,2,"https://fbref.com/en/players/8ff2354e/Marcel-Halstenberg"
"4624","Stefan Ilsanker_2020",2020,"RB Leipzig","Bundesliga","Stefan Ilsanker","AUT","DF","30",1989,4.6,3,1,3,0,0,3,6,50,3,6,3,3,7,10,21,0,"https://fbref.com/en/players/8494acc4/Stefan-Ilsanker"
"4625","Kevin Kampl_2020",2020,"RB Leipzig","Bundesliga","Kevin Kampl","SVN","MF","28",1990,7.5,17,11,7,10,0,7,23,30.4,16,7,2,5,16,33,6,0,"https://fbref.com/en/players/b825a650/Kevin-Kampl"
"4626","Lukas Klostermann_2020",2020,"RB Leipzig","Bundesliga","Lukas Klostermann","GER","DF","23",1996,29.4,45,26,24,16,5,18,31,58.1,13,34,16,18,26,71,101,2,"https://fbref.com/en/players/ca8033cb/Lukas-Klostermann"
"4627","Ibrahima Konaté_2020",2020,"RB Leipzig","Bundesliga","Ibrahima Konaté","FRA","DF","20",1999,6.3,11,6,10,1,0,2,7,28.6,5,9,4,5,5,16,35,1,"https://fbref.com/en/players/5ed9b537/Ibrahima-Konate"
"4628","Tom Krauß_2020",2020,"RB Leipzig","Bundesliga","Tom Krauß","GER","MF","18",2001,0,1,1,0,1,0,1,2,50,1,0,0,0,0,1,0,0,"https://fbref.com/en/players/9f77012e/Tom-Krauss"
"4629","Konrad Laimer_2020",2020,"RB Leipzig","Bundesliga","Konrad Laimer","AUT","MF","22",1997,23.5,91,45,30,46,15,43,102,42.2,59,51,8,43,34,125,14,0,"https://fbref.com/en/players/c1b7847c/Konrad-Laimer"
"4630","Ademola Lookman_2020",2020,"RB Leipzig","Bundesliga","Ademola Lookman","NGA","FW,MF","21",1997,3.4,6,4,3,1,2,1,1,100,0,3,0,3,1,7,0,1,"https://fbref.com/en/players/7c104bb7/Ademola-Lookman"
"4631","Nordi Mukiele_2020",2020,"RB Leipzig","Bundesliga","Nordi Mukiele","FRA","DF,FW","21",1997,19.8,61,39,39,12,10,25,38,65.8,13,26,4,22,47,108,57,0,"https://fbref.com/en/players/ac73ec79/Nordi-Mukiele"
"4632","Yvon Mvogo_2020",2020,"RB Leipzig","Bundesliga","Yvon Mvogo","SUI","GK","25",1994,2,0,0,0,0,0,0,0,NA,0,0,0,0,0,0,0,1,"https://fbref.com/en/players/dc29b608/Yvon-Mvogo"
"4633","Christopher Nkunku_2020",2020,"RB Leipzig","Bundesliga","Christopher Nkunku","FRA","MF,FW","21",1997,21.4,21,13,4,11,6,9,33,27.3,24,25,2,23,20,41,8,0,"https://fbref.com/en/players/7c56da38/Christopher-Nkunku"
"4634","Dani Olmo_2020",2020,"RB Leipzig","Bundesliga","Dani Olmo","ESP","MF,FW","21",1998,8.3,20,14,5,10,5,1,13,7.7,12,7,1,6,4,24,6,0,"https://fbref.com/en/players/ae44e8e2/Dani-Olmo"
"4635","Willi Orban_2020",2020,"RB Leipzig","Bundesliga","Willi Orban","HUN","DF","26",1992,9.5,20,12,13,7,0,12,20,60,8,14,3,11,16,36,52,1,"https://fbref.com/en/players/20030c06/Willi-Orban"
"4636","Yussuf Poulsen_2020",2020,"RB Leipzig","Bundesliga","Yussuf Poulsen","DEN","FW","25",1994,13.6,14,10,2,10,2,4,21,19,17,12,0,12,4,18,15,0,"https://fbref.com/en/players/d2416c2e/Yussuf-Poulsen"
"4637","Marcel Sabitzer_2020",2020,"RB Leipzig","Bundesliga","Marcel Sabitzer","AUT","MF,FW","25",1994,27.8,39,25,15,18,6,19,56,33.9,37,27,4,23,23,62,25,0,"https://fbref.com/en/players/e280527c/Marcel-Sabitzer"
"4638","Marcelo Saracchi_2020",2020,"RB Leipzig","Bundesliga","Marcelo Saracchi","URU","DF","21",1998,2,8,6,2,5,1,5,6,83.3,1,3,1,2,1,9,5,0,"https://fbref.com/en/players/1c96ad85/Marcelo-Saracchi"
"4639","Patrik Schick_2020",2020,"RB Leipzig","Bundesliga","Patrik Schick","CZE","FW","23",1996,14.4,7,3,1,3,3,2,9,22.2,7,8,2,6,2,9,17,0,"https://fbref.com/en/players/5d4f7d61/Patrik-Schick"
"4640","Dayot Upamecano_2020",2020,"RB Leipzig","Bundesliga","Dayot Upamecano","FRA","DF","20",1998,26.2,52,31,37,15,0,23,43,53.5,20,31,17,14,43,95,88,1,"https://fbref.com/en/players/d248cd8f/Dayot-Upamecano"
"4641","Timo Werner_2020",2020,"RB Leipzig","Bundesliga","Timo Werner","GER","FW","23",1996,31.1,20,9,6,7,7,3,16,18.8,13,16,0,16,5,25,2,0,"https://fbref.com/en/players/49fe9070/Timo-Werner"
"4642","Hannes Wolf_2020",2020,"RB Leipzig","Bundesliga","Hannes Wolf","AUT","FW,MF","20",1999,0.6,3,0,0,1,2,1,4,25,3,0,0,0,0,3,0,0,"https://fbref.com/en/players/be42a291/Hannes-Wolf"
"4643","Alphonse Areola_2020",2020,"Real Madrid","La Liga","Alphonse Areola","FRA","GK","26",1993,4,0,0,0,0,0,0,0,NA,0,0,0,0,0,0,0,0,"https://fbref.com/en/players/2f965a72/Alphonse-Areola"
"4644","Marco Asensio_2020",2020,"Real Madrid","La Liga","Marco Asensio","ESP","FW","23",1996,3.7,4,3,3,1,0,1,4,25,3,2,0,2,1,5,4,0,"https://fbref.com/en/players/45af8a54/Marco-Asensio"
"4645","Gareth Bale_2020",2020,"Real Madrid","La Liga","Gareth Bale","WAL","FW,MF","30",1989,12.1,9,5,5,2,2,3,14,21.4,11,8,2,6,6,15,9,0,"https://fbref.com/en/players/a58bb1e1/Gareth-Bale"
"4646","Karim Benzema_2020",2020,"Real Madrid","La Liga","Karim Benzema","FRA","FW","31",1987,34.9,18,8,3,11,4,2,16,12.5,14,16,4,12,7,25,30,1,"https://fbref.com/en/players/70d74ece/Karim-Benzema"
"4647","Dani Carvajal_2020",2020,"Real Madrid","La Liga","Dani Carvajal","ESP","DF","27",1992,30.4,65,46,33,25,7,23,42,54.8,19,43,14,29,36,101,53,0,"https://fbref.com/en/players/4958bfb2/Dani-Carvajal"
"4648","Casemiro_2020",2020,"Real Madrid","La Liga","Casemiro","BRA","MF","27",1992,34.3,96,60,43,45,8,39,99,39.4,60,53,10,43,68,164,72,0,"https://fbref.com/en/players/4d224fe8/Casemiro"
"4649","Thibaut Courtois_2020",2020,"Real Madrid","La Liga","Thibaut Courtois","BEL","GK","27",1992,34,0,0,0,0,0,0,2,0,2,0,0,0,2,2,18,2,"https://fbref.com/en/players/1840e36d/Thibaut-Courtois"
"4650","Brahim Díaz_2020",2020,"Real Madrid","La Liga","Brahim Díaz","ESP","FW","19",1999,0.7,1,0,0,1,0,0,2,0,2,2,0,2,0,1,0,0,"https://fbref.com/en/players/407feb71/Brahim-Diaz"
"4651","Eden Hazard_2020",2020,"Real Madrid","La Liga","Eden Hazard","BEL","FW,MF","28",1991,12,7,3,2,3,2,3,15,20,12,5,0,5,6,13,0,0,"https://fbref.com/en/players/a39bb753/Eden-Hazard"
"4652","Isco_2020",2020,"Real Madrid","La Liga","Isco","ESP","FW,MF","27",1992,13.1,13,9,2,10,1,5,14,35.7,9,9,0,9,7,20,4,1,"https://fbref.com/en/players/a0b4bb3e/Isco"
"4653","Luka Jović_2020",2020,"Real Madrid","La Liga","Luka Jović","SRB","FW","21",1997,4.8,2,1,0,0,2,1,2,50,1,1,0,1,2,4,0,0,"https://fbref.com/en/players/4d8cd038/Luka-Jovic"
"4654","Vinicius Júnior_2020",2020,"Real Madrid","La Liga","Vinicius Júnior","BRA","FW,MF","19",2000,15.2,26,16,13,8,5,8,32,25,24,14,0,14,3,29,2,0,"https://fbref.com/en/players/7111d552/Vinicius-Junior"
"4655","Toni Kroos_2020",2020,"Real Madrid","La Liga","Toni Kroos","GER","MF","29",1990,29.5,56,28,18,29,9,18,70,25.7,52,27,0,27,23,79,15,0,"https://fbref.com/en/players/6ce1f46f/Toni-Kroos"
"4656","Marcelo_2020",2020,"Real Madrid","La Liga","Marcelo","BRA","DF","31",1988,14.4,19,11,8,8,3,9,28,32.1,19,19,2,17,18,37,21,0,"https://fbref.com/en/players/603116a7/Marcelo"
"4657","Mariano_2020",2020,"Real Madrid","La Liga","Mariano","DOM","FW,MF","25",1993,0.5,0,0,0,0,0,0,1,0,1,0,0,0,0,0,0,0,"https://fbref.com/en/players/5c4dc0ff/Mariano"
"4658","Ferland Mendy_2020",2020,"Real Madrid","La Liga","Ferland Mendy","FRA","DF","24",1995,20.1,32,26,20,9,3,14,18,77.8,4,19,5,14,22,54,30,1,"https://fbref.com/en/players/3cefcaef/Ferland-Mendy"
"4659","Éder Militão_2020",2020,"Real Madrid","La Liga","Éder Militão","BRA","DF","21",1998,11.4,25,15,15,9,1,10,17,58.8,7,12,6,6,20,45,42,0,"https://fbref.com/en/players/2784f898/Eder-Militao"
"4660","Luka Modrić_2020",2020,"Real Madrid","La Liga","Luka Modrić","CRO","MF","33",1985,22.2,37,18,9,15,13,16,41,39,25,10,2,8,22,59,12,0,"https://fbref.com/en/players/6025fab1/Luka-Modric"
"4661","Nacho_2020",2020,"Real Madrid","La Liga","Nacho","ESP","DF","29",1990,4.9,11,6,6,3,2,6,10,60,4,5,3,2,12,23,18,1,"https://fbref.com/en/players/2946f9a1/Nacho"
"4662","Álvaro Odriozola_2020",2020,"Real Madrid","La Liga","Álvaro Odriozola","ESP","DF","23",1995,3.8,5,2,4,0,1,5,8,62.5,3,4,0,4,2,7,8,0,"https://fbref.com/en/players/1d1691ad/Alvaro-Odriozola"
"4663","Sergio Ramos_2020",2020,"Real Madrid","La Liga","Sergio Ramos","ESP","DF","33",1986,33.5,46,31,26,17,3,20,42,47.6,22,22,9,13,49,95,102,4,"https://fbref.com/en/players/08511d65/Sergio-Ramos"
"4664","James Rodríguez_2020",2020,"Real Madrid","La Liga","James Rodríguez","COL","MF,FW","28",1991,4.7,17,13,6,8,3,6,12,50,6,3,0,3,3,20,1,0,"https://fbref.com/en/players/715bf047/James-Rodriguez"
"4665","Rodrygo_2020",2020,"Real Madrid","La Liga","Rodrygo","BRA","FW","18",2001,11.3,6,1,2,3,1,2,21,9.5,19,13,0,13,10,16,5,0,"https://fbref.com/en/players/8f5e92a6/Rodrygo"
"4666","Federico Valverde_2020",2020,"Real Madrid","La Liga","Federico Valverde","URU","MF","21",1998,21.2,38,19,9,19,10,12,36,33.3,24,38,4,34,21,59,12,2,"https://fbref.com/en/players/0959c2a2/Federico-Valverde"
"4667","Raphaël Varane_2020",2020,"Real Madrid","La Liga","Raphaël Varane","FRA","DF","26",1993,31.4,30,17,15,14,1,12,23,52.2,11,32,16,16,31,61,124,0,"https://fbref.com/en/players/9f8e9423/Raphael-Varane"
"4668","Lucas Vázquez_2020",2020,"Real Madrid","La Liga","Lucas Vázquez","ESP","MF,FW","28",1991,9.4,23,17,10,13,0,11,26,42.3,15,10,0,10,10,33,8,1,"https://fbref.com/en/players/fd51b456/Lucas-Vazquez"
"4669","Miguel Ángel Moyá_2020",2020,"Real Sociedad","La Liga","Miguel Ángel Moyá","ESP","GK","35",1984,13,0,0,0,0,0,0,1,0,1,0,0,0,1,1,6,2,"https://fbref.com/en/players/011d8c56/Miguel-Angel-Moya"
"4670","Ander Barrenetxea_2020",2020,"Real Sociedad","La Liga","Ander Barrenetxea","ESP","FW,MF","17",2001,4.9,12,9,5,5,2,4,10,40,6,3,0,3,3,15,4,0,"https://fbref.com/en/players/200e89e1/Ander-Barrenetxea"
"4671","Naïs Djouahra_2020",2020,"Real Sociedad","La Liga","Naïs Djouahra","FRA","FW","19",1999,0.3,0,0,0,0,0,0,0,NA,0,0,0,0,0,0,0,0,"https://fbref.com/en/players/3594a357/Nais-Djouahra"
"4672","Aritz Elustondo_2020",2020,"Real Sociedad","La Liga","Aritz Elustondo","ESP","DF","25",1994,16.8,28,17,19,8,1,13,23,56.5,10,21,8,13,15,43,67,0,"https://fbref.com/en/players/f7dc2ae5/Aritz-Elustondo"
"4673","Andoni Gorosabel_2020",2020,"Real Sociedad","La Liga","Andoni Gorosabel","ESP","DF","22",1996,7.9,14,8,9,3,2,10,20,50,10,13,1,12,13,27,21,0,"https://fbref.com/en/players/6f5f82c0/Andoni-Gorosabel"
"4674","Ander Guevara_2020",2020,"Real Sociedad","La Liga","Ander Guevara","ESP","MF","22",1997,10.4,27,11,9,17,1,12,30,40,18,13,3,10,8,35,15,1,"https://fbref.com/en/players/8e48dc61/Ander-Guevara"
"4675","Asier Illarramendi_2020",2020,"Real Sociedad","La Liga","Asier Illarramendi","ESP","MF","29",1990,2.4,2,2,1,0,1,2,6,33.3,4,2,1,1,5,7,6,0,"https://fbref.com/en/players/5ce0b5ba/Asier-Illarramendi"
"4676","Alexander Isak_2020",2020,"Real Sociedad","La Liga","Alexander Isak","SWE","FW","19",1999,16.7,7,2,0,3,4,1,8,12.5,7,8,0,8,3,10,6,0,"https://fbref.com/en/players/8e92be30/Alexander-Isak"
"4677","Adnan Januzaj_2020",2020,"Real Sociedad","La Liga","Adnan Januzaj","BEL","FW,MF","24",1995,13,8,7,3,2,3,3,16,18.8,13,9,1,8,7,15,2,0,"https://fbref.com/en/players/4737cebe/Adnan-Januzaj"
"4678","Willian José_2020",2020,"Real Sociedad","La Liga","Willian José","BRA","FW","27",1991,22.3,5,2,0,4,1,2,8,25,6,10,4,6,1,6,16,0,"https://fbref.com/en/players/d87e2cae/Willian-Jose"
"4679","Robin Le Normand_2020",2020,"Real Sociedad","La Liga","Robin Le Normand","ESP","DF","22",1996,26.6,48,27,33,15,0,26,35,74.3,9,20,7,13,20,68,99,0,"https://fbref.com/en/players/9a64e67e/Robin-Le-Normand"
"4680","Diego Llorente_2020",2020,"Real Sociedad","La Liga","Diego Llorente","ESP","DF","25",1993,25.9,30,14,20,9,1,16,28,57.1,12,14,7,7,28,58,101,5,"https://fbref.com/en/players/bba30585/Diego-Llorente"
"4681","Roberto López_2020",2020,"Real Sociedad","La Liga","Roberto López","ESP","FW,MF","19",2000,0.6,4,2,1,1,2,2,2,100,0,0,0,0,0,4,0,0,"https://fbref.com/en/players/2a8c9f98/Roberto-Lopez"
"4682","Mikel Merino_2020",2020,"Real Sociedad","La Liga","Mikel Merino","ESP","MF","23",1996,34.9,79,52,20,44,15,28,86,32.6,58,46,8,38,51,130,52,0,"https://fbref.com/en/players/d080ed5e/Mikel-Merino"
"4683","Nacho Monreal_2020",2020,"Real Sociedad","La Liga","Nacho Monreal","ESP","DF","33",1986,26.6,38,16,26,9,3,22,42,52.4,20,20,4,16,43,81,66,0,"https://fbref.com/en/players/d4cb83cc/Nacho-Monreal"
"4684","Aihen Muñoz_2020",2020,"Real Sociedad","La Liga","Aihen Muñoz","ESP","DF","21",1997,10.9,28,18,13,12,3,18,27,66.7,9,13,2,11,2,30,19,0,"https://fbref.com/en/players/228b0d9d/Aihen-Munoz"
"4685","Mikel Oyarzabal_2020",2020,"Real Sociedad","La Liga","Mikel Oyarzabal","ESP","FW,MF","22",1997,33.9,36,15,13,15,8,16,46,34.8,30,32,2,30,13,49,19,1,"https://fbref.com/en/players/8c3c640c/Mikel-Oyarzabal"
"4686","Jon Pacheco_2020",2020,"Real Sociedad","La Liga","Jon Pacheco","ESP","DF","18",2001,0.9,0,0,0,0,0,0,0,NA,0,1,0,1,0,0,2,0,"https://fbref.com/en/players/44150beb/Jon-Pacheco"
"4687","Portu_2020",2020,"Real Sociedad","La Liga","Portu","ESP","FW,MF","27",1992,26.6,32,21,10,15,7,13,33,39.4,20,28,3,25,13,45,5,0,"https://fbref.com/en/players/1bda5842/Portu"
"4688","Álex Remiro_2020",2020,"Real Sociedad","La Liga","Álex Remiro","ESP","GK","24",1995,25,0,0,0,0,0,0,1,0,1,0,0,0,0,0,25,1,"https://fbref.com/en/players/374ee424/Alex-Remiro"
"4689","Kévin Rodrigues_2020",2020,"Real Sociedad","La Liga","Kévin Rodrigues","POR","DF","25",1994,0.1,1,0,1,0,0,1,1,100,0,0,0,0,0,1,0,0,"https://fbref.com/en/players/f1bed920/Kevin-Rodrigues"
"4690","Luca Sangalli_2020",2020,"Real Sociedad","La Liga","Luca Sangalli","ESP","MF","24",1995,4.1,1,0,0,1,0,1,8,12.5,7,3,0,3,1,2,0,0,"https://fbref.com/en/players/7958dc65/Luca-Sangalli"
"4691","Joseba Zaldúa_2020",2020,"Real Sociedad","La Liga","Joseba Zaldúa","ESP","DF","27",1992,28.3,62,43,39,18,5,31,59,52.5,28,31,7,24,37,99,71,0,"https://fbref.com/en/players/5ca20b7a/Joseba-Zaldua"
"4692","Igor Zubeldia_2020",2020,"Real Sociedad","La Liga","Igor Zubeldia","ESP","MF,DF","22",1997,29.3,42,21,18,19,5,17,35,48.6,18,38,21,17,26,68,82,2,"https://fbref.com/en/players/5c7845f6/Igor-Zubeldia"
"4693","Martín Zubimendi_2020",2020,"Real Sociedad","La Liga","Martín Zubimendi","ESP","MF","20",1999,5.8,16,12,9,7,0,6,12,50,6,7,0,7,9,25,2,0,"https://fbref.com/en/players/3ee0dd59/Martin-Zubimendi"
"4694","David Zurutuza_2020",2020,"Real Sociedad","La Liga","David Zurutuza","ESP","MF","33",1986,1.7,4,3,0,3,1,1,2,50,1,1,0,1,4,8,3,0,"https://fbref.com/en/players/d9bda115/David-Zurutuza"
"4695","Martin Ødegaard_2020",2020,"Real Sociedad","La Liga","Martin Ødegaard","NOR","MF","20",1998,28.1,27,19,5,14,8,7,34,20.6,27,13,0,13,17,44,5,0,"https://fbref.com/en/players/79300479/Martin-Odegaard"
"4696","Yunis Abdelhamid_2020",2020,"Reims","Ligue 1","Yunis Abdelhamid","MAR","DF","31",1987,28,46,33,29,15,2,17,30,56.7,13,26,14,12,47,93,99,1,"https://fbref.com/en/players/32c2d95f/Yunis-Abdelhamid"
"4697","El Bilal Touré_2020",2020,"Reims","Ligue 1","El Bilal Touré","MLI","FW","17",2001,5,3,3,1,0,2,0,0,NA,0,6,0,6,1,4,1,0,"https://fbref.com/en/players/47c609d5/El-Bilal-Toure"
"4698","Mathieu Cafaro_2020",2020,"Reims","Ligue 1","Mathieu Cafaro","FRA","FW,MF","22",1997,10.3,12,6,5,5,2,6,17,35.3,11,13,0,13,2,14,0,0,"https://fbref.com/en/players/2a657da0/Mathieu-Cafaro"
"4699","Moreto Cassamã_2020",2020,"Reims","Ligue 1","Moreto Cassamã","GNB","MF","21",1998,6.6,17,11,2,13,2,5,7,71.4,2,7,2,5,5,22,6,0,"https://fbref.com/en/players/f54d2149/Moreto-Cassama"
"4700","Xavier Chavalerin_2020",2020,"Reims","Ligue 1","Xavier Chavalerin","FRA","MF","28",1991,23.9,71,52,29,33,9,19,49,38.8,30,23,8,15,36,107,36,0,"https://fbref.com/en/players/279ddf6a/Xavier-Chavalerin"
"4701","Boulaye Dia_2020",2020,"Reims","Ligue 1","Boulaye Dia","SEN","FW","22",1996,20.1,15,9,7,6,2,3,10,30,7,9,2,7,7,22,16,0,"https://fbref.com/en/players/244bc2c8/Boulaye-Dia"
"4702","Tristan Dingomé_2020",2020,"Reims","Ligue 1","Tristan Dingomé","CMR","MF","28",1991,9.9,10,4,3,6,1,2,12,16.7,10,6,0,6,6,16,1,0,"https://fbref.com/en/players/92b56413/Tristan-Dingome"
"4703","Axel Disasi_2020",2020,"Reims","Ligue 1","Axel Disasi","FRA","DF","21",1998,27,32,21,18,13,1,17,27,63,10,29,24,5,26,58,97,0,"https://fbref.com/en/players/ad82197c/Axel-Disasi"
"4704","Anastasios Donis_2020",2020,"Reims","Ligue 1","Anastasios Donis","GRE","FW","22",1996,6.8,3,2,2,1,0,1,9,11.1,8,2,0,2,1,4,3,0,"https://fbref.com/en/players/0f26fd24/Anastasios-Donis"
"4705","Moussa Doumbia_2020",2020,"Reims","Ligue 1","Moussa Doumbia","MLI","FW,MF","24",1994,19.1,16,8,5,6,5,7,24,29.2,17,14,1,13,9,25,5,0,"https://fbref.com/en/players/6481421d/Moussa-Doumbia"
"4706","Thomas Foket_2020",2020,"Reims","Ligue 1","Thomas Foket","BEL","DF","24",1994,27,61,36,31,23,7,30,48,62.5,18,15,4,11,39,100,59,1,"https://fbref.com/en/players/90eb507d/Thomas-Foket"
"4707","Suk Hyun-jun_2020",2020,"Reims","Ligue 1","Suk Hyun-jun","KOR","FW,MF","28",1991,2.9,3,3,1,1,1,1,2,50,1,1,0,1,1,4,2,0,"https://fbref.com/en/players/7ffaf233/Suk-Hyun-jun"
"4708","Hassane Kamara_2020",2020,"Reims","Ligue 1","Hassane Kamara","CIV","DF,FW","25",1994,19,58,47,40,14,4,24,35,68.6,11,17,2,15,58,116,58,0,"https://fbref.com/en/players/19a12bed/Hassane-Kamara"
"4709","Ghislain Konan_2020",2020,"Reims","Ligue 1","Ghislain Konan","CIV","DF","23",1995,14.8,43,26,28,14,1,19,28,67.9,9,13,3,10,24,67,34,0,"https://fbref.com/en/players/6b2c894b/Ghislain-Konan"
"4710","Dereck Kutesa_2020",2020,"Reims","Ligue 1","Dereck Kutesa","SUI","FW,MF","21",1997,5.9,6,5,3,2,1,3,9,33.3,6,5,0,5,1,7,1,0,"https://fbref.com/en/players/1b6862e8/Dereck-Kutesa"
"4711","Nicolas Lemaître_2020",2020,"Reims","Ligue 1","Nicolas Lemaître","FRA","GK","22",1997,1,0,0,0,0,0,0,1,0,1,0,0,0,1,1,1,1,"https://fbref.com/en/players/586ef3a3/Nicolas-Lemaitre"
"4712","Dario Maresic_2020",2020,"Reims","Ligue 1","Dario Maresic","AUT","DF","19",1999,1,0,0,0,0,0,0,0,NA,0,1,1,0,1,1,6,0,"https://fbref.com/en/players/5d93ccee/Dario-Maresic"
"4713","Nathanael Mbuku_2020",2020,"Reims","Ligue 1","Nathanael Mbuku","FRA","FW,MF","17",2002,4.4,4,2,2,2,0,0,3,0,3,0,0,0,2,6,1,0,"https://fbref.com/en/players/46750e9c/Nathanael-Mbuku"
"4714","Marshall Munetsi_2020",2020,"Reims","Ligue 1","Marshall Munetsi","ZIM","MF","23",1996,9.3,27,19,12,12,3,6,12,50,6,13,7,6,12,39,20,1,"https://fbref.com/en/players/2acf0cd7/Marshall-Munetsi"
"4715","Timothée Nkada_2020",2020,"Reims","Ligue 1","Timothée Nkada","FRA","FW","20",1999,1.6,1,0,1,0,0,0,1,0,1,0,0,0,0,1,1,0,"https://fbref.com/en/players/80d1adb3/Timothee-Nkada"
"4716","Remi Oudin_2020",2020,"Reims","Ligue 1","Remi Oudin","FRA","FW,MF","22",1996,15.5,15,7,8,5,2,6,19,31.6,13,16,1,15,18,33,18,1,"https://fbref.com/en/players/ea02beaf/Remi-Oudin"
"4717","Predrag Rajković_2020",2020,"Reims","Ligue 1","Predrag Rajković","SRB","GK","23",1995,27,1,1,1,0,0,1,1,100,0,0,0,0,1,2,9,0,"https://fbref.com/en/players/58ad9383/Predrag-Rajkovic"
"4718","Alaixys Romao_2020",2020,"Reims","Ligue 1","Alaixys Romao","TOG","MF","35",1984,19.8,46,29,31,14,1,17,57,29.8,40,12,3,9,26,72,38,3,"https://fbref.com/en/players/0aa874f4/Alaixys-Romao"
"4719","Kaj Sierhuis_2020",2020,"Reims","Ligue 1","Kaj Sierhuis","NED","FW","21",1998,0.1,0,0,0,0,0,0,0,NA,0,0,0,0,0,0,0,0,"https://fbref.com/en/players/9c2b1f11/Kaj-Sierhuis"
"4720","Sambou Sissoko_2020",2020,"Reims","Ligue 1","Sambou Sissoko","FRA","MF,FW","20",1999,0.4,0,0,0,0,0,0,0,NA,0,0,0,0,1,1,2,0,"https://fbref.com/en/players/e4bb1f08/Sambou-Sissoko"
"4721","Arber Zeneli_2020",2020,"Reims","Ligue 1","Arber Zeneli","KVX","MF","24",1995,0.1,0,0,0,0,0,0,0,NA,0,0,0,0,0,0,0,0,"https://fbref.com/en/players/095e4199/Arber-Zeneli"
"4722","Sacha Boey_2020",2020,"Rennes","Ligue 1","Sacha Boey","FRA","DF","18",2000,1.9,6,4,3,1,2,4,8,50,4,0,0,0,2,8,5,0,"https://fbref.com/en/players/6c8ddd52/Sacha-Boey"
"4723","Benjamin Bourigeaud_2020",2020,"Rennes","Ligue 1","Benjamin Bourigeaud","FRA","MF","25",1994,21.1,40,12,18,20,2,17,68,25,51,38,7,31,20,60,25,0,"https://fbref.com/en/players/20e73fac/Benjamin-Bourigeaud"
"4724","Eduardo Camavinga_2020",2020,"Rennes","Ligue 1","Eduardo Camavinga","FRA","MF","16",2002,23.4,105,64,45,56,4,48,96,50,48,26,8,18,34,139,35,0,"https://fbref.com/en/players/7b9c2d84/Eduardo-Camavinga"
"4725","Lucas Da Cunha_2020",2020,"Rennes","Ligue 1","Lucas Da Cunha","FRA","MF","18",2001,0.8,1,0,1,0,0,1,1,100,0,0,0,0,0,1,0,0,"https://fbref.com/en/players/007faf7a/Lucas-Da-Cunha"
"4726","Damien Da Silva_2020",2020,"Rennes","Ligue 1","Damien Da Silva","FRA","DF","31",1988,24.9,27,14,20,5,2,10,19,52.6,9,21,13,8,26,53,143,1,"https://fbref.com/en/players/1ec7e1c5/Damien-Da-Silva"
"4727","Romain Del Castillo_2020",2020,"Rennes","Ligue 1","Romain Del Castillo","FRA","FW,MF","23",1996,13.8,20,14,5,11,4,6,27,22.2,21,12,2,10,7,27,7,0,"https://fbref.com/en/players/0be95d34/Romain-Del-Castillo"
"4728","Souleyman Doumbia_2020",2020,"Rennes","Ligue 1","Souleyman Doumbia","CIV","DF","22",1996,1,1,1,1,0,0,1,1,100,0,2,2,0,0,1,3,0,"https://fbref.com/en/players/9daeac61/Souleyman-Doumbia"
"4729","Yann Gboho_2020",2020,"Rennes","Ligue 1","Yann Gboho","FRA","FW","18",2001,2.5,2,2,1,0,1,0,2,0,2,1,0,1,1,3,0,0,"https://fbref.com/en/players/6be41a31/Yann-Gboho"
"4730","Jérémy Gélin_2020",2020,"Rennes","Ligue 1","Jérémy Gélin","FRA","DF,MF","22",1997,10.3,14,5,10,2,2,8,13,61.5,5,14,7,7,15,29,33,1,"https://fbref.com/en/players/4c700f46/Jeremy-Gelin"
"4731","Joris Gnagnon_2020",2020,"Rennes","Ligue 1","Joris Gnagnon","FRA","DF","22",1997,14.2,16,13,14,2,0,10,11,90.9,1,21,17,4,18,34,61,0,"https://fbref.com/en/players/1232e1dc/Joris-Gnagnon"
"4732","Clément Grenier_2020",2020,"Rennes","Ligue 1","Clément Grenier","FRA","MF","28",1991,9.3,21,12,6,15,0,11,40,27.5,29,7,2,5,7,28,16,0,"https://fbref.com/en/players/8b298f56/Clement-Grenier"
"4733","Rafik Guitane_2020",2020,"Rennes","Ligue 1","Rafik Guitane","FRA","MF","20",1999,0.2,0,0,0,0,0,0,0,NA,0,0,0,0,0,0,0,0,"https://fbref.com/en/players/7091324a/Rafik-Guitane"
"4734","Adrien Hunou_2020",2020,"Rennes","Ligue 1","Adrien Hunou","FRA","FW,MF","25",1994,13.4,21,18,5,11,5,4,21,19,17,16,1,15,5,26,5,0,"https://fbref.com/en/players/d14229f3/Adrien-Hunou"
"4735","James Lea Siliki_2020",2020,"Rennes","Ligue 1","James Lea Siliki","CMR","MF","23",1996,12,28,16,19,9,0,16,29,55.2,13,15,4,11,12,40,12,0,"https://fbref.com/en/players/7cf431a5/James-Lea-Siliki"
"4736","Faitout Maouassa_2020",2020,"Rennes","Ligue 1","Faitout Maouassa","FRA","DF","21",1998,20,51,33,27,20,4,14,26,53.8,12,13,5,8,23,74,59,0,"https://fbref.com/en/players/e54a9890/Faitout-Maouassa"
"4737","Jonas Martin_2020",2020,"Rennes","Ligue 1","Jonas Martin","FRA","MF","29",1990,1.3,6,2,4,0,2,1,1,100,0,2,2,0,0,6,0,0,"https://fbref.com/en/players/468fdbad/Jonas-Martin"
"4738","Edouard Mendy_2020",2020,"Rennes","Ligue 1","Edouard Mendy","SEN","GK","27",1992,24,0,0,0,0,0,0,0,NA,0,0,0,0,0,0,5,1,"https://fbref.com/en/players/33887998/Edouard-Mendy"
"4739","Jérémy Morel_2020",2020,"Rennes","Ligue 1","Jérémy Morel","MAD","DF","35",1984,20.1,15,9,13,1,1,9,20,45,11,21,17,4,17,32,59,1,"https://fbref.com/en/players/e97150c0/Jeremy-Morel"
"4740","M'Baye Niang_2020",2020,"Rennes","Ligue 1","M'Baye Niang","SEN","FW","24",1994,23.6,17,10,3,11,3,6,21,28.6,15,10,1,9,5,22,20,0,"https://fbref.com/en/players/2054d037/MBaye-Niang"
"4741","Gerzino Nyamsi_2020",2020,"Rennes","Ligue 1","Gerzino Nyamsi","FRA","DF","22",1997,1.3,1,0,1,0,0,0,0,NA,0,1,0,1,1,2,5,0,"https://fbref.com/en/players/6043997c/Gerzino-Nyamsi"
"4742","Steven Nzonzi_2020",2020,"Rennes","Ligue 1","Steven Nzonzi","FRA","MF","30",1988,4.3,5,4,3,1,1,1,2,50,1,2,2,0,4,9,18,0,"https://fbref.com/en/players/c7526c18/Steven-Nzonzi"
"4743","Jordan Pefok_2020",2020,"Rennes","Ligue 1","Jordan Pefok","USA","FW","23",1996,4.9,7,6,1,4,2,0,2,0,2,3,0,3,1,8,2,0,"https://fbref.com/en/players/b684a484/Jordan-Pefok"
"4744","Raphinha_2020",2020,"Rennes","Ligue 1","Raphinha","BRA","MF,FW","22",1996,18.8,22,18,5,12,5,10,32,31.3,22,23,1,22,17,39,14,1,"https://fbref.com/en/players/3423f250/Raphinha"
"4745","Romain Salin_2020",2020,"Rennes","Ligue 1","Romain Salin","FRA","GK","35",1984,4,0,0,0,0,0,0,1,0,1,0,0,0,0,0,3,0,"https://fbref.com/en/players/74733221/Romain-Salin"
"4746","Flavien Tait_2020",2020,"Rennes","Ligue 1","Flavien Tait","FRA","MF,FW","26",1993,9.8,20,13,12,6,2,9,28,32.1,19,7,0,7,9,29,5,1,"https://fbref.com/en/players/a0f9b535/Flavien-Tait"
"4747","Hamari Traoré_2020",2020,"Rennes","Ligue 1","Hamari Traoré","MLI","DF","27",1992,26.8,55,26,34,18,3,32,64,50,32,22,5,17,48,103,59,1,"https://fbref.com/en/players/a4b1028a/Hamari-Traore"
"4748","Mirko Antonucci_2020",2020,"Roma","Serie A","Mirko Antonucci","ITA","FW,MF","20",1999,0.9,4,3,1,0,3,3,3,100,0,2,0,2,2,6,1,0,"https://fbref.com/en/players/91976866/Mirko-Antonucci"
"4749","Riccardo Calafiori_2020",2020,"Roma","Serie A","Riccardo Calafiori","ITA","DF","17",2002,0.7,0,0,0,0,0,0,1,0,1,0,0,0,2,2,0,0,"https://fbref.com/en/players/aded8e6f/Riccardo-Calafiori"
"4750","Bryan Cristante_2020",2020,"Roma","Serie A","Bryan Cristante","ITA","MF","24",1995,18,25,15,6,14,5,8,27,29.6,19,13,4,9,22,47,23,0,"https://fbref.com/en/players/16657b95/Bryan-Cristante"
"4751","Amadou Diawara_2020",2020,"Roma","Serie A","Amadou Diawara","GUI","MF","22",1997,16.9,40,25,14,20,6,8,30,26.7,22,10,1,9,33,73,16,2,"https://fbref.com/en/players/bf309d24/Amadou-Diawara"
"4752","Edin Džeko_2020",2020,"Roma","Serie A","Edin Džeko","BIH","FW","33",1986,31.7,16,11,2,7,7,2,13,15.4,11,11,4,7,6,22,33,0,"https://fbref.com/en/players/3bb7f478/Edin-Dzeko"
"4753","Federico Fazio_2020",2020,"Roma","Serie A","Federico Fazio","ARG","DF","32",1987,13.5,19,11,12,6,1,6,11,54.5,5,8,6,2,19,38,52,0,"https://fbref.com/en/players/4e358a2d/Federico-Fazio"
"4754","Alessandro Florenzi_2020",2020,"Roma","Serie A","Alessandro Florenzi","ITA","DF,FW","28",1991,11.1,14,11,8,4,2,7,20,35,13,9,3,6,16,30,19,0,"https://fbref.com/en/players/e288d4b3/Alessandro-Florenzi"
"4755","Daniel Fuzato_2020",2020,"Roma","Serie A","Daniel Fuzato","BRA","GK","22",1997,1,0,0,0,0,0,0,0,NA,0,0,0,0,0,0,0,0,"https://fbref.com/en/players/82328faf/Daniel-Fuzato"
"4756","Roger Ibanez_2020",2020,"Roma","Serie A","Roger Ibanez","BRA","DF","20",1998,6.8,11,8,6,3,2,5,7,71.4,2,9,6,3,18,29,21,1,"https://fbref.com/en/players/82efe6fa/Roger-Ibanez"
"4757","Juan Jesus_2020",2020,"Roma","Serie A","Juan Jesus","BRA","DF","28",1991,1.5,2,1,2,0,0,0,3,0,3,1,0,1,1,3,7,0,"https://fbref.com/en/players/79083382/Juan-Jesus"
"4758","Nikola Kalinić_2020",2020,"Roma","Serie A","Nikola Kalinić","CRO","FW","31",1988,6.3,2,1,0,2,0,0,0,NA,0,2,0,2,1,3,1,0,"https://fbref.com/en/players/d4931a5a/Nikola-Kalinic"
"4759","Justin Kluivert_2020",2020,"Roma","Serie A","Justin Kluivert","NED","FW","20",1999,16.8,17,11,4,8,5,7,16,43.8,9,15,0,15,6,23,7,0,"https://fbref.com/en/players/4c3a6744/Justin-Kluivert"
"4760","Aleksandar Kolarov_2020",2020,"Roma","Serie A","Aleksandar Kolarov","SRB","DF","33",1985,30.4,37,28,16,16,5,20,37,54.1,17,20,9,11,31,68,57,0,"https://fbref.com/en/players/eda40760/Aleksandar-Kolarov"
"4761","Pau López_2020",2020,"Roma","Serie A","Pau López","ESP","GK","24",1994,32,1,0,1,0,0,1,5,20,4,0,0,0,1,2,10,3,"https://fbref.com/en/players/20b9f052/Pau-Lopez"
"4762","Gianluca Mancini_2020",2020,"Roma","Serie A","Gianluca Mancini","ITA","DF,MF","23",1996,30.4,49,26,26,18,5,22,44,50,22,32,15,17,60,109,98,1,"https://fbref.com/en/players/5aa53281/Gianluca-Mancini"
"4763","Yıldırım Mert Çetin_2020",2020,"Roma","Serie A","Yıldırım Mert Çetin","TUR","DF","22",1997,2.9,5,1,4,1,0,3,5,60,2,4,3,1,4,9,8,1,"https://fbref.com/en/players/c730da00/Yildirim-Mert-Cetin"
"4764","Antonio Mirante_2020",2020,"Roma","Serie A","Antonio Mirante","ITA","GK","36",1983,5,0,0,0,0,0,0,1,0,1,0,0,0,0,0,2,1,"https://fbref.com/en/players/30223b33/Antonio-Mirante"
"4765","Henrikh Mkhitaryan_2020",2020,"Roma","Serie A","Henrikh Mkhitaryan","ARM","MF,FW","30",1989,17,32,22,10,17,5,19,45,42.2,26,27,3,24,11,43,6,0,"https://fbref.com/en/players/dd0daf32/Henrikh-Mkhitaryan"
"4766","Javier Pastore_2020",2020,"Roma","Serie A","Javier Pastore","ARG","MF","30",1989,5.7,14,10,3,5,6,5,12,41.7,7,4,0,4,5,19,5,0,"https://fbref.com/en/players/881ef58c/Javier-Pastore"
"4767","Lorenzo Pellegrini_2020",2020,"Roma","Serie A","Lorenzo Pellegrini","ITA","MF","23",1996,23.3,30,13,9,13,8,12,33,36.4,21,28,0,28,15,45,18,0,"https://fbref.com/en/players/4a5a45c7/Lorenzo-Pellegrini"
"4768","Bruno Peres_2020",2020,"Roma","Serie A","Bruno Peres","BRA","DF","29",1990,11.7,14,10,10,3,1,8,21,38.1,13,12,3,9,15,29,19,2,"https://fbref.com/en/players/852351df/Bruno-Peres"
"4769","Carles Pérez_2020",2020,"Roma","Serie A","Carles Pérez","ESP","FW,MF","21",1998,6.3,12,8,4,6,2,3,10,30,7,6,1,5,3,15,1,0,"https://fbref.com/en/players/a8f21b9f/Carles-Perez"
"4770","Diego Perotti_2020",2020,"Roma","Serie A","Diego Perotti","ARG","FW,MF","31",1988,9.7,16,13,5,8,3,5,20,25,15,14,0,14,3,19,6,0,"https://fbref.com/en/players/a40d5a0c/Diego-Perotti"
"4771","Davide Santon_2020",2020,"Roma","Serie A","Davide Santon","ITA","DF","28",1991,6.9,11,6,6,5,0,6,17,35.3,11,2,1,1,11,22,13,0,"https://fbref.com/en/players/88c89891/Davide-Santon"
"4772","Chris Smalling_2020",2020,"Roma","Serie A","Chris Smalling","ENG","DF","29",1989,28.5,25,16,15,9,1,10,13,76.9,3,44,35,9,56,81,126,2,"https://fbref.com/en/players/b6964eb6/Chris-Smalling"
"4773","Leonardo Spinazzola_2020",2020,"Roma","Serie A","Leonardo Spinazzola","ITA","DF","26",1993,17.2,24,12,11,8,5,12,21,57.1,9,13,5,8,20,44,41,0,"https://fbref.com/en/players/3626daea/Leonardo-Spinazzola"
"4774","Cengiz Ünder_2020",2020,"Roma","Serie A","Cengiz Ünder","TUR","FW","22",1997,9.7,10,6,4,4,2,2,9,22.2,7,7,2,5,8,18,7,0,"https://fbref.com/en/players/1880614f/Cengiz-Under"
"4775","Jordan Veretout_2020",2020,"Roma","Serie A","Jordan Veretout","FRA","MF","26",1993,29.2,36,18,13,16,7,14,43,32.6,29,35,5,30,18,54,31,1,"https://fbref.com/en/players/4a56052c/Jordan-Veretout"
"4776","Gonzalo Villar_2020",2020,"Roma","Serie A","Gonzalo Villar","ESP","MF","21",1998,3.3,5,3,4,0,1,2,4,50,2,2,0,2,2,7,3,0,"https://fbref.com/en/players/bdc74a8f/Gonzalo-Villar"
"4777","Nicolò Zaniolo_2020",2020,"Roma","Serie A","Nicolò Zaniolo","ITA","FW,MF","20",1999,16.7,15,11,4,7,4,3,24,12.5,21,14,0,14,5,20,5,0,"https://fbref.com/en/players/9907b1c8/Nicolo-Zaniolo"
"4778","Davide Zappacosta_2020",2020,"Roma","Serie A","Davide Zappacosta","ITA","DF","27",1992,5,7,3,2,3,2,4,8,50,4,3,1,2,6,13,8,1,"https://fbref.com/en/players/7fe90ccd/Davide-Zappacosta"
"4779","Etrit Berisha_2020",2020,"SPAL","Serie A","Etrit Berisha","ALB","GK","30",1989,26,3,2,3,0,0,2,3,66.7,1,0,0,0,1,4,9,0,"https://fbref.com/en/players/ee833569/Etrit-Berisha"
"4780","Kevin Bonifazi_2020",2020,"SPAL","Serie A","Kevin Bonifazi","ITA","DF","23",1996,13.2,16,9,15,1,0,9,18,50,9,20,12,8,35,51,50,2,"https://fbref.com/en/players/fb77bfef/Kevin-Bonifazi"
"4781","Lucas Castro_2020",2020,"SPAL","Serie A","Lucas Castro","ARG","MF","30",1989,4.7,13,5,5,5,3,2,4,50,2,4,0,4,2,15,3,0,"https://fbref.com/en/players/56b2957b/Lucas-Castro"
"4782","Alberto Cerri_2020",2020,"SPAL","Serie A","Alberto Cerri","ITA","FW","23",1996,4.7,2,1,0,2,0,1,3,33.3,2,1,0,1,0,2,3,0,"https://fbref.com/en/players/1079c685/Alberto-Cerri"
"4783","Thiago Cionek_2020",2020,"SPAL","Serie A","Thiago Cionek","POL","DF","33",1986,24.1,53,32,36,12,5,22,53,41.5,31,30,11,19,46,99,91,2,"https://fbref.com/en/players/46f5c54d/Thiago-Cionek"
"4784","Jaume Cuéllar_2020",2020,"SPAL","Serie A","Jaume Cuéllar","BOL","MF,FW","17",2001,0.8,1,0,0,0,1,0,1,0,1,0,0,0,0,1,0,0,"https://fbref.com/en/players/934e264d/Jaume-Cuellar"
"4785","Marco D'Alessandro_2020",2020,"SPAL","Serie A","Marco D'Alessandro","ITA","MF,DF","28",1991,8.7,11,8,5,3,3,5,8,62.5,3,11,0,11,5,16,6,0,"https://fbref.com/en/players/060606ec/Marco-DAlessandro"
"4786","Bryan Dabo_2020",2020,"SPAL","Serie A","Bryan Dabo","BFA","MF","27",1992,12.5,18,10,13,4,1,5,15,33.3,10,13,2,11,9,27,14,0,"https://fbref.com/en/players/c53083ad/Bryan-Dabo"
"4787","Felipe dal Belo_2020",2020,"SPAL","Serie A","Felipe dal Belo","BRA","DF","35",1984,11.1,13,6,9,4,0,9,15,60,6,14,12,2,9,22,30,0,"https://fbref.com/en/players/8cea6319/Felipe-dal-Belo"
"4788","Federico Di Francesco_2020",2020,"SPAL","Serie A","Federico Di Francesco","ITA","FW","25",1994,12,11,5,2,6,3,3,15,20,12,9,1,8,3,14,2,1,"https://fbref.com/en/players/1fca9171/Federico-Di-Francesco"
"4789","Mohamed Fares_2020",2020,"SPAL","Serie A","Mohamed Fares","ALG","DF,MF","23",1996,4.7,6,4,3,2,1,2,10,20,8,5,3,2,5,11,8,0,"https://fbref.com/en/players/b7a5bc86/Mohamed-Fares"
"4790","Sergio Floccari_2020",2020,"SPAL","Serie A","Sergio Floccari","ITA","FW","37",1981,10.5,8,3,3,1,4,0,13,0,13,9,1,8,5,13,1,0,"https://fbref.com/en/players/df301450/Sergio-Floccari"
"4791","Krisztofer Horváth_2020",2020,"SPAL","Serie A","Krisztofer Horváth","HUN","FW,DF","17",2002,0.5,1,1,0,1,0,0,0,NA,0,0,0,0,0,1,0,0,"https://fbref.com/en/players/4ce8f4a3/Krisztofer-Horvath"
"4792","Igor_2020",2020,"SPAL","Serie A","Igor","BRA","DF","21",1998,14.9,24,16,13,10,1,14,20,70,6,17,9,8,24,48,37,1,"https://fbref.com/en/players/a4e85758/Igor"
"4793","Jakub Iskra_2020",2020,"SPAL","Serie A","Jakub Iskra","POL","DF","16",2002,0.9,0,0,0,0,0,0,0,NA,0,0,0,0,1,1,2,0,"https://fbref.com/en/players/103b7264/Jakub-Iskra"
"4794","Marko Janković_2020",2020,"SPAL","Serie A","Marko Janković","MNE","FW,DF","24",1995,1.3,2,1,0,0,2,1,2,50,1,2,1,1,0,2,0,0,"https://fbref.com/en/players/9866afec/Marko-Jankovic"
"4795","Jasmin Kurtić_2020",2020,"SPAL","Serie A","Jasmin Kurtić","SVN","MF","30",1989,15.7,20,7,8,8,4,6,27,22.2,21,14,2,12,10,30,20,1,"https://fbref.com/en/players/144607cc/Jasmin-Kurtic"
"4796","Karlo Letica_2020",2020,"SPAL","Serie A","Karlo Letica","CRO","GK","22",1997,10,0,0,0,0,0,0,2,0,2,0,0,0,0,0,4,3,"https://fbref.com/en/players/4a6914ff/Karlo-Letica"
"4797","Simone Missiroli_2020",2020,"SPAL","Serie A","Simone Missiroli","ITA","MF","33",1986,31.1,42,27,18,20,4,13,43,30.2,30,42,27,15,54,96,62,1,"https://fbref.com/en/players/331c0a43/Simone-Missiroli"
"4798","Gabriele Moncini_2020",2020,"SPAL","Serie A","Gabriele Moncini","ITA","FW,MF","23",1996,1.7,1,0,0,1,0,0,0,NA,0,2,1,1,1,2,0,0,"https://fbref.com/en/players/c4efe2b4/Gabriele-Moncini"
"4799","Alessandro Murgia_2020",2020,"SPAL","Serie A","Alessandro Murgia","ITA","MF","22",1996,19.4,27,17,16,8,3,14,34,41.2,20,10,3,7,18,45,15,0,"https://fbref.com/en/players/fb2c533b/Alessandro-Murgia"
"4800","Alberto Paloschi_2020",2020,"SPAL","Serie A","Alberto Paloschi","ITA","FW","29",1990,4.9,3,0,3,0,0,2,8,25,6,3,0,3,0,3,2,0,"https://fbref.com/en/players/b5cae4e6/Alberto-Paloschi"
"4801","Andrea Petagna_2020",2020,"SPAL","Serie A","Andrea Petagna","ITA","FW","24",1995,33.7,9,4,2,7,0,3,17,17.6,14,11,5,6,1,10,27,0,"https://fbref.com/en/players/03f946ed/Andrea-Petagna"
"4802","Arkadiusz Reca_2020",2020,"SPAL","Serie A","Arkadiusz Reca","POL","DF","24",1995,21.4,38,23,22,10,6,13,39,33.3,26,15,2,13,32,70,48,1,"https://fbref.com/en/players/6213fd82/Arkadiusz-Reca"
"4803","Jacopo Sala_2020",2020,"SPAL","Serie A","Jacopo Sala","ITA","DF","27",1991,9.5,29,24,17,11,1,17,31,54.8,14,4,0,4,13,42,15,1,"https://fbref.com/en/players/da5a981b/Jacopo-Sala"
"4804","Bartosz Salamon_2020",2020,"SPAL","Serie A","Bartosz Salamon","POL","DF","28",1991,3.8,2,1,2,0,0,1,2,50,1,4,4,0,6,8,14,0,"https://fbref.com/en/players/9b30df1e/Bartosz-Salamon"
"4805","Gabriel Strefezza_2020",2020,"SPAL","Serie A","Gabriel Strefezza","BRA","DF,MF","22",1997,23.4,64,40,28,26,10,22,54,40.7,32,29,3,26,21,85,17,0,"https://fbref.com/en/players/674cfc5a/Gabriel-Strefezza"
"4806","Demba Thiam_2020",2020,"SPAL","Serie A","Demba Thiam","SEN","GK","21",1998,2,0,0,0,0,0,0,0,NA,0,0,0,0,1,1,0,0,"https://fbref.com/en/players/0f47717b/Demba-Thiam"
"4807","Nenad Tomović_2020",2020,"SPAL","Serie A","Nenad Tomović","SRB","DF","31",1987,19.5,26,19,18,6,2,10,21,47.6,11,32,23,9,30,56,65,1,"https://fbref.com/en/players/6aafdc27/Nenad-Tomovic"
"4808","Georgi Tunjov_2020",2020,"SPAL","Serie A","Georgi Tunjov","EST","MF","18",2001,3.2,4,4,3,1,0,1,11,9.1,10,3,1,2,1,5,0,0,"https://fbref.com/en/players/7aa84ac5/Georgi-Tunjov"
"4809","Mirko Valdifiori_2020",2020,"SPAL","Serie A","Mirko Valdifiori","ITA","MF","33",1986,15.6,31,15,14,17,0,16,33,48.5,17,8,3,5,4,35,25,0,"https://fbref.com/en/players/c710f7d5/Mirko-Valdifiori"
"4810","Mattia Valoti_2020",2020,"SPAL","Serie A","Mattia Valoti","ITA","MF,FW","25",1993,17,48,30,21,25,2,16,43,37.2,27,27,6,21,16,64,18,0,"https://fbref.com/en/players/c414df9d/Mattia-Valoti"
"4811","Francesco Vicari_2020",2020,"SPAL","Serie A","Francesco Vicari","ITA","DF","24",1994,32.2,27,13,20,6,1,12,25,48,13,48,37,11,38,65,145,1,"https://fbref.com/en/players/de045b15/Francesco-Vicari"
"4812","Ervin Zukanović_2020",2020,"SPAL","Serie A","Ervin Zukanović","BIH","DF","32",1987,2.3,1,0,0,0,1,1,1,100,0,3,1,2,3,4,15,0,"https://fbref.com/en/players/1253a12e/Ervin-Zukanovic"
"4813","Charles Abi_2020",2020,"Saint-Étienne","Ligue 1","Charles Abi","FRA","FW","19",2000,6.9,9,9,2,5,2,2,7,28.6,5,2,0,2,4,13,4,0,"https://fbref.com/en/players/469d3d84/Charles-Abi"
"4814","Jean-Eudes Aholou_2020",2020,"Saint-Étienne","Ligue 1","Jean-Eudes Aholou","CIV","MF","25",1994,7,16,12,2,11,3,3,9,33.3,6,6,1,5,15,31,10,0,"https://fbref.com/en/players/48b28bfd/Jean-Eudes-Aholou"
"4815","Stefan Bajic_2020",2020,"Saint-Étienne","Ligue 1","Stefan Bajic","FRA","GK","17",2001,1,0,0,0,0,0,0,0,NA,0,1,0,1,0,0,2,0,"https://fbref.com/en/players/be13e5a8/Stefan-Bajic"
"4816","Bilal Benkhedim_2020",2020,"Saint-Étienne","Ligue 1","Bilal Benkhedim","FRA","MF,FW","18",2001,1.5,3,3,1,1,1,1,4,25,3,1,0,1,1,4,0,0,"https://fbref.com/en/players/b6047994/Bilal-Benkhedim"
"4817","Robert Berić_2020",2020,"Saint-Étienne","Ligue 1","Robert Berić","SVN","FW","28",1991,4.6,3,2,0,2,1,0,5,0,5,2,0,2,4,7,2,0,"https://fbref.com/en/players/9001138b/Robert-Beric"
"4818","Denis Bouanga_2020",2020,"Saint-Étienne","Ligue 1","Denis Bouanga","GAB","FW,MF","24",1994,22.7,45,34,10,25,10,20,55,36.4,35,30,0,30,10,55,15,0,"https://fbref.com/en/players/0b0cbe5b/Denis-Bouanga"
"4819","Ryad Boudebouz_2020",2020,"Saint-Étienne","Ligue 1","Ryad Boudebouz","ALG","MF,FW","29",1990,17.7,25,16,9,14,2,8,25,32,17,14,1,13,7,32,5,0,"https://fbref.com/en/players/1001ae82/Ryad-Boudebouz"
"4820","Yohan Cabaye_2020",2020,"Saint-Étienne","Ligue 1","Yohan Cabaye","FRA","MF","33",1986,9.5,29,18,11,14,4,14,25,56,11,10,0,10,22,51,7,1,"https://fbref.com/en/players/ad7b19ef/Yohan-Cabaye"
"4821","Mahdi Camara_2020",2020,"Saint-Étienne","Ligue 1","Mahdi Camara","FRA","MF","21",1998,10,33,20,12,16,5,18,32,56.3,14,20,2,18,18,51,5,0,"https://fbref.com/en/players/8577e60a/Mahdi-Camara"
"4822","Edmilson Correia_2020",2020,"Saint-Étienne","Ligue 1","Edmilson Correia","GNB","FW,DF","19",2000,0.5,0,0,0,0,0,0,1,0,1,1,0,1,1,1,0,0,"https://fbref.com/en/players/bc50c437/Edmilson-Correia"
"4823","Mathieu Debuchy_2020",2020,"Saint-Étienne","Ligue 1","Mathieu Debuchy","FRA","DF","34",1985,19.7,44,26,22,15,7,24,47,51.1,23,21,11,10,43,87,59,0,"https://fbref.com/en/players/92232aad/Mathieu-Debuchy"
"4824","Lois Diony_2020",2020,"Saint-Étienne","Ligue 1","Lois Diony","FRA","FW","26",1992,7.4,15,5,0,11,4,5,9,55.6,4,3,0,3,1,16,0,0,"https://fbref.com/en/players/4be0b467/Lois-Diony"
"4825","Assane Dioussé_2020",2020,"Saint-Étienne","Ligue 1","Assane Dioussé","SEN","MF","21",1997,1.3,1,1,0,1,0,0,3,0,3,0,0,0,0,1,2,0,"https://fbref.com/en/players/7f622eef/Assane-Diousse"
"4826","Wesley Fofana_2020",2020,"Saint-Étienne","Ligue 1","Wesley Fofana","FRA","DF","18",2000,13.5,25,15,16,9,0,12,18,66.7,6,10,5,5,36,61,55,4,"https://fbref.com/en/players/132a82f1/Wesley-Fofana"
"4827","Romain Hamouma_2020",2020,"Saint-Étienne","Ligue 1","Romain Hamouma","FRA","FW,MF","32",1987,9.6,12,9,1,5,6,2,12,16.7,10,12,0,12,0,12,4,0,"https://fbref.com/en/players/0b4d8274/Romain-Hamouma"
"4828","Franck Honorat_2020",2020,"Saint-Étienne","Ligue 1","Franck Honorat","FRA","FW,DF","22",1996,9.4,16,11,7,8,1,8,23,34.8,15,12,1,11,5,21,13,1,"https://fbref.com/en/players/db7849ca/Franck-Honorat"
"4829","Wahbi Khazri_2020",2020,"Saint-Étienne","Ligue 1","Wahbi Khazri","TUN","FW,MF","28",1991,12.8,17,9,5,7,5,9,27,33.3,18,11,0,11,4,21,0,0,"https://fbref.com/en/players/2677a1de/Wahbi-Khazri"
"4830","Timothée Kolodziejczak_2020",2020,"Saint-Étienne","Ligue 1","Timothée Kolodziejczak","FRA","DF","27",1991,14.5,17,10,13,4,0,9,21,42.9,12,8,3,5,30,47,44,2,"https://fbref.com/en/players/ab096c6f/Timothee-Kolodziejczak"
"4831","Yann M'Vila_2020",2020,"Saint-Étienne","Ligue 1","Yann M'Vila","FRA","MF,DF","29",1990,21.6,29,14,12,16,1,12,43,27.9,31,14,4,10,40,69,47,1,"https://fbref.com/en/players/d4133fa1/Yann-MVila"
"4832","Yvann Macon_2020",2020,"Saint-Étienne","Ligue 1","Yvann Macon","FRA","DF","20",1998,1.1,0,0,0,0,0,0,1,0,1,2,0,2,3,3,4,0,"https://fbref.com/en/players/0bb6e193/Yvann-Macon"
"4833","Harold Moukoudi_2020",2020,"Saint-Étienne","Ligue 1","Harold Moukoudi","CMR","DF","21",1997,11,28,19,20,7,1,11,14,78.6,3,16,10,6,16,44,42,2,"https://fbref.com/en/players/5f26e0c5/Harold-Moukoudi"
"4834","Jessy Moulin_2020",2020,"Saint-Étienne","Ligue 1","Jessy Moulin","FRA","GK","33",1986,5,0,0,0,0,0,0,0,NA,0,0,0,0,1,1,2,0,"https://fbref.com/en/players/28a65a2c/Jessy-Moulin"
"4835","Arnaud Nordin_2020",2020,"Saint-Étienne","Ligue 1","Arnaud Nordin","FRA","FW,MF","21",1998,10.1,7,3,3,3,1,4,13,30.8,9,11,1,10,4,11,6,0,"https://fbref.com/en/players/7b9a9e25/Arnaud-Nordin"
"4836","Sergi Palencia_2020",2020,"Saint-Étienne","Ligue 1","Sergi Palencia","ESP","DF","23",1996,5.2,16,10,6,10,0,5,7,71.4,2,6,1,5,8,24,4,0,"https://fbref.com/en/players/19f8e480/Sergi-Palencia"
"4837","Loïc Perrin_2020",2020,"Saint-Étienne","Ligue 1","Loïc Perrin","FRA","DF","33",1985,19,27,20,16,11,0,11,14,78.6,3,23,17,6,39,66,59,0,"https://fbref.com/en/players/6b200d45/Loic-Perrin"
"4838","Maxence Rivera_2020",2020,"Saint-Étienne","Ligue 1","Maxence Rivera","FRA","MF,FW","17",2002,0.3,0,0,0,0,0,0,1,0,1,1,0,1,0,0,0,0,"https://fbref.com/en/players/46a7b605/Maxence-Rivera"
"4839","Stéphane Ruffier_2020",2020,"Saint-Étienne","Ligue 1","Stéphane Ruffier","FRA","GK","32",1986,22,0,0,0,0,0,0,0,NA,0,0,0,0,0,0,5,3,"https://fbref.com/en/players/cac76a72/Stephane-Ruffier"
"4840","William Saliba_2020",2020,"Saint-Étienne","Ligue 1","William Saliba","FRA","DF","18",2001,11,19,9,15,3,1,5,10,50,5,13,4,9,21,40,36,1,"https://fbref.com/en/players/972aeb2a/William-Saliba"
"4841","Gabriel Silva_2020",2020,"Saint-Étienne","Ligue 1","Gabriel Silva","BRA","DF","28",1991,2.6,4,1,1,2,1,2,3,66.7,1,2,0,2,4,8,8,0,"https://fbref.com/en/players/4914ed4a/Gabriel-Silva"
"4842","Miguel Trauco_2020",2020,"Saint-Étienne","Ligue 1","Miguel Trauco","PER","DF","26",1992,16.4,32,20,16,12,4,19,44,43.2,25,8,1,7,23,55,25,0,"https://fbref.com/en/players/e4b72e34/Miguel-Trauco"
"4843","Zaydou Youssouf_2020",2020,"Saint-Étienne","Ligue 1","Zaydou Youssouf","FRA","MF","20",1999,12,40,22,12,26,2,15,35,42.9,20,7,1,6,16,56,13,0,"https://fbref.com/en/players/e2f9bb5f/Zaydou-Youssouf"
"4844","Kristoffer Askildsen_2020",2020,"Sampdoria","Serie A","Kristoffer Askildsen","NOR","MF","18",2001,0.8,1,1,1,0,0,0,0,NA,0,1,0,1,1,2,0,0,"https://fbref.com/en/players/a69cc629/Kristoffer-Askildsen"
"4845","Emil Audero_2020",2020,"Sampdoria","Serie A","Emil Audero","ITA","GK","22",1997,36,1,1,1,0,0,1,3,33.3,2,0,0,0,0,1,21,1,"https://fbref.com/en/players/649b01d8/Emil-Audero"
"4846","Tommaso Augello_2020",2020,"Sampdoria","Serie A","Tommaso Augello","ITA","DF","24",1994,12.6,14,9,6,3,5,5,7,71.4,2,8,0,8,15,29,21,1,"https://fbref.com/en/players/3cd3b384/Tommaso-Augello"
"4847","Édgar Barreto_2020",2020,"Sampdoria","Serie A","Édgar Barreto","PAR","MF","35",1984,1,4,3,0,1,3,2,3,66.7,1,1,0,1,0,4,0,0,"https://fbref.com/en/players/43a1bea5/Edgar-Barreto"
"4848","Bartosz Bereszyński_2020",2020,"Sampdoria","Serie A","Bartosz Bereszyński","POL","DF","27",1992,26.7,53,35,25,23,5,26,52,50,26,38,16,22,35,88,88,1,"https://fbref.com/en/players/61b3978f/Bartosz-Bereszynski"
"4849","Andrea Bertolacci_2020",2020,"Sampdoria","Serie A","Andrea Bertolacci","ITA","MF","28",1991,5.9,7,4,2,3,2,1,8,12.5,7,4,1,3,2,9,13,0,"https://fbref.com/en/players/c75b6a02/Andrea-Bertolacci"
"4850","Federico Bonazzoli_2020",2020,"Sampdoria","Serie A","Federico Bonazzoli","ITA","FW","22",1997,8.3,7,5,1,4,2,0,7,0,7,3,0,3,5,12,2,0,"https://fbref.com/en/players/bf57eaab/Federico-Bonazzoli"
"4851","Gianluca Caprari_2020",2020,"Sampdoria","Serie A","Gianluca Caprari","ITA","FW,MF","26",1993,7.4,9,7,1,6,2,4,13,30.8,9,5,0,5,7,16,1,0,"https://fbref.com/en/players/54e53b7e/Gianluca-Caprari"
"4852","Julian Chabot_2020",2020,"Sampdoria","Serie A","Julian Chabot","GER","DF","21",1998,6.3,11,7,6,5,0,6,11,54.5,5,3,2,1,15,26,26,0,"https://fbref.com/en/players/ae7058f9/Julian-Chabot"
"4853","Omar Colley_2020",2020,"Sampdoria","Serie A","Omar Colley","GAM","DF","26",1992,30.8,42,26,27,14,1,12,24,50,12,33,22,11,59,101,155,1,"https://fbref.com/en/players/8b95acda/Omar-Colley"
"4854","Felice D'Amico_2020",2020,"Sampdoria","Serie A","Felice D'Amico","ITA","MF","18",2000,0,1,1,0,0,1,0,0,NA,0,0,0,0,0,1,0,0,"https://fbref.com/en/players/0c35d28d/Felice-DAmico"
"4855","Fabio Depaoli_2020",2020,"Sampdoria","Serie A","Fabio Depaoli","ITA","MF,DF","22",1997,20.6,41,28,26,10,5,17,31,54.8,14,29,3,26,16,57,39,0,"https://fbref.com/en/players/d97f2e8d/Fabio-Depaoli"
"4856","Albin Ekdal_2020",2020,"Sampdoria","Serie A","Albin Ekdal","SWE","MF","30",1989,26.5,51,25,18,31,2,24,68,35.3,44,35,14,21,33,84,46,1,"https://fbref.com/en/players/f503ea63/Albin-Ekdal"
"4857","Wladimiro Falcone_2020",2020,"Sampdoria","Serie A","Wladimiro Falcone","ITA","GK","24",1995,2,0,0,0,0,0,0,0,NA,0,0,0,0,0,0,0,0,"https://fbref.com/en/players/9f5a610b/Wladimiro-Falcone"
"4858","Alex Ferrari_2020",2020,"Sampdoria","Serie A","Alex Ferrari","ITA","DF","25",1994,11.2,18,13,13,5,0,7,12,58.3,5,13,8,5,12,30,31,0,"https://fbref.com/en/players/d0dbca9f/Alex-Ferrari"
"4859","Manolo Gabbiadini_2020",2020,"Sampdoria","Serie A","Manolo Gabbiadini","ITA","FW","27",1991,22.6,9,7,2,3,4,1,7,14.3,6,12,0,12,10,19,11,0,"https://fbref.com/en/players/8f866fe8/Manolo-Gabbiadini"
"4860","Jakub Jankto_2020",2020,"Sampdoria","Serie A","Jakub Jankto","CZE","MF,FW","23",1996,23.3,27,13,14,10,3,10,42,23.8,32,30,3,27,22,49,22,0,"https://fbref.com/en/players/1ea5f91c/Jakub-Jankto"
"4861","Antonino La Gumina_2020",2020,"Sampdoria","Serie A","Antonino La Gumina","ITA","FW","23",1996,2.1,0,0,0,0,0,0,0,NA,0,0,0,0,0,0,1,0,"https://fbref.com/en/players/822a7761/Antonino-La-Gumina"
"4862","Mehdi Léris_2020",2020,"Sampdoria","Serie A","Mehdi Léris","ALG","MF,FW","21",1998,5.7,13,11,4,2,7,7,19,36.8,12,12,4,8,6,19,6,0,"https://fbref.com/en/players/7d3cbc67/Mehdi-Leris"
"4863","Karol Linetty_2020",2020,"Sampdoria","Serie A","Karol Linetty","POL","MF","24",1995,22.4,61,32,24,25,12,21,65,32.3,44,26,3,23,26,87,17,0,"https://fbref.com/en/players/d023d70f/Karol-Linetty"
"4864","Gonzalo Maroni_2020",2020,"Sampdoria","Serie A","Gonzalo Maroni","ARG","MF,FW","20",1999,2,3,1,1,1,1,3,7,42.9,4,1,0,1,3,6,0,0,"https://fbref.com/en/players/e01ca8f4/Gonzalo-Maroni"
"4865","Jeison Murillo_2020",2020,"Sampdoria","Serie A","Jeison Murillo","COL","DF","27",1992,7.4,18,6,14,4,0,10,19,52.6,9,8,4,4,10,28,28,0,"https://fbref.com/en/players/b233e8e4/Jeison-Murillo"
"4866","Nicola Murru_2020",2020,"Sampdoria","Serie A","Nicola Murru","ITA","DF","24",1994,25.1,40,22,24,8,8,21,41,51.2,20,22,4,18,27,67,58,0,"https://fbref.com/en/players/d183e9d6/Nicola-Murru"
"4867","Fabio Quagliarella_2020",2020,"Sampdoria","Serie A","Fabio Quagliarella","ITA","FW","36",1983,25.3,9,5,0,6,3,2,30,6.7,28,13,0,13,8,17,15,0,"https://fbref.com/en/players/ee4f2f3b/Fabio-Quagliarella"
"4868","Gastón Ramírez_2020",2020,"Sampdoria","Serie A","Gastón Ramírez","URU","MF,FW","28",1990,15.5,32,21,7,16,9,8,30,26.7,22,28,2,26,11,43,10,0,"https://fbref.com/en/players/2c851997/Gaston-Ramirez"
"4869","Vasco Regini_2020",2020,"Sampdoria","Serie A","Vasco Regini","ITA","DF","28",1990,1.9,4,2,3,1,0,0,0,NA,0,4,2,2,1,5,6,0,"https://fbref.com/en/players/339c6ed4/Vasco-Regini"
"4870","Emiliano Rigoni_2020",2020,"Sampdoria","Serie A","Emiliano Rigoni","ARG","MF,FW","26",1993,4.8,5,4,2,1,2,3,10,30,7,5,1,4,3,8,1,0,"https://fbref.com/en/players/a1216563/Emiliano-Rigoni"
"4871","Morten Thorsby_2020",2020,"Sampdoria","Serie A","Morten Thorsby","NOR","MF,DF","23",1996,20.7,53,34,17,23,13,27,52,51.9,25,24,6,18,17,70,34,0,"https://fbref.com/en/players/d1b49282/Morten-Thorsby"
"4872","Lorenzo Tonelli_2020",2020,"Sampdoria","Serie A","Lorenzo Tonelli","ITA","DF","29",1990,7.8,13,9,13,0,0,4,10,40,6,10,7,3,4,17,23,0,"https://fbref.com/en/players/8cc29864/Lorenzo-Tonelli"
"4873","Ronaldo Vieira_2020",2020,"Sampdoria","Serie A","Ronaldo Vieira","GNB","MF","21",1998,20.2,NA,21,NA,NA,NA,NA,NA,NA,NA,NA,NA,NA,22,NA,NA,NA,"https://fbref.com/en/players/75e60d75/Ronaldo-Vieira"
"4874","Maya Yoshida_2020",2020,"Sampdoria","Serie A","Maya Yoshida","JPN","DF","30",1988,13.2,4,3,2,2,0,2,6,33.3,4,15,12,3,27,31,72,0,"https://fbref.com/en/players/caffaf5a/Maya-Yoshida"
"4875","Domenico Berardi_2020",2020,"Sassuolo","Serie A","Domenico Berardi","ITA","FW","24",1994,27.7,32,16,19,8,5,13,59,22,46,31,3,28,33,65,27,0,"https://fbref.com/en/players/53a0e358/Domenico-Berardi"
"4876","Jeremie Boga_2020",2020,"Sassuolo","Serie A","Jeremie Boga","CIV","FW","22",1997,27.9,12,7,3,8,1,6,20,30,14,24,0,24,3,15,4,0,"https://fbref.com/en/players/fe012aca/Jeremie-Boga"
"4877","Mehdi Bourabia_2020",2020,"Sassuolo","Serie A","Mehdi Bourabia","MAR","MF","27",1991,10.3,19,9,8,10,1,9,22,40.9,13,12,2,10,22,41,23,0,"https://fbref.com/en/players/0d077b88/Mehdi-Bourabia"
"4878","Francesco Caputo_2020",2020,"Sassuolo","Serie A","Francesco Caputo","ITA","FW","31",1987,32.6,7,4,3,2,2,3,11,27.3,8,15,0,15,1,8,8,0,"https://fbref.com/en/players/5bd72174/Francesco-Caputo"
"4879","Vlad Chiricheș_2020",2020,"Sassuolo","Serie A","Vlad Chiricheș","ROU","DF","29",1989,7.9,14,9,12,2,0,7,10,70,3,13,8,5,11,25,28,2,"https://fbref.com/en/players/c316607a/Vlad-Chiriches"
"4880","Andrea Consigli_2020",2020,"Sassuolo","Serie A","Andrea Consigli","ITA","GK","32",1987,31,0,0,0,0,0,0,1,0,1,0,0,0,4,4,19,2,"https://fbref.com/en/players/8cabdc1e/Andrea-Consigli"
"4881","Grégoire Defrel_2020",2020,"Sassuolo","Serie A","Grégoire Defrel","MTQ","FW,MF","28",1991,10.9,12,8,4,6,2,4,15,26.7,11,9,0,9,3,15,5,0,"https://fbref.com/en/players/854ee61a/Gregoire-Defrel"
"4882","Alfred Duncan_2020",2020,"Sassuolo","Serie A","Alfred Duncan","GHA","MF","26",1993,9.4,19,12,8,7,4,6,16,37.5,10,7,0,7,9,28,13,0,"https://fbref.com/en/players/528492ea/Alfred-Duncan"
"4883","Andrea Ghion_2020",2020,"Sassuolo","Serie A","Andrea Ghion","ITA","FW,MF","19",2000,0.5,3,1,1,2,0,1,1,100,0,0,0,0,0,3,0,0,"https://fbref.com/en/players/7f24b3eb/Andrea-Ghion"
"4884","Lukáš Haraslín_2020",2020,"Sassuolo","Serie A","Lukáš Haraslín","SVK","FW","23",1996,4.3,5,2,1,3,1,2,9,22.2,7,5,0,5,4,9,1,0,"https://fbref.com/en/players/5c397195/Lukas-Haraslin"
"4885","Hamed Junior Traorè_2020",2020,"Sassuolo","Serie A","Hamed Junior Traorè","CIV","MF,FW","19",2000,17.4,31,15,10,15,6,14,39,35.9,25,22,1,21,11,42,7,0,"https://fbref.com/en/players/570bb4b9/Hamed-Junior-Traore"
"4886","Giorgos Kyriakopoulos_2020",2020,"Sassuolo","Serie A","Giorgos Kyriakopoulos","GRE","DF","23",1996,18.3,35,18,22,7,6,18,32,56.3,14,19,6,13,18,53,41,0,"https://fbref.com/en/players/0a483542/Giorgos-Kyriakopoulos"
"4887","Manuel Locatelli_2020",2020,"Sassuolo","Serie A","Manuel Locatelli","ITA","MF","21",1998,28.7,76,50,35,37,4,33,69,47.8,36,42,14,28,33,109,36,0,"https://fbref.com/en/players/a8a874f1/Manuel-Locatelli"
"4888","Francesco Magnanelli_2020",2020,"Sassuolo","Serie A","Francesco Magnanelli","ITA","MF","34",1984,15.5,25,13,9,12,4,11,35,31.4,24,12,6,6,19,44,23,1,"https://fbref.com/en/players/07767f42/Francesco-Magnanelli"
"4889","Giangiacomo Magnani_2020",2020,"Sassuolo","Serie A","Giangiacomo Magnani","ITA","DF","23",1995,1.6,0,0,0,0,0,0,0,NA,0,2,1,1,2,2,7,0,"https://fbref.com/en/players/cce9f582/Giangiacomo-Magnani"
"4890","Giacomo Manzari_2020",2020,"Sassuolo","Serie A","Giacomo Manzari","ITA","FW,MF","18",2000,0.2,0,0,0,0,0,0,0,NA,0,0,0,0,0,0,0,0,"https://fbref.com/en/players/d8dfae8a/Giacomo-Manzari"
"4891","Gian Marco Ferrari_2020",2020,"Sassuolo","Serie A","Gian Marco Ferrari","ITA","DF","27",1992,21.1,9,5,6,3,0,4,8,50,4,25,22,3,26,35,41,1,"https://fbref.com/en/players/8650af85/Gian-Marco-Ferrari"
"4892","Marlon_2020",2020,"Sassuolo","Serie A","Marlon","BRA","DF","23",1995,20.2,40,23,24,15,1,17,27,63,10,20,13,7,35,75,69,0,"https://fbref.com/en/players/cdf65d12/Marlon"
"4893","Luca Mazzitelli_2020",2020,"Sassuolo","Serie A","Luca Mazzitelli","ITA","MF","23",1995,0.1,1,1,0,1,0,1,1,100,0,0,0,0,0,1,0,0,"https://fbref.com/en/players/dc61b402/Luca-Mazzitelli"
"4894","Mert Müldür_2020",2020,"Sassuolo","Serie A","Mert Müldür","TUR","DF","20",1999,14.1,47,27,33,8,6,27,42,64.3,15,10,0,10,22,69,42,0,"https://fbref.com/en/players/1295552e/Mert-Muldur"
"4895","Pedro Obiang_2020",2020,"Sassuolo","Serie A","Pedro Obiang","EQG","MF","27",1992,18.6,46,31,21,19,6,19,40,47.5,21,24,10,14,21,67,31,1,"https://fbref.com/en/players/ba1e04b3/Pedro-Obiang"
"4896","Gianluca Pegolo_2020",2020,"Sassuolo","Serie A","Gianluca Pegolo","ITA","GK","38",1981,5,0,0,0,0,0,0,0,NA,0,0,0,0,0,0,4,0,"https://fbref.com/en/players/f058ed1f/Gianluca-Pegolo"
"4897","Federico Peluso_2020",2020,"Sassuolo","Serie A","Federico Peluso","ITA","DF","35",1984,16.8,19,16,8,8,3,8,9,88.9,1,14,9,5,22,41,58,1,"https://fbref.com/en/players/4f2908e5/Federico-Peluso"
"4898","Stefano Piccinini_2020",2020,"Sassuolo","Serie A","Stefano Piccinini","ITA","DF","16",2002,0.1,0,0,0,0,0,0,0,NA,0,0,0,0,0,0,0,0,"https://fbref.com/en/players/6010ba04/Stefano-Piccinini"
"4899","Giacomo Raspadori_2020",2020,"Sassuolo","Serie A","Giacomo Raspadori","ITA","MF,FW","19",2000,2.9,8,6,5,2,1,3,4,75,1,5,0,5,1,9,0,0,"https://fbref.com/en/players/6e058f06/Giacomo-Raspadori"
"4900","Rogério_2020",2020,"Sassuolo","Serie A","Rogério","BRA","DF","21",1998,11.3,22,14,12,8,2,16,23,69.6,7,13,3,10,9,31,34,0,"https://fbref.com/en/players/10e7f486/Rogerio"
"4901","Filippo Romagna_2020",2020,"Sassuolo","Serie A","Filippo Romagna","ITA","DF","22",1997,16.4,7,6,2,5,0,5,6,83.3,1,24,17,7,10,17,69,0,"https://fbref.com/en/players/84594618/Filippo-Romagna"
"4902","Jeremy Toljan_2020",2020,"Sassuolo","Serie A","Jeremy Toljan","GER","DF","24",1994,24.3,37,21,24,10,3,18,35,51.4,17,23,12,11,18,55,58,1,"https://fbref.com/en/players/a96e5dc0/Jeremy-Toljan"
"4903","Alessandro Tripaldelli_2020",2020,"Sassuolo","Serie A","Alessandro Tripaldelli","ITA","DF","20",1999,1.5,4,4,1,3,0,1,3,33.3,2,1,0,1,3,7,3,0,"https://fbref.com/en/players/4571fa88/Alessandro-Tripaldelli"
"4904","Stefano Turati_2020",2020,"Sassuolo","Serie A","Stefano Turati","ITA","GK","17",2001,2,0,0,0,0,0,0,0,NA,0,0,0,0,0,0,1,0,"https://fbref.com/en/players/bf168004/Stefano-Turati"
"4905","Filip Đuričić_2020",2020,"Sassuolo","Serie A","Filip Đuričić","SRB","MF,FW","27",1992,18.1,23,14,2,10,11,3,19,15.8,16,20,3,17,8,31,14,0,"https://fbref.com/en/players/eccbe56a/Filip-Djuricic"
"4906","Timo Becker_2020",2020,"Schalke 04","Bundesliga","Timo Becker","GER","DF,MF","22",1997,3.7,10,9,3,6,1,5,9,55.6,4,6,1,5,3,13,8,0,"https://fbref.com/en/players/543ddcaf/Timo-Becker"
"4907","Nassim Boujellab_2020",2020,"Schalke 04","Bundesliga","Nassim Boujellab","MAR","MF,FW","20",1999,4.7,12,10,5,4,3,5,14,35.7,9,8,1,7,7,19,5,0,"https://fbref.com/en/players/541127d5/Nassim-Boujellab"
"4908","Can Bozdogan_2020",2020,"Schalke 04","Bundesliga","Can Bozdogan","GER","MF","18",2001,2.6,8,6,5,3,0,3,12,25,9,2,0,2,2,10,2,0,"https://fbref.com/en/players/b797f558/Can-Bozdogan"
"4909","Guido Burgstaller_2020",2020,"Schalke 04","Bundesliga","Guido Burgstaller","AUT","FW","30",1989,13.7,7,3,0,5,2,4,15,26.7,11,12,3,9,4,11,10,0,"https://fbref.com/en/players/2bcc6d52/Guido-Burgstaller"
"4910","Daniel Caligiuri_2020",2020,"Schalke 04","Bundesliga","Daniel Caligiuri","ITA","MF,FW","31",1988,25.5,58,37,18,25,15,27,74,36.5,47,67,6,61,25,83,39,0,"https://fbref.com/en/players/d1273f09/Daniel-Caligiuri"
"4911","Michael Gregoritsch_2020",2020,"Schalke 04","Bundesliga","Michael Gregoritsch","AUT","FW","25",1994,9.2,8,5,0,6,2,0,9,0,9,9,1,8,2,10,10,0,"https://fbref.com/en/players/8e235926/Michael-Gregoritsch"
"4912","Amine Harit_2020",2020,"Schalke 04","Bundesliga","Amine Harit","MAR","MF,FW","22",1997,23.4,16,7,8,5,3,6,25,24,19,13,0,13,7,23,2,1,"https://fbref.com/en/players/e7d59f4f/Amine-Harit"
"4913","Jonas Hofmann_2020",2020,"Schalke 04","Bundesliga","Jonas Hofmann","GER","MF","22",1997,0,0,0,0,0,0,0,0,NA,0,0,0,0,0,0,2,0,"https://fbref.com/en/players/9908c518/Jonas-Hofmann"
"4914","Ozan Kabak_2020",2020,"Schalke 04","Bundesliga","Ozan Kabak","TUR","DF","19",2000,19.7,37,23,28,9,0,14,21,66.7,7,33,19,14,37,74,97,0,"https://fbref.com/en/players/2d61d13a/Ozan-Kabak"
"4915","Jonjoe Kenny_2020",2020,"Schalke 04","Bundesliga","Jonjoe Kenny","ENG","DF","22",1997,30.2,49,29,24,19,6,26,51,51,25,45,10,35,26,75,79,0,"https://fbref.com/en/players/099e666f/Jonjoe-Kenny"
"4916","Ahmed Kutucu_2020",2020,"Schalke 04","Bundesliga","Ahmed Kutucu","TUR","FW,MF","19",2000,7.5,11,7,3,6,2,4,15,26.7,11,5,0,5,2,13,5,0,"https://fbref.com/en/players/beda9675/Ahmed-Kutucu"
"4917","Omar Mascarell_2020",2020,"Schalke 04","Bundesliga","Omar Mascarell","ESP","MF","26",1993,22.5,42,23,17,22,3,21,57,36.8,36,46,14,32,62,104,40,0,"https://fbref.com/en/players/11fd2b75/Omar-Mascarell"
"4918","Rabbi Matondo_2020",2020,"Schalke 04","Bundesliga","Rabbi Matondo","WAL","FW,MF","18",2000,12.9,10,3,3,2,5,3,13,23.1,10,4,0,4,5,15,1,0,"https://fbref.com/en/players/33144cc5/Rabbi-Matondo"
"4919","Weston McKennie_2020",2020,"Schalke 04","Bundesliga","Weston McKennie","USA","MF,DF","20",1998,23,38,20,17,16,5,13,40,32.5,27,38,12,26,46,84,39,0,"https://fbref.com/en/players/01c3aff5/Weston-McKennie"
"4920","Levent Mercan_2020",2020,"Schalke 04","Bundesliga","Levent Mercan","GER","MF,FW","18",2000,0.8,0,0,0,0,0,0,0,NA,0,0,0,0,0,0,2,1,"https://fbref.com/en/players/33340bd6/Levent-Mercan"
"4921","Juan Miranda_2020",2020,"Schalke 04","Bundesliga","Juan Miranda","ESP","DF","19",2000,8.7,14,10,8,6,0,6,18,33.3,12,12,4,8,10,24,27,1,"https://fbref.com/en/players/ead61f73/Juan-Miranda"
"4922","Matija Nastasić_2020",2020,"Schalke 04","Bundesliga","Matija Nastasić","SRB","DF","26",1993,15.2,26,16,17,9,0,14,17,82.4,3,28,16,12,22,48,79,0,"https://fbref.com/en/players/f35430a4/Matija-Nastasic"
"4923","Alexander Nübel_2020",2020,"Schalke 04","Bundesliga","Alexander Nübel","GER","GK","22",1996,25.7,0,0,0,0,0,0,0,NA,0,0,0,0,2,2,9,6,"https://fbref.com/en/players/afb0c500/Alexander-Nubel"
"4924","Bastian Oczipka_2020",2020,"Schalke 04","Bundesliga","Bastian Oczipka","GER","DF","30",1989,33.5,72,50,42,21,9,36,62,58.1,26,35,6,29,37,109,68,0,"https://fbref.com/en/players/d1661819/Bastian-Oczipka"
"4925","Benito Raman_2020",2020,"Schalke 04","Bundesliga","Benito Raman","BEL","FW","24",1994,17.8,18,9,4,9,5,7,24,29.2,17,11,1,10,7,25,1,0,"https://fbref.com/en/players/867501bf/Benito-Raman"
"4926","Fabian Reese_2020",2020,"Schalke 04","Bundesliga","Fabian Reese","GER","FW","21",1997,1,1,1,1,0,0,0,0,NA,0,1,1,0,0,1,1,0,"https://fbref.com/en/players/b1823b08/Fabian-Reese"
"4927","Salif Sané_2020",2020,"Schalke 04","Bundesliga","Salif Sané","SEN","DF","28",1990,12.5,16,9,12,4,0,11,19,57.9,8,19,7,12,21,37,50,0,"https://fbref.com/en/players/791abba1/Salif-Sane"
"4928","Alessandro Schöpf_2020",2020,"Schalke 04","Bundesliga","Alessandro Schöpf","AUT","MF","25",1994,15.9,29,16,11,10,8,12,33,36.4,21,17,1,16,26,55,8,0,"https://fbref.com/en/players/106bca06/Alessandro-Schopf"
"4929","Markus Schubert_2020",2020,"Schalke 04","Bundesliga","Markus Schubert","GER","GK","21",1998,8.2,0,0,0,0,0,0,1,0,1,0,0,0,0,0,9,4,"https://fbref.com/en/players/289b90cd/Markus-Schubert"
"4930","Suat Serdar_2020",2020,"Schalke 04","Bundesliga","Suat Serdar","GER","MF","22",1997,17.8,56,37,16,33,7,18,61,29.5,43,39,7,32,24,80,7,0,"https://fbref.com/en/players/b3325a30/Suat-Serdar"
"4931","Benjamin Stambouli_2020",2020,"Schalke 04","Bundesliga","Benjamin Stambouli","FRA","DF","28",1990,9,31,19,14,15,2,11,21,52.4,10,16,6,10,12,43,28,1,"https://fbref.com/en/players/5939baa2/Benjamin-Stambouli"
"4932","Malick Thiaw_2020",2020,"Schalke 04","Bundesliga","Malick Thiaw","GER","DF","17",2001,0.8,2,0,1,1,0,1,2,50,1,2,2,0,2,4,4,1,"https://fbref.com/en/players/ff5ea0bf/Malick-Thiaw"
"4933","Jean-Clair Todibo_2020",2020,"Schalke 04","Bundesliga","Jean-Clair Todibo","FRA","DF","19",1999,4.1,15,10,10,5,0,8,9,88.9,1,2,0,2,15,30,24,0,"https://fbref.com/en/players/88f130ed/Jean-Clair-Todibo"
"4934","Mark Uth_2020",2020,"Schalke 04","Bundesliga","Mark Uth","GER","FW,MF","27",1991,3.9,3,2,1,1,1,0,3,0,3,4,0,4,1,4,0,0,"https://fbref.com/en/players/a3ddb1b9/Mark-Uth"
"4935","Éver Banega_2020",2020,"Sevilla","La Liga","Éver Banega","ARG","MF","31",1988,27.5,43,28,16,18,9,21,70,30,49,19,1,18,15,58,5,0,"https://fbref.com/en/players/fa937f7a/Ever-Banega"
"4936","Yassine Bounou_2020",2020,"Sevilla","La Liga","Yassine Bounou","MAR","GK","28",1991,5.5,0,0,0,0,0,0,0,NA,0,0,0,0,0,0,0,0,"https://fbref.com/en/players/f6798fc3/Yassine-Bounou"
"4937","Diego Carlos_2020",2020,"Sevilla","La Liga","Diego Carlos","BRA","DF","26",1993,34.8,35,23,25,9,1,15,25,60,10,33,24,9,37,72,176,1,"https://fbref.com/en/players/b4a014b1/Diego-Carlos"
"4938","Daniel Carriço_2020",2020,"Sevilla","La Liga","Daniel Carriço","POR","DF","30",1988,9.4,8,2,4,3,1,1,6,16.7,5,4,3,1,8,16,23,0,"https://fbref.com/en/players/e1deea75/Daniel-Carrico"
"4939","Moanes Dabbur_2020",2020,"Sevilla","La Liga","Moanes Dabbur","ISR","FW","27",1992,0.3,1,1,0,0,1,0,0,NA,0,1,0,1,0,1,0,0,"https://fbref.com/en/players/eac044ad/Moanes-Dabbur"
"4940","Youssef En-Nesyri_2020",2020,"Sevilla","La Liga","Youssef En-Nesyri","MAR","FW","22",1997,8.8,7,5,1,6,0,3,10,30,7,9,3,6,5,12,7,0,"https://fbref.com/en/players/04e17fd5/Youssef-En-Nesyri"
"4941","Sergio Escudero_2020",2020,"Sevilla","La Liga","Sergio Escudero","ESP","DF","29",1989,8.6,29,16,17,10,2,19,28,67.9,9,11,1,10,13,42,35,0,"https://fbref.com/en/players/b0616e3d/Sergio-Escudero"
"4942","Fernando_2020",2020,"Sevilla","La Liga","Fernando","BRA","MF","32",1987,29.5,62,33,37,24,1,34,58,58.6,24,38,15,23,67,129,73,1,"https://fbref.com/en/players/41f32541/Fernando"
"4943","Bryan Gil_2020",2020,"Sevilla","La Liga","Bryan Gil","ESP","FW","18",2001,0.7,1,1,0,1,0,0,1,0,1,0,0,0,0,1,0,0,"https://fbref.com/en/players/7b5ab7f2/Bryan-Gil"
"4944","Sergi Gómez_2020",2020,"Sevilla","La Liga","Sergi Gómez","ESP","DF","27",1992,8,9,7,7,2,0,4,4,100,0,6,6,0,7,16,30,0,"https://fbref.com/en/players/bc6f5f06/Sergi-Gomez"
"4945","Nemanja Gudelj_2020",2020,"Sevilla","La Liga","Nemanja Gudelj","SRB","MF,DF","27",1991,13.5,20,14,11,8,1,6,19,31.6,13,17,8,9,12,32,35,1,"https://fbref.com/en/players/0076ab7f/Nemanja-Gudelj"
"4946","Munir El Haddadi_2020",2020,"Sevilla","La Liga","Munir El Haddadi","MAR","FW","23",1995,13.9,19,17,6,11,2,4,21,19,17,8,0,8,7,26,8,0,"https://fbref.com/en/players/8696bc90/Munir-El-Haddadi"
"4947","Javier Hernández_2020",2020,"Sevilla","La Liga","Javier Hernández","MEX","FW","31",1988,5,6,4,0,4,2,1,6,16.7,5,5,0,5,5,11,1,0,"https://fbref.com/en/players/189cee7b/Javier-Hernandez"
"4948","Luuk de Jong_2020",2020,"Sevilla","La Liga","Luuk de Jong","NED","FW","28",1990,22.9,21,10,4,8,9,6,17,35.3,11,12,1,11,7,28,22,0,"https://fbref.com/en/players/abb3bb95/Luuk-de-Jong"
"4949","Joan Jordán_2020",2020,"Sevilla","La Liga","Joan Jordán","ESP","MF","25",1994,25,64,34,27,31,6,21,76,27.6,55,25,5,20,26,90,20,4,"https://fbref.com/en/players/2a0c8ba4/Joan-Jordan"
"4950","Jules Koundé_2020",2020,"Sevilla","La Liga","Jules Koundé","FRA","DF","20",1998,25.7,23,12,14,5,4,10,18,55.6,8,16,12,4,23,46,91,2,"https://fbref.com/en/players/4d1666ff/Jules-Kounde"
"4951","Rony Lopes_2020",2020,"Sevilla","La Liga","Rony Lopes","POR","FW","23",1995,1.5,0,0,0,0,0,0,0,NA,0,0,0,0,2,2,0,0,"https://fbref.com/en/players/7c2965bb/Rony-Lopes"
"4952","Jesús Navas_2020",2020,"Sevilla","La Liga","Jesús Navas","ESP","DF","33",1985,37.4,27,15,16,7,4,15,32,46.9,17,20,7,13,31,58,70,0,"https://fbref.com/en/players/3f10bd22/Jesus-Navas"
"4953","Nolito_2020",2020,"Sevilla","La Liga","Nolito","ESP","FW","32",1986,10,21,12,5,11,5,7,20,35,13,7,0,7,1,22,1,0,"https://fbref.com/en/players/b2d0ec1b/Nolito"
"4954","Lucas Ocampos_2020",2020,"Sevilla","La Liga","Lucas Ocampos","ARG","FW,MF","25",1994,30.5,54,31,30,19,5,30,72,41.7,42,33,2,31,22,76,27,0,"https://fbref.com/en/players/a08b974a/Lucas-Ocampos"
"4955","Alejandro Pozo Pozo_2020",2020,"Sevilla","La Liga","Alejandro Pozo Pozo","ESP","MF,FW","20",1999,0.4,1,1,1,0,0,1,1,100,0,0,0,0,0,1,1,0,"https://fbref.com/en/players/3c16d927/Alejandro-Pozo-Pozo"
"4956","Sergio Reguilón_2020",2020,"Sevilla","La Liga","Sergio Reguilón","ESP","DF","22",1996,27.9,57,30,28,25,4,27,64,42.2,37,25,5,20,33,90,53,0,"https://fbref.com/en/players/3353737a/Sergio-Reguilon"
"4957","Suso_2020",2020,"Sevilla","La Liga","Suso","ESP","FW,MF","25",1993,8.7,9,4,4,4,1,7,16,43.8,9,6,0,6,2,11,0,0,"https://fbref.com/en/players/4e219ad2/Suso"
"4958","Óliver Torres_2020",2020,"Sevilla","La Liga","Óliver Torres","ESP","MF,FW","24",1994,17.7,45,27,12,26,7,23,60,38.3,37,23,1,22,13,58,9,1,"https://fbref.com/en/players/58a9a4d9/Oliver-Torres"
"4959","Tomáš Vaclík_2020",2020,"Sevilla","La Liga","Tomáš Vaclík","CZE","GK","30",1989,32.5,0,0,0,0,0,0,1,0,1,0,0,0,0,0,7,0,"https://fbref.com/en/players/7b456af7/Tomas-Vaclik"
"4960","Franco Vázquez_2020",2020,"Sevilla","La Liga","Franco Vázquez","ARG","MF,FW","30",1989,12.2,25,17,9,14,2,6,36,16.7,30,13,0,13,10,35,10,0,"https://fbref.com/en/players/467bae22/Franco-Vazquez"
"4961","George Baldock_2020",2020,"Sheffield Utd","Premier League","George Baldock","GRE","DF","26",1993,38,62,43,35,17,10,27,47,57.4,20,26,3,23,34,96,83,3,"https://fbref.com/en/players/394854c4/George-Baldock"
"4962","Chris Basham_2020",2020,"Sheffield Utd","Premier League","Chris Basham","ENG","DF","31",1988,36,85,48,58,20,7,48,81,59.3,33,38,15,23,77,162,173,1,"https://fbref.com/en/players/1aa84968/Chris-Basham"
"4963","Sander Berge_2020",2020,"Sheffield Utd","Premier League","Sander Berge","NOR","MF","21",1998,10.5,22,15,3,14,5,5,10,50,5,15,1,14,10,32,16,0,"https://fbref.com/en/players/d0b6129f/Sander-Berge"
"4964","Muhamed Bešić_2020",2020,"Sheffield Utd","Premier League","Muhamed Bešić","BIH","MF","26",1992,2.8,8,6,4,4,0,2,5,40,3,4,0,4,1,9,6,0,"https://fbref.com/en/players/7ca9f0f0/Muhamed-Besic"
"4965","Leon Clarke_2020",2020,"Sheffield Utd","Premier League","Leon Clarke","ENG","FW,MF","34",1985,0.4,0,0,0,0,0,0,0,NA,0,0,0,0,0,0,2,0,"https://fbref.com/en/players/91c975a0/Leon-Clarke"
"4966","John Egan_2020",2020,"Sheffield Utd","Premier League","John Egan","IRL","DF","26",1992,35.4,44,27,34,10,0,25,45,55.6,20,39,27,12,58,102,171,4,"https://fbref.com/en/players/debe38a0/John-Egan"
"4967","John Fleck_2020",2020,"Sheffield Utd","Premier League","John Fleck","SCO","MF","27",1991,28,36,25,13,14,9,22,64,34.4,42,25,3,22,24,60,26,0,"https://fbref.com/en/players/b63e789d/John-Fleck"
"4968","Kieron Freeman_2020",2020,"Sheffield Utd","Premier League","Kieron Freeman","WAL","FW","27",1992,0.1,0,0,0,0,0,0,0,NA,0,0,0,0,0,0,0,0,"https://fbref.com/en/players/c13c24c8/Kieron-Freeman"
"4969","Luke Freeman_2020",2020,"Sheffield Utd","Premier League","Luke Freeman","ENG","MF","27",1992,4.1,6,4,2,2,2,2,8,25,6,1,0,1,10,16,6,0,"https://fbref.com/en/players/636b64cd/Luke-Freeman"
"4970","Dean Henderson_2020",2020,"Sheffield Utd","Premier League","Dean Henderson","ENG","GK","22",1997,36,0,0,0,0,0,0,0,NA,0,0,0,0,1,1,13,1,"https://fbref.com/en/players/e5a76dfe/Dean-Henderson"
"4971","Phil Jagielka_2020",2020,"Sheffield Utd","Premier League","Phil Jagielka","ENG","DF","36",1982,2.7,5,4,3,2,0,1,3,33.3,2,5,5,0,4,9,19,0,"https://fbref.com/en/players/3233eefd/Phil-Jagielka"
"4972","John Lundstram_2020",2020,"Sheffield Utd","Premier League","John Lundstram","ENG","MF","25",1994,27.3,46,30,18,21,7,21,65,32.3,44,18,4,14,33,79,46,1,"https://fbref.com/en/players/0df2b165/John-Lundstram"
"4973","Oliver McBurnie_2020",2020,"Sheffield Utd","Premier League","Oliver McBurnie","SCO","FW","23",1996,23.5,37,22,6,27,4,11,40,27.5,29,25,3,22,15,52,43,0,"https://fbref.com/en/players/78b8ac63/Oliver-McBurnie"
"4974","David McGoldrick_2020",2020,"Sheffield Utd","Premier League","David McGoldrick","IRL","FW","31",1987,20.2,41,26,9,24,8,5,20,25,15,14,2,12,3,44,23,0,"https://fbref.com/en/players/dbe56a33/David-McGoldrick"
"4975","Simon Moore_2020",2020,"Sheffield Utd","Premier League","Simon Moore","ENG","GK","29",1990,2,1,0,1,0,0,1,1,100,0,0,0,0,0,1,0,1,"https://fbref.com/en/players/e7434f04/Simon-Moore"
"4976","Ravel Morrison_2020",2020,"Sheffield Utd","Premier League","Ravel Morrison","JAM","MF","26",1993,0.1,0,0,0,0,0,0,0,NA,0,0,0,0,0,0,0,0,"https://fbref.com/en/players/bf59c794/Ravel-Morrison"
"4977","Lys Mousset_2020",2020,"Sheffield Utd","Premier League","Lys Mousset","FRA","FW","23",1996,13.8,9,5,0,5,4,3,7,42.9,4,3,0,3,4,13,2,0,"https://fbref.com/en/players/d9cfca3d/Lys-Mousset"
"4978","Oliver Norwood_2020",2020,"Sheffield Utd","Premier League","Oliver Norwood","NIR","MF","28",1991,34.3,66,37,35,24,7,28,97,28.9,69,34,12,22,47,113,40,1,"https://fbref.com/en/players/43439614/Oliver-Norwood"
"4979","Jack O'Connell_2020",2020,"Sheffield Utd","Premier League","Jack O'Connell","ENG","DF","25",1994,32.4,23,14,15,6,2,10,20,50,10,38,17,21,42,65,154,1,"https://fbref.com/en/players/312626c1/Jack-OConnell"
"4980","Ben Osborn_2020",2020,"Sheffield Utd","Premier League","Ben Osborn","ENG","MF,DF","24",1994,6.6,15,10,11,3,1,3,16,18.8,13,6,1,5,6,21,7,0,"https://fbref.com/en/players/79bc4c45/Ben-Osborn"
"4981","Callum Robinson_2020",2020,"Sheffield Utd","Premier League","Callum Robinson","IRL","FW,MF","24",1995,7.5,6,3,2,2,2,2,7,28.6,5,3,0,3,7,13,3,0,"https://fbref.com/en/players/e75750a3/Callum-Robinson"
"4982","Jack Robinson_2020",2020,"Sheffield Utd","Premier League","Jack Robinson","ENG","DF","25",1993,5.6,10,5,5,5,0,1,6,16.7,5,12,5,7,8,18,24,0,"https://fbref.com/en/players/7399c7a8/Jack-Robinson"
"4983","Jack Rodwell_2020",2020,"Sheffield Utd","Premier League","Jack Rodwell","ENG","MF","28",1991,0.2,0,0,0,0,0,0,0,NA,0,0,0,0,0,0,1,0,"https://fbref.com/en/players/a07579ee/Jack-Rodwell"
"4984","Billy Sharp_2020",2020,"Sheffield Utd","Premier League","Billy Sharp","ENG","FW","33",1986,11.7,6,5,2,1,3,1,6,16.7,5,2,0,2,1,7,2,0,"https://fbref.com/en/players/e8c9f4e9/Billy-Sharp"
"4985","Enda Stevens_2020",2020,"Sheffield Utd","Premier League","Enda Stevens","IRL","DF","29",1990,37.2,81,46,48,26,7,42,96,43.8,54,27,8,19,35,116,71,3,"https://fbref.com/en/players/17d4507a/Enda-Stevens"
"4986","Richairo Živković_2020",2020,"Sheffield Utd","Premier League","Richairo Živković","CUW","FW","22",1996,1.2,2,2,0,2,0,1,2,50,1,1,0,1,0,2,0,0,"https://fbref.com/en/players/d2d74d9c/Richairo-Zivkovic"
"4987","Che Adams_2020",2020,"Southampton","Premier League","Che Adams","SCO","FW","23",1996,12.3,6,4,1,5,0,1,4,25,3,9,1,8,2,8,10,0,"https://fbref.com/en/players/f2bf1b0f/Che-Adams"
"4988","Stuart Armstrong_2020",2020,"Southampton","Premier League","Stuart Armstrong","SCO","MF","27",1992,19.1,32,19,19,11,2,9,38,23.7,29,22,4,18,11,43,23,1,"https://fbref.com/en/players/97333cf5/Stuart-Armstrong"
"4989","Jan Bednarek_2020",2020,"Southampton","Premier League","Jan Bednarek","POL","DF","23",1996,34,65,38,41,18,6,31,61,50.8,30,44,23,21,77,142,198,4,"https://fbref.com/en/players/4115ce4e/Jan-Bednarek"
"4990","Ryan Bertrand_2020",2020,"Southampton","Premier League","Ryan Bertrand","ENG","DF","29",1989,30.5,47,29,22,15,10,26,58,44.8,32,27,12,15,37,84,31,1,"https://fbref.com/en/players/01226327/Ryan-Bertrand"
"4991","Sofiane Boufal_2020",2020,"Southampton","Premier League","Sofiane Boufal","MAR","MF,FW","25",1993,8.5,16,8,6,5,5,6,15,40,9,17,0,17,4,20,1,0,"https://fbref.com/en/players/b0c71810/Sofiane-Boufal"
"4992","Kevin Danso_2020",2020,"Southampton","Premier League","Kevin Danso","AUT","DF","20",1998,3.1,6,4,3,3,0,4,7,57.1,3,7,3,4,2,8,7,0,"https://fbref.com/en/players/6e33125f/Kevin-Danso"
"4993","Moussa Djenepo_2020",2020,"Southampton","Premier League","Moussa Djenepo","MLI","MF,DF","21",1998,10.3,27,21,13,9,5,11,21,52.4,10,15,1,14,9,36,9,0,"https://fbref.com/en/players/254147d4/Moussa-Djenepo"
"4994","Angus Gunn_2020",2020,"Southampton","Premier League","Angus Gunn","SCO","GK","23",1996,10,1,1,1,0,0,1,3,33.3,2,0,0,0,0,1,1,0,"https://fbref.com/en/players/e082af5b/Angus-Gunn"
"4995","Pierre Højbjerg_2020",2020,"Southampton","Premier League","Pierre Højbjerg","DEN","MF","23",1995,30.6,80,49,34,38,8,39,91,42.9,52,44,5,39,46,126,54,2,"https://fbref.com/en/players/8b04d6c1/Pierre-Hojbjerg"
"4996","Danny Ings_2020",2020,"Southampton","Premier League","Danny Ings","ENG","FW","27",1992,31.2,42,25,16,16,10,13,67,19.4,54,62,4,58,9,51,30,1,"https://fbref.com/en/players/07802f7f/Danny-Ings"
"4997","Shane Long_2020",2020,"Southampton","Premier League","Shane Long","IRL","FW","32",1987,15.5,19,10,5,8,6,7,19,36.8,12,12,0,12,4,23,16,0,"https://fbref.com/en/players/9f472354/Shane-Long"
"4998","Alex McCarthy_2020",2020,"Southampton","Premier League","Alex McCarthy","ENG","GK","29",1989,28,1,1,1,0,0,1,1,100,0,1,0,1,0,1,11,3,"https://fbref.com/en/players/36c2ca73/Alex-McCarthy"
"4999","Michael Obafemi_2020",2020,"Southampton","Premier League","Michael Obafemi","IRL","FW","19",2000,7.4,7,3,1,3,3,2,14,14.3,12,3,0,3,6,13,0,0,"https://fbref.com/en/players/caa1a7f0/Michael-Obafemi"
"5000","Nathan Redmond_2020",2020,"Southampton","Premier League","Nathan Redmond","ENG","MF,FW","25",1994,30.7,49,29,17,23,9,21,57,36.8,36,39,2,37,16,65,16,0,"https://fbref.com/en/players/ab651565/Nathan-Redmond"
"5001","Oriol Romeu_2020",2020,"Southampton","Premier League","Oriol Romeu","ESP","MF","27",1991,20.7,55,35,23,30,2,27,75,36,48,35,13,22,34,89,32,0,"https://fbref.com/en/players/4b511457/Oriol-Romeu"
"5002","William Smallbone_2020",2020,"Southampton","Premier League","William Smallbone","IRL","MF","19",2000,4.4,10,5,2,8,0,5,10,50,5,7,1,6,1,11,2,0,"https://fbref.com/en/players/5e105217/William-Smallbone"
"5003","Cédric Soares_2020",2020,"Southampton","Premier League","Cédric Soares","POR","DF","27",1991,14.5,45,26,19,24,2,25,41,61,16,18,4,14,19,64,51,0,"https://fbref.com/en/players/839c14e1/Cedric-Soares"
"5004","Jack Stephens_2020",2020,"Southampton","Premier League","Jack Stephens","ENG","DF","25",1994,27.2,44,27,30,13,1,24,46,52.2,22,38,22,16,31,75,120,2,"https://fbref.com/en/players/6adbc307/Jack-Stephens"
"5005","Nathan Tella_2020",2020,"Southampton","Premier League","Nathan Tella","ENG","FW","20",1999,0,0,0,0,0,0,0,0,NA,0,0,0,0,0,0,0,0,"https://fbref.com/en/players/f1e94cd6/Nathan-Tella"
"5006","Yan Valery_2020",2020,"Southampton","Premier League","Yan Valery","TUN","DF","20",1999,8.7,20,7,9,7,4,11,19,57.9,8,9,1,8,13,33,32,2,"https://fbref.com/en/players/531a4aa8/Yan-Valery"
"5007","Jannik Vestergaard_2020",2020,"Southampton","Premier League","Jannik Vestergaard","DEN","DF","26",1992,16.6,19,12,14,5,0,11,28,39.3,17,15,9,6,26,45,99,2,"https://fbref.com/en/players/1900032e/Jannik-Vestergaard"
"5008","Jake Vokins_2020",2020,"Southampton","Premier League","Jake Vokins","ENG","DF","19",2000,1,2,2,0,0,2,1,1,100,0,0,0,0,0,2,1,0,"https://fbref.com/en/players/d484c261/Jake-Vokins"
"5009","Kyle Walker-Peters_2020",2020,"Southampton","Premier League","Kyle Walker-Peters","ENG","DF","22",1997,7.8,13,8,5,6,2,6,16,37.5,10,10,3,7,14,27,21,1,"https://fbref.com/en/players/984a5a64/Kyle-Walker-Peters"
"5010","James Ward-Prowse_2020",2020,"Southampton","Premier League","James Ward-Prowse","ENG","MF,DF","24",1994,38,92,48,39,39,14,39,94,41.5,55,48,14,34,60,152,75,1,"https://fbref.com/en/players/3515d404/James-Ward-Prowse"
"5011","Maya Yoshida_2020",2020,"Southampton","Premier League","Maya Yoshida","JPN","DF","30",1988,6.2,8,5,4,1,3,3,7,42.9,4,6,2,4,4,12,27,1,"https://fbref.com/en/players/caffaf5a/Maya-Yoshida"
"5012","Ludovic Ajorque_2020",2020,"Strasbourg","Ligue 1","Ludovic Ajorque","FRA","FW","25",1994,22.9,15,10,2,10,3,2,13,15.4,11,11,0,11,2,17,20,0,"https://fbref.com/en/players/462475ed/Ludovic-Ajorque"
"5013","Jean-Ricner Bellegarde_2020",2020,"Strasbourg","Ligue 1","Jean-Ricner Bellegarde","FRA","MF","21",1998,16.6,40,27,18,19,3,13,21,61.9,8,16,3,13,22,62,6,0,"https://fbref.com/en/players/10f0fdd3/Jean-Ricner-Bellegarde"
"5014","Anthony Caci_2020",2020,"Strasbourg","Ligue 1","Anthony Caci","FRA","DF","22",1997,7.7,29,17,19,9,1,8,17,47.1,9,15,5,10,19,48,15,1,"https://fbref.com/en/players/0118c54c/Anthony-Caci"
"5015","Lionel Carole_2020",2020,"Strasbourg","Ligue 1","Lionel Carole","FRA","DF","28",1991,14.1,23,8,15,6,2,13,17,76.5,4,2,1,1,19,42,22,0,"https://fbref.com/en/players/5b5724d2/Lionel-Carole"
"5016","Benjamin Corgnet_2020",2020,"Strasbourg","Ligue 1","Benjamin Corgnet","FRA","MF,FW","32",1987,2.9,1,1,1,0,0,1,3,33.3,2,2,0,2,2,3,3,0,"https://fbref.com/en/players/cfd8dde3/Benjamin-Corgnet"
"5017","Nuno da Costa_2020",2020,"Strasbourg","Ligue 1","Nuno da Costa","CPV","FW","28",1991,5.9,15,10,3,8,4,4,10,40,6,7,0,7,4,19,3,0,"https://fbref.com/en/players/909222de/Nuno-da-Costa"
"5018","Alexander Djiku_2020",2020,"Strasbourg","Ligue 1","Alexander Djiku","GHA","DF,MF","24",1994,22.9,46,32,27,19,0,21,29,72.4,8,14,8,6,55,101,82,4,"https://fbref.com/en/players/43e7a164/Alexander-Djiku"
"5019","Youssouf Fofana_2020",2020,"Strasbourg","Ligue 1","Youssouf Fofana","FRA","MF","20",1999,11.2,25,17,10,12,3,13,30,43.3,17,11,0,11,14,39,7,0,"https://fbref.com/en/players/822d51d7/Youssouf-Fofana"
"5020","Jérémy Grimm_2020",2020,"Strasbourg","Ligue 1","Jérémy Grimm","FRA","MF","32",1987,0,0,0,0,0,0,0,0,NA,0,0,0,0,0,0,0,0,"https://fbref.com/en/players/53283127/Jeremy-Grimm"
"5021","Lamine Koné_2020",2020,"Strasbourg","Ligue 1","Lamine Koné","CIV","DF","30",1989,16.4,31,21,20,10,1,12,17,70.6,5,8,5,3,25,56,47,1,"https://fbref.com/en/players/a46472d0/Lamine-Kone"
"5022","Kenny Lala_2020",2020,"Strasbourg","Ligue 1","Kenny Lala","FRA","DF,MF","27",1991,22.7,29,16,17,11,1,11,27,40.7,16,14,5,9,20,49,40,1,"https://fbref.com/en/players/770d7eb8/Kenny-Lala"
"5023","Adrien Lebeau_2020",2020,"Strasbourg","Ligue 1","Adrien Lebeau","FRA","MF,FW","20",1999,0.1,1,1,1,0,0,0,1,0,1,1,0,1,0,1,0,0,"https://fbref.com/en/players/ca122e29/Adrien-Lebeau"
"5024","Dimitri Liénard_2020",2020,"Strasbourg","Ligue 1","Dimitri Liénard","FRA","MF","31",1988,16.5,37,24,10,22,5,18,39,46.2,21,18,4,14,17,54,25,0,"https://fbref.com/en/players/f7691f63/Dimitri-Lienard"
"5025","Abdul Majeed Waris_2020",2020,"Strasbourg","Ligue 1","Abdul Majeed Waris","GHA","FW","27",1991,4.1,6,4,4,2,0,3,8,37.5,5,2,0,2,4,10,0,0,"https://fbref.com/en/players/46907171/Abdul-Majeed-Waris"
"5026","Jonas Martin_2020",2020,"Strasbourg","Ligue 1","Jonas Martin","FRA","MF","29",1990,2.7,5,3,4,0,1,1,3,33.3,2,3,0,3,1,6,3,0,"https://fbref.com/en/players/468fdbad/Jonas-Martin"
"5027","Stefan Mitrović_2020",2020,"Strasbourg","Ligue 1","Stefan Mitrović","SRB","DF","29",1990,22.8,15,9,10,5,0,6,14,42.9,8,14,9,5,23,38,90,3,"https://fbref.com/en/players/e6777e6b/Stefan-Mitrovic"
"5028","Lebo Mothiba_2020",2020,"Strasbourg","Ligue 1","Lebo Mothiba","RSA","FW","23",1996,11.6,4,3,1,1,2,1,6,16.7,5,5,0,5,3,7,1,0,"https://fbref.com/en/players/3eaf8817/Lebo-Mothiba"
"5029","Abdallah N'dour_2020",2020,"Strasbourg","Ligue 1","Abdallah N'dour","SEN","DF","25",1993,4.1,5,4,2,3,0,5,10,50,5,4,1,3,4,9,5,1,"https://fbref.com/en/players/4749367a/Abdallah-Ndour"
"5030","Sanjin Prcić_2020",2020,"Strasbourg","Ligue 1","Sanjin Prcić","BIH","MF,FW","25",1993,0.9,1,0,0,0,1,1,2,50,1,1,1,0,1,2,0,0,"https://fbref.com/en/players/51c30111/Sanjin-Prcic"
"5031","Matz Sels_2020",2020,"Strasbourg","Ligue 1","Matz Sels","BEL","GK","27",1992,27,0,0,0,0,0,0,1,0,1,0,0,0,1,1,6,0,"https://fbref.com/en/players/834b5c4c/Matz-Sels"
"5032","Mohamed Simakan_2020",2020,"Strasbourg","Ligue 1","Mohamed Simakan","FRA","DF","19",2000,16.7,54,32,35,16,3,22,34,64.7,12,14,3,11,31,85,25,0,"https://fbref.com/en/players/fcb27134/Mohamed-Simakan"
"5033","Ibrahima Sissoko_2020",2020,"Strasbourg","Ligue 1","Ibrahima Sissoko","FRA","MF","21",1997,17.8,46,27,21,21,4,16,48,33.3,32,14,5,9,20,66,25,0,"https://fbref.com/en/players/0f8418aa/Ibrahima-Sissoko"
"5034","Adrien Thomasson_2020",2020,"Strasbourg","Ligue 1","Adrien Thomasson","FRA","MF,FW","25",1993,23,36,21,11,16,9,15,47,31.9,32,21,1,20,9,45,9,0,"https://fbref.com/en/players/c76b7567/Adrien-Thomasson"
"5035","Mootaz Zemzemi_2020",2020,"Strasbourg","Ligue 1","Mootaz Zemzemi","TUN","MF","19",1999,0.3,0,0,0,0,0,0,0,NA,0,0,0,0,1,1,0,0,"https://fbref.com/en/players/242b350c/Mootaz-Zemzemi"
"5036","Kévin Zohi_2020",2020,"Strasbourg","Ligue 1","Kévin Zohi","MLI","FW,MF","22",1996,5.9,8,6,3,3,2,3,6,50,3,1,0,1,4,12,2,0,"https://fbref.com/en/players/775185ae/Kevin-Zohi"
"5037","Ola Aina_2020",2020,"Torino","Serie A","Ola Aina","NGA","DF","22",1996,23.1,45,24,23,18,4,17,37,45.9,20,24,6,18,41,86,61,0,"https://fbref.com/en/players/246d153b/Ola-Aina"
"5038","Cristian Ansaldi_2020",2020,"Torino","Serie A","Cristian Ansaldi","ARG","DF,MF","32",1986,19.6,37,25,24,7,6,19,34,55.9,15,23,3,20,14,51,20,4,"https://fbref.com/en/players/bbafc0c4/Cristian-Ansaldi"
"5039","Daniele Baselli_2020",2020,"Torino","Serie A","Daniele Baselli","ITA","MF","27",1992,14.2,43,23,17,19,7,13,40,32.5,27,20,4,16,25,68,25,0,"https://fbref.com/en/players/ea06dd97/Daniele-Baselli"
"5040","Andrea Belotti_2020",2020,"Torino","Serie A","Andrea Belotti","ITA","FW","25",1993,33.4,29,16,7,17,5,5,31,16.1,26,23,5,18,5,34,20,1,"https://fbref.com/en/players/d705ba44/Andrea-Belotti"
"5041","Álex Berenguer_2020",2020,"Torino","Serie A","Álex Berenguer","ESP","MF,DF","24",1995,20.3,20,6,6,13,1,8,33,24.2,25,17,1,16,18,38,17,0,"https://fbref.com/en/players/dc1c2fce/Alex-Berenguer"
"5042","Kevin Bonifazi_2020",2020,"Torino","Serie A","Kevin Bonifazi","ITA","DF","23",1996,2.7,9,8,6,3,0,5,6,83.3,1,3,2,1,5,14,10,0,"https://fbref.com/en/players/fb77bfef/Kevin-Bonifazi"
"5043","Gleison Bremer_2020",2020,"Torino","Serie A","Gleison Bremer","BRA","DF","22",1997,25.2,63,36,37,20,6,20,34,58.8,14,48,22,26,74,137,118,1,"https://fbref.com/en/players/5fd5ed86/Gleison-Bremer"
"5044","Christian Celesia_2020",2020,"Torino","Serie A","Christian Celesia","ITA","DF","17",2002,0,0,0,0,0,0,0,0,NA,0,0,0,0,0,0,0,0,"https://fbref.com/en/players/d2fd20d6/Christian-Celesia"
"5045","Lorenzo De Silvestri_2020",2020,"Torino","Serie A","Lorenzo De Silvestri","ITA","DF","31",1988,24.9,15,8,4,7,4,11,27,40.7,16,20,7,13,19,34,72,0,"https://fbref.com/en/players/e74f0e59/Lorenzo-De-Silvestri"
"5046","Koffi Djidji_2020",2020,"Torino","Serie A","Koffi Djidji","CIV","DF","26",1992,9.5,27,12,19,8,0,8,18,44.4,10,28,23,5,15,42,53,1,"https://fbref.com/en/players/933d3b51/Koffi-Djidji"
"5047","Simone Edera_2020",2020,"Torino","Serie A","Simone Edera","ITA","MF,FW","22",1997,4.4,13,5,3,7,3,2,12,16.7,10,1,0,1,1,14,3,0,"https://fbref.com/en/players/8697c095/Simone-Edera"
"5048","Iago Falque_2020",2020,"Torino","Serie A","Iago Falque","ESP","FW,MF","29",1990,1.1,0,0,0,0,0,0,1,0,1,1,0,1,0,0,0,0,"https://fbref.com/en/players/440c84ed/Iago-Falque"
"5049","Armando Izzo_2020",2020,"Torino","Serie A","Armando Izzo","ITA","DF","27",1992,29.8,42,24,24,14,4,17,35,48.6,18,44,29,15,71,113,121,1,"https://fbref.com/en/players/89976232/Armando-Izzo"
"5050","Diego Laxalt_2020",2020,"Torino","Serie A","Diego Laxalt","URU","DF,MF","26",1993,6.6,19,10,10,6,3,6,20,30,14,12,4,8,6,25,20,0,"https://fbref.com/en/players/f26e3c59/Diego-Laxalt"
"5051","Saša Lukić_2020",2020,"Torino","Serie A","Saša Lukić","SRB","MF","22",1996,20.7,29,17,8,19,2,10,35,28.6,25,21,7,14,29,58,15,0,"https://fbref.com/en/players/c6e8cf1f/Sasa-Lukic"
"5052","Lyanco_2020",2020,"Torino","Serie A","Lyanco","BRA","DF","22",1997,13.1,23,13,9,12,2,7,13,53.8,6,29,19,10,23,46,54,2,"https://fbref.com/en/players/b5bf1770/Lyanco"
"5053","Soualiho Meïté_2020",2020,"Torino","Serie A","Soualiho Meïté","FRA","MF","25",1994,24.5,32,18,14,13,5,12,35,34.3,23,31,6,25,24,56,36,0,"https://fbref.com/en/players/5cec2c74/Soualiho-Meite"
"5054","Vincenzo Millico_2020",2020,"Torino","Serie A","Vincenzo Millico","ITA","MF,FW","18",2000,2.4,1,0,1,0,0,1,3,33.3,2,2,0,2,0,1,1,0,"https://fbref.com/en/players/6817095b/Vincenzo-Millico"
"5055","Michel Ndary Adopo_2020",2020,"Torino","Serie A","Michel Ndary Adopo","FRA","DF,MF","19",2000,0,0,0,0,0,0,0,0,NA,0,1,1,0,0,0,0,0,"https://fbref.com/en/players/599d91d0/Michel-Ndary-Adopo"
"5056","Nicolas Nkoulou_2020",2020,"Torino","Serie A","Nicolas Nkoulou","CMR","DF","29",1990,29.9,34,24,21,11,2,16,22,72.7,6,40,18,22,70,104,138,2,"https://fbref.com/en/players/93cf32a8/Nicolas-Nkoulou"
"5057","Tomás Rincón_2020",2020,"Torino","Serie A","Tomás Rincón","VEN","MF","31",1988,30,56,25,23,25,8,23,65,35.4,42,20,3,17,36,92,62,0,"https://fbref.com/en/players/f1cfc209/Tomas-Rincon"
"5058","Antonio Rosati_2020",2020,"Torino","Serie A","Antonio Rosati","ITA","GK","36",1983,1,0,0,0,0,0,0,0,NA,0,0,0,0,0,0,0,1,"https://fbref.com/en/players/28a15394/Antonio-Rosati"
"5059","Wilfried Singo_2020",2020,"Torino","Serie A","Wilfried Singo","CIV","DF","18",2000,1.5,1,0,0,1,0,0,0,NA,0,0,0,0,1,2,2,0,"https://fbref.com/en/players/8b609c34/Wilfried-Singo"
"5060","Salvatore Sirigu_2020",2020,"Torino","Serie A","Salvatore Sirigu","ITA","GK","32",1987,36,0,0,0,0,0,0,0,NA,0,0,0,0,2,2,12,0,"https://fbref.com/en/players/10dc46f0/Salvatore-Sirigu"
"5061","Samir Ujkani_2020",2020,"Torino","Serie A","Samir Ujkani","KVX","GK","31",1988,1,0,0,0,0,0,0,0,NA,0,0,0,0,0,0,1,0,"https://fbref.com/en/players/96640846/Samir-Ujkani"
"5062","Simone Verdi_2020",2020,"Torino","Serie A","Simone Verdi","ITA","MF,FW","27",1992,23,19,10,4,12,3,9,38,23.7,29,14,0,14,7,26,1,0,"https://fbref.com/en/players/0375723e/Simone-Verdi"
"5063","Simone Zaza_2020",2020,"Torino","Serie A","Simone Zaza","ITA","FW","28",1991,18.2,15,10,6,4,5,3,10,30,7,11,0,11,9,24,13,1,"https://fbref.com/en/players/9592289a/Simone-Zaza"
"5064","Toby Alderweireld_2020",2020,"Tottenham","Premier League","Toby Alderweireld","BEL","DF","30",1989,32.9,40,29,24,13,3,11,24,45.8,13,48,32,16,31,71,172,2,"https://fbref.com/en/players/f7d50789/Toby-Alderweireld"
"5065","Dele Alli_2020",2020,"Tottenham","Premier League","Dele Alli","ENG","MF,FW","23",1996,20.5,34,16,11,20,3,13,37,35.1,24,35,3,32,17,51,17,2,"https://fbref.com/en/players/cea4ee8f/Dele-Alli"
"5066","Serge Aurier_2020",2020,"Tottenham","Premier League","Serge Aurier","CIV","DF","26",1992,30,93,69,58,27,8,39,69,56.5,30,38,6,32,47,140,98,2,"https://fbref.com/en/players/5c2b4f07/Serge-Aurier"
"5067","Steven Bergwijn_2020",2020,"Tottenham","Premier League","Steven Bergwijn","NED","FW,MF","21",1997,7.8,10,6,3,6,1,4,12,33.3,8,12,0,12,1,11,5,0,"https://fbref.com/en/players/a29b1131/Steven-Bergwijn"
"5068","Ben Davies_2020",2020,"Tottenham","Premier League","Ben Davies","WAL","DF","26",1993,15.9,28,15,13,11,4,7,21,33.3,14,28,12,16,22,50,47,0,"https://fbref.com/en/players/44781702/Ben-Davies"
"5069","Eric Dier_2020",2020,"Tottenham","Premier League","Eric Dier","ENG","DF,MF","25",1994,14.9,21,12,10,10,1,10,20,50,10,14,9,5,21,42,65,0,"https://fbref.com/en/players/ac861941/Eric-Dier"
"5070","Christian Eriksen_2020",2020,"Tottenham","Premier League","Christian Eriksen","DEN","MF,FW","27",1992,12.2,19,9,10,8,1,7,24,29.2,17,10,1,9,12,31,16,0,"https://fbref.com/en/players/980522ec/Christian-Eriksen"
"5071","Gedson Fernandes_2020",2020,"Tottenham","Premier League","Gedson Fernandes","POR","MF,DF","20",1999,0.8,2,0,2,0,0,0,2,0,2,2,0,2,1,3,0,0,"https://fbref.com/en/players/e2dde94c/Gedson-Fernandes"
"5072","Juan Foyth_2020",2020,"Tottenham","Premier League","Juan Foyth","ARG","DF","21",1998,0.8,7,3,5,2,0,3,4,75,1,1,0,1,1,8,3,1,"https://fbref.com/en/players/6c7762c3/Juan-Foyth"
"5073","Paulo Gazzaniga_2020",2020,"Tottenham","Premier League","Paulo Gazzaniga","ARG","GK","27",1992,17.9,0,0,0,0,0,0,0,NA,0,0,0,0,1,1,4,1,"https://fbref.com/en/players/63d17038/Paulo-Gazzaniga"
"5074","Son Heung-min_2020",2020,"Tottenham","Premier League","Son Heung-min","KOR","FW","27",1992,27.5,23,15,10,11,2,9,57,15.8,48,23,0,23,19,42,18,1,"https://fbref.com/en/players/92e7e919/Son-Heung-min"
"5075","Harry Kane_2020",2020,"Tottenham","Premier League","Harry Kane","ENG","FW","26",1993,28.7,18,12,3,12,3,4,17,23.5,13,17,7,10,6,24,30,0,"https://fbref.com/en/players/21a66f6a/Harry-Kane"
"5076","Érik Lamela_2020",2020,"Tottenham","Premier League","Érik Lamela","ARG","MF,FW","27",1992,13.5,24,20,9,13,2,2,21,9.5,19,12,3,9,8,32,10,0,"https://fbref.com/en/players/abe66106/Erik-Lamela"
"5077","Hugo Lloris_2020",2020,"Tottenham","Premier League","Hugo Lloris","FRA","GK","32",1986,20.1,0,0,0,0,0,0,0,NA,0,0,0,0,1,1,3,2,"https://fbref.com/en/players/8f62b6ee/Hugo-Lloris"
"5078","Giovani Lo Celso_2020",2020,"Tottenham","Premier League","Giovani Lo Celso","ARG","MF,FW","23",1996,16.6,51,29,12,33,6,12,59,20.3,47,20,4,16,9,60,19,0,"https://fbref.com/en/players/d7553721/Giovani-Lo-Celso"
"5079","Lucas Moura_2020",2020,"Tottenham","Premier League","Lucas Moura","BRA","FW,MF","26",1992,24.9,57,33,25,22,10,16,58,27.6,42,29,2,27,15,72,27,0,"https://fbref.com/en/players/2b622f01/Lucas-Moura"
"5080","Georges-Kévin N'Koudou_2020",2020,"Tottenham","Premier League","Georges-Kévin N'Koudou","CMR","FW","24",1995,0,0,0,0,0,0,0,1,0,1,0,0,0,0,0,0,0,"https://fbref.com/en/players/76c131da/Georges-Kevin-NKoudou"
"5081","Tanguy Ndombele_2020",2020,"Tottenham","Premier League","Tanguy Ndombele","FRA","MF","22",1996,11.2,24,16,10,13,1,9,22,40.9,13,20,3,17,14,38,7,0,"https://fbref.com/en/players/5cdddffa/Tanguy-Ndombele"
"5082","Troy Parrott_2020",2020,"Tottenham","Premier League","Troy Parrott","IRL","FW","17",2002,0.1,0,0,0,0,0,0,0,NA,0,0,0,0,0,0,0,0,"https://fbref.com/en/players/4357f557/Troy-Parrott"
"5083","Danny Rose_2020",2020,"Tottenham","Premier League","Danny Rose","ENG","DF","29",1990,9.9,18,11,6,10,2,9,20,45,11,14,6,8,8,26,34,2,"https://fbref.com/en/players/89d10e53/Danny-Rose"
"5084","Davinson Sánchez_2020",2020,"Tottenham","Premier League","Davinson Sánchez","COL","DF","23",1996,27,44,27,32,12,0,22,44,50,22,40,28,12,34,78,128,5,"https://fbref.com/en/players/da7b447d/Davinson-Sanchez"
"5085","Ryan Sessegnon_2020",2020,"Tottenham","Premier League","Ryan Sessegnon","ENG","DF,FW","19",2000,3.8,6,4,2,4,0,3,6,50,3,0,0,0,3,9,12,0,"https://fbref.com/en/players/6aa3e78b/Ryan-Sessegnon"
"5086","Moussa Sissoko_2020",2020,"Tottenham","Premier League","Moussa Sissoko","FRA","MF","29",1989,27.2,39,25,25,12,2,20,48,41.7,28,19,4,15,27,66,43,2,"https://fbref.com/en/players/2acd49b9/Moussa-Sissoko"
"5087","Oliver Skipp_2020",2020,"Tottenham","Premier League","Oliver Skipp","ENG","MF","18",2000,0.9,2,2,0,2,0,1,4,25,3,3,2,1,0,2,0,0,"https://fbref.com/en/players/6250083a/Oliver-Skipp"
"5088","Japhet Tanganga_2020",2020,"Tottenham","Premier League","Japhet Tanganga","ENG","DF","20",1999,5.8,17,9,10,6,1,10,17,58.8,7,7,6,1,11,28,31,2,"https://fbref.com/en/players/e9971f2d/Japhet-Tanganga"
"5089","Jan Vertonghen_2020",2020,"Tottenham","Premier League","Jan Vertonghen","BEL","DF","32",1987,18.3,40,24,25,14,1,20,31,64.5,11,18,10,8,33,73,68,0,"https://fbref.com/en/players/ba23a904/Jan-Vertonghen"
"5090","Kyle Walker-Peters_2020",2020,"Tottenham","Premier League","Kyle Walker-Peters","ENG","DF","22",1997,2.7,8,5,8,0,0,5,9,55.6,4,4,2,2,3,11,5,1,"https://fbref.com/en/players/984a5a64/Kyle-Walker-Peters"
"5091","Victor Wanyama_2020",2020,"Tottenham","Premier League","Victor Wanyama","KEN","MF","28",1991,0.3,0,0,0,0,0,0,0,NA,0,0,0,0,0,0,0,0,"https://fbref.com/en/players/e0900238/Victor-Wanyama"
"5092","Harry Winks_2020",2020,"Tottenham","Premier League","Harry Winks","ENG","MF","23",1996,24.7,40,24,18,20,2,17,54,31.5,37,27,8,19,36,76,32,1,"https://fbref.com/en/players/2f7acede/Harry-Winks"
"5093","Amine Adli_2020",2020,"Toulouse","Ligue 1","Amine Adli","FRA","MF,FW","19",2000,0.5,0,0,0,0,0,0,1,0,1,0,0,0,1,1,0,0,"https://fbref.com/en/players/dcfb17f4/Amine-Adli"
"5094","Kelvin Amian_2020",2020,"Toulouse","Ligue 1","Kelvin Amian","FRA","DF","21",1998,18.1,27,21,21,5,1,14,25,56,11,14,7,7,18,45,56,0,"https://fbref.com/en/players/bcc81786/Kelvin-Amian"
"5095","Janis Antiste_2020",2020,"Toulouse","Ligue 1","Janis Antiste","FRA","MF","16",2002,0.1,0,0,0,0,0,0,0,NA,0,0,0,0,0,0,0,0,"https://fbref.com/en/players/38d9ce53/Janis-Antiste"
"5096","Quentin Boisgard_2020",2020,"Toulouse","Ligue 1","Quentin Boisgard","FRA","MF,FW","22",1997,12.7,31,19,10,14,7,14,35,40,21,11,0,11,12,43,4,1,"https://fbref.com/en/players/f6496133/Quentin-Boisgard"
"5097","Bafodé Diakité_2020",2020,"Toulouse","Ligue 1","Bafodé Diakité","FRA","DF","18",2001,15.2,23,19,15,8,0,7,13,53.8,6,18,9,9,20,43,75,0,"https://fbref.com/en/players/1bfb6fef/Bafode-Diakite"
"5098","Moussa Diarra_2020",2020,"Toulouse","Ligue 1","Moussa Diarra","MLI","DF","18",2000,1,3,3,2,1,0,1,1,100,0,0,0,0,3,6,2,0,"https://fbref.com/en/players/698f11e3/Moussa-Diarra"
"5099","Mathieu Dossevi_2020",2020,"Toulouse","Ligue 1","Mathieu Dossevi","TOG","MF,FW","31",1988,19.5,32,20,7,17,8,15,30,50,15,17,0,17,14,46,7,0,"https://fbref.com/en/players/6421dd73/Mathieu-Dossevi"
"5100","Ruben Gabrielsen_2020",2020,"Toulouse","Ligue 1","Ruben Gabrielsen","NOR","DF","27",1992,7.3,3,2,3,0,0,2,4,50,2,5,3,2,8,11,41,0,"https://fbref.com/en/players/9e64fc85/Ruben-Gabrielsen"
"5101","Mauro Goicoechea_2020",2020,"Toulouse","Ligue 1","Mauro Goicoechea","URU","GK","31",1988,2,0,0,0,0,0,0,0,NA,0,0,0,0,0,0,1,2,"https://fbref.com/en/players/132bb875/Mauro-Goicoechea"
"5102","Mathieu Goncalves_2020",2020,"Toulouse","Ligue 1","Mathieu Goncalves","FRA","DF","18",2001,3.5,5,3,5,0,0,2,8,25,6,4,3,1,4,9,10,0,"https://fbref.com/en/players/d26cd32d/Mathieu-Goncalves"
"5103","Max Gradel_2020",2020,"Toulouse","Ligue 1","Max Gradel","CIV","MF,FW","31",1987,18.2,36,20,17,14,5,12,47,25.5,35,11,1,10,11,47,23,0,"https://fbref.com/en/players/c5a500ca/Max-Gradel"
"5104","Nicolas Isimat-Mirin_2020",2020,"Toulouse","Ligue 1","Nicolas Isimat-Mirin","FRA","DF","27",1991,14,14,8,8,6,0,5,11,45.5,6,18,12,6,22,36,71,0,"https://fbref.com/en/players/14e8e9d7/Nicolas-Isimat-Mirin"
"5105","Corentin Jean_2020",2020,"Toulouse","Ligue 1","Corentin Jean","FRA","DF","24",1995,0.1,0,0,0,0,0,0,0,NA,0,0,0,0,0,0,1,0,"https://fbref.com/en/players/7d9b37bf/Corentin-Jean"
"5106","Lovre Kalinić_2020",2020,"Toulouse","Ligue 1","Lovre Kalinić","CRO","GK","29",1990,3.4,0,0,0,0,0,0,1,0,1,0,0,0,0,0,0,0,"https://fbref.com/en/players/3a74f92b/Lovre-Kalinic"
"5107","Kouadio Koné_2020",2020,"Toulouse","Ligue 1","Kouadio Koné","FRA","MF","18",2001,9.7,35,20,17,14,4,13,30,43.3,17,15,1,14,19,54,10,1,"https://fbref.com/en/players/86574238/Kouadio-Kone"
"5108","Efthimis Koulouris_2020",2020,"Toulouse","Ligue 1","Efthimis Koulouris","GRE","FW","23",1996,17.1,13,8,5,5,3,3,13,23.1,10,8,4,4,3,16,16,0,"https://fbref.com/en/players/21f8d950/Efthimis-Koulouris"
"5109","Aaron Leya Iseka_2020",2020,"Toulouse","Ligue 1","Aaron Leya Iseka","BEL","FW","21",1997,8.6,2,0,0,2,0,0,3,0,3,5,0,5,1,3,7,0,"https://fbref.com/en/players/29ef0f49/Aaron-Leya-Iseka"
"5110","Jean-Victor Makengo_2020",2020,"Toulouse","Ligue 1","Jean-Victor Makengo","FRA","MF","21",1998,11,14,11,3,10,1,4,13,30.8,9,7,1,6,3,17,5,1,"https://fbref.com/en/players/22bfb57e/Jean-Victor-Makengo"
"5111","Steven Moreira_2020",2020,"Toulouse","Ligue 1","Steven Moreira","FRA","DF","24",1994,15.4,37,25,21,15,1,19,31,61.3,12,16,3,13,16,53,29,0,"https://fbref.com/en/players/f10983ae/Steven-Moreira"
"5112","Nathan N'Goumou_2020",2020,"Toulouse","Ligue 1","Nathan N'Goumou","FRA","FW","19",2000,0.1,0,0,0,0,0,0,0,NA,0,0,0,0,0,0,1,0,"https://fbref.com/en/players/e110ea4b/Nathan-NGoumou"
"5113","Baptiste Reynet_2020",2020,"Toulouse","Ligue 1","Baptiste Reynet","FRA","GK","28",1990,22.6,1,1,1,0,0,1,3,33.3,2,0,0,0,0,1,12,0,"https://fbref.com/en/players/bcf1b2e9/Baptiste-Reynet"
"5114","Agustín Rogel_2020",2020,"Toulouse","Ligue 1","Agustín Rogel","URU","DF","21",1997,9.5,15,8,12,3,0,7,13,53.8,6,13,10,3,11,26,35,2,"https://fbref.com/en/players/ea42c03f/Agustin-Rogel"
"5115","Wesley Saïd_2020",2020,"Toulouse","Ligue 1","Wesley Saïd","FRA","MF,FW","24",1995,12.9,20,9,8,10,2,2,13,15.4,11,6,0,6,9,29,8,0,"https://fbref.com/en/players/90fcf472/Wesley-Said"
"5116","Ibrahim Sangaré_2020",2020,"Toulouse","Ligue 1","Ibrahim Sangaré","CIV","MF","21",1997,24.2,84,54,37,42,5,33,74,44.6,41,28,10,18,39,123,49,4,"https://fbref.com/en/players/bced0375/Ibrahim-Sangare"
"5117","Yaya Sanogo_2020",2020,"Toulouse","Ligue 1","Yaya Sanogo","FRA","FW","26",1993,10.1,6,3,2,3,1,1,2,50,1,4,1,3,7,13,14,0,"https://fbref.com/en/players/11ced928/Yaya-Sanogo"
"5118","Gen Shoji_2020",2020,"Toulouse","Ligue 1","Gen Shoji","JPN","DF","26",1992,0.5,2,2,2,0,0,1,1,100,0,0,0,0,0,2,2,0,"https://fbref.com/en/players/8b28686a/Gen-Shoji"
"5119","Kalidou Sidibé_2020",2020,"Toulouse","Ligue 1","Kalidou Sidibé","FRA","MF","20",1999,1,3,3,0,3,0,2,5,40,3,0,0,0,1,4,0,0,"https://fbref.com/en/players/ea540835/Kalidou-Sidibe"
"5120","Issiaga Sylla_2020",2020,"Toulouse","Ligue 1","Issiaga Sylla","GUI","DF","25",1994,28,73,49,44,21,8,40,69,58,29,31,7,24,67,140,90,2,"https://fbref.com/en/players/b99bec05/Issiaga-Sylla"
"5121","Adil Taoui_2020",2020,"Toulouse","Ligue 1","Adil Taoui","FRA","MF","17",2001,0.3,2,2,0,2,0,0,2,0,2,0,0,0,2,4,0,0,"https://fbref.com/en/players/53e585f2/Adil-Taoui"
"5122","William Vainqueur_2020",2020,"Toulouse","Ligue 1","William Vainqueur","FRA","MF","30",1988,19.1,68,36,30,32,6,22,60,36.7,38,21,5,16,29,97,23,0,"https://fbref.com/en/players/92cd4bef/William-Vainqueur"
"5123","Marco Ballarini_2020",2020,"Udinese","Serie A","Marco Ballarini","ITA","MF","18",2001,0,0,0,0,0,0,0,0,NA,0,0,0,0,0,0,0,0,"https://fbref.com/en/players/8cb494c9/Marco-Ballarini"
"5124","Antonín Barák_2020",2020,"Udinese","Serie A","Antonín Barák","CZE","MF,FW","24",1994,2.2,5,4,3,0,2,1,5,20,4,6,1,5,0,5,4,0,"https://fbref.com/en/players/01efac19/Antonin-Barak"
"5125","Rodrigo Becão_2020",2020,"Udinese","Serie A","Rodrigo Becão","BRA","DF","23",1996,24.6,56,25,34,19,3,26,46,56.5,20,40,20,20,45,101,77,0,"https://fbref.com/en/players/19e4eab9/Rodrigo-Becao"
"5126","Sebastien De Maio_2020",2020,"Udinese","Serie A","Sebastien De Maio","FRA","DF","32",1987,16.7,18,11,11,7,0,7,11,63.6,4,28,20,8,32,50,86,2,"https://fbref.com/en/players/952a03fe/Sebastien-De-Maio"
"5127","Rodrigo De Paul_2020",2020,"Udinese","Serie A","Rodrigo De Paul","ARG","MF","25",1994,31.4,61,31,31,26,4,27,65,41.5,38,38,3,35,29,90,8,1,"https://fbref.com/en/players/162efffd/Rodrigo-De-Paul"
"5128","Seko Fofana_2020",2020,"Udinese","Serie A","Seko Fofana","CIV","MF","24",1995,25,17,12,8,8,1,9,35,25.7,26,20,1,19,17,34,19,0,"https://fbref.com/en/players/5313ed43/Seko-Fofana"
"5129","Mato Jajalo_2020",2020,"Udinese","Serie A","Mato Jajalo","BIH","MF","31",1988,18.3,44,19,19,22,3,14,38,36.8,24,20,7,13,19,63,19,2,"https://fbref.com/en/players/8c65eb5f/Mato-Jajalo"
"5130","Kevin Lasagna_2020",2020,"Udinese","Serie A","Kevin Lasagna","ITA","FW","26",1992,28.5,27,14,7,13,7,6,31,19.4,25,23,1,22,10,37,18,1,"https://fbref.com/en/players/09538fdb/Kevin-Lasagna"
"5131","Rolando Mandragora_2020",2020,"Udinese","Serie A","Rolando Mandragora","ITA","MF","22",1997,22.8,47,24,15,25,7,15,55,27.3,40,30,5,25,26,73,25,0,"https://fbref.com/en/players/c7259b83/Rolando-Mandragora"
"5132","Juan Musso_2020",2020,"Udinese","Serie A","Juan Musso","ARG","GK","25",1994,38,0,0,0,0,0,0,1,0,1,0,0,0,1,1,18,2,"https://fbref.com/en/players/a111cf41/Juan-Musso"
"5133","Ilija Nestorovski_2020",2020,"Udinese","Serie A","Ilija Nestorovski","MKD","FW","29",1990,13.9,10,7,5,5,0,6,21,28.6,15,13,2,11,4,14,12,0,"https://fbref.com/en/players/b1236c63/Ilija-Nestorovski"
"5134","Bram Nuytinck_2020",2020,"Udinese","Serie A","Bram Nuytinck","NED","DF","29",1990,24.7,46,32,30,13,3,17,27,63,10,50,32,18,27,73,96,1,"https://fbref.com/en/players/e33f36d5/Bram-Nuytinck"
"5135","Stefano Okaka_2020",2020,"Udinese","Serie A","Stefano Okaka","ITA","FW","29",1989,26.8,19,11,6,8,5,7,27,25.9,20,23,2,21,8,27,28,0,"https://fbref.com/en/players/601ef102/Stefano-Okaka"
"5136","Nicholas Opoku_2020",2020,"Udinese","Serie A","Nicholas Opoku","GHA","DF","21",1997,5.3,13,8,8,3,2,6,11,54.5,5,6,4,2,4,17,19,0,"https://fbref.com/en/players/b871bf55/Nicholas-Opoku"
"5137","Martin Palumbo_2020",2020,"Udinese","Serie A","Martin Palumbo","NOR","MF","17",2002,0,0,0,0,0,0,0,0,NA,0,0,0,0,0,0,0,0,"https://fbref.com/en/players/f8d41a8c/Martin-Palumbo"
"5138","Giuseppe Pezzella_2020",2020,"Udinese","Serie A","Giuseppe Pezzella","ITA","DF","21",1997,0.9,0,0,0,0,0,0,0,NA,0,0,0,0,1,1,4,0,"https://fbref.com/en/players/149c5f5d/Giuseppe-Pezzella"
"5139","Ignacio Pussetto_2020",2020,"Udinese","Serie A","Ignacio Pussetto","ARG","FW,MF","23",1995,3.8,8,4,4,3,1,1,4,25,3,3,0,3,4,12,7,0,"https://fbref.com/en/players/62437b4f/Ignacio-Pussetto"
"5140","Samir Santos_2020",2020,"Udinese","Serie A","Samir Santos","BRA","DF","24",1994,17.2,35,27,24,8,3,12,23,52.2,11,16,6,10,33,68,64,1,"https://fbref.com/en/players/92b4758e/Samir-Santos"
"5141","Ken Sema_2020",2020,"Udinese","Serie A","Ken Sema","SWE","DF,MF","25",1993,27.3,59,41,43,15,1,36,68,52.9,32,26,6,20,17,76,41,1,"https://fbref.com/en/players/1770bd68/Ken-Sema"
"5142","Jens Stryger Larsen_2020",2020,"Udinese","Serie A","Jens Stryger Larsen","DEN","DF","28",1991,31,27,19,15,9,3,17,30,56.7,13,20,5,15,20,47,52,0,"https://fbref.com/en/players/f91e81c9/Jens-Stryger-Larsen"
"5143","Łukasz Teodorczyk_2020",2020,"Udinese","Serie A","Łukasz Teodorczyk","POL","FW","28",1991,2.5,7,5,1,5,1,3,7,42.9,4,2,0,2,0,7,1,0,"https://fbref.com/en/players/7e81a17d/Lukasz-Teodorczyk"
"5144","Hidde ter Avest_2020",2020,"Udinese","Serie A","Hidde ter Avest","NED","DF","22",1997,7.6,18,9,13,3,2,14,17,82.4,3,6,1,5,9,27,27,0,"https://fbref.com/en/players/18f9dbd0/Hidde-ter-Avest"
"5145","William Troost-Ekong_2020",2020,"Udinese","Serie A","William Troost-Ekong","NGA","DF","25",1993,28.6,37,19,25,12,0,10,18,55.6,8,41,29,12,31,68,135,2,"https://fbref.com/en/players/7ed4921e/William-Troost-Ekong"
"5146","Walace_2020",2020,"Udinese","Serie A","Walace","BRA","MF","24",1995,12.7,28,9,19,6,3,13,42,31,29,14,6,8,33,61,19,0,"https://fbref.com/en/players/26db8853/Walace"
"5147","Marvin Zeegelaar_2020",2020,"Udinese","Serie A","Marvin Zeegelaar","NED","DF","28",1990,6.6,15,9,8,4,3,6,11,54.5,5,9,2,7,5,20,10,0,"https://fbref.com/en/players/8abd0c03/Marvin-Zeegelaar"
"5148","Suleiman Abdullahi_2020",2020,"Union Berlin","Bundesliga","Suleiman Abdullahi","NGA","FW,MF","22",1996,1.7,0,0,0,0,0,0,3,0,3,2,1,1,1,1,1,0,"https://fbref.com/en/players/abf0cad0/Suleiman-Abdullahi"
"5149","Sebastian Andersson_2020",2020,"Union Berlin","Bundesliga","Sebastian Andersson","SWE","FW","28",1991,29.8,20,10,0,12,8,4,19,21.1,15,19,3,16,5,25,36,0,"https://fbref.com/en/players/b4cf5806/Sebastian-Andersson"
"5150","Robert Andrich_2020",2020,"Union Berlin","Bundesliga","Robert Andrich","GER","MF","24",1994,28.6,52,27,28,18,6,19,60,31.7,41,27,7,20,47,99,36,0,"https://fbref.com/en/players/e0b113a7/Robert-Andrich"
"5151","Sheraldo Becker_2020",2020,"Union Berlin","Bundesliga","Sheraldo Becker","SUR","MF,FW","24",1995,6,2,1,2,0,0,1,3,33.3,2,1,0,1,0,2,1,0,"https://fbref.com/en/players/8eb55dbb/Sheraldo-Becker"
"5152","Marius Bülter_2020",2020,"Union Berlin","Bundesliga","Marius Bülter","GER","MF,FW","26",1993,25.8,38,22,19,13,6,17,54,31.5,37,37,3,34,11,49,20,1,"https://fbref.com/en/players/ab5b7dc1/Marius-Bulter"
"5153","Marvin Friedrich_2020",2020,"Union Berlin","Bundesliga","Marvin Friedrich","GER","DF","23",1995,31,45,31,30,14,1,12,37,32.4,25,46,24,22,42,87,110,0,"https://fbref.com/en/players/b77f44a4/Marvin-Friedrich"
"5154","Christian Gentner_2020",2020,"Union Berlin","Bundesliga","Christian Gentner","GER","MF","33",1985,27.1,53,28,16,32,5,22,73,30.1,51,46,8,38,54,107,50,0,"https://fbref.com/en/players/a4f94a0d/Christian-Gentner"
"5155","Rafał Gikiewicz_2020",2020,"Union Berlin","Bundesliga","Rafał Gikiewicz","POL","GK","31",1987,33,1,0,1,0,0,1,4,25,3,0,0,0,2,3,26,4,"https://fbref.com/en/players/17376543/Rafal-Gikiewicz"
"5156","Akaki Gogia_2020",2020,"Union Berlin","Bundesliga","Akaki Gogia","GER","MF,FW","27",1992,1.3,2,1,0,0,2,0,2,0,2,2,2,0,0,2,0,0,"https://fbref.com/en/players/deee6467/Akaki-Gogia"
"5157","Florian Hübner_2020",2020,"Union Berlin","Bundesliga","Florian Hübner","GER","DF","28",1991,9.4,16,14,12,4,0,7,17,41.2,10,11,7,4,16,32,39,0,"https://fbref.com/en/players/e87ad81a/Florian-Hubner"
"5158","Marcus Ingvartsen_2020",2020,"Union Berlin","Bundesliga","Marcus Ingvartsen","DEN","MF,FW","23",1996,19.1,20,14,5,7,8,9,28,32.1,19,16,1,15,16,36,16,0,"https://fbref.com/en/players/271b8617/Marcus-Ingvartsen"
"5159","Felix Kroos_2020",2020,"Union Berlin","Bundesliga","Felix Kroos","GER","MF,DF","28",1991,4.2,17,9,9,6,2,8,15,53.3,7,6,3,3,3,20,13,1,"https://fbref.com/en/players/4d7faad1/Felix-Kroos"
"5160","Christopher Lenz_2020",2020,"Union Berlin","Bundesliga","Christopher Lenz","GER","DF,MF","24",1994,25.2,63,37,37,20,6,26,49,53.1,23,46,11,35,43,106,65,0,"https://fbref.com/en/players/bbd86530/Christopher-Lenz"
"5161","Yunus Mallı_2020",2020,"Union Berlin","Bundesliga","Yunus Mallı","TUR","MF,FW","27",1992,7.5,8,3,1,5,2,5,10,50,5,2,0,2,7,15,7,0,"https://fbref.com/en/players/f3722c97/Yunus-Malli"
"5162","Joshua Mees_2020",2020,"Union Berlin","Bundesliga","Joshua Mees","GER","MF,FW","23",1996,3.6,8,5,3,4,1,4,12,33.3,8,3,0,3,2,10,4,0,"https://fbref.com/en/players/4b6dd263/Joshua-Mees"
"5163","Moritz Nicolas_2020",2020,"Union Berlin","Bundesliga","Moritz Nicolas","GER","GK","21",1997,1,0,0,0,0,0,0,0,NA,0,0,0,0,0,0,0,0,"https://fbref.com/en/players/226ddf9d/Moritz-Nicolas"
"5164","Michael Parensen_2020",2020,"Union Berlin","Bundesliga","Michael Parensen","GER","DF","33",1986,7,11,6,5,6,0,5,10,50,5,14,8,6,12,23,17,0,"https://fbref.com/en/players/3acad81a/Michael-Parensen"
"5165","Sebastian Polter_2020",2020,"Union Berlin","Bundesliga","Sebastian Polter","GER","FW","28",1991,3.7,2,2,0,1,1,1,3,33.3,2,2,0,2,1,3,1,0,"https://fbref.com/en/players/3745e8bd/Sebastian-Polter"
"5166","Grischa Prömel_2020",2020,"Union Berlin","Bundesliga","Grischa Prömel","GER","MF","24",1995,10.3,14,11,6,6,2,7,19,36.8,12,10,2,8,14,28,9,0,"https://fbref.com/en/players/924f9191/Grischa-Promel"
"5167","Ken Reichel_2020",2020,"Union Berlin","Bundesliga","Ken Reichel","GER","DF","32",1986,5.9,6,3,2,3,1,3,13,23.1,10,8,1,7,9,15,12,0,"https://fbref.com/en/players/e881ed15/Ken-Reichel"
"5168","Julian Ryerson_2020",2020,"Union Berlin","Bundesliga","Julian Ryerson","NOR","DF,MF","21",1997,4.1,7,5,2,1,4,3,6,50,3,5,3,2,5,12,9,0,"https://fbref.com/en/players/009a4f60/Julian-Ryerson"
"5169","Keven Schlotterbeck_2020",2020,"Union Berlin","Bundesliga","Keven Schlotterbeck","GER","DF","22",1997,21.5,52,27,36,15,1,17,29,58.6,12,40,21,19,40,92,113,1,"https://fbref.com/en/players/f6bdc830/Keven-Schlotterbeck"
"5170","Manuel Schmiedebach_2020",2020,"Union Berlin","Bundesliga","Manuel Schmiedebach","GER","MF","30",1988,2,4,1,0,3,1,1,7,14.3,6,1,1,0,3,7,3,0,"https://fbref.com/en/players/d8f5dc3d/Manuel-Schmiedebach"
"5171","Neven Subotić_2020",2020,"Union Berlin","Bundesliga","Neven Subotić","SRB","DF","30",1988,21.8,30,18,12,16,2,8,32,25,24,21,8,13,34,64,89,0,"https://fbref.com/en/players/821233cc/Neven-Subotic"
"5172","Christopher Trimmel_2020",2020,"Union Berlin","Bundesliga","Christopher Trimmel","AUT","DF,MF","32",1987,31.8,71,41,35,32,4,32,54,59.3,22,31,10,21,51,122,88,1,"https://fbref.com/en/players/056d2d95/Christopher-Trimmel"
"5173","Anthony Ujah_2020",2020,"Union Berlin","Bundesliga","Anthony Ujah","NGA","FW,MF","28",1990,10.5,8,6,4,2,2,1,6,16.7,5,0,0,0,3,11,10,0,"https://fbref.com/en/players/99be8fb5/Anthony-Ujah"
"5174","Denis Cheryshev_2020",2020,"Valencia","La Liga","Denis Cheryshev","RUS","MF,FW","28",1990,10.3,16,9,5,4,7,3,17,17.6,14,15,1,14,7,23,10,0,"https://fbref.com/en/players/0ac94a23/Denis-Cheryshev"
"5175","Jasper Cillessen_2020",2020,"Valencia","La Liga","Jasper Cillessen","NED","GK","30",1989,23.3,0,0,0,0,0,0,1,0,1,0,0,0,3,3,3,1,"https://fbref.com/en/players/04ac8285/Jasper-Cillessen"
"5176","Francis Coquelin_2020",2020,"Valencia","La Liga","Francis Coquelin","FRA","MF","28",1991,21.2,37,21,25,11,1,16,38,42.1,22,19,9,10,38,75,25,0,"https://fbref.com/en/players/a6951bf8/Francis-Coquelin"
"5177","Thierry Correia_2020",2020,"Valencia","La Liga","Thierry Correia","POR","DF","20",1999,2.9,8,3,5,3,0,1,2,50,1,5,0,5,2,10,10,0,"https://fbref.com/en/players/c78b352d/Thierry-Correia"
"5178","Jaume Costa_2020",2020,"Valencia","La Liga","Jaume Costa","ESP","DF","31",1988,15.4,27,23,17,8,2,14,28,50,14,11,6,5,24,51,52,1,"https://fbref.com/en/players/808d48f3/Jaume-Costa"
"5179","Mouctar Diakhaby_2020",2020,"Valencia","La Liga","Mouctar Diakhaby","GUI","DF","22",1996,16,11,8,7,3,1,5,8,62.5,3,17,15,2,11,22,73,0,"https://fbref.com/en/players/d2110326/Mouctar-Diakhaby"
"5180","Jaume Doménech_2020",2020,"Valencia","La Liga","Jaume Doménech","ESP","GK","28",1990,14.7,0,0,0,0,0,0,1,0,1,0,0,0,1,1,3,1,"https://fbref.com/en/players/c9cb972b/Jaume-Domenech"
"5181","Vicente Esquerdo_2020",2020,"Valencia","La Liga","Vicente Esquerdo","ESP","MF,FW","20",1999,0.2,1,0,1,0,0,0,0,NA,0,1,0,1,0,1,1,0,"https://fbref.com/en/players/ced26057/Vicente-Esquerdo"
"5182","Alessandro Florenzi_2020",2020,"Valencia","La Liga","Alessandro Florenzi","ITA","DF","28",1991,8.4,13,9,9,4,0,8,18,44.4,10,11,1,10,14,27,21,0,"https://fbref.com/en/players/e288d4b3/Alessandro-Florenzi"
"5183","Kévin Gameiro_2020",2020,"Valencia","La Liga","Kévin Gameiro","FRA","FW","32",1987,17.6,17,9,7,6,4,5,21,23.8,16,10,1,9,5,22,5,0,"https://fbref.com/en/players/42276181/Kevin-Gameiro"
"5184","Ezequiel Garay_2020",2020,"Valencia","La Liga","Ezequiel Garay","ARG","DF","32",1986,16,12,8,9,2,1,7,11,63.6,4,19,17,2,14,26,71,0,"https://fbref.com/en/players/ac3fb1be/Ezequiel-Garay"
"5185","Maxi Gómez_2020",2020,"Valencia","La Liga","Maxi Gómez","URU","FW","22",1996,23.8,9,7,1,6,2,4,8,50,4,8,1,7,5,14,14,0,"https://fbref.com/en/players/4c2e9442/Maxi-Gomez"
"5186","Gonçalo Guedes_2020",2020,"Valencia","La Liga","Gonçalo Guedes","POR","MF,FW","22",1996,14.1,19,11,11,7,1,9,32,28.1,23,10,1,9,7,26,1,0,"https://fbref.com/en/players/e6bc67d7/Goncalo-Guedes"
"5187","Adrián Guerrero_2020",2020,"Valencia","La Liga","Adrián Guerrero","ESP","DF","21",1998,1.4,2,2,1,1,0,2,3,66.7,1,0,0,0,2,4,1,0,"https://fbref.com/en/players/58a3a572/Adrian-Guerrero"
"5188","Hugo Guillamón_2020",2020,"Valencia","La Liga","Hugo Guillamón","ESP","DF","19",2000,5.5,8,3,5,2,1,5,10,50,5,3,2,1,5,13,29,0,"https://fbref.com/en/players/f7c12fbf/Hugo-Guillamon"
"5189","Lee Kangin_2020",2020,"Valencia","La Liga","Lee Kangin","KOR","MF,FW","18",2001,5,3,1,0,2,1,3,6,50,3,5,0,5,3,6,0,0,"https://fbref.com/en/players/8455ad90/Lee-Kangin"
"5190","Geoffrey Kondogbia_2020",2020,"Valencia","La Liga","Geoffrey Kondogbia","CTA","MF","26",1993,20.1,63,40,40,18,5,19,51,37.3,32,25,6,19,57,120,36,2,"https://fbref.com/en/players/cce181df/Geoffrey-Kondogbia"
"5191","José Luis Gayà_2020",2020,"Valencia","La Liga","José Luis Gayà","ESP","DF","24",1995,22.1,44,30,29,12,3,28,41,68.3,13,22,9,13,18,62,48,1,"https://fbref.com/en/players/b05e2dbd/Jose-Luis-Gaya"
"5192","Eliaquim Mangala_2020",2020,"Valencia","La Liga","Eliaquim Mangala","FRA","DF","28",1991,7.5,4,4,3,1,0,1,2,50,1,7,6,1,7,11,40,0,"https://fbref.com/en/players/f520049f/Eliaquim-Mangala"
"5193","Daniel Parejo_2020",2020,"Valencia","La Liga","Daniel Parejo","ESP","MF","30",1989,33.6,67,41,29,32,6,32,101,31.7,69,38,11,27,22,89,20,2,"https://fbref.com/en/players/7460ca0d/Daniel-Parejo"
"5194","Gabriel Paulista_2020",2020,"Valencia","La Liga","Gabriel Paulista","BRA","DF","28",1990,31.1,22,14,17,2,3,15,25,60,10,36,29,7,48,70,151,3,"https://fbref.com/en/players/b7ca5c51/Gabriel-Paulista"
"5195","Cristiano Piccini_2020",2020,"Valencia","La Liga","Cristiano Piccini","ITA","DF","26",1992,0.8,5,4,1,0,4,4,4,100,0,0,0,0,2,7,1,0,"https://fbref.com/en/players/32c0491f/Cristiano-Piccini"
"5196","Rodrigo_2020",2020,"Valencia","La Liga","Rodrigo","ESP","FW","28",1991,20.9,10,6,4,5,1,2,23,8.7,21,9,1,8,9,19,13,0,"https://fbref.com/en/players/1fb1c435/Rodrigo"
"5197","Rubén Sobrino_2020",2020,"Valencia","La Liga","Rubén Sobrino","ESP","FW,MF","27",1992,1.9,7,5,3,2,2,2,3,66.7,1,1,0,1,0,7,1,0,"https://fbref.com/en/players/19b776e9/Ruben-Sobrino"
"5198","Carlos Soler_2020",2020,"Valencia","La Liga","Carlos Soler","ESP","MF","22",1997,23,21,10,10,10,1,9,39,23.1,30,16,6,10,9,30,14,0,"https://fbref.com/en/players/fed17f5a/Carlos-Soler"
"5199","Ferrán Torres_2020",2020,"Valencia","La Liga","Ferrán Torres","ESP","MF,FW","19",2000,25,23,15,6,16,1,8,30,26.7,22,20,3,17,14,37,12,0,"https://fbref.com/en/players/9e1035f8/Ferran-Torres"
"5200","Manu Vallejo_2020",2020,"Valencia","La Liga","Manu Vallejo","ESP","MF,FW","22",1997,4.6,7,3,0,3,4,5,9,55.6,4,4,0,4,2,9,2,0,"https://fbref.com/en/players/0bc4e720/Manu-Vallejo"
"5201","Daniel Wass_2020",2020,"Valencia","La Liga","Daniel Wass","DEN","DF,MF","30",1989,30.4,44,25,25,13,6,25,57,43.9,32,22,5,17,31,75,91,1,"https://fbref.com/en/players/d83bbc54/Daniel-Wass"
"5202","Rubén Alcaraz_2020",2020,"Valladolid","La Liga","Rubén Alcaraz","ESP","MF","28",1991,21.4,61,30,37,20,4,30,63,47.6,33,46,15,31,15,76,41,0,"https://fbref.com/en/players/036bba5f/Ruben-Alcaraz"
"5203","Antoñito_2020",2020,"Valladolid","La Liga","Antoñito","ESP","DF,MF","31",1987,11.4,26,18,19,7,0,12,20,60,8,9,0,9,15,41,20,1,"https://fbref.com/en/players/dbe519cf/Antonito"
"5204","Anuar_2020",2020,"Valladolid","La Liga","Anuar","MAR","MF,FW","24",1995,2.1,4,2,1,2,1,2,6,33.3,4,7,3,4,5,9,0,0,"https://fbref.com/en/players/c93231dc/Anuar"
"5205","Federico Barba_2020",2020,"Valladolid","La Liga","Federico Barba","ITA","DF","25",1993,5,12,6,10,2,0,7,9,77.8,2,5,2,3,8,20,12,0,"https://fbref.com/en/players/c010b898/Federico-Barba"
"5206","Hatem Ben Arfa_2020",2020,"Valladolid","La Liga","Hatem Ben Arfa","FRA","MF,FW","32",1987,1.8,0,0,0,0,0,0,4,0,4,1,0,1,0,0,0,0,"https://fbref.com/en/players/74dc806c/Hatem-Ben-Arfa"
"5207","Churripi_2020",2020,"Valladolid","La Liga","Churripi","ESP","GK","25",1994,2.7,1,1,1,0,0,1,1,100,0,0,0,0,0,1,2,0,"https://fbref.com/en/players/81a606fc/Churripi"
"5208","Matheus Fernandes_2020",2020,"Valladolid","La Liga","Matheus Fernandes","BRA","MF,FW","21",1998,1.8,6,2,2,2,2,3,5,60,2,4,0,4,2,8,2,0,"https://fbref.com/en/players/f76fdcd2/Matheus-Fernandes"
"5209","Joaquín Fernández_2020",2020,"Valladolid","La Liga","Joaquín Fernández","ESP","MF,DF","23",1996,18.4,30,24,17,10,3,9,30,30,21,14,10,4,32,62,57,0,"https://fbref.com/en/players/b86a64b2/Joaquin-Fernandez"
"5210","Jorge de Frutos_2020",2020,"Valladolid","La Liga","Jorge de Frutos","ESP","MF,DF","22",1997,0.7,2,2,2,0,0,1,2,50,1,0,0,0,0,2,1,0,"https://fbref.com/en/players/38ce1150/Jorge-de-Frutos"
"5211","Raúl García_2020",2020,"Valladolid","La Liga","Raúl García","ESP","DF,MF","30",1989,11.2,20,12,11,7,2,9,22,40.9,13,12,2,10,8,28,30,0,"https://fbref.com/en/players/1a317a1b/Raul-Garcia"
"5212","Víctor García_2020",2020,"Valladolid","La Liga","Víctor García","ESP","FW,MF","22",1997,1,0,0,0,0,0,0,1,0,1,1,0,1,0,0,1,0,"https://fbref.com/en/players/6636496a/Victor-Garcia"
"5213","Sergi Guardiola_2020",2020,"Valladolid","La Liga","Sergi Guardiola","ESP","FW","28",1991,29.5,14,6,3,7,4,4,24,16.7,20,23,0,23,6,20,18,1,"https://fbref.com/en/players/32974271/Sergi-Guardiola"
"5214","Pablo Hervías_2020",2020,"Valladolid","La Liga","Pablo Hervías","ESP","MF,FW","26",1993,11.3,24,20,8,14,2,12,22,54.5,10,8,0,8,5,29,0,0,"https://fbref.com/en/players/ba5a9545/Pablo-Hervias"
"5215","Jordi Masip_2020",2020,"Valladolid","La Liga","Jordi Masip","ESP","GK","30",1989,35,1,1,1,0,0,0,2,0,2,0,0,0,1,2,7,3,"https://fbref.com/en/players/8fae77ea/Jordi-Masip"
"5216","Míchel_2020",2020,"Valladolid","La Liga","Míchel","ESP","MF","31",1988,24.2,50,28,26,19,5,22,75,29.3,53,22,4,18,33,83,41,1,"https://fbref.com/en/players/418f8f61/Michel"
"5217","Miguel_2020",2020,"Valladolid","La Liga","Miguel","ESP","FW","19",1999,2.6,2,1,1,0,1,1,2,50,1,3,1,2,0,2,1,0,"https://fbref.com/en/players/6763373d/Miguel"
"5218","Javi Moyano_2020",2020,"Valladolid","La Liga","Javi Moyano","ESP","DF","33",1986,24.7,19,8,11,8,0,8,20,40,12,18,5,13,27,46,63,0,"https://fbref.com/en/players/933e8c8a/Javi-Moyano"
"5219","Nacho_2020",2020,"Valladolid","La Liga","Nacho","ESP","DF","30",1989,21,43,22,24,15,4,17,48,35.4,31,36,8,28,25,68,61,0,"https://fbref.com/en/players/e29d1111/Nacho"
"5220","Kiko Olivas_2020",2020,"Valladolid","La Liga","Kiko Olivas","ESP","DF","30",1988,32.7,33,16,25,7,1,13,35,37.1,22,30,16,14,61,94,112,2,"https://fbref.com/en/players/72b07a9c/Kiko-Olivas"
"5221","Kike Pérez_2020",2020,"Valladolid","La Liga","Kike Pérez","ESP","MF,FW","22",1997,2.4,6,1,1,3,2,3,7,42.9,4,1,0,1,10,16,4,0,"https://fbref.com/en/players/237a3851/Kike-Perez"
"5222","Samu Pérez_2020",2020,"Valladolid","La Liga","Samu Pérez","ESP","GK","22",1997,0.3,0,0,0,0,0,0,0,NA,0,0,0,0,0,0,0,0,"https://fbref.com/en/players/aae17c81/Samu-Perez"
"5223","Óscar Plano_2020",2020,"Valladolid","La Liga","Óscar Plano","ESP","MF","28",1991,27.8,48,30,25,19,4,20,61,32.8,41,36,3,33,35,83,29,0,"https://fbref.com/en/players/7c388b20/Oscar-Plano"
"5224","Pedro Porro_2020",2020,"Valladolid","La Liga","Pedro Porro","ESP","DF,MF","19",1999,8.2,18,10,11,7,0,10,18,55.6,8,3,0,3,7,25,19,1,"https://fbref.com/en/players/27d0a506/Pedro-Porro"
"5225","Sandro Ramírez_2020",2020,"Valladolid","La Liga","Sandro Ramírez","ESP","FW,MF","24",1995,14.5,12,10,2,6,4,2,20,10,18,11,1,10,7,19,2,0,"https://fbref.com/en/players/833fb62e/Sandro-Ramirez"
"5226","Waldo Rubio_2020",2020,"Valladolid","La Liga","Waldo Rubio","ESP","MF,FW","23",1995,9.8,13,8,10,3,0,5,31,16.1,26,12,0,12,7,20,7,0,"https://fbref.com/en/players/ccaa5728/Waldo-Rubio"
"5227","Mohammed Salisu_2020",2020,"Valladolid","La Liga","Mohammed Salisu","GHA","DF","20",1999,30.3,41,24,28,13,0,21,34,61.8,13,32,26,6,35,76,158,3,"https://fbref.com/en/players/0b33f6ad/Mohammed-Salisu"
"5228","Fede San Emeterio_2020",2020,"Valladolid","La Liga","Fede San Emeterio","ESP","MF","22",1997,19.5,26,13,18,6,2,7,29,24.1,22,20,8,12,28,54,13,1,"https://fbref.com/en/players/efecd633/Fede-San-Emeterio"
"5229","Javi Sánchez_2020",2020,"Valladolid","La Liga","Javi Sánchez","ESP","DF","22",1997,5.5,5,4,3,2,0,1,3,33.3,2,4,2,2,4,9,24,0,"https://fbref.com/en/players/60359288/Javi-Sanchez"
"5230","Enes Ünal_2020",2020,"Valladolid","La Liga","Enes Ünal","TUR","FW","22",1997,26,20,12,6,11,3,6,28,21.4,22,17,5,12,6,26,13,0,"https://fbref.com/en/players/f8eca1b6/Enes-Unal"
"5231","Toni Villa_2020",2020,"Valladolid","La Liga","Toni Villa","ESP","MF","24",1995,15,31,16,13,14,4,13,50,26,37,16,1,15,8,39,11,0,"https://fbref.com/en/players/636eae97/Toni-Villa"
"5232","Raúl Albiol_2020",2020,"Villarreal","La Liga","Raúl Albiol","ESP","DF","33",1985,36,43,23,27,16,0,18,27,66.7,9,29,21,8,42,85,175,2,"https://fbref.com/en/players/4bd414c1/Raul-Albiol"
"5233","Paco Alcácer_2020",2020,"Villarreal","La Liga","Paco Alcácer","ESP","FW","25",1993,10.3,3,3,2,1,0,1,7,14.3,6,4,1,3,2,5,10,0,"https://fbref.com/en/players/a7a9d95a/Paco-Alcacer"
"5234","Sergio Asenjo_2020",2020,"Villarreal","La Liga","Sergio Asenjo","ESP","GK","30",1989,34,0,0,0,0,0,0,2,0,2,0,0,0,1,1,15,1,"https://fbref.com/en/players/9f0ea33f/Sergio-Asenjo"
"5235","Carlos Bacca_2020",2020,"Villarreal","La Liga","Carlos Bacca","COL","FW","32",1986,7.6,5,1,1,2,2,2,6,33.3,4,4,0,4,0,5,7,0,"https://fbref.com/en/players/09a9e921/Carlos-Bacca"
"5236","Alex Baena_2020",2020,"Villarreal","La Liga","Alex Baena","ESP","MF","18",2001,0.2,0,0,0,0,0,0,0,NA,0,1,0,1,0,0,0,0,"https://fbref.com/en/players/518f2234/Alex-Baena"
"5237","Santi Cazorla_2020",2020,"Villarreal","La Liga","Santi Cazorla","ESP","MF","34",1984,27.2,48,25,14,21,13,20,57,35.1,37,23,1,22,19,67,16,2,"https://fbref.com/en/players/e2e9c250/Santi-Cazorla"
"5238","Sofian Chakla_2020",2020,"Villarreal","La Liga","Sofian Chakla","MAR","DF","25",1993,2,0,0,0,0,0,0,1,0,1,2,1,1,3,3,7,1,"https://fbref.com/en/players/37f04799/Sofian-Chakla"
"5239","Samuel Chukwueze_2020",2020,"Villarreal","La Liga","Samuel Chukwueze","NGA","FW,MF","20",1999,22.8,23,14,12,6,5,13,30,43.3,17,15,1,14,10,33,14,1,"https://fbref.com/en/players/b8a642fc/Samuel-Chukwueze"
"5240","Andrés Fernández_2020",2020,"Villarreal","La Liga","Andrés Fernández","ESP","GK","32",1986,4,0,0,0,0,0,0,0,NA,0,0,0,0,0,0,2,0,"https://fbref.com/en/players/307fcd26/Andres-Fernandez"
"5241","Ramiro Funes Mori_2020",2020,"Villarreal","La Liga","Ramiro Funes Mori","ARG","DF","28",1991,5,5,2,2,3,0,0,2,0,2,8,2,6,3,8,9,1,"https://fbref.com/en/players/89cbc961/Ramiro-Funes-Mori"
"5242","Mario Gaspar_2020",2020,"Villarreal","La Liga","Mario Gaspar","ESP","DF","28",1990,21.8,35,20,16,16,3,15,31,48.4,16,25,10,15,26,61,69,0,"https://fbref.com/en/players/fb5d47b3/Mario-Gaspar"
"5243","Moi Gómez_2020",2020,"Villarreal","La Liga","Moi Gómez","ESP","FW,MF","25",1994,25.8,30,22,9,14,7,11,33,33.3,22,22,2,20,25,55,23,0,"https://fbref.com/en/players/5a626448/Moi-Gomez"
"5244","Vicente Iborra_2020",2020,"Villarreal","La Liga","Vicente Iborra","ESP","MF","31",1988,29.4,61,42,31,25,5,30,67,44.8,37,35,16,19,40,101,63,1,"https://fbref.com/en/players/ad1ffcfd/Vicente-Iborra"
"5245","Alberto Moreno_2020",2020,"Villarreal","La Liga","Alberto Moreno","ESP","DF","27",1992,16.3,27,16,15,11,1,9,25,36,16,15,3,12,25,52,36,0,"https://fbref.com/en/players/11b9265b/Alberto-Moreno"
"5246","Gerard Moreno_2020",2020,"Villarreal","La Liga","Gerard Moreno","ESP","FW,MF","27",1992,30.5,19,8,4,10,5,5,46,10.9,41,19,3,16,10,29,51,0,"https://fbref.com/en/players/81f0781e/Gerard-Moreno"
"5247","Manu Morlanes_2020",2020,"Villarreal","La Liga","Manu Morlanes","ESP","MF","20",1999,2.8,7,3,3,4,0,2,9,22.2,7,1,1,0,2,9,2,0,"https://fbref.com/en/players/a0255c67/Manu-Morlanes"
"5248","Fernando Niño_2020",2020,"Villarreal","La Liga","Fernando Niño","ESP","FW","18",2000,0.9,1,0,0,1,0,1,2,50,1,0,0,0,0,1,2,0,"https://fbref.com/en/players/81d5c497/Fernando-Nino"
"5249","Javier Ontiveros_2020",2020,"Villarreal","La Liga","Javier Ontiveros","ESP","FW,MF","21",1997,9.9,29,14,13,14,2,8,35,22.9,27,13,1,12,5,34,7,0,"https://fbref.com/en/players/a83d8b0c/Javier-Ontiveros"
"5250","Rubén Peña_2020",2020,"Villarreal","La Liga","Rubén Peña","ESP","DF","28",1991,21.2,42,24,23,19,0,17,50,34,33,25,8,17,35,77,58,2,"https://fbref.com/en/players/1f079188/Ruben-Pena"
"5251","Xavi Quintillà_2020",2020,"Villarreal","La Liga","Xavi Quintillà","ESP","DF","22",1996,17.5,22,12,14,4,4,10,20,50,10,11,4,7,12,34,35,0,"https://fbref.com/en/players/84fb6aff/Xavi-Quintilla"
"5252","Bruno Soriano_2020",2020,"Villarreal","La Liga","Bruno Soriano","ESP","MF,FW","35",1984,2.9,4,0,1,2,1,1,1,100,0,4,0,4,1,5,7,0,"https://fbref.com/en/players/09332647/Bruno-Soriano"
"5253","Karl Toko Ekambi_2020",2020,"Villarreal","La Liga","Karl Toko Ekambi","CMR","FW","26",1992,11,5,3,0,3,2,1,4,25,3,2,0,2,3,8,2,0,"https://fbref.com/en/players/5ceba7fc/Karl-Toko-Ekambi"
"5254","Pau Torres_2020",2020,"Villarreal","La Liga","Pau Torres","ESP","DF","22",1997,33,34,21,24,10,0,16,24,66.7,8,39,23,16,27,61,153,1,"https://fbref.com/en/players/532e1e4f/Pau-Torres"
"5255","Manu Trigueros_2020",2020,"Villarreal","La Liga","Manu Trigueros","ESP","MF","27",1991,17.2,34,21,10,17,7,12,45,26.7,33,23,12,11,4,38,21,0,"https://fbref.com/en/players/963829d0/Manu-Trigueros"
"5256","Andre-Frank Zambo Anguissa_2020",2020,"Villarreal","La Liga","Andre-Frank Zambo Anguissa","CMR","MF","23",1995,28.7,76,49,29,40,7,26,78,33.3,52,42,6,36,44,120,30,0,"https://fbref.com/en/players/6bb2c084/Andre-Frank-Zambo-Anguissa"
"5257","Étienne Capoue_2020",2020,"Watford","Premier League","Étienne Capoue","FRA","MF","31",1988,29.2,75,40,38,30,7,37,85,43.5,48,30,11,19,68,143,61,0,"https://fbref.com/en/players/5acc4a10/Etienne-Capoue"
"5258","Craig Cathcart_2020",2020,"Watford","Premier League","Craig Cathcart","NIR","DF","30",1989,27.6,41,26,25,15,1,10,24,41.7,14,19,16,3,25,66,136,1,"https://fbref.com/en/players/89e4b358/Craig-Cathcart"
"5259","Nathaniel Chalobah_2020",2020,"Watford","Premier League","Nathaniel Chalobah","ENG","MF","24",1994,10.3,30,11,13,13,4,12,27,44.4,15,10,4,6,18,48,20,0,"https://fbref.com/en/players/422862ea/Nathaniel-Chalobah"
"5260","Tom Cleverley_2020",2020,"Watford","Premier League","Tom Cleverley","ENG","MF","29",1989,10.8,28,15,8,14,6,9,36,25,27,13,1,12,10,38,15,0,"https://fbref.com/en/players/6cdd8245/Tom-Cleverley"
"5261","Craig Dawson_2020",2020,"Watford","Premier League","Craig Dawson","ENG","DF","29",1990,26.2,29,18,16,13,0,17,31,54.8,14,41,32,9,34,63,116,0,"https://fbref.com/en/players/3e9e06cb/Craig-Dawson"
"5262","Troy Deeney_2020",2020,"Watford","Premier League","Troy Deeney","ENG","FW","31",1988,24.7,19,12,6,10,3,6,29,20.7,23,13,1,12,11,30,27,0,"https://fbref.com/en/players/82e34b69/Troy-Deeney"
"5263","Gerard Deulofeu_2020",2020,"Watford","Premier League","Gerard Deulofeu","ESP","FW","25",1994,23.3,33,16,18,9,6,12,59,20.3,47,10,0,10,25,58,6,0,"https://fbref.com/en/players/39583cfd/Gerard-Deulofeu"
"5264","Abdoulaye Doucouré_2020",2020,"Watford","Premier League","Abdoulaye Doucouré","MLI","MF","26",1993,35.1,64,30,29,29,6,16,57,28.1,41,46,8,38,31,95,32,0,"https://fbref.com/en/players/02b29014/Abdoulaye-Doucoure"
"5265","Kiko Femenía_2020",2020,"Watford","Premier League","Kiko Femenía","ESP","DF","28",1991,24.9,68,38,49,17,2,43,80,53.8,37,16,2,14,36,104,49,0,"https://fbref.com/en/players/e5d01ecf/Kiko-Femenia"
"5266","Ben Foster_2020",2020,"Watford","Premier League","Ben Foster","ENG","GK","36",1983,38,1,0,1,0,0,1,3,33.3,2,1,0,1,0,1,16,2,"https://fbref.com/en/players/d0b3ceb9/Ben-Foster"
"5267","Dimitri Foulquier_2020",2020,"Watford","Premier League","Dimitri Foulquier","FRA","DF,MF","26",1993,0.7,1,0,1,0,0,0,0,NA,0,1,0,1,2,3,2,0,"https://fbref.com/en/players/45e17712/Dimitri-Foulquier"
"5268","Andre Gray_2020",2020,"Watford","Premier League","Andre Gray","JAM","FW","28",1991,8.4,4,3,0,2,2,1,3,33.3,2,4,1,3,1,5,2,0,"https://fbref.com/en/players/c24dba2a/Andre-Gray"
"5269","José Holebas_2020",2020,"Watford","Premier League","José Holebas","GRE","DF","35",1984,11.4,26,15,19,7,0,9,28,32.1,19,11,4,7,3,29,33,0,"https://fbref.com/en/players/12aa7661/Jose-Holebas"
"5270","Will Hughes_2020",2020,"Watford","Premier League","Will Hughes","ENG","MF","24",1995,25,75,47,24,41,10,25,67,37.3,42,48,8,40,37,112,28,0,"https://fbref.com/en/players/a0666d3e/Will-Hughes"
"5271","Daryl Janmaat_2020",2020,"Watford","Premier League","Daryl Janmaat","NED","DF","30",1989,6.7,14,10,8,6,0,6,13,46.2,7,7,2,5,7,21,23,0,"https://fbref.com/en/players/45da6694/Daryl-Janmaat"
"5272","João Pedro_2020",2020,"Watford","Premier League","João Pedro","BRA","FW,MF","17",2001,0.3,0,0,0,0,0,0,0,NA,0,0,0,0,0,0,0,0,"https://fbref.com/en/players/e8832875/Joao-Pedro"
"5273","Christian Kabasele_2020",2020,"Watford","Premier League","Christian Kabasele","BEL","DF","28",1991,25,37,24,26,11,0,17,32,53.1,15,31,23,8,36,73,127,0,"https://fbref.com/en/players/914ab9a1/Christian-Kabasele"
"5274","Adrian Mariappa_2020",2020,"Watford","Premier League","Adrian Mariappa","JAM","DF","32",1986,16.8,20,14,15,4,1,11,30,36.7,19,22,7,15,11,31,73,0,"https://fbref.com/en/players/8aa5f52c/Adrian-Mariappa"
"5275","Adam Masina_2020",2020,"Watford","Premier League","Adam Masina","MAR","DF","25",1994,20.2,38,22,24,11,3,14,37,37.8,23,26,12,14,28,66,66,0,"https://fbref.com/en/players/de0f152c/Adam-Masina"
"5276","Roberto Pereyra_2020",2020,"Watford","Premier League","Roberto Pereyra","ARG","FW,MF","28",1991,18.3,20,8,11,7,2,9,28,32.1,19,21,0,21,14,34,12,1,"https://fbref.com/en/players/75f2c59f/Roberto-Pereyra"
"5277","Sebastian Prödl_2020",2020,"Watford","Premier League","Sebastian Prödl","AUT","DF","32",1987,0.6,0,0,0,0,0,0,0,NA,0,0,0,0,0,0,4,0,"https://fbref.com/en/players/f5e6d08d/Sebastian-Prodl"
"5278","Ignacio Pussetto_2020",2020,"Watford","Premier League","Ignacio Pussetto","ARG","FW,MF","23",1995,0.8,7,4,4,2,1,3,8,37.5,5,2,1,1,3,10,4,0,"https://fbref.com/en/players/62437b4f/Ignacio-Pussetto"
"5279","Domingos Quina_2020",2020,"Watford","Premier League","Domingos Quina","POR","MF,FW","19",1999,0.2,2,0,1,1,0,1,2,50,1,3,0,3,0,2,0,0,"https://fbref.com/en/players/41fb0f4e/Domingos-Quina"
"5280","Ismaila Sarr_2020",2020,"Watford","Premier League","Ismaila Sarr","SEN","FW,MF","21",1998,22.5,11,10,5,2,4,5,23,21.7,18,9,1,8,18,29,10,0,"https://fbref.com/en/players/bfdb33aa/Ismaila-Sarr"
"5281","Isaac Success_2020",2020,"Watford","Premier League","Isaac Success","NGA","FW,MF","23",1996,0.8,0,0,0,0,0,0,0,NA,0,0,0,0,1,1,0,0,"https://fbref.com/en/players/f573a8bf/Isaac-Success"
"5282","Danny Welbeck_2020",2020,"Watford","Premier League","Danny Welbeck","ENG","FW,MF","28",1990,9.1,14,6,6,5,3,3,11,27.3,8,12,1,11,5,19,7,0,"https://fbref.com/en/players/ce5143da/Danny-Welbeck"
"5283","Ludwig Augustinsson_2020",2020,"Werder Bremen","Bundesliga","Ludwig Augustinsson","SWE","DF,MF","25",1994,10.3,29,12,15,9,5,12,23,52.2,11,19,5,14,10,39,29,0,"https://fbref.com/en/players/9fec8860/Ludwig-Augustinsson"
"5284","Philipp Bargfrede_2020",2020,"Werder Bremen","Bundesliga","Philipp Bargfrede","GER","MF","30",1989,6.5,15,12,8,5,2,6,23,26.1,17,8,2,6,16,31,15,0,"https://fbref.com/en/players/3f7cd8f1/Philipp-Bargfrede"
"5285","Fin Bartels_2020",2020,"Werder Bremen","Bundesliga","Fin Bartels","GER","MF,FW","32",1987,3.8,9,5,4,4,1,3,12,25,9,3,1,2,1,10,1,0,"https://fbref.com/en/players/acc7b7ec/Fin-Bartels"
"5286","Leonardo Bittencourt_2020",2020,"Werder Bremen","Bundesliga","Leonardo Bittencourt","GER","FW,MF","25",1993,21,52,28,23,18,11,9,51,17.6,42,20,3,17,12,64,14,0,"https://fbref.com/en/players/dc62fbee/Leonardo-Bittencourt"
"5287","Johannes Eggestein_2020",2020,"Werder Bremen","Bundesliga","Johannes Eggestein","GER","MF,FW","21",1998,5.7,8,6,2,2,4,3,12,25,9,6,0,6,2,10,4,0,"https://fbref.com/en/players/d571df78/Johannes-Eggestein"
"5288","Maximilian Eggestein_2020",2020,"Werder Bremen","Bundesliga","Maximilian Eggestein","GER","MF","22",1996,31.7,40,28,20,18,2,15,43,34.9,28,37,8,29,36,76,57,0,"https://fbref.com/en/players/beb882a8/Maximilian-Eggestein"
"5289","Marco Friedl_2020",2020,"Werder Bremen","Bundesliga","Marco Friedl","AUT","DF,MF","21",1998,24.3,61,39,42,15,4,29,54,53.7,25,29,9,20,34,95,78,0,"https://fbref.com/en/players/f86ad3f5/Marco-Friedl"
"5290","Niclas Füllkrug_2020",2020,"Werder Bremen","Bundesliga","Niclas Füllkrug","GER","FW","26",1993,4.5,2,2,1,1,0,1,3,33.3,2,3,0,3,3,5,6,0,"https://fbref.com/en/players/4f16405e/Niclas-Fullkrug"
"5291","Theodor Gebre Selassie_2020",2020,"Werder Bremen","Bundesliga","Theodor Gebre Selassie","CZE","DF,MF","32",1986,27,36,27,23,10,3,17,35,48.6,18,26,9,17,63,99,81,0,"https://fbref.com/en/players/3f65898c/Theodor-Gebre-Selassie"
"5292","Benjamin Goller_2020",2020,"Werder Bremen","Bundesliga","Benjamin Goller","GER","FW,MF","20",1999,3.2,8,3,3,4,1,3,10,30,7,3,0,3,1,9,1,0,"https://fbref.com/en/players/d5980989/Benjamin-Goller"
"5293","Christian Groß_2020",2020,"Werder Bremen","Bundesliga","Christian Groß","GER","DF,MF","30",1989,9.7,23,17,16,5,2,9,16,56.3,7,13,7,6,14,37,50,1,"https://fbref.com/en/players/14a7af33/Christian-Gross"
"5294","Martin Harnik_2020",2020,"Werder Bremen","Bundesliga","Martin Harnik","AUT","MF,FW","32",1987,0.1,0,0,0,0,0,0,0,NA,0,0,0,0,0,0,0,0,"https://fbref.com/en/players/99b7584f/Martin-Harnik"
"5295","Luc Ihorst_2020",2020,"Werder Bremen","Bundesliga","Luc Ihorst","GER","FW","19",2000,0.1,1,1,0,0,1,0,0,NA,0,1,0,1,0,1,0,0,"https://fbref.com/en/players/e5cad51e/Luc-Ihorst"
"5296","Stefanos Kapino_2020",2020,"Werder Bremen","Bundesliga","Stefanos Kapino","GRE","GK","25",1994,1,0,0,0,0,0,0,0,NA,0,0,0,0,1,1,0,0,"https://fbref.com/en/players/62ba5881/Stefanos-Kapino"
"5297","Davy Klaassen_2020",2020,"Werder Bremen","Bundesliga","Davy Klaassen","NED","MF","26",1993,32.6,55,43,19,23,13,19,57,33.3,38,46,18,28,38,93,45,2,"https://fbref.com/en/players/15fd5593/Davy-Klaassen"
"5298","Michael Lang_2020",2020,"Werder Bremen","Bundesliga","Michael Lang","SUI","DF,FW","28",1991,6,8,5,3,5,0,6,12,50,6,5,1,4,7,15,22,0,"https://fbref.com/en/players/864db10a/Michael-Lang"
"5299","Sebastian Langkamp_2020",2020,"Werder Bremen","Bundesliga","Sebastian Langkamp","GER","DF","31",1988,3.5,3,2,3,0,0,2,4,50,2,5,3,2,3,6,11,1,"https://fbref.com/en/players/74d70fb5/Sebastian-Langkamp"
"5300","Kevin Möhwald_2020",2020,"Werder Bremen","Bundesliga","Kevin Möhwald","GER","MF","26",1993,0.8,2,1,1,1,0,1,2,50,1,0,0,0,0,2,1,0,"https://fbref.com/en/players/a5ce09f2/Kevin-Mohwald"
"5301","Niklas Moisander_2020",2020,"Werder Bremen","Bundesliga","Niklas Moisander","FIN","DF","33",1985,22,27,15,19,6,2,11,26,42.3,15,37,19,18,49,76,85,0,"https://fbref.com/en/players/00844823/Niklas-Moisander"
"5302","Yuya Osako_2020",2020,"Werder Bremen","Bundesliga","Yuya Osako","JPN","FW,MF","29",1990,20.5,29,16,5,19,5,3,29,10.3,26,10,1,9,6,35,13,1,"https://fbref.com/en/players/f69fba57/Yuya-Osako"
"5303","Jiří Pavlenka_2020",2020,"Werder Bremen","Bundesliga","Jiří Pavlenka","CZE","GK","27",1992,33,1,0,1,0,0,1,2,50,1,1,0,1,5,6,11,3,"https://fbref.com/en/players/0a1cb833/Jiri-Pavlenka"
"5304","Claudio Pizarro_2020",2020,"Werder Bremen","Bundesliga","Claudio Pizarro","PER","FW,MF","40",1978,2.6,2,1,0,1,1,0,1,0,1,2,0,2,2,4,2,0,"https://fbref.com/en/players/54b6ee79/Claudio-Pizarro"
"5305","Milot Rashica_2020",2020,"Werder Bremen","Bundesliga","Milot Rashica","KVX","FW","23",1996,25.2,21,14,13,6,2,9,33,27.3,24,15,2,13,6,27,16,1,"https://fbref.com/en/players/6c6a3300/Milot-Rashica"
"5306","Nuri Şahin_2020",2020,"Werder Bremen","Bundesliga","Nuri Şahin","TUR","MF","30",1988,13.9,27,16,10,14,3,11,35,31.4,24,15,7,8,37,64,38,0,"https://fbref.com/en/players/f4081572/Nuri-Sahin"
"5307","Josh Sargent_2020",2020,"Werder Bremen","Bundesliga","Josh Sargent","USA","FW","19",2000,15.7,11,6,5,4,2,2,12,16.7,10,17,1,16,14,25,21,0,"https://fbref.com/en/players/a8d4428b/Josh-Sargent"
"5308","Davie Selke_2020",2020,"Werder Bremen","Bundesliga","Davie Selke","GER","FW","24",1995,5.1,2,0,1,1,0,0,2,0,2,1,0,1,0,2,2,0,"https://fbref.com/en/players/1238a3f9/Davie-Selke"
"5309","Ömer Toprak_2020",2020,"Werder Bremen","Bundesliga","Ömer Toprak","TUR","DF","30",1989,7.9,7,2,4,2,1,3,6,50,3,6,4,2,12,19,41,0,"https://fbref.com/en/players/c5fd13e9/Omer-Toprak"
"5310","Miloš Veljković_2020",2020,"Werder Bremen","Bundesliga","Miloš Veljković","SRB","DF","23",1995,22.8,55,33,36,18,1,33,53,62.3,20,25,11,14,26,81,92,1,"https://fbref.com/en/players/a5ae8f8e/Milos-Veljkovic"
"5311","Kevin Vogt_2020",2020,"Werder Bremen","Bundesliga","Kevin Vogt","GER","DF,MF","27",1991,12.3,14,10,8,6,0,8,16,50,8,15,12,3,25,39,37,1,"https://fbref.com/en/players/1d8e9add/Kevin-Vogt"
"5312","Nick Woltemade_2020",2020,"Werder Bremen","Bundesliga","Nick Woltemade","GER","FW,MF","17",2002,1,2,1,0,2,0,0,1,0,1,1,0,1,0,2,2,0,"https://fbref.com/en/players/7ca196eb/Nick-Woltemade"
"5313","Albian Ajeti_2020",2020,"West Ham","Premier League","Albian Ajeti","SUI","FW","22",1997,1.5,1,0,0,0,1,0,0,NA,0,0,0,0,0,1,0,0,"https://fbref.com/en/players/2b1c4abd/Albian-Ajeti"
"5314","Felipe Anderson_2020",2020,"West Ham","Premier League","Felipe Anderson","BRA","MF,FW","26",1993,16.6,46,32,20,21,5,11,47,23.4,36,19,1,18,22,68,11,0,"https://fbref.com/en/players/9f1893b9/Felipe-Anderson"
"5315","Michail Antonio_2020",2020,"West Ham","Premier League","Michail Antonio","JAM","FW","29",1990,19.6,13,9,5,4,4,4,14,28.6,10,17,2,15,9,22,5,0,"https://fbref.com/en/players/ac05f970/Michail-Antonio"
"5316","Fabián Balbuena_2020",2020,"West Ham","Premier League","Fabián Balbuena","PAR","DF","27",1991,13.1,17,12,13,3,1,9,25,36,16,15,5,10,26,43,75,3,"https://fbref.com/en/players/3626f7d9/Fabian-Balbuena"
"5317","Jarrod Bowen_2020",2020,"West Ham","Premier League","Jarrod Bowen","ENG","FW,MF","22",1996,10.2,19,15,7,9,3,4,17,23.5,13,6,0,6,16,35,8,0,"https://fbref.com/en/players/79c84d1c/Jarrod-Bowen"
"5318","Aaron Cresswell_2020",2020,"West Ham","Premier League","Aaron Cresswell","ENG","DF","29",1989,30.3,43,26,21,18,4,23,46,50,23,33,10,23,35,78,75,2,"https://fbref.com/en/players/4f974391/Aaron-Cresswell"
"5319","Issa Diop_2020",2020,"West Ham","Premier League","Issa Diop","FRA","DF","22",1997,30.7,27,15,18,9,0,16,25,64,9,37,21,16,47,74,166,2,"https://fbref.com/en/players/a712ca2b/Issa-Diop"
"5320","Łukasz Fabiański_2020",2020,"West Ham","Premier League","Łukasz Fabiański","POL","GK","34",1985,23.5,2,2,2,0,0,2,4,50,2,0,0,0,1,3,5,3,"https://fbref.com/en/players/9328b835/Lukasz-Fabianski"
"5321","Pablo Fornals_2020",2020,"West Ham","Premier League","Pablo Fornals","ESP","MF,FW","23",1996,24.1,46,28,21,18,7,19,64,29.7,45,35,1,34,25,71,15,0,"https://fbref.com/en/players/82927de4/Pablo-Fornals"
"5322","Ryan Fredericks_2020",2020,"West Ham","Premier League","Ryan Fredericks","ENG","DF","26",1992,24.9,82,56,59,18,5,41,64,64.1,23,20,10,10,24,106,73,1,"https://fbref.com/en/players/c067631c/Ryan-Fredericks"
"5323","Sébastien Haller_2020",2020,"West Ham","Premier League","Sébastien Haller","CIV","FW","25",1994,25.2,22,15,8,10,4,3,30,10,27,19,5,14,8,30,27,0,"https://fbref.com/en/players/ba115a40/Sebastien-Haller"
"5324","Javier Hernández_2020",2020,"West Ham","Premier League","Javier Hernández","MEX","FW","31",1988,1.2,0,0,0,0,0,0,1,0,1,0,0,0,1,1,0,0,"https://fbref.com/en/players/189cee7b/Javier-Hernandez"
"5325","Nathan Holland_2020",2020,"West Ham","Premier League","Nathan Holland","ENG","MF","21",1998,0.4,3,1,2,1,0,0,0,NA,0,1,0,1,0,3,0,0,"https://fbref.com/en/players/45ab2170/Nathan-Holland"
"5326","Ben Johnson_2020",2020,"West Ham","Premier League","Ben Johnson","ENG","DF","19",2000,3,8,4,7,1,0,7,10,70,3,5,2,3,3,11,11,0,"https://fbref.com/en/players/9319781b/Ben-Johnson"
"5327","Manuel Lanzini_2020",2020,"West Ham","Premier League","Manuel Lanzini","ARG","MF,FW","26",1993,15.3,14,9,6,6,2,7,39,17.9,32,9,1,8,10,24,3,0,"https://fbref.com/en/players/26f6dca8/Manuel-Lanzini"
"5328","David Martin_2020",2020,"West Ham","Premier League","David Martin","ENG","GK","33",1986,4.8,0,0,0,0,0,0,0,NA,0,0,0,0,0,0,1,1,"https://fbref.com/en/players/07666c20/David-Martin"
"5329","Arthur Masuaku_2020",2020,"West Ham","Premier League","Arthur Masuaku","COD","DF","25",1993,10.4,41,23,24,13,4,23,39,59,16,19,5,14,14,55,23,0,"https://fbref.com/en/players/57df7a11/Arthur-Masuaku"
"5330","Jeremy Ngakia_2020",2020,"West Ham","Premier League","Jeremy Ngakia","ENG","DF","18",2000,4.9,15,7,10,5,0,9,21,42.9,12,6,1,5,7,22,16,0,"https://fbref.com/en/players/3631ad41/Jeremy-Ngakia"
"5331","Mark Noble_2020",2020,"West Ham","Premier League","Mark Noble","ENG","MF","32",1987,29.7,52,30,19,28,5,22,64,34.4,42,20,6,14,20,72,10,1,"https://fbref.com/en/players/ff527768/Mark-Noble"
"5332","Angelo Ogbonna_2020",2020,"West Ham","Premier League","Angelo Ogbonna","ITA","DF","31",1988,31,38,24,20,14,4,18,32,56.3,14,50,32,18,27,65,134,1,"https://fbref.com/en/players/74b2cd7e/Angelo-Ogbonna"
"5333","Darren Randolph_2020",2020,"West Ham","Premier League","Darren Randolph","IRL","GK","32",1987,2,0,0,0,0,0,0,0,NA,0,0,0,0,0,0,2,0,"https://fbref.com/en/players/6385ebfb/Darren-Randolph"
"5334","Declan Rice_2020",2020,"West Ham","Premier League","Declan Rice","ENG","MF","20",1999,38,116,60,64,48,4,47,98,48,51,41,9,32,77,193,55,0,"https://fbref.com/en/players/1c7012b8/Declan-Rice"
"5335","Roberto_2020",2020,"West Ham","Premier League","Roberto","ESP","GK","33",1986,7.6,0,0,0,0,0,0,0,NA,0,0,0,0,0,0,2,2,"https://fbref.com/en/players/ba3ca78f/Roberto"
"5336","Carlos Sánchez_2020",2020,"West Ham","Premier League","Carlos Sánchez","COL","MF","33",1986,1.3,1,0,0,1,0,1,1,100,0,1,0,1,2,3,1,0,"https://fbref.com/en/players/50b51fac/Carlos-Sanchez"
"5337","Robert Snodgrass_2020",2020,"West Ham","Premier League","Robert Snodgrass","SCO","MF,FW","31",1987,16.8,29,16,17,10,2,13,44,29.5,31,12,1,11,4,33,11,0,"https://fbref.com/en/players/9f4647e9/Robert-Snodgrass"
"5338","Tomáš Souček_2020",2020,"West Ham","Premier League","Tomáš Souček","CZE","MF","24",1995,11.6,29,15,13,15,1,10,23,43.5,13,7,1,6,22,51,35,0,"https://fbref.com/en/players/6613c819/Tomas-Soucek"
"5339","Jack Wilshere_2020",2020,"West Ham","Premier League","Jack Wilshere","ENG","MF","27",1992,2.4,1,0,1,0,0,0,4,0,4,3,0,3,1,2,0,0,"https://fbref.com/en/players/9c318325/Jack-Wilshere"
"5340","Andriy Yarmolenko_2020",2020,"West Ham","Premier League","Andriy Yarmolenko","UKR","MF,FW","29",1989,11,13,8,5,6,2,5,20,25,15,3,1,2,6,19,4,0,"https://fbref.com/en/players/849c826a/Andriy-Yarmolenko"
"5341","Pablo Zabaleta_2020",2020,"West Ham","Premier League","Pablo Zabaleta","ARG","DF","34",1985,6.6,18,10,12,5,1,6,13,46.2,7,5,3,2,14,32,21,0,"https://fbref.com/en/players/6813ac34/Pablo-Zabaleta"
"5342","Maximilian Arnold_2020",2020,"Wolfsburg","Bundesliga","Maximilian Arnold","GER","MF","25",1994,31.3,42,24,15,23,4,16,62,25.8,46,25,6,19,25,67,35,0,"https://fbref.com/en/players/86e119e0/Maximilian-Arnold"
"5343","Josip Brekalo_2020",2020,"Wolfsburg","Bundesliga","Josip Brekalo","CRO","MF,FW","21",1998,18.6,18,8,5,6,7,5,23,21.7,18,26,0,26,16,34,4,0,"https://fbref.com/en/players/d4a2533d/Josip-Brekalo"
"5344","John Brooks_2020",2020,"Wolfsburg","Bundesliga","John Brooks","USA","DF","26",1993,24.7,38,27,27,9,2,24,49,49,25,31,12,19,41,79,93,0,"https://fbref.com/en/players/e27da244/John-Brooks"
"5345","Jeffrey Bruma_2020",2020,"Wolfsburg","Bundesliga","Jeffrey Bruma","NED","DF","27",1991,9,9,5,4,5,0,7,13,53.8,6,6,3,3,13,22,51,1,"https://fbref.com/en/players/fbffc4b1/Jeffrey-Bruma"
"5346","Koen Casteels_2020",2020,"Wolfsburg","Bundesliga","Koen Casteels","BEL","GK","27",1992,26,0,0,0,0,0,0,0,NA,0,0,0,0,0,0,9,1,"https://fbref.com/en/players/db401046/Koen-Casteels"
"5347","Yannick Gerhardt_2020",2020,"Wolfsburg","Bundesliga","Yannick Gerhardt","GER","MF","25",1994,9.2,28,18,7,15,6,8,21,38.1,13,11,3,8,12,40,9,0,"https://fbref.com/en/players/62ab9184/Yannick-Gerhardt"
"5348","Daniel Ginczek_2020",2020,"Wolfsburg","Bundesliga","Daniel Ginczek","GER","FW","28",1991,8.5,4,3,3,1,0,1,11,9.1,10,3,1,2,1,5,3,0,"https://fbref.com/en/players/e5f63987/Daniel-Ginczek"
"5349","Josuha Guilavogui_2020",2020,"Wolfsburg","Bundesliga","Josuha Guilavogui","FRA","MF,DF","28",1990,22.9,41,26,17,23,1,10,30,33.3,20,35,9,26,45,86,64,2,"https://fbref.com/en/players/e6c43eec/Josuha-Guilavogui"
"5350","Luca Horn_2020",2020,"Wolfsburg","Bundesliga","Luca Horn","GER","DF","20",1998,0.1,0,0,0,0,0,0,0,NA,0,0,0,0,0,0,0,0,"https://fbref.com/en/players/60dfc525/Luca-Horn"
"5351","Mamoudou Karamoko_2020",2020,"Wolfsburg","Bundesliga","Mamoudou Karamoko","FRA","MF","19",1999,0.1,0,0,0,0,0,0,0,NA,0,0,0,0,0,0,0,0,"https://fbref.com/en/players/23a10591/Mamoudou-Karamoko"
"5352","Felix Klaus_2020",2020,"Wolfsburg","Bundesliga","Felix Klaus","GER","MF,FW","26",1992,7.4,24,16,4,13,7,7,19,36.8,12,10,2,8,3,27,5,0,"https://fbref.com/en/players/aeda1f69/Felix-Klaus"
"5353","Robin Knoche_2020",2020,"Wolfsburg","Bundesliga","Robin Knoche","GER","DF","27",1992,17.7,29,14,24,5,0,17,30,56.7,13,19,11,8,27,56,77,1,"https://fbref.com/en/players/6bd5cd5d/Robin-Knoche"
"5354","Omar Marmoush_2020",2020,"Wolfsburg","Bundesliga","Omar Marmoush","EGY","MF,FW","20",1999,0.9,1,1,1,0,0,0,0,NA,0,1,0,1,1,2,0,0,"https://fbref.com/en/players/0e0102eb/Omar-Marmoush"
"5355","Kevin Mbabu_2020",2020,"Wolfsburg","Bundesliga","Kevin Mbabu","SUI","DF","24",1995,18.8,69,48,39,24,6,35,54,64.8,19,33,10,23,23,92,53,0,"https://fbref.com/en/players/493924a7/Kevin-Mbabu"
"5356","Admir Mehmedi_2020",2020,"Wolfsburg","Bundesliga","Admir Mehmedi","SUI","MF,FW","28",1991,13.3,14,6,2,9,3,4,15,26.7,11,10,0,10,5,19,4,0,"https://fbref.com/en/players/b500b384/Admir-Mehmedi"
"5357","Lukas Nmecha_2020",2020,"Wolfsburg","Bundesliga","Lukas Nmecha","GER","MF,FW","20",1998,1.5,0,0,0,0,0,0,0,NA,0,0,0,0,0,0,0,0,"https://fbref.com/en/players/0cc5f4a5/Lukas-Nmecha"
"5358","Paulo Otávio_2020",2020,"Wolfsburg","Bundesliga","Paulo Otávio","BRA","DF","24",1994,4.2,21,16,11,9,1,10,13,76.9,3,12,2,10,9,30,11,0,"https://fbref.com/en/players/1cbe4984/Paulo-Otavio"
"5359","Pavao Pervan_2020",2020,"Wolfsburg","Bundesliga","Pavao Pervan","AUT","GK","31",1987,8,0,0,0,0,0,0,1,0,1,0,0,0,0,0,4,0,"https://fbref.com/en/players/c89e8aae/Pavao-Pervan"
"5360","Marin Pongračić_2020",2020,"Wolfsburg","Bundesliga","Marin Pongračić","CRO","DF","21",1997,10.3,14,9,11,2,1,9,10,90,1,11,7,4,19,33,21,1,"https://fbref.com/en/players/2a6cd437/Marin-Pongracic"
"5361","Jérôme Roussillon_2020",2020,"Wolfsburg","Bundesliga","Jérôme Roussillon","FRA","DF","26",1993,26.3,48,29,26,18,4,15,29,51.7,14,33,5,28,30,78,58,0,"https://fbref.com/en/players/13203c45/Jerome-Roussillon"
"5362","João Victor Santos Sá_2020",2020,"Wolfsburg","Bundesliga","João Victor Santos Sá","BRA","MF,FW","25",1994,18.1,35,22,12,17,6,10,38,26.3,28,31,1,30,9,44,9,0,"https://fbref.com/en/players/1a1033a1/Joao-Victor-Santos-Sa"
"5363","Xaver Schlager_2020",2020,"Wolfsburg","Bundesliga","Xaver Schlager","AUT","MF","21",1997,19.1,47,29,13,30,4,14,44,31.8,30,16,2,14,17,64,12,0,"https://fbref.com/en/players/8f056768/Xaver-Schlager"
"5364","Renato Steffen_2020",2020,"Wolfsburg","Bundesliga","Renato Steffen","SUI","MF,FW","27",1991,17.6,25,18,4,14,7,14,39,35.9,25,25,2,23,23,48,10,0,"https://fbref.com/en/players/dd669209/Renato-Steffen"
"5365","Marcel Tisserand_2020",2020,"Wolfsburg","Bundesliga","Marcel Tisserand","COD","DF","26",1993,13.4,21,10,14,5,2,7,12,58.3,5,13,4,9,32,53,49,2,"https://fbref.com/en/players/45954ec7/Marcel-Tisserand"
"5366","Wout Weghorst_2020",2020,"Wolfsburg","Bundesliga","Wout Weghorst","NED","FW","26",1992,30.4,15,8,4,5,6,1,17,5.9,16,17,4,13,2,17,30,0,"https://fbref.com/en/players/c4e87b8b/Wout-Weghorst"
"5367","William_2020",2020,"Wolfsburg","Bundesliga","William","BRA","DF","24",1995,15.2,55,26,34,14,7,27,59,45.8,32,10,3,7,24,79,38,1,"https://fbref.com/en/players/d4d0a9ad/William"
"5368","Ryan Bennett_2020",2020,"Wolves","Premier League","Ryan Bennett","ENG","DF","29",1990,6.7,4,2,4,0,0,2,6,33.3,4,14,8,6,9,13,29,0,"https://fbref.com/en/players/0bad4516/Ryan-Bennett"
"5369","Willy Boly_2020",2020,"Wolves","Premier League","Willy Boly","CIV","DF","28",1991,22,57,33,36,21,0,25,43,58.1,18,28,11,17,39,96,108,3,"https://fbref.com/en/players/a4ac4b8f/Willy-Boly"
"5370","Jonny Castro_2020",2020,"Wolves","Premier League","Jonny Castro","ESP","MF,DF","25",1994,32.1,91,55,54,26,11,29,82,35.4,53,45,10,35,53,144,45,2,"https://fbref.com/en/players/e28868f3/Jonny-Castro"
"5371","Conor Coady_2020",2020,"Wolves","Premier League","Conor Coady","ENG","DF","26",1993,38,36,23,30,6,0,15,30,50,15,22,15,7,28,64,119,2,"https://fbref.com/en/players/2928dca2/Conor-Coady"
"5372","Patrick Cutrone_2020",2020,"Wolves","Premier League","Patrick Cutrone","ITA","FW","21",1998,3.3,4,2,2,1,1,1,5,20,4,1,1,0,2,6,1,0,"https://fbref.com/en/players/a4fe8cda/Patrick-Cutrone"
"5373","Leander Dendoncker_2020",2020,"Wolves","Premier League","Leander Dendoncker","BEL","MF,DF","24",1995,31.1,68,31,41,19,8,28,67,41.8,39,39,12,27,38,106,64,2,"https://fbref.com/en/players/5a7301ae/Leander-Dendoncker"
"5374","Matt Doherty_2020",2020,"Wolves","Premier League","Matt Doherty","IRL","MF,DF","27",1992,31.5,55,29,34,17,4,27,41,65.9,14,34,4,30,40,95,52,1,"https://fbref.com/en/players/d557d734/Matt-Doherty"
"5375","Morgan Gibbs-White_2020",2020,"Wolves","Premier League","Morgan Gibbs-White","ENG","MF,FW","19",2000,1.4,0,0,0,0,0,0,0,NA,0,0,0,0,2,2,0,0,"https://fbref.com/en/players/32f60ed8/Morgan-Gibbs-White"
"5376","Raúl Jiménez_2020",2020,"Wolves","Premier League","Raúl Jiménez","MEX","FW","28",1991,36,20,12,6,10,4,3,31,9.7,28,26,0,26,16,36,34,1,"https://fbref.com/en/players/b561db50/Raul-Jimenez"
"5377","Bruno Jordão_2020",2020,"Wolves","Premier League","Bruno Jordão","POR","FW","20",1998,0.1,0,0,0,0,0,0,0,NA,0,1,0,1,0,0,0,0,"https://fbref.com/en/players/41ff002d/Bruno-Jordao"
"5378","Diogo Jota_2020",2020,"Wolves","Premier League","Diogo Jota","POR","FW","22",1996,25.4,28,15,16,10,2,12,48,25,36,17,0,17,9,37,10,2,"https://fbref.com/en/players/178ae8f8/Diogo-Jota"
"5379","Max Kilman_2020",2020,"Wolves","Premier League","Max Kilman","ENG","DF","22",1997,2.1,4,2,1,3,0,2,2,100,0,1,1,0,4,8,7,0,"https://fbref.com/en/players/d0f72bf1/Max-Kilman"
"5380","João Moutinho_2020",2020,"Wolves","Premier League","João Moutinho","POR","MF","32",1986,34.5,93,50,43,41,9,46,139,33.1,93,43,13,30,50,143,18,1,"https://fbref.com/en/players/f5a00fa4/Joao-Moutinho"
"5381","Pedro Neto_2020",2020,"Wolves","Premier League","Pedro Neto","POR","FW,MF","19",2000,10.4,9,4,3,6,0,4,15,26.7,11,2,0,2,6,15,4,0,"https://fbref.com/en/players/7ba2eaa9/Pedro-Neto"
"5382","Rúben Neves_2020",2020,"Wolves","Premier League","Rúben Neves","POR","MF","22",1997,34,62,33,27,32,3,34,86,39.5,52,38,9,29,56,118,34,1,"https://fbref.com/en/players/44bfb6c5/Ruben-Neves"
"5383","Rui Patrício_2020",2020,"Wolves","Premier League","Rui Patrício","POR","GK","31",1988,38,0,0,0,0,0,0,2,0,2,2,0,2,2,2,5,2,"https://fbref.com/en/players/79b0d6a0/Rui-Patricio"
"5384","Daniel Podence_2020",2020,"Wolves","Premier League","Daniel Podence","POR","FW,MF","23",1995,3.2,3,3,2,0,1,0,2,0,2,4,1,3,2,5,1,0,"https://fbref.com/en/players/7fcc71d8/Daniel-Podence"
"5385","Romain Saïss_2020",2020,"Wolves","Premier League","Romain Saïss","MAR","DF","29",1990,30.1,55,38,37,15,3,32,46,69.6,14,31,16,15,55,110,127,3,"https://fbref.com/en/players/9fbbcf39/Romain-Saiss"
"5386","Adama Traoré_2020",2020,"Wolves","Premier League","Adama Traoré","ESP","FW,DF","23",1996,28.9,33,21,6,14,13,8,23,34.8,15,19,3,16,13,46,14,2,"https://fbref.com/en/players/9a28eba4/Adama-Traore"
"5387","Jesús Vallejo_2020",2020,"Wolves","Premier League","Jesús Vallejo","ESP","DF","22",1997,1.8,1,1,1,0,0,1,2,50,1,4,3,1,2,3,8,1,"https://fbref.com/en/players/c2111b45/Jesus-Vallejo"
"5388","Rúben Vinagre_2020",2020,"Wolves","Premier League","Rúben Vinagre","POR","MF,DF","20",1999,7.2,23,13,15,6,2,12,15,80,3,7,2,5,11,34,22,0,"https://fbref.com/en/players/b937e490/Ruben-Vinagre"
"5389","Martin Agirregabiria_2021",2021,"Alavés","La Liga","Martin Agirregabiria","ESP","DF,MF","24",1996,17.3,32,18,17,12,3,17,33,51.5,16,9,3,6,27,59,36,0,"https://fbref.com/en/players/355c883a/Martin-Agirregabiria"
"5390","Rodrigo Battaglia_2021",2021,"Alavés","La Liga","Rodrigo Battaglia","ARG","MF","29",1991,27.7,38,16,21,14,3,16,50,32,34,30,14,16,29,67,40,1,"https://fbref.com/en/players/d637fc22/Rodrigo-Battaglia"
"5391","Burgui_2021",2021,"Alavés","La Liga","Burgui","ESP","MF","26",1993,0.2,3,1,2,1,0,1,1,100,0,0,0,0,0,3,0,0,"https://fbref.com/en/players/45e304c8/Burgui"
"5392","Iñigo Córdoba_2021",2021,"Alavés","La Liga","Iñigo Córdoba","ESP","MF","23",1997,2.4,6,4,1,3,2,2,10,20,8,7,0,7,3,9,2,0,"https://fbref.com/en/players/49ea92be/Inigo-Cordoba"
"5393","Deyverson_2021",2021,"Alavés","La Liga","Deyverson","BRA","FW","29",1991,9.7,6,4,3,1,2,2,13,15.4,11,9,0,9,9,15,13,0,"https://fbref.com/en/players/2e5e846d/Deyverson"
"5394","Rubén Duarte_2021",2021,"Alavés","La Liga","Rubén Duarte","ESP","DF","24",1995,28.3,55,30,28,21,6,23,52,44.2,29,44,6,38,66,121,72,0,"https://fbref.com/en/players/1fe0492d/Ruben-Duarte"
"5395","Rodrigo Ely_2021",2021,"Alavés","La Liga","Rodrigo Ely","BRA","DF","26",1993,5.2,5,2,3,2,0,3,4,75,1,2,1,1,7,12,23,1,"https://fbref.com/en/players/fd47b4f2/Rodrigo-Ely"
"5396","Manu García_2021",2021,"Alavés","La Liga","Manu García","ESP","MF","34",1986,12.5,24,13,10,13,1,8,35,22.9,27,16,1,15,12,36,21,0,"https://fbref.com/en/players/05a4465d/Manu-Garcia"
"5397","Sergi García_2021",2021,"Alavés","La Liga","Sergi García","ESP","MF","21",1999,0.2,1,1,0,1,0,0,1,0,1,0,0,0,0,1,0,0,"https://fbref.com/en/players/a039d52e/Sergi-Garcia"
"5398","John Guidetti_2021",2021,"Alavés","La Liga","John Guidetti","SWE","FW","28",1992,2.3,2,2,0,2,0,0,2,0,2,0,0,0,1,3,2,0,"https://fbref.com/en/players/99bebd12/John-Guidetti"
"5399","Joselu_2021",2021,"Alavés","La Liga","Joselu","ESP","FW","30",1990,33.6,27,14,6,15,6,8,28,28.6,20,26,3,23,15,42,58,1,"https://fbref.com/en/players/6265208f/Joselu"
"5400","Jota_2021",2021,"Alavés","La Liga","Jota","ESP","MF","29",1991,15.5,19,14,6,7,6,3,29,10.3,26,12,0,12,9,28,9,0,"https://fbref.com/en/players/9f351459/Jota"
"5401","Stephane Keller_2021",2021,"Alavés","La Liga","Stephane Keller","CMR","DF","18",2001,0.2,1,0,1,0,0,1,1,100,0,0,0,0,0,1,0,0,"https://fbref.com/en/players/89d1e9fa/Stephane-Keller"
"5402","Víctor Laguardia_2021",2021,"Alavés","La Liga","Víctor Laguardia","ESP","DF","30",1989,29.2,20,12,13,6,1,14,31,45.2,17,25,13,12,37,57,104,0,"https://fbref.com/en/players/b7c99b9b/Victor-Laguardia"
"5403","Florian Lejeune_2021",2021,"Alavés","La Liga","Florian Lejeune","FRA","DF","29",1991,33.5,43,32,36,7,0,21,35,60,14,38,24,14,51,94,149,1,"https://fbref.com/en/players/6eaed4eb/Florian-Lejeune"
"5404","Javi López_2021",2021,"Alavés","La Liga","Javi López","ESP","DF,MF","18",2002,2.8,5,5,3,2,0,2,3,66.7,1,2,0,2,3,8,3,1,"https://fbref.com/en/players/e9ada8cf/Javi-Lopez"
"5405","Abdallahi Mahmoud_2021",2021,"Alavés","La Liga","Abdallahi Mahmoud","MTN","MF","20",2000,0.7,2,2,1,1,0,0,1,0,1,0,0,0,1,3,0,0,"https://fbref.com/en/players/ab99e4a0/Abdallahi-Mahmoud"
"5406","Adrián Marín_2021",2021,"Alavés","La Liga","Adrián Marín","ESP","DF,MF","23",1997,1,1,1,0,1,0,0,2,0,2,1,0,1,2,3,2,0,"https://fbref.com/en/players/b7f2edff/Adrian-Marin"
"5407","Édgar Méndez_2021",2021,"Alavés","La Liga","Édgar Méndez","ESP","MF,FW","30",1990,23.2,39,29,18,13,8,15,48,31.3,33,20,3,17,19,58,14,0,"https://fbref.com/en/players/aed746df/Edgar-Mendez"
"5408","Ximo Navarro_2021",2021,"Alavés","La Liga","Ximo Navarro","ESP","DF","30",1990,26.4,54,30,36,17,1,14,30,46.7,16,14,4,10,47,101,75,3,"https://fbref.com/en/players/8db394aa/Ximo-Navarro"
"5409","Fernando Pacheco_2021",2021,"Alavés","La Liga","Fernando Pacheco","ESP","GK","28",1992,37.2,2,0,2,0,0,2,4,50,2,0,0,0,2,4,19,0,"https://fbref.com/en/players/97852360/Fernando-Pacheco"
"5410","Facundo Pellistri_2021",2021,"Alavés","La Liga","Facundo Pellistri","URU","MF,FW","18",2001,6,8,5,2,4,2,3,13,23.1,10,0,0,0,4,12,3,0,"https://fbref.com/en/players/ac7e7b1c/Facundo-Pellistri"
"5411","Lucas Pérez_2021",2021,"Alavés","La Liga","Lucas Pérez","ESP","FW","31",1988,19.5,6,2,3,3,0,2,10,20,8,6,1,5,2,8,5,0,"https://fbref.com/en/players/a300ac7e/Lucas-Perez"
"5412","Tomás Pina Isla_2021",2021,"Alavés","La Liga","Tomás Pina Isla","ESP","MF","32",1987,28.6,39,18,18,16,5,16,42,38.1,26,28,8,20,37,76,42,0,"https://fbref.com/en/players/e54bd0a2/Tomas-Pina-Isla"
"5413","Pere Pons_2021",2021,"Alavés","La Liga","Pere Pons","ESP","MF","27",1993,13.2,20,10,8,8,4,5,16,31.3,11,15,2,13,7,27,10,0,"https://fbref.com/en/players/29b61deb/Pere-Pons"
"5414","Luis Rioja_2021",2021,"Alavés","La Liga","Luis Rioja","ESP","MF,FW","26",1993,23.2,21,14,11,7,3,7,39,17.9,32,23,1,22,20,41,30,0,"https://fbref.com/en/players/eb3dd471/Luis-Rioja"
"5415","Borja Sainz_2021",2021,"Alavés","La Liga","Borja Sainz","ESP","MF,FW","19",2001,5,7,3,3,2,2,4,16,25,12,4,0,4,6,13,1,0,"https://fbref.com/en/players/1b40049a/Borja-Sainz"
"5416","Antonio Sivera_2021",2021,"Alavés","La Liga","Antonio Sivera","ESP","GK","23",1996,0.8,0,0,0,0,0,0,0,NA,0,0,0,0,0,0,0,0,"https://fbref.com/en/players/9970da54/Antonio-Sivera"
"5417","Tachi_2021",2021,"Alavés","La Liga","Tachi","ESP","DF","22",1997,9.4,11,9,9,2,0,6,14,42.9,8,9,6,3,11,22,32,0,"https://fbref.com/en/players/8b625720/Tachi"
"5418","Tomás Tavares_2021",2021,"Alavés","La Liga","Tomás Tavares","POR","MF,DF","19",2001,0.7,2,1,2,0,0,2,2,100,0,1,0,1,0,2,1,0,"https://fbref.com/en/players/0dce3356/Tomas-Tavares"
"5419","Rayan Aït Nouri_2021",2021,"Angers","Ligue 1","Rayan Aït Nouri","ALG","DF","19",2001,2.1,3,2,1,2,0,3,5,60,2,2,1,1,4,7,1,0,"https://fbref.com/en/players/9b398aea/Rayan-Ait-Nouri"
"5420","Mohamed Ali Cho_2021",2021,"Angers","Ligue 1","Mohamed Ali Cho","FRA","FW,MF","16",2004,3.9,9,7,2,6,1,4,9,44.4,5,4,0,4,3,12,0,0,"https://fbref.com/en/players/f8405304/Mohamed-Ali-Cho"
"5421","Rachid Alioui_2021",2021,"Angers","Ligue 1","Rachid Alioui","MAR","FW","28",1992,0.2,0,0,0,0,0,0,1,0,1,0,0,0,0,0,0,0,"https://fbref.com/en/players/bdedd861/Rachid-Alioui"
"5422","Ibrahim Amadou_2021",2021,"Angers","Ligue 1","Ibrahim Amadou","FRA","MF","27",1993,16.7,39,26,18,19,2,15,38,39.5,23,14,4,10,23,62,25,0,"https://fbref.com/en/players/9260926b/Ibrahim-Amadou"
"5423","Stéphane Bahoken_2021",2021,"Angers","Ligue 1","Stéphane Bahoken","CMR","FW","28",1992,18,9,6,1,7,1,4,12,33.3,8,9,0,9,9,18,9,0,"https://fbref.com/en/players/5046b7d4/Stephane-Bahoken"
"5424","Abdoulaye Bamba_2021",2021,"Angers","Ligue 1","Abdoulaye Bamba","CIV","DF","30",1990,15,27,17,19,7,1,19,28,67.9,9,7,1,6,19,46,34,0,"https://fbref.com/en/players/7fecbcdb/Abdoulaye-Bamba"
"5425","Paul Bernardoni_2021",2021,"Angers","Ligue 1","Paul Bernardoni","FRA","GK","23",1997,38,1,1,1,0,0,1,2,50,1,0,0,0,2,3,23,1,"https://fbref.com/en/players/28dabd43/Paul-Bernardoni"
"5426","Antonin Bobichon_2021",2021,"Angers","Ligue 1","Antonin Bobichon","FRA","MF,FW","24",1995,10.1,23,14,10,8,5,9,15,60,6,4,1,3,2,25,1,0,"https://fbref.com/en/players/7d937aa1/Antonin-Bobichon"
"5427","Sofiane Boufal_2021",2021,"Angers","Ligue 1","Sofiane Boufal","MAR","FW,MF","26",1993,8.1,17,11,8,6,3,8,28,28.6,20,8,0,8,3,20,1,0,"https://fbref.com/en/players/b0c71810/Sofiane-Boufal"
"5428","Jimmy Cabot_2021",2021,"Angers","Ligue 1","Jimmy Cabot","FRA","FW,MF","26",1994,10.5,26,13,8,14,4,11,36,30.6,25,8,0,8,12,38,6,0,"https://fbref.com/en/players/46359159/Jimmy-Cabot"
"5429","Pierrick Capelle_2021",2021,"Angers","Ligue 1","Pierrick Capelle","FRA","MF,DF","33",1987,22.8,53,28,24,17,12,31,79,39.2,48,25,1,24,47,100,32,0,"https://fbref.com/en/players/79b2399c/Pierrick-Capelle"
"5430","Lassana Coulibaly_2021",2021,"Angers","Ligue 1","Lassana Coulibaly","MLI","MF","24",1996,18.7,78,41,33,34,11,39,75,52,36,29,4,25,33,111,17,0,"https://fbref.com/en/players/85a44ecc/Lassana-Coulibaly"
"5431","Lois Diony_2021",2021,"Angers","Ligue 1","Lois Diony","FRA","FW","27",1992,19.4,15,10,3,9,3,4,18,22.2,14,6,3,3,5,20,16,0,"https://fbref.com/en/players/4be0b467/Lois-Diony"
"5432","Souleyman Doumbia_2021",2021,"Angers","Ligue 1","Souleyman Doumbia","CIV","DF","23",1996,24.7,48,33,25,19,4,22,36,61.1,14,18,4,14,42,90,50,0,"https://fbref.com/en/players/9daeac61/Souleyman-Doumbia"
"5433","Enzo Ebosse_2021",2021,"Angers","Ligue 1","Enzo Ebosse","CMR","DF","21",1999,2.9,5,3,5,0,0,3,4,75,1,1,1,0,2,7,13,0,"https://fbref.com/en/players/9ba7b4fa/Enzo-Ebosse"
"5434","Noah Fatar_2021",2021,"Angers","Ligue 1","Noah Fatar","FRA","FW,MF","18",2002,0.2,1,0,0,0,1,0,0,NA,0,0,0,0,0,1,0,0,"https://fbref.com/en/players/2693f6bc/Noah-Fatar"
"5435","Yassin Fortune_2021",2021,"Angers","Ligue 1","Yassin Fortune","FRA","FW","21",1999,0.2,0,0,0,0,0,0,0,NA,0,0,0,0,0,0,0,0,"https://fbref.com/en/players/ddcc9e22/Yassin-Fortune"
"5436","Angelo Fulgini_2021",2021,"Angers","Ligue 1","Angelo Fulgini","FRA","MF","23",1996,30.3,22,13,4,12,6,12,34,35.3,22,17,0,17,15,37,9,0,"https://fbref.com/en/players/4b96c347/Angelo-Fulgini"
"5437","Wilfried Kanga_2021",2021,"Angers","Ligue 1","Wilfried Kanga","CIV","FW","22",1998,1.5,0,0,0,0,0,0,1,0,1,1,0,1,0,0,2,0,"https://fbref.com/en/players/b4c816a9/Wilfried-Kanga"
"5438","Vincent Manceau_2021",2021,"Angers","Ligue 1","Vincent Manceau","FRA","DF","31",1989,25.7,42,27,23,17,2,30,63,47.6,33,23,2,21,35,77,61,0,"https://fbref.com/en/players/c26a3918/Vincent-Manceau"
"5439","Thomas Mangani_2021",2021,"Angers","Ligue 1","Thomas Mangani","FRA","MF","33",1987,29.9,54,37,25,26,3,30,90,33.3,60,31,8,23,38,92,39,0,"https://fbref.com/en/players/c801616a/Thomas-Mangani"
"5440","Farid El Melali_2021",2021,"Angers","Ligue 1","Farid El Melali","ALG","FW,MF","23",1997,4.6,9,5,5,4,0,2,13,15.4,11,12,0,12,6,15,2,0,"https://fbref.com/en/players/d21e361a/Farid-El-Melali"
"5441","Casimir Ninga_2021",2021,"Angers","Ligue 1","Casimir Ninga","CHA","FW","27",1993,0.3,0,0,0,0,0,0,0,NA,0,0,0,0,0,0,1,0,"https://fbref.com/en/players/91f2da4c/Casimir-Ninga"
"5442","Zinédine Ould Khaled_2021",2021,"Angers","Ligue 1","Zinédine Ould Khaled","FRA","MF","20",2000,0.4,0,0,0,0,0,0,0,NA,0,0,0,0,1,1,0,0,"https://fbref.com/en/players/6b4436ba/Zinedine-Ould-Khaled"
"5443","Mateo Pavlović_2021",2021,"Angers","Ligue 1","Mateo Pavlović","BIH","DF","30",1990,12.3,11,6,8,3,0,8,23,34.8,15,13,11,2,21,32,40,0,"https://fbref.com/en/players/450e277f/Mateo-Pavlovic"
"5444","Mathias Pereira Lage_2021",2021,"Angers","Ligue 1","Mathias Pereira Lage","POR","FW,MF","23",1996,16.3,29,17,12,15,2,10,40,25,30,21,4,17,15,44,16,0,"https://fbref.com/en/players/8846a40f/Mathias-Pereira-Lage"
"5445","Baptiste Santamaria_2021",2021,"Angers","Ligue 1","Baptiste Santamaria","FRA","MF","25",1995,3,9,6,3,5,1,2,7,28.6,5,4,0,4,7,16,8,0,"https://fbref.com/en/players/5e22e2a4/Baptiste-Santamaria"
"5446","Waniss Taibi_2021",2021,"Angers","Ligue 1","Waniss Taibi","FRA","MF","18",2002,0.4,0,0,0,0,0,0,2,0,2,1,0,1,0,0,0,0,"https://fbref.com/en/players/95192fe4/Waniss-Taibi"
"5447","Sada Thioub_2021",2021,"Angers","Ligue 1","Sada Thioub","SEN","FW,MF","25",1995,14,17,14,7,6,4,7,23,30.4,16,10,0,10,9,26,3,0,"https://fbref.com/en/players/f4bc42b1/Sada-Thioub"
"5448","Romain Thomas_2021",2021,"Angers","Ligue 1","Romain Thomas","FRA","DF","32",1988,33.6,47,25,34,11,2,20,35,57.1,15,35,20,15,50,97,138,0,"https://fbref.com/en/players/275e2c51/Romain-Thomas"
"5449","Ismaël Traoré_2021",2021,"Angers","Ligue 1","Ismaël Traoré","CIV","DF","33",1986,33.3,32,14,23,9,0,20,37,54.1,17,27,13,14,40,72,107,0,"https://fbref.com/en/players/b666421b/Ismael-Traore"
"5450","Jacob Barrett Laursen_2021",2021,"Arminia","Bundesliga","Jacob Barrett Laursen","DEN","DF","25",1994,12.3,23,12,13,8,2,10,16,62.5,6,14,4,10,24,47,37,0,"https://fbref.com/en/players/c0d3bd23/Jacob-Barrett-Laursen"
"5451","Brian Behrendt_2021",2021,"Arminia","Bundesliga","Brian Behrendt","GER","DF","28",1991,0.9,0,0,0,0,0,0,1,0,1,0,0,0,0,0,1,0,"https://fbref.com/en/players/b1a21aca/Brian-Behrendt"
"5452","Cédric Brunner_2021",2021,"Arminia","Bundesliga","Cédric Brunner","SUI","DF","26",1994,29.5,42,22,24,15,3,27,40,67.5,13,30,10,20,42,84,96,0,"https://fbref.com/en/players/f0a37d36/Cedric-Brunner"
"5453","Sergio Córdova_2021",2021,"Arminia","Bundesliga","Sergio Córdova","VEN","FW,MF","22",1997,12.1,16,8,0,10,6,2,15,13.3,13,14,3,11,9,25,9,0,"https://fbref.com/en/players/229cd98a/Sergio-Cordova"
"5454","Mike van der Hoorn_2021",2021,"Arminia","Bundesliga","Mike van der Hoorn","NED","DF","27",1992,15.1,8,4,3,5,0,1,3,33.3,2,12,8,4,27,35,73,0,"https://fbref.com/en/players/25f50295/Mike-van-der-Hoorn"
"5455","Ritsu Doan_2021",2021,"Arminia","Bundesliga","Ritsu Doan","JPN","MF,FW","22",1998,30.8,53,31,22,19,12,19,52,36.5,33,42,1,41,31,84,11,0,"https://fbref.com/en/players/d01bbb6f/Ritsu-Doan"
"5456","Christian Gebauer_2021",2021,"Arminia","Bundesliga","Christian Gebauer","AUT","MF,FW","26",1993,7.6,9,4,2,5,2,4,11,36.4,7,4,1,3,6,15,14,0,"https://fbref.com/en/players/d847944b/Christian-Gebauer"
"5457","Marcel Hartel_2021",2021,"Arminia","Bundesliga","Marcel Hartel","GER","MF","24",1996,18.7,35,19,15,18,2,20,40,50,20,17,4,13,26,61,16,1,"https://fbref.com/en/players/614eca9b/Marcel-Hartel"
"5458","Fabian Klos_2021",2021,"Arminia","Bundesliga","Fabian Klos","GER","FW","32",1987,30.1,24,13,9,11,4,7,26,26.9,19,20,6,14,4,28,29,0,"https://fbref.com/en/players/e21042ae/Fabian-Klos"
"5459","Fabian Kunze_2021",2021,"Arminia","Bundesliga","Fabian Kunze","GER","MF","22",1998,14.1,38,26,19,15,4,19,42,45.2,23,19,3,16,18,56,22,1,"https://fbref.com/en/players/d25fee56/Fabian-Kunze"
"5460","Anderson Lucoqui_2021",2021,"Arminia","Bundesliga","Anderson Lucoqui","ANG","DF","23",1997,17.8,40,25,23,17,0,20,40,50,20,30,7,23,27,67,53,0,"https://fbref.com/en/players/5569bf9a/Anderson-Lucoqui"
"5461","Arne Maier_2021",2021,"Arminia","Bundesliga","Arne Maier","GER","MF","21",1999,11.5,13,9,5,7,1,4,11,36.4,7,10,3,7,8,21,11,1,"https://fbref.com/en/players/ab700320/Arne-Maier"
"5462","Nathan de Medina_2021",2021,"Arminia","Bundesliga","Nathan de Medina","BEL","DF","22",1997,7.1,16,10,9,6,1,3,10,30,7,12,2,10,11,27,22,0,"https://fbref.com/en/players/d686dbc0/Nathan-de-Medina"
"5463","Sebastian Müller_2021",2021,"Arminia","Bundesliga","Sebastian Müller","GER","MF,DF","19",2001,0,0,0,0,0,0,0,0,NA,0,0,0,0,0,0,0,0,"https://fbref.com/en/players/d3585b17/Sebastian-Muller"
"5464","Joakim Nilsson_2021",2021,"Arminia","Bundesliga","Joakim Nilsson","SWE","DF","26",1994,24,36,24,23,12,1,14,23,60.9,9,29,22,7,39,75,111,0,"https://fbref.com/en/players/c562c5b4/Joakim-Nilsson"
"5465","Masaya Okugawa_2021",2021,"Arminia","Bundesliga","Masaya Okugawa","JPN","MF","24",1996,10.2,17,8,5,11,1,6,14,42.9,8,17,2,15,8,25,5,0,"https://fbref.com/en/players/63b9cc6d/Masaya-Okugawa"
"5466","Stefan Ortega_2021",2021,"Arminia","Bundesliga","Stefan Ortega","GER","GK","27",1992,34,2,1,2,0,0,2,6,33.3,4,0,0,0,0,2,12,3,"https://fbref.com/en/players/c1242d4e/Stefan-Ortega"
"5467","Amos Pieper_2021",2021,"Arminia","Bundesliga","Amos Pieper","GER","DF","22",1998,29.8,58,32,39,17,2,20,33,60.6,13,48,35,13,66,124,160,3,"https://fbref.com/en/players/526ea7cc/Amos-Pieper"
"5468","Manuel Prietl_2021",2021,"Arminia","Bundesliga","Manuel Prietl","AUT","MF","28",1991,28,65,44,33,28,4,12,73,16.4,61,34,7,27,45,110,24,0,"https://fbref.com/en/players/901c0f97/Manuel-Prietl"
"5469","Sven Schipplock_2021",2021,"Arminia","Bundesliga","Sven Schipplock","GER","FW,MF","31",1988,8.3,15,8,7,6,2,6,27,22.2,21,13,2,11,6,21,8,0,"https://fbref.com/en/players/53eeaf6a/Sven-Schipplock"
"5470","Nils Seufert_2021",2021,"Arminia","Bundesliga","Nils Seufert","GER","MF,FW","23",1997,3.8,12,9,2,5,5,2,8,25,6,3,1,2,5,17,6,0,"https://fbref.com/en/players/0da32a38/Nils-Seufert"
"5471","Jóan Símun Edmundsson_2021",2021,"Arminia","Bundesliga","Jóan Símun Edmundsson","FRO","FW,MF","29",1991,0.6,0,0,0,0,0,0,0,NA,0,1,0,1,1,1,0,0,"https://fbref.com/en/players/1be390b3/Joan-Simun-Edmundsson"
"5472","Cebio Soukou_2021",2021,"Arminia","Bundesliga","Cebio Soukou","BEN","FW,MF","27",1992,5.1,12,8,5,5,2,6,11,54.5,5,3,0,3,3,15,4,0,"https://fbref.com/en/players/3c4b7820/Cebio-Soukou"
"5473","Michel Vlap_2021",2021,"Arminia","Bundesliga","Michel Vlap","NED","MF,FW","23",1997,4.1,1,1,0,1,0,0,8,0,8,4,0,4,5,6,3,0,"https://fbref.com/en/players/02760e49/Michel-Vlap"
"5474","Andreas Voglsammer_2021",2021,"Arminia","Bundesliga","Andreas Voglsammer","GER","FW,MF","28",1992,11.1,12,8,6,6,0,8,17,47.1,9,11,0,11,3,15,11,0,"https://fbref.com/en/players/daa78200/Andreas-Voglsammer"
"5475","Reinhold Yabo_2021",2021,"Arminia","Bundesliga","Reinhold Yabo","GER","MF,FW","28",1992,7.2,5,2,2,2,1,2,9,22.2,7,6,1,5,4,9,1,0,"https://fbref.com/en/players/7dca49f6/Reinhold-Yabo"
"5476","Rúnar Alex Rúnarsson_2021",2021,"Arsenal","Premier League","Rúnar Alex Rúnarsson","ISL","GK","25",1995,0.2,0,0,0,0,0,0,0,NA,0,0,0,0,0,0,0,0,"https://fbref.com/en/players/8fa8f8d2/Runar-Alex-Runarsson"
"5477","Pierre-Emerick Aubameyang_2021",2021,"Arsenal","Premier League","Pierre-Emerick Aubameyang","GAB","FW","31",1989,25.9,12,8,7,4,1,3,20,15,17,18,0,18,7,19,17,0,"https://fbref.com/en/players/d5dd5f1f/Pierre-Emerick-Aubameyang"
"5478","Héctor Bellerín_2021",2021,"Arsenal","Premier League","Héctor Bellerín","ESP","DF,MF","25",1995,23.2,29,19,14,12,3,12,41,29.3,29,26,8,18,33,62,33,0,"https://fbref.com/en/players/f874dd44/Hector-Bellerin"
"5479","Dani Ceballos_2021",2021,"Arsenal","Premier League","Dani Ceballos","ESP","MF","23",1996,17.9,37,22,20,11,6,21,51,41.2,30,23,6,17,35,72,14,1,"https://fbref.com/en/players/c0617e2b/Dani-Ceballos"
"5480","Calum Chambers_2021",2021,"Arsenal","Premier League","Calum Chambers","ENG","DF","25",1995,8.4,7,3,3,2,2,3,8,37.5,5,6,2,4,10,17,37,0,"https://fbref.com/en/players/dc6f5bdd/Calum-Chambers"
"5481","Gabriel Dos Santos_2021",2021,"Arsenal","Premier League","Gabriel Dos Santos","BRA","DF","22",1997,22.2,25,15,19,5,1,13,19,68.4,6,27,19,8,26,51,74,2,"https://fbref.com/en/players/67ac5bb8/Gabriel-Dos-Santos"
"5482","Mohamed Elneny_2021",2021,"Arsenal","Premier League","Mohamed Elneny","EGY","MF","28",1992,17.2,14,6,7,7,0,7,28,25,21,11,4,7,24,38,20,2,"https://fbref.com/en/players/47a34c4f/Mohamed-Elneny"
"5483","Rob Holding_2021",2021,"Arsenal","Premier League","Rob Holding","ENG","DF","24",1995,28.4,43,20,28,13,2,17,35,48.6,18,37,27,10,24,67,120,0,"https://fbref.com/en/players/d79a8c87/Rob-Holding"
"5484","Sead Kolašinac_2021",2021,"Arsenal","Premier League","Sead Kolašinac","BIH","DF","27",1993,1,0,0,0,0,0,0,0,NA,0,0,0,0,1,1,0,0,"https://fbref.com/en/players/3935e52e/Sead-Kolasinac"
"5485","Alexandre Lacazette_2021",2021,"Arsenal","Premier League","Alexandre Lacazette","FRA","FW","29",1991,21.4,18,10,4,11,3,4,22,18.2,18,20,1,19,12,30,13,0,"https://fbref.com/en/players/9dbb75ca/Alexandre-Lacazette"
"5486","Bernd Leno_2021",2021,"Arsenal","Premier League","Bernd Leno","GER","GK","28",1992,34.8,1,0,1,0,0,1,1,100,0,1,0,1,0,1,11,2,"https://fbref.com/en/players/2628fd2b/Bernd-Leno"
"5487","David Luiz_2021",2021,"Arsenal","Premier League","David Luiz","BRA","DF","33",1987,15.5,12,9,5,7,0,4,4,100,0,16,9,7,16,28,50,2,"https://fbref.com/en/players/c0e27d1a/David-Luiz"
"5488","Ainsley Maitland-Niles_2021",2021,"Arsenal","Premier League","Ainsley Maitland-Niles","ENG","MF,DF","22",1997,5.4,11,7,6,5,0,8,12,66.7,4,12,2,10,14,25,7,1,"https://fbref.com/en/players/e3a5814e/Ainsley-Maitland-Niles"
"5489","Pablo Marí_2021",2021,"Arsenal","Premier League","Pablo Marí","ESP","DF","26",1993,10,15,9,12,3,0,5,10,50,5,8,7,1,9,24,30,2,"https://fbref.com/en/players/aa54ec6f/Pablo-Mari"
"5490","Martinelli_2021",2021,"Arsenal","Premier League","Martinelli","BRA","FW","19",2001,6.5,7,1,2,3,2,4,10,40,6,6,0,6,8,15,4,0,"https://fbref.com/en/players/48a5a5d6/Martinelli"
"5491","Shkodran Mustafi_2021",2021,"Arsenal","Premier League","Shkodran Mustafi","GER","DF","28",1992,0.5,1,1,1,0,0,1,1,100,0,1,0,1,0,1,3,0,"https://fbref.com/en/players/3f2d59fe/Shkodran-Mustafi"
"5492","Reiss Nelson_2021",2021,"Arsenal","Premier League","Reiss Nelson","ENG","FW,MF","20",1999,0.8,1,0,0,0,1,0,0,NA,0,0,0,0,1,2,1,0,"https://fbref.com/en/players/c5bdb6e3/Reiss-Nelson"
"5493","Eddie Nketiah_2021",2021,"Arsenal","Premier League","Eddie Nketiah","ENG","FW","21",1999,4.7,3,1,0,2,1,0,2,0,2,6,0,6,0,3,5,0,"https://fbref.com/en/players/a53649b7/Eddie-Nketiah"
"5494","Thomas Partey_2021",2021,"Arsenal","Premier League","Thomas Partey","GHA","MF","27",1993,17,44,21,16,24,4,24,56,42.9,32,17,5,12,23,67,18,0,"https://fbref.com/en/players/529f49ab/Thomas-Partey"
"5495","Nicolas Pépé_2021",2021,"Arsenal","Premier League","Nicolas Pépé","CIV","FW","25",1995,18,20,15,8,6,6,8,23,34.8,15,16,1,15,12,32,19,0,"https://fbref.com/en/players/57e3f0c7/Nicolas-Pepe"
"5496","Mathew Ryan_2021",2021,"Arsenal","Premier League","Mathew Ryan","AUS","GK","28",1992,3,0,0,0,0,0,0,0,NA,0,0,0,0,0,0,1,0,"https://fbref.com/en/players/4535e4bb/Mathew-Ryan"
"5497","Bukayo Saka_2021",2021,"Arsenal","Premier League","Bukayo Saka","ENG","FW,MF","18",2001,28.4,25,16,10,13,2,11,40,27.5,29,21,2,19,25,50,24,0,"https://fbref.com/en/players/bc7dc64d/Bukayo-Saka"
"5498","Emile Smith Rowe_2021",2021,"Arsenal","Premier League","Emile Smith Rowe","ENG","MF,FW","20",2000,16,14,7,5,5,4,6,17,35.3,11,15,1,14,10,24,12,0,"https://fbref.com/en/players/17695062/Emile-Smith-Rowe"
"5499","Cédric Soares_2021",2021,"Arsenal","Premier League","Cédric Soares","POR","DF","28",1991,8.3,12,8,6,4,2,6,21,28.6,15,6,1,5,8,20,16,1,"https://fbref.com/en/players/839c14e1/Cedric-Soares"
"5500","Kieran Tierney_2021",2021,"Arsenal","Premier League","Kieran Tierney","SCO","DF","23",1997,25.5,27,15,5,14,8,11,31,35.5,20,31,10,21,16,43,63,0,"https://fbref.com/en/players/fce2302c/Kieran-Tierney"
"5501","Willian_2021",2021,"Arsenal","Premier League","Willian","BRA","FW","31",1988,15.6,13,7,6,6,1,6,16,37.5,10,13,0,13,8,21,8,0,"https://fbref.com/en/players/8b9ebd03/Willian"
"5502","Joe Willock_2021",2021,"Arsenal","Premier League","Joe Willock","ENG","MF","20",1999,2.6,6,3,1,4,1,3,7,42.9,4,6,1,5,3,9,0,0,"https://fbref.com/en/players/a3b03921/Joe-Willock"
"5503","Granit Xhaka_2021",2021,"Arsenal","Premier League","Granit Xhaka","SUI","MF,DF","27",1992,28,50,26,18,17,15,30,58,51.7,28,23,7,16,24,74,38,3,"https://fbref.com/en/players/e61b8aee/Granit-Xhaka"
"5504","Martin Ødegaard_2021",2021,"Arsenal","Premier League","Martin Ødegaard","NOR","MF","21",1998,9.6,9,3,2,6,1,4,14,28.6,10,2,0,2,2,11,5,0,"https://fbref.com/en/players/79300479/Martin-Odegaard"
"5505","Ross Barkley_2021",2021,"Aston Villa","Premier League","Ross Barkley","ENG","MF","26",1993,17,6,2,2,4,0,3,15,20,12,9,1,8,5,11,6,1,"https://fbref.com/en/players/3a24769f/Ross-Barkley"
"5506","Matty Cash_2021",2021,"Aston Villa","Premier League","Matty Cash","POL","DF","22",1997,26.4,71,40,43,22,6,41,74,55.4,33,50,11,39,60,131,95,0,"https://fbref.com/en/players/2389cdc2/Matty-Cash"
"5507","Carney Chukwuemeka_2021",2021,"Aston Villa","Premier League","Carney Chukwuemeka","ENG","MF,FW","16",2003,0.2,2,2,1,0,1,1,3,33.3,2,0,0,0,0,2,0,0,"https://fbref.com/en/players/b2f9c73e/Carney-Chukwuemeka"
"5508","Keinan Davis_2021",2021,"Aston Villa","Premier League","Keinan Davis","ENG","FW,MF","22",1998,3.1,2,1,1,0,1,0,1,0,1,1,0,1,0,2,2,0,"https://fbref.com/en/players/9deaf2c8/Keinan-Davis"
"5509","Ahmed Elmohamady_2021",2021,"Aston Villa","Premier League","Ahmed Elmohamady","EGY","DF","32",1987,9.3,17,13,12,4,1,9,14,64.3,5,6,3,3,17,34,26,0,"https://fbref.com/en/players/615ef733/Ahmed-Elmohamady"
"5510","Anwar El Ghazi_2021",2021,"Aston Villa","Premier League","Anwar El Ghazi","NED","FW","25",1995,17.9,16,13,6,7,3,7,23,30.4,16,11,0,11,6,22,11,0,"https://fbref.com/en/players/ffa90327/Anwar-El-Ghazi"
"5511","Jack Grealish_2021",2021,"Aston Villa","Premier League","Jack Grealish","ENG","FW,MF","24",1995,24.3,31,14,8,16,7,15,24,62.5,9,20,3,17,12,43,5,3,"https://fbref.com/en/players/b0b4fd3e/Jack-Grealish"
"5512","Kortney Hause_2021",2021,"Aston Villa","Premier League","Kortney Hause","ENG","DF","25",1995,7,4,2,3,1,0,0,3,0,3,4,2,2,8,12,53,0,"https://fbref.com/en/players/bf8fad51/Kortney-Hause"
"5513","Conor Hourihane_2021",2021,"Aston Villa","Premier League","Conor Hourihane","IRL","MF","29",1991,2.5,0,0,0,0,0,0,2,0,2,3,0,3,0,0,2,0,"https://fbref.com/en/players/fcab00a0/Conor-Hourihane"
"5514","Ezri Konsa_2021",2021,"Aston Villa","Premier League","Ezri Konsa","ENG","DF","22",1997,35.5,25,13,18,6,1,9,13,69.2,4,53,47,6,29,54,162,1,"https://fbref.com/en/players/0313a347/Ezri-Konsa"
"5515","Douglas Luiz_2021",2021,"Aston Villa","Premier League","Douglas Luiz","BRA","MF","22",1998,30.9,49,18,22,26,1,20,58,34.5,38,52,17,35,43,92,44,2,"https://fbref.com/en/players/6f7d826d/Douglas-Luiz"
"5516","Emiliano Martínez_2021",2021,"Aston Villa","Premier League","Emiliano Martínez","ARG","GK","27",1992,38,3,3,3,0,0,3,4,75,1,0,0,0,2,5,10,2,"https://fbref.com/en/players/7956236f/Emiliano-Martinez"
"5517","John McGinn_2021",2021,"Aston Villa","Premier League","John McGinn","SCO","MF","25",1994,37,61,37,23,31,7,27,84,32.1,57,38,6,32,43,104,23,2,"https://fbref.com/en/players/90f91999/John-McGinn"
"5518","Tyrone Mings_2021",2021,"Aston Villa","Premier League","Tyrone Mings","ENG","DF","27",1993,35.5,32,16,23,7,2,16,24,66.7,8,59,40,19,41,73,172,3,"https://fbref.com/en/players/8397a50c/Tyrone-Mings"
"5519","Wesley Moraes_2021",2021,"Aston Villa","Premier League","Wesley Moraes","BRA","FW","23",1996,0.2,0,0,0,0,0,0,1,0,1,0,0,0,0,0,0,0,"https://fbref.com/en/players/bfae110f/Wesley-Moraes"
"5520","Marvelous Nakamba_2021",2021,"Aston Villa","Premier League","Marvelous Nakamba","ZIM","MF","26",1994,8.3,22,14,10,11,1,7,12,58.3,5,16,5,11,17,39,9,1,"https://fbref.com/en/players/de5b5570/Marvelous-Nakamba"
"5521","Jaden Philogene Bidace_2021",2021,"Aston Villa","Premier League","Jaden Philogene Bidace","ENG","FW","18",2002,0,0,0,0,0,0,0,0,NA,0,0,0,0,0,0,0,0,"https://fbref.com/en/players/19f4d211/Jaden-Philogene-Bidace"
"5522","Jacob Ramsey_2021",2021,"Aston Villa","Premier League","Jacob Ramsey","ENG","MF","19",2001,7,10,5,3,4,3,2,12,16.7,10,13,6,7,4,14,5,0,"https://fbref.com/en/players/1544f145/Jacob-Ramsey"
"5523","Morgan Sanson_2021",2021,"Aston Villa","Premier League","Morgan Sanson","FRA","MF","25",1994,3.3,7,4,4,2,1,1,4,25,3,5,0,5,4,11,1,0,"https://fbref.com/en/players/6e7f1353/Morgan-Sanson"
"5524","Matt Targett_2021",2021,"Aston Villa","Premier League","Matt Targett","ENG","DF","24",1995,37.8,83,39,52,20,11,56,88,63.6,32,40,14,26,55,138,102,1,"https://fbref.com/en/players/e514ab62/Matt-Targett"
"5525","Neil Taylor_2021",2021,"Aston Villa","Premier League","Neil Taylor","WAL","DF","31",1989,0.2,1,1,1,0,0,0,0,NA,0,1,0,1,0,1,0,0,"https://fbref.com/en/players/c2f9d19f/Neil-Taylor"
"5526","Bertrand Traoré_2021",2021,"Aston Villa","Premier League","Bertrand Traoré","BFA","FW","24",1995,25.7,26,10,8,10,8,10,34,29.4,24,23,1,22,15,41,14,1,"https://fbref.com/en/players/c47541e0/Bertrand-Traore"
"5527","Trézéguet_2021",2021,"Aston Villa","Premier League","Trézéguet","EGY","FW","25",1994,13,33,18,14,15,4,13,45,28.9,32,13,1,12,19,52,17,0,"https://fbref.com/en/players/3ae14ed1/Trezeguet"
"5528","Ollie Watkins_2021",2021,"Aston Villa","Premier League","Ollie Watkins","ENG","FW","24",1995,37,29,17,5,16,8,10,33,30.3,23,21,2,19,7,36,24,0,"https://fbref.com/en/players/aed3a70f/Ollie-Watkins"
"5529","Davide Angelo Ghislandi_2021",2021,"Atalanta","Serie A","Davide Angelo Ghislandi","ITA","DF","19",2001,0.1,0,0,0,0,0,0,0,NA,0,0,0,0,0,0,1,0,"https://fbref.com/en/players/0e0e4422/Davide-Angelo-Ghislandi"
"5530","Mattia Caldara_2021",2021,"Atalanta","Serie A","Mattia Caldara","ITA","DF","26",1994,1.2,1,0,0,1,0,1,1,100,0,3,2,1,4,5,3,0,"https://fbref.com/en/players/ac7e640b/Mattia-Caldara"
"5531","Fabio Depaoli_2021",2021,"Atalanta","Serie A","Fabio Depaoli","ITA","DF","23",1997,2.1,3,2,0,1,2,1,2,50,1,4,0,4,3,6,2,0,"https://fbref.com/en/players/d97f2e8d/Fabio-Depaoli"
"5532","Amad Diallo_2021",2021,"Atalanta","Serie A","Amad Diallo","CIV","MF","18",2002,0.2,0,0,0,0,0,0,0,NA,0,0,0,0,0,0,0,0,"https://fbref.com/en/players/9dc96f10/Amad-Diallo"
"5533","Berat Djimsiti_2021",2021,"Atalanta","Serie A","Berat Djimsiti","ALB","DF","27",1993,29.2,41,29,27,12,2,17,34,50,17,34,20,14,62,103,89,1,"https://fbref.com/en/players/6eee05f1/Berat-Djimsiti"
"5534","Remo Freuler_2021",2021,"Atalanta","Serie A","Remo Freuler","SUI","MF","28",1992,30.1,63,39,17,38,8,32,76,42.1,44,52,4,48,39,102,27,2,"https://fbref.com/en/players/98d2c2c4/Remo-Freuler"
"5535","Pierluigi Gollini_2021",2021,"Atalanta","Serie A","Pierluigi Gollini","ITA","GK","25",1995,24,1,0,1,0,0,1,2,50,1,1,0,1,1,2,11,0,"https://fbref.com/en/players/f0f7f62f/Pierluigi-Gollini"
"5536","Papu Gómez_2021",2021,"Atalanta","Serie A","Papu Gómez","ARG","MF,FW","32",1988,7.4,3,2,2,1,0,2,8,25,6,8,1,7,1,4,1,0,"https://fbref.com/en/players/6e4df551/Papu-Gomez"
"5537","Robin Gosens_2021",2021,"Atalanta","Serie A","Robin Gosens","GER","DF","26",1994,28,46,35,20,15,11,17,41,41.5,24,50,7,43,41,87,34,0,"https://fbref.com/en/players/2d970560/Robin-Gosens"
"5538","Manu Gyabuaa_2021",2021,"Atalanta","Serie A","Manu Gyabuaa","ITA","MF","18",2001,0,0,0,0,0,0,0,0,NA,0,0,0,0,0,0,0,0,"https://fbref.com/en/players/a69eb5fd/Manu-Gyabuaa"
"5539","Hans Hateboer_2021",2021,"Atalanta","Serie A","Hans Hateboer","NED","DF","26",1994,19.6,28,17,12,14,2,13,23,56.5,10,8,1,7,17,45,9,0,"https://fbref.com/en/players/3b333ac3/Hans-Hateboer"
"5540","Josip Iličić_2021",2021,"Atalanta","Serie A","Josip Iličić","SVN","MF,FW","32",1988,17,9,4,1,5,3,5,21,23.8,16,12,0,12,2,11,0,1,"https://fbref.com/en/players/68252d6d/Josip-Ilicic"
"5541","Viktor Kovalenko_2021",2021,"Atalanta","Serie A","Viktor Kovalenko","UKR","FW","24",1996,0,0,0,0,0,0,0,0,NA,0,0,0,0,0,0,1,0,"https://fbref.com/en/players/9d60028d/Viktor-Kovalenko"
"5542","Sam Lammers_2021",2021,"Atalanta","Serie A","Sam Lammers","NED","FW,MF","23",1997,3.2,2,0,0,2,0,0,6,0,6,0,0,0,0,2,3,0,"https://fbref.com/en/players/c283ddef/Sam-Lammers"
"5543","José Luis Palomino_2021",2021,"Atalanta","Serie A","José Luis Palomino","ARG","DF","30",1990,27,67,33,41,19,7,24,48,50,24,30,16,14,79,146,60,2,"https://fbref.com/en/players/921f6058/Jose-Luis-Palomino"
"5544","Ruslan Malinovskyi_2021",2021,"Atalanta","Serie A","Ruslan Malinovskyi","UKR","MF,FW","27",1993,20.8,19,8,2,13,4,8,23,34.8,15,16,1,15,2,21,4,0,"https://fbref.com/en/players/48d5bd33/Ruslan-Malinovskyi"
"5545","Aleksei Miranchuk_2021",2021,"Atalanta","Serie A","Aleksei Miranchuk","RUS","MF,FW","24",1995,7.5,24,13,8,9,7,6,9,66.7,3,1,0,1,3,27,1,0,"https://fbref.com/en/players/a9aa0d1d/Aleksei-Miranchuk"
"5546","Johan Mojica_2021",2021,"Atalanta","Serie A","Johan Mojica","COL","DF","27",1992,3.3,4,4,3,1,0,2,3,66.7,1,3,0,3,7,11,6,0,"https://fbref.com/en/players/608f2092/Johan-Mojica"
"5547","Luis Muriel_2021",2021,"Atalanta","Serie A","Luis Muriel","COL","FW","29",1991,16,20,9,4,8,8,9,26,34.6,17,17,0,17,7,27,4,0,"https://fbref.com/en/players/eb2fe5b6/Luis-Muriel"
"5548","Joakim Mæhle_2021",2021,"Atalanta","Serie A","Joakim Mæhle","DEN","DF","23",1997,13.5,18,10,7,5,6,8,19,42.1,11,17,2,15,11,29,5,0,"https://fbref.com/en/players/c459a650/Joakim-Maehle"
"5549","Mario Pašalić_2021",2021,"Atalanta","Serie A","Mario Pašalić","CRO","MF","25",1995,12.5,26,15,5,17,4,12,19,63.2,7,12,1,11,8,34,6,0,"https://fbref.com/en/players/e599253a/Mario-Pasalic"
"5550","Matteo Pessina_2021",2021,"Atalanta","Serie A","Matteo Pessina","ITA","MF","23",1997,18.3,14,7,4,6,4,7,24,29.2,17,17,2,15,17,31,7,1,"https://fbref.com/en/players/780e3631/Matteo-Pessina"
"5551","Cristiano Piccini_2021",2021,"Atalanta","Serie A","Cristiano Piccini","ITA","DF","27",1992,0.7,1,1,1,0,0,0,1,0,1,1,0,1,0,1,0,0,"https://fbref.com/en/players/32c0491f/Cristiano-Piccini"
"5552","Cristian Romero_2021",2021,"Atalanta","Serie A","Cristian Romero","ARG","DF","22",1998,28.3,63,32,41,19,3,27,49,55.1,22,31,13,18,96,159,71,2,"https://fbref.com/en/players/a3d94a58/Cristian-Romero"
"5553","Marten de Roon_2021",2021,"Atalanta","Serie A","Marten de Roon","NED","MF","29",1991,33.6,80,48,30,36,14,36,84,42.9,48,44,9,35,69,149,40,0,"https://fbref.com/en/players/2a1beb34/Marten-de-Roon"
"5554","Matteo Ruggeri_2021",2021,"Atalanta","Serie A","Matteo Ruggeri","ITA","DF","18",2002,2.3,3,0,1,2,0,2,3,66.7,1,2,0,2,4,7,2,0,"https://fbref.com/en/players/ae9898c5/Matteo-Ruggeri"
"5555","Marco Sportiello_2021",2021,"Atalanta","Serie A","Marco Sportiello","ITA","GK","28",1992,14,2,2,2,0,0,1,3,33.3,2,0,0,0,2,4,5,1,"https://fbref.com/en/players/ac4003af/Marco-Sportiello"
"5556","Bosko Sutalo_2021",2021,"Atalanta","Serie A","Bosko Sutalo","CRO","DF","20",2000,2.6,5,5,0,3,2,4,5,80,1,2,1,1,2,7,7,1,"https://fbref.com/en/players/1d0bb7e4/Bosko-Sutalo"
"5557","Rafael Tolói_2021",2021,"Atalanta","Serie A","Rafael Tolói","ITA","DF","29",1990,28.2,51,23,21,26,4,26,48,54.2,22,37,7,30,33,84,66,0,"https://fbref.com/en/players/c56dc39e/Rafael-Toloi"
"5558","Duván Zapata_2021",2021,"Atalanta","Serie A","Duván Zapata","COL","FW","29",1991,26.4,12,5,2,3,7,4,13,30.8,9,19,5,14,6,18,19,0,"https://fbref.com/en/players/d3de9af0/Duvan-Zapata"
"5559","Yeray Álvarez_2021",2021,"Athletic Club","La Liga","Yeray Álvarez","ESP","DF","25",1995,21.6,19,12,11,8,0,9,21,42.9,12,12,5,7,53,72,73,0,"https://fbref.com/en/players/3ecc11d8/Yeray-Alvarez"
"5560","Mikel Balenziaga_2021",2021,"Athletic Club","La Liga","Mikel Balenziaga","ESP","DF","32",1988,18.8,26,15,11,12,3,9,18,50,9,22,7,15,7,33,46,0,"https://fbref.com/en/players/1fe67e86/Mikel-Balenziaga"
"5561","Yuri Berchiche_2021",2021,"Athletic Club","La Liga","Yuri Berchiche","ESP","DF","30",1990,18.7,24,19,14,5,5,10,24,41.7,14,14,0,14,11,35,29,0,"https://fbref.com/en/players/b6e50615/Yuri-Berchiche"
"5562","Álex Berenguer_2021",2021,"Athletic Club","La Liga","Álex Berenguer","ESP","MF,FW","25",1995,25.3,47,31,21,20,6,9,51,17.6,42,48,3,45,18,65,27,0,"https://fbref.com/en/players/dc1c2fce/Alex-Berenguer"
"5563","Ander Capa_2021",2021,"Athletic Club","La Liga","Ander Capa","ESP","DF","28",1992,23.7,37,18,22,13,2,18,37,48.6,19,21,8,13,25,62,57,0,"https://fbref.com/en/players/37f1cf47/Ander-Capa"
"5564","Iñigo Córdoba_2021",2021,"Athletic Club","La Liga","Iñigo Córdoba","ESP","FW,MF","23",1997,1.1,0,0,0,0,0,0,3,0,3,4,0,4,2,2,1,0,"https://fbref.com/en/players/49ea92be/Inigo-Cordoba"
"5565","Jokin Ezkieta_2021",2021,"Athletic Club","La Liga","Jokin Ezkieta","ESP","GK","23",1996,1,0,0,0,0,0,0,0,NA,0,0,0,0,0,0,0,0,"https://fbref.com/en/players/0f7dbaf6/Jokin-Ezkieta"
"5566","Dani García_2021",2021,"Athletic Club","La Liga","Dani García","ESP","MF","30",1990,21.3,39,19,10,23,6,15,46,32.6,31,20,7,13,33,72,34,0,"https://fbref.com/en/players/240d3a0b/Dani-Garcia"
"5567","Raúl García_2021",2021,"Athletic Club","La Liga","Raúl García","ESP","FW,MF","34",1986,19.4,34,19,9,19,6,7,22,31.8,15,30,1,29,15,49,20,0,"https://fbref.com/en/players/b418dbd4/Raul-Garcia"
"5568","Ibai Gómez_2021",2021,"Athletic Club","La Liga","Ibai Gómez","ESP","MF","30",1989,4.7,6,4,2,3,1,4,7,57.1,3,3,0,3,2,8,4,0,"https://fbref.com/en/players/9d2a3d5f/Ibai-Gomez"
"5569","Kenan Kodro_2021",2021,"Athletic Club","La Liga","Kenan Kodro","BIH","FW,MF","26",1993,0.5,0,0,0,0,0,0,1,0,1,0,0,0,0,0,0,0,"https://fbref.com/en/players/e82d2807/Kenan-Kodro"
"5570","Iñigo Lekue_2021",2021,"Athletic Club","La Liga","Iñigo Lekue","ESP","DF","27",1993,7.2,9,7,6,3,0,3,8,37.5,5,8,1,7,4,13,24,0,"https://fbref.com/en/players/59b7d823/Inigo-Lekue"
"5571","Unai López_2021",2021,"Athletic Club","La Liga","Unai López","ESP","MF","24",1995,15.8,27,17,13,13,1,10,29,34.5,19,20,5,15,18,45,9,1,"https://fbref.com/en/players/88050721/Unai-Lopez"
"5572","Óscar de Marcos_2021",2021,"Athletic Club","La Liga","Óscar de Marcos","ESP","DF,MF","31",1989,16.9,28,17,12,10,6,10,25,40,15,12,1,11,12,40,38,0,"https://fbref.com/en/players/9f323c71/Oscar-de-Marcos"
"5573","Iñigo Martínez_2021",2021,"Athletic Club","La Liga","Iñigo Martínez","ESP","DF","29",1991,28,22,15,16,6,0,9,27,33.3,18,17,7,10,28,50,96,0,"https://fbref.com/en/players/3fc45c73/Inigo-Martinez"
"5574","Jon Morcillo_2021",2021,"Athletic Club","La Liga","Jon Morcillo","ESP","MF,FW","21",1998,15.1,16,9,3,6,7,7,30,23.3,23,9,0,9,15,31,11,0,"https://fbref.com/en/players/b7d7f3bf/Jon-Morcillo"
"5575","Iker Muniain_2021",2021,"Athletic Club","La Liga","Iker Muniain","ESP","MF,FW","27",1992,21.6,20,7,4,10,6,6,24,25,18,15,0,15,11,31,4,0,"https://fbref.com/en/players/c05dfb74/Iker-Muniain"
"5576","Unai Núñez_2021",2021,"Athletic Club","La Liga","Unai Núñez","ESP","DF","23",1997,23.4,23,12,16,7,0,10,15,66.7,5,19,14,5,32,55,110,0,"https://fbref.com/en/players/be170419/Unai-Nunez"
"5577","Oihan Sancet_2021",2021,"Athletic Club","La Liga","Oihan Sancet","ESP","FW,MF","20",2000,11.5,8,2,3,4,1,2,7,28.6,5,4,0,4,5,13,7,0,"https://fbref.com/en/players/bdb624a3/Oihan-Sancet"
"5578","Unai Simón_2021",2021,"Athletic Club","La Liga","Unai Simón","ESP","GK","23",1997,37,1,0,1,0,0,1,2,50,1,0,0,0,0,1,7,7,"https://fbref.com/en/players/5dcf3e90/Unai-Simon"
"5579","Unai Vencedor Paris_2021",2021,"Athletic Club","La Liga","Unai Vencedor Paris","ESP","MF","19",2000,18.9,31,21,10,15,6,11,42,26.2,31,17,6,11,18,49,14,0,"https://fbref.com/en/players/4112ace5/Unai-Vencedor-Paris"
"5580","Mikel Vesga_2021",2021,"Athletic Club","La Liga","Mikel Vesga","ESP","MF","27",1993,19.1,28,14,8,16,4,12,50,24,38,28,8,20,27,55,35,1,"https://fbref.com/en/players/b0fce72c/Mikel-Vesga"
"5581","Iñigo Vicente_2021",2021,"Athletic Club","La Liga","Iñigo Vicente","ESP","FW,MF","22",1998,0.6,1,1,1,0,0,1,1,100,0,0,0,0,0,1,0,0,"https://fbref.com/en/players/afafac57/Inigo-Vicente"
"5582","Asier Villalibre_2021",2021,"Athletic Club","La Liga","Asier Villalibre","ESP","FW","22",1997,17.7,3,2,0,2,1,2,8,25,6,4,0,4,2,5,16,0,"https://fbref.com/en/players/57be54ec/Asier-Villalibre"
"5583","Iñaki Williams_2021",2021,"Athletic Club","La Liga","Iñaki Williams","GHA","FW","26",1994,26.5,11,7,0,4,7,2,14,14.3,12,13,1,12,5,16,22,0,"https://fbref.com/en/players/6a99e0b1/Inaki-Williams"
"5584","Nico Williams_2021",2021,"Athletic Club","La Liga","Nico Williams","ESP","MF","18",2002,0.6,1,0,1,0,0,0,2,0,2,0,0,0,1,2,0,0,"https://fbref.com/en/players/afdc14d7/Nico-Williams"
"5585","Oier Zarraga_2021",2021,"Athletic Club","La Liga","Oier Zarraga","ESP","MF","21",1999,1.1,1,1,0,1,0,1,2,50,1,1,0,1,0,1,0,0,"https://fbref.com/en/players/968a1c2f/Oier-Zarraga"
"5586","Yannick Carrasco_2021",2021,"Atlético Madrid","La Liga","Yannick Carrasco","BEL","DF,MF","26",1993,24.2,27,15,14,6,7,15,34,44.1,19,24,0,24,17,44,16,1,"https://fbref.com/en/players/de39485a/Yannick-Carrasco"
"5587","Ángel Correa_2021",2021,"Atlético Madrid","La Liga","Ángel Correa","ARG","FW,MF","25",1995,26.6,38,21,10,23,5,15,45,33.3,30,18,1,17,22,60,16,0,"https://fbref.com/en/players/01eb744d/Angel-Correa"
"5588","Diego Costa_2021",2021,"Atlético Madrid","La Liga","Diego Costa","ESP","FW","31",1988,2.3,1,0,1,0,0,1,3,33.3,2,0,0,0,0,1,2,0,"https://fbref.com/en/players/a190d597/Diego-Costa"
"5589","Moussa Dembélé_2021",2021,"Atlético Madrid","La Liga","Moussa Dembélé","FRA","FW","24",1996,1.1,0,0,0,0,0,0,1,0,1,0,0,0,1,1,0,0,"https://fbref.com/en/players/e7986081/Moussa-Dembele"
"5590","Felipe_2021",2021,"Atlético Madrid","La Liga","Felipe","BRA","DF","31",1989,22.9,29,17,19,10,0,18,23,78.3,5,30,15,15,36,65,128,2,"https://fbref.com/en/players/51a3c4c8/Felipe"
"5591","João Félix_2021",2021,"Atlético Madrid","La Liga","João Félix","POR","FW,MF","20",1999,17.5,8,4,1,6,1,4,17,23.5,13,3,0,3,5,13,2,0,"https://fbref.com/en/players/8aafd64f/Joao-Felix"
"5592","Mario Hermoso_2021",2021,"Atlético Madrid","La Liga","Mario Hermoso","ESP","DF","25",1995,28.6,55,31,40,11,4,37,61,60.7,24,23,10,13,36,91,73,0,"https://fbref.com/en/players/555f3a0b/Mario-Hermoso"
"5593","Héctor Herrera_2021",2021,"Atlético Madrid","La Liga","Héctor Herrera","MEX","MF","30",1990,7.6,12,7,5,6,1,7,13,53.8,6,7,2,5,14,26,8,0,"https://fbref.com/en/players/a8542814/Hector-Herrera"
"5594","Koke_2021",2021,"Atlético Madrid","La Liga","Koke","ESP","MF","28",1992,33.6,64,42,22,31,11,28,98,28.6,70,35,6,29,36,100,40,0,"https://fbref.com/en/players/55126f3b/Koke"
"5595","Geoffrey Kondogbia_2021",2021,"Atlético Madrid","La Liga","Geoffrey Kondogbia","CTA","MF","27",1993,6.8,30,20,12,16,2,11,20,55,9,11,5,6,11,41,8,1,"https://fbref.com/en/players/cce181df/Geoffrey-Kondogbia"
"5596","Thomas Lemar_2021",2021,"Atlético Madrid","La Liga","Thomas Lemar","FRA","MF","24",1995,15.2,30,17,9,17,4,11,24,45.8,13,22,1,21,11,41,10,0,"https://fbref.com/en/players/4dbd0916/Thomas-Lemar"
"5597","Marcos Llorente_2021",2021,"Atlético Madrid","La Liga","Marcos Llorente","ESP","MF,FW","25",1995,32.8,71,42,21,40,10,26,62,41.9,36,40,3,37,29,100,28,0,"https://fbref.com/en/players/02c15616/Marcos-Llorente"
"5598","Renan Lodi_2021",2021,"Atlético Madrid","La Liga","Renan Lodi","BRA","DF,FW","22",1998,12.5,30,17,13,12,5,17,26,65.4,9,15,0,15,16,46,18,0,"https://fbref.com/en/players/ed9f7cfe/Renan-Lodi"
"5599","José María Giménez_2021",2021,"Atlético Madrid","La Liga","José María Giménez","URU","DF","25",1995,19.6,20,7,14,5,1,12,17,70.6,5,17,11,6,21,41,65,0,"https://fbref.com/en/players/f0da930c/Jose-Maria-Gimenez"
"5600","Saúl Ñíguez_2021",2021,"Atlético Madrid","La Liga","Saúl Ñíguez","ESP","MF,DF","25",1994,22.6,57,34,27,23,7,30,59,50.8,29,35,2,33,19,76,43,0,"https://fbref.com/en/players/c14bc029/Saul-Niguez"
"5601","Jan Oblak_2021",2021,"Atlético Madrid","La Liga","Jan Oblak","SVN","GK","27",1993,38,0,0,0,0,0,0,0,NA,0,0,0,0,0,0,6,2,"https://fbref.com/en/players/ee8508c0/Jan-Oblak"
"5602","Thomas Partey_2021",2021,"Atlético Madrid","La Liga","Thomas Partey","GHA","MF","27",1993,2.2,7,4,4,3,0,5,8,62.5,3,4,1,3,2,9,1,0,"https://fbref.com/en/players/529f49ab/Thomas-Partey"
"5603","Ricard_2021",2021,"Atlético Madrid","La Liga","Ricard","ESP","DF","20",2000,0.3,1,1,0,0,1,0,0,NA,0,1,0,1,0,1,1,0,"https://fbref.com/en/players/fce521d7/Ricard"
"5604","Manu Sánchez_2021",2021,"Atlético Madrid","La Liga","Manu Sánchez","ESP","DF","19",2000,0.5,0,0,0,0,0,0,1,0,1,1,0,1,0,0,1,0,"https://fbref.com/en/players/ffacd3d5/Manu-Sanchez"
"5605","Stefan Savić_2021",2021,"Atlético Madrid","La Liga","Stefan Savić","MNE","DF","29",1991,32.8,40,25,32,7,1,21,34,61.8,13,33,19,14,42,82,110,0,"https://fbref.com/en/players/f6ac68c1/Stefan-Savic"
"5606","Luis Suárez_2021",2021,"Atlético Madrid","La Liga","Luis Suárez","URU","FW","33",1987,27.9,11,7,0,4,7,3,12,25,9,7,0,7,5,16,13,0,"https://fbref.com/en/players/a6154613/Luis-Suarez"
"5607","Lucas Torreira_2021",2021,"Atlético Madrid","La Liga","Lucas Torreira","URU","MF","24",1996,5.8,8,4,2,3,3,0,3,0,3,5,3,2,12,20,8,0,"https://fbref.com/en/players/52611641/Lucas-Torreira"
"5608","Kieran Trippier_2021",2021,"Atlético Madrid","La Liga","Kieran Trippier","ENG","DF","29",1990,27.5,61,39,30,25,6,26,52,50,26,22,4,18,40,101,58,1,"https://fbref.com/en/players/21512407/Kieran-Trippier"
"5609","Vitolo_2021",2021,"Atlético Madrid","La Liga","Vitolo","ESP","MF,FW","30",1989,3.3,4,1,2,0,2,1,6,16.7,5,3,0,3,3,7,2,0,"https://fbref.com/en/players/db750822/Vitolo"
"5610","Šime Vrsaljko_2021",2021,"Atlético Madrid","La Liga","Šime Vrsaljko","CRO","FW,DF","28",1992,5.8,18,12,13,5,0,8,12,66.7,4,5,0,5,8,26,14,0,"https://fbref.com/en/players/46a8347f/Sime-Vrsaljko"
"5611","Noah Joel Sarenren Bazee_2021",2021,"Augsburg","Bundesliga","Noah Joel Sarenren Bazee","NGA","FW,MF","23",1996,0.4,0,0,0,0,0,0,1,0,1,0,0,0,1,1,0,0,"https://fbref.com/en/players/fbbc8e15/Noah-Joel-Sarenren-Bazee"
"5612","László Bénes_2021",2021,"Augsburg","Bundesliga","László Bénes","SVK","MF","22",1997,7.3,8,6,4,4,0,2,8,25,6,6,2,4,7,15,1,1,"https://fbref.com/en/players/fe888e39/Laszlo-Benes"
"5613","Daniel Caligiuri_2021",2021,"Augsburg","Bundesliga","Daniel Caligiuri","ITA","MF,FW","32",1988,29.6,71,46,29,31,11,29,92,31.5,63,45,6,39,38,109,41,0,"https://fbref.com/en/players/d1273f09/Daniel-Caligiuri"
"5614","Tim Civeja_2021",2021,"Augsburg","Bundesliga","Tim Civeja","GER","MF","18",2002,0.4,0,0,0,0,0,0,1,0,1,0,0,0,3,3,0,0,"https://fbref.com/en/players/59a48c59/Tim-Civeja"
"5615","Ohis Felix Uduokhai_2021",2021,"Augsburg","Bundesliga","Ohis Felix Uduokhai","GER","DF","22",1997,29,33,24,19,10,4,18,27,66.7,9,48,25,23,54,87,164,2,"https://fbref.com/en/players/677da306/Ohis-Felix-Uduokhai"
"5616","Alfreð Finnbogason_2021",2021,"Augsburg","Bundesliga","Alfreð Finnbogason","ISL","FW","31",1989,6,2,1,0,1,1,0,1,0,1,7,1,6,1,3,4,0,"https://fbref.com/en/players/f9e7c4ac/Alfred-Finnbogason"
"5617","Raphael Framberger_2021",2021,"Augsburg","Bundesliga","Raphael Framberger","GER","DF","24",1995,17.1,42,23,26,11,5,19,25,76,6,24,2,22,36,78,62,1,"https://fbref.com/en/players/626fab5f/Raphael-Framberger"
"5618","Rafał Gikiewicz_2021",2021,"Augsburg","Bundesliga","Rafał Gikiewicz","POL","GK","32",1987,34,0,0,0,0,0,0,3,0,3,0,0,0,3,3,9,1,"https://fbref.com/en/players/17376543/Rafal-Gikiewicz"
"5619","Jeffrey Gouweleeuw_2021",2021,"Augsburg","Bundesliga","Jeffrey Gouweleeuw","NED","DF","29",1991,31.5,36,20,24,11,1,16,33,48.5,17,37,18,19,69,105,149,2,"https://fbref.com/en/players/1025db8e/Jeffrey-Gouweleeuw"
"5620","Michael Gregoritsch_2021",2021,"Augsburg","Bundesliga","Michael Gregoritsch","AUT","FW,MF","26",1994,9.3,13,10,6,7,0,3,10,30,7,2,0,2,3,16,17,0,"https://fbref.com/en/players/8e235926/Michael-Gregoritsch"
"5621","Carlos Gruezo_2021",2021,"Augsburg","Bundesliga","Carlos Gruezo","ECU","MF","25",1995,23.2,57,32,20,32,5,20,52,38.5,32,32,5,27,35,92,29,1,"https://fbref.com/en/players/f2dd9a21/Carlos-Gruezo"
"5622","Robert Gumny_2021",2021,"Augsburg","Bundesliga","Robert Gumny","POL","DF","22",1998,15.3,24,15,12,9,3,15,23,65.2,8,12,2,10,18,42,31,0,"https://fbref.com/en/players/1df0c0b9/Robert-Gumny"
"5623","André Hahn_2021",2021,"Augsburg","Bundesliga","André Hahn","GER","FW,MF","29",1990,22.6,31,17,14,13,4,9,44,20.5,35,35,3,32,14,45,24,0,"https://fbref.com/en/players/cd82452e/Andre-Hahn"
"5624","Iago_2021",2021,"Augsburg","Bundesliga","Iago","BRA","DF","23",1997,17.3,37,27,21,13,3,17,29,58.6,12,17,5,12,22,59,55,0,"https://fbref.com/en/players/054849d2/Iago"
"5625","Fredrik Jensen_2021",2021,"Augsburg","Bundesliga","Fredrik Jensen","FIN","FW,MF","22",1997,4.2,3,2,1,2,0,3,6,50,3,4,1,3,2,5,6,0,"https://fbref.com/en/players/3eeb80e0/Fredrik-Jensen"
"5626","Rani Khedira_2021",2021,"Augsburg","Bundesliga","Rani Khedira","GER","MF","26",1994,20.2,29,10,13,15,1,10,20,50,10,14,5,9,31,60,47,0,"https://fbref.com/en/players/59e4b92e/Rani-Khedira"
"5627","Jan Morávek_2021",2021,"Augsburg","Bundesliga","Jan Morávek","CZE","MF","30",1989,3,5,3,4,1,0,1,8,12.5,7,3,0,3,7,12,2,0,"https://fbref.com/en/players/e7d22eae/Jan-Moravek"
"5628","Florian Niederlechner_2021",2021,"Augsburg","Bundesliga","Florian Niederlechner","GER","FW","29",1990,19.3,7,5,1,4,2,0,10,0,10,8,3,5,10,17,18,0,"https://fbref.com/en/players/d6862409/Florian-Niederlechner"
"5629","Reece Oxford_2021",2021,"Augsburg","Bundesliga","Reece Oxford","ENG","DF","21",1998,15.1,26,18,15,11,0,10,17,58.8,7,28,22,6,29,55,89,0,"https://fbref.com/en/players/8b6e0db2/Reece-Oxford"
"5630","Mads Pedersen_2021",2021,"Augsburg","Bundesliga","Mads Pedersen","DEN","DF","23",1996,9.9,25,16,20,3,2,10,22,45.5,12,13,3,10,15,40,32,0,"https://fbref.com/en/players/582a5247/Mads-Pedersen"
"5631","Lukas Petkov_2021",2021,"Augsburg","Bundesliga","Lukas Petkov","GER","MF","19",2000,0,0,0,0,0,0,0,0,NA,0,0,0,0,0,0,0,0,"https://fbref.com/en/players/f503ef6e/Lukas-Petkov"
"5632","Marco Richter_2021",2021,"Augsburg","Bundesliga","Marco Richter","GER","FW,MF","22",1997,15.7,17,9,3,12,2,7,23,30.4,16,10,0,10,6,23,9,0,"https://fbref.com/en/players/f972644c/Marco-Richter"
"5633","Tobias Strobl_2021",2021,"Augsburg","Bundesliga","Tobias Strobl","GER","MF","30",1990,20.5,21,10,12,9,0,10,30,33.3,20,21,8,13,28,49,27,0,"https://fbref.com/en/players/17780d2b/Tobias-Strobl"
"5634","Marek Suchý_2021",2021,"Augsburg","Bundesliga","Marek Suchý","CZE","DF","32",1988,3.4,4,2,1,3,0,1,2,50,1,3,3,0,4,8,9,0,"https://fbref.com/en/players/c5224618/Marek-Suchy"
"5635","Ruben Vargas_2021",2021,"Augsburg","Bundesliga","Ruben Vargas","SUI","MF,FW","21",1998,17.9,18,12,6,9,3,1,16,6.3,15,26,2,24,18,36,27,0,"https://fbref.com/en/players/6ecbddf6/Ruben-Vargas"
"5636","Jordi Alba_2021",2021,"Barcelona","La Liga","Jordi Alba","ESP","DF,FW","31",1989,33.6,45,30,22,16,7,24,52,46.2,28,21,2,19,49,94,48,0,"https://fbref.com/en/players/4601e194/Jordi-Alba"
"5637","Carles Aleñá_2021",2021,"Barcelona","La Liga","Carles Aleñá","ESP","MF","22",1998,0.5,1,0,1,0,0,0,0,NA,0,0,0,0,0,1,0,0,"https://fbref.com/en/players/6c811eb7/Carles-Alena"
"5638","Ronald Araújo_2021",2021,"Barcelona","La Liga","Ronald Araújo","URU","DF","21",1999,16.8,22,11,12,8,2,9,9,100,0,24,15,9,20,42,47,1,"https://fbref.com/en/players/2bef2bca/Ronald-Araujo"
"5639","Martin Braithwaite_2021",2021,"Barcelona","La Liga","Martin Braithwaite","DEN","FW","29",1991,13.1,8,4,2,3,3,1,6,16.7,5,2,0,2,6,14,7,0,"https://fbref.com/en/players/fd771f95/Martin-Braithwaite"
"5640","Sergio Busquets_2021",2021,"Barcelona","La Liga","Sergio Busquets","ESP","MF","32",1988,28,63,35,21,29,13,27,76,35.5,49,27,4,23,53,116,18,2,"https://fbref.com/en/players/5ab0ea87/Sergio-Busquets"
"5641","Philippe Coutinho_2021",2021,"Barcelona","La Liga","Philippe Coutinho","BRA","MF,FW","28",1992,7.3,8,6,2,5,1,3,9,33.3,6,7,0,7,2,10,1,0,"https://fbref.com/en/players/0ef89a37/Philippe-Coutinho"
"5642","Ousmane Dembélé_2021",2021,"Barcelona","La Liga","Ousmane Dembélé","FRA","FW","23",1997,19.7,14,9,4,9,1,6,17,35.3,11,10,0,10,9,23,3,1,"https://fbref.com/en/players/b19db005/Ousmane-Dembele"
"5643","Sergiño Dest_2021",2021,"Barcelona","La Liga","Sergiño Dest","USA","DF,FW","19",2000,21.2,31,16,23,6,2,18,32,56.3,14,25,4,21,10,41,24,1,"https://fbref.com/en/players/5976f83e/Sergino-Dest"
"5644","Ansu Fati_2021",2021,"Barcelona","La Liga","Ansu Fati","ESP","FW","17",2002,4.8,9,4,2,4,3,2,10,20,8,4,0,4,3,12,1,0,"https://fbref.com/en/players/0ba976e4/Ansu-Fati"
"5645","Junior Firpo_2021",2021,"Barcelona","La Liga","Junior Firpo","ESP","DF,MF","23",1996,3.2,1,1,1,0,0,0,1,0,1,5,3,2,4,5,7,0,"https://fbref.com/en/players/24f59bb2/Junior-Firpo"
"5646","Antoine Griezmann_2021",2021,"Barcelona","La Liga","Antoine Griezmann","FRA","FW,MF","29",1991,28.9,37,22,10,18,9,12,40,30,28,20,1,19,12,49,11,0,"https://fbref.com/en/players/df69b544/Antoine-Griezmann"
"5647","Frenkie de Jong_2021",2021,"Barcelona","La Liga","Frenkie de Jong","NED","MF,DF","23",1997,35,44,27,21,19,4,15,35,42.9,20,20,4,16,38,82,29,2,"https://fbref.com/en/players/1bacc518/Frenkie-de-Jong"
"5648","Clément Lenglet_2021",2021,"Barcelona","La Liga","Clément Lenglet","FRA","DF","25",1995,27.5,36,21,23,10,3,19,28,67.9,9,26,12,14,33,69,71,1,"https://fbref.com/en/players/4f28a6ff/Clement-Lenglet"
"5649","Lionel Messi_2021",2021,"Barcelona","La Liga","Lionel Messi","ARG","FW,MF","33",1987,33.6,18,10,3,9,6,6,17,35.3,11,12,0,12,6,24,0,2,"https://fbref.com/en/players/d70ce98e/Lionel-Messi"
"5650","Óscar Mingueza_2021",2021,"Barcelona","La Liga","Óscar Mingueza","ESP","DF","21",1999,21.1,52,33,28,17,7,30,53,56.6,23,19,6,13,20,72,48,2,"https://fbref.com/en/players/056269d7/Oscar-Mingueza"
"5651","Ilaix Moriba_2021",2021,"Barcelona","La Liga","Ilaix Moriba","GUI","MF","17",2003,6,14,6,5,7,2,5,10,50,5,16,1,15,5,19,4,1,"https://fbref.com/en/players/f4c69aa6/Ilaix-Moriba"
"5652","Neto_2021",2021,"Barcelona","La Liga","Neto","BRA","GK","31",1989,7,0,0,0,0,0,0,1,0,1,0,0,0,0,0,3,1,"https://fbref.com/en/players/a9dc785c/Neto"
"5653","Pedri_2021",2021,"Barcelona","La Liga","Pedri","ESP","MF","17",2002,26.8,44,27,16,16,12,17,71,23.9,54,46,1,45,33,77,7,0,"https://fbref.com/en/players/0d9b2d31/Pedri"
"5654","Gerard Piqué_2021",2021,"Barcelona","La Liga","Gerard Piqué","ESP","DF","33",1987,16.5,16,11,11,5,0,9,12,75,3,9,4,5,26,42,46,0,"https://fbref.com/en/players/adfc9123/Gerard-Pique"
"5655","Miralem Pjanić_2021",2021,"Barcelona","La Liga","Miralem Pjanić","BIH","MF","30",1990,7,13,8,7,4,2,7,13,53.8,6,5,1,4,11,24,5,0,"https://fbref.com/en/players/ad6df2d5/Miralem-Pjanic"
"5656","Riqui Puig_2021",2021,"Barcelona","La Liga","Riqui Puig","ESP","MF,FW","20",1999,3.2,5,3,1,3,1,4,8,50,4,0,0,0,1,6,0,0,"https://fbref.com/en/players/f090a37a/Riqui-Puig"
"5657","Sergi Roberto_2021",2021,"Barcelona","La Liga","Sergi Roberto","ESP","DF,FW","28",1992,10.5,9,6,5,2,2,7,13,53.8,6,12,6,6,10,19,20,0,"https://fbref.com/en/players/335fa267/Sergi-Roberto"
"5658","Marc-André ter Stegen_2021",2021,"Barcelona","La Liga","Marc-André ter Stegen","GER","GK","28",1992,31,0,0,0,0,0,0,2,0,2,0,0,0,0,0,12,2,"https://fbref.com/en/players/6f51e382/Marc-Andre-ter-Stegen"
"5659","Francisco Trincão_2021",2021,"Barcelona","La Liga","Francisco Trincão","POR","FW,MF","20",1999,7.8,4,2,0,3,1,2,5,40,3,4,0,4,1,5,2,0,"https://fbref.com/en/players/77e39b04/Francisco-Trincao"
"5660","Samuel Umtiti_2021",2021,"Barcelona","La Liga","Samuel Umtiti","FRA","DF","26",1993,7.2,5,1,3,2,0,1,2,50,1,11,6,5,9,14,15,0,"https://fbref.com/en/players/3eed9821/Samuel-Umtiti"
"5661","David Alaba_2021",2021,"Bayern Munich","Bundesliga","David Alaba","AUT","DF,MF","28",1992,29.7,37,21,14,19,4,17,32,53.1,15,29,13,16,43,80,60,0,"https://fbref.com/en/players/05439de2/David-Alaba"
"5662","Jérôme Boateng_2021",2021,"Bayern Munich","Bundesliga","Jérôme Boateng","GER","DF","31",1988,26.3,26,16,17,8,1,14,32,43.8,18,24,17,7,40,66,63,1,"https://fbref.com/en/players/2db2fd7b/Jerome-Boateng"
"5663","Kingsley Coman_2021",2021,"Bayern Munich","Bundesliga","Kingsley Coman","FRA","FW,MF","24",1996,19.5,14,8,6,7,1,2,21,9.5,19,22,0,22,4,18,3,0,"https://fbref.com/en/players/042e8a49/Kingsley-Coman"
"5664","Douglas Costa_2021",2021,"Bayern Munich","Bundesliga","Douglas Costa","BRA","FW,MF","29",1990,3.6,2,1,1,1,0,1,3,33.3,2,7,0,7,2,4,1,0,"https://fbref.com/en/players/4fa7cb9b/Douglas-Costa"
"5665","Mickaël Cuisance_2021",2021,"Bayern Munich","Bundesliga","Mickaël Cuisance","FRA","FW","20",1999,0.2,0,0,0,0,0,0,0,NA,0,1,0,1,0,0,0,0,"https://fbref.com/en/players/5722eced/Mickael-Cuisance"
"5666","Tiago Dantas_2021",2021,"Bayern Munich","Bundesliga","Tiago Dantas","POR","MF","19",2000,0.8,1,1,0,0,1,0,0,NA,0,0,0,0,0,1,0,0,"https://fbref.com/en/players/234204f4/Tiago-Dantas"
"5667","Alphonso Davies_2021",2021,"Bayern Munich","Bundesliga","Alphonso Davies","CAN","DF","19",2000,19.6,39,27,16,17,6,28,40,70,12,21,1,20,28,67,33,1,"https://fbref.com/en/players/d781d855/Alphonso-Davies"
"5668","Serge Gnabry_2021",2021,"Bayern Munich","Bundesliga","Serge Gnabry","GER","FW,MF","25",1995,18.3,39,19,7,19,13,12,32,37.5,20,17,0,17,26,65,3,0,"https://fbref.com/en/players/88e357ef/Serge-Gnabry"
"5669","Leon Goretzka_2021",2021,"Bayern Munich","Bundesliga","Leon Goretzka","GER","MF","25",1995,18.9,37,23,12,21,4,16,39,41,23,30,2,28,44,81,11,0,"https://fbref.com/en/players/cc86b9a3/Leon-Goretzka"
"5670","Lucas Hernández_2021",2021,"Bayern Munich","Bundesliga","Lucas Hernández","FRA","DF","24",1996,17.7,41,31,16,17,8,17,31,54.8,14,24,6,18,19,60,38,0,"https://fbref.com/en/players/c3ee18ef/Lucas-Hernandez"
"5671","Joshua Kimmich_2021",2021,"Bayern Munich","Bundesliga","Joshua Kimmich","GER","MF","25",1995,24.4,40,28,16,19,5,10,53,18.9,43,25,5,20,36,76,19,0,"https://fbref.com/en/players/49296448/Joshua-Kimmich"
"5672","Robert Lewandowski_2021",2021,"Bayern Munich","Bundesliga","Robert Lewandowski","POL","FW","31",1988,27.3,15,9,0,7,8,2,13,15.4,11,9,1,8,3,18,11,0,"https://fbref.com/en/players/8d78e732/Robert-Lewandowski"
"5673","Javi Martínez_2021",2021,"Bayern Munich","Bundesliga","Javi Martínez","ESP","DF,MF","31",1988,5.2,10,5,4,4,2,7,9,77.8,2,8,4,4,13,23,19,0,"https://fbref.com/en/players/7f97771d/Javi-Martinez"
"5674","Eric Maxim Choupo-Moting_2021",2021,"Bayern Munich","Bundesliga","Eric Maxim Choupo-Moting","CMR","FW,MF","31",1989,9.1,8,2,0,5,3,1,4,25,3,6,0,6,2,10,7,0,"https://fbref.com/en/players/0e6bc38c/Eric-Maxim-Choupo-Moting"
"5675","Thomas Müller_2021",2021,"Bayern Munich","Bundesliga","Thomas Müller","GER","MF","30",1989,29.7,49,22,11,23,15,24,73,32.9,49,43,3,40,21,70,18,1,"https://fbref.com/en/players/3c6089ab/Thomas-Muller"
"5676","Jamal Musiala_2021",2021,"Bayern Munich","Bundesliga","Jamal Musiala","GER","FW,MF","17",2003,9.8,20,12,5,7,8,7,22,31.8,15,17,2,15,14,34,3,0,"https://fbref.com/en/players/2c0558b8/Jamal-Musiala"
"5677","Manuel Neuer_2021",2021,"Bayern Munich","Bundesliga","Manuel Neuer","GER","GK","34",1986,33,0,0,0,0,0,0,1,0,1,0,0,0,2,2,12,3,"https://fbref.com/en/players/8778c910/Manuel-Neuer"
"5678","Tanguy Nianzou_2021",2021,"Bayern Munich","Bundesliga","Tanguy Nianzou","FRA","DF,FW","18",2002,1.3,3,1,3,0,0,1,1,100,0,0,0,0,3,6,1,0,"https://fbref.com/en/players/5853ac44/Tanguy-Nianzou"
"5679","Alexander Nübel_2021",2021,"Bayern Munich","Bundesliga","Alexander Nübel","GER","GK","23",1996,1,0,0,0,0,0,0,0,NA,0,0,0,0,0,0,1,0,"https://fbref.com/en/players/afb0c500/Alexander-Nubel"
"5680","Benjamin Pavard_2021",2021,"Bayern Munich","Bundesliga","Benjamin Pavard","FRA","DF","24",1996,21.6,44,27,20,16,8,23,40,57.5,17,29,5,24,48,92,31,1,"https://fbref.com/en/players/45a03961/Benjamin-Pavard"
"5681","Chris Richards_2021",2021,"Bayern Munich","Bundesliga","Chris Richards","USA","DF","20",2000,1,0,0,0,0,0,0,0,NA,0,0,0,0,1,1,1,0,"https://fbref.com/en/players/0a3d6d2b/Chris-Richards"
"5682","Marc Roca_2021",2021,"Bayern Munich","Bundesliga","Marc Roca","ESP","MF","23",1996,2,2,2,0,0,2,0,4,0,4,4,1,3,2,4,1,0,"https://fbref.com/en/players/da27e268/Marc-Roca"
"5683","Leroy Sané_2021",2021,"Bayern Munich","Bundesliga","Leroy Sané","GER","FW,MF","24",1996,20.1,18,10,2,10,6,13,30,43.3,17,23,1,22,9,27,8,1,"https://fbref.com/en/players/2b114be3/Leroy-Sane"
"5684","Bouna Sarr_2021",2021,"Bayern Munich","Bundesliga","Bouna Sarr","SEN","DF","28",1992,5,9,8,4,3,2,3,6,50,3,7,0,7,10,19,7,1,"https://fbref.com/en/players/1a4b9094/Bouna-Sarr"
"5685","Christopher Scott_2021",2021,"Bayern Munich","Bundesliga","Christopher Scott","GER","MF,FW","18",2002,0.4,2,1,0,1,1,2,2,100,0,0,0,0,0,2,1,0,"https://fbref.com/en/players/2723ce5d/Christopher-Scott"
"5686","Josip Stanišić_2021",2021,"Bayern Munich","Bundesliga","Josip Stanišić","CRO","DF","20",2000,1,2,2,1,1,0,1,1,100,0,3,0,3,2,4,2,0,"https://fbref.com/en/players/7ed08d5c/Josip-Stanisic"
"5687","Niklas Süle_2021",2021,"Bayern Munich","Bundesliga","Niklas Süle","GER","DF","24",1995,16.7,32,21,15,14,3,13,21,61.9,8,24,12,12,21,53,36,1,"https://fbref.com/en/players/e33c06cf/Niklas-Sule"
"5688","Corentin Tolisso_2021",2021,"Bayern Munich","Bundesliga","Corentin Tolisso","FRA","MF","25",1994,8.7,19,19,4,11,4,9,29,31,20,15,2,13,6,25,8,0,"https://fbref.com/en/players/652d4c37/Corentin-Tolisso"
"5689","Joshua Zirkzee_2021",2021,"Bayern Munich","Bundesliga","Joshua Zirkzee","NED","FW","19",2001,1,1,0,0,1,0,1,2,50,1,0,0,0,0,1,0,0,"https://fbref.com/en/players/028e70b9/Joshua-Zirkzee"
"5690","Federico Barba_2021",2021,"Benevento","Serie A","Federico Barba","ITA","DF","26",1993,29.5,31,16,22,8,1,21,35,60,14,39,18,21,48,79,94,4,"https://fbref.com/en/players/c010b898/Federico-Barba"
"5691","Luca Caldirola_2021",2021,"Benevento","Serie A","Luca Caldirola","ITA","DF","29",1991,17.5,21,13,13,6,2,10,22,45.5,12,20,15,5,20,41,56,0,"https://fbref.com/en/players/226008f1/Luca-Caldirola"
"5692","Gianluca Caprari_2021",2021,"Benevento","Serie A","Gianluca Caprari","ITA","MF,FW","27",1993,20.7,16,11,5,5,6,6,31,19.4,25,19,1,18,18,34,8,0,"https://fbref.com/en/players/54e53b7e/Gianluca-Caprari"
"5693","Bryan Dabo_2021",2021,"Benevento","Serie A","Bryan Dabo","BFA","MF","28",1992,12.4,11,8,5,3,3,5,16,31.3,11,7,1,6,13,24,16,0,"https://fbref.com/en/players/c53083ad/Bryan-Dabo"
"5694","Lorenzo Del Pinto_2021",2021,"Benevento","Serie A","Lorenzo Del Pinto","ITA","MF","30",1990,0.1,0,0,0,0,0,0,2,0,2,0,0,0,0,0,0,0,"https://fbref.com/en/players/081b6080/Lorenzo-Del-Pinto"
"5695","Fabio Depaoli_2021",2021,"Benevento","Serie A","Fabio Depaoli","ITA","DF","23",1997,12.4,25,13,15,6,4,15,32,46.9,17,16,4,12,12,37,38,0,"https://fbref.com/en/players/d97f2e8d/Fabio-Depaoli"
"5696","Giuseppe Di Serio_2021",2021,"Benevento","Serie A","Giuseppe Di Serio","ITA","FW,MF","19",2001,3.2,2,2,1,1,0,0,4,0,4,5,0,5,0,2,4,0,"https://fbref.com/en/players/5048486b/Giuseppe-Di-Serio"
"5697","Amadou Diambo_2021",2021,"Benevento","Serie A","Amadou Diambo","GHA","FW","19",2001,0,0,0,0,0,0,0,0,NA,0,0,0,0,0,0,0,0,"https://fbref.com/en/players/c3a847c7/Amadou-Diambo"
"5698","Iago Falque_2021",2021,"Benevento","Serie A","Iago Falque","ESP","MF,FW","30",1990,4,4,2,2,2,0,1,6,16.7,5,4,1,3,0,4,1,0,"https://fbref.com/en/players/440c84ed/Iago-Falque"
"5699","Daam Foulon_2021",2021,"Benevento","Serie A","Daam Foulon","BEL","DF","21",1999,11.3,26,15,21,5,0,16,28,57.1,12,12,3,9,14,40,34,0,"https://fbref.com/en/players/658d44be/Daam-Foulon"
"5700","Adolfo Gaich_2021",2021,"Benevento","Serie A","Adolfo Gaich","ARG","FW","21",1999,8.5,9,4,1,7,1,1,13,7.7,12,4,0,4,2,11,4,0,"https://fbref.com/en/players/8dfed6e9/Adolfo-Gaich"
"5701","Kamil Glik_2021",2021,"Benevento","Serie A","Kamil Glik","POL","DF","32",1988,35.6,44,24,33,10,1,25,53,47.2,28,37,31,6,62,106,153,0,"https://fbref.com/en/players/c6056d58/Kamil-Glik"
"5702","Përparim Hetemaj_2021",2021,"Benevento","Serie A","Përparim Hetemaj","FIN","MF","33",1986,24.6,44,27,21,18,5,26,61,42.6,35,41,5,36,22,66,24,1,"https://fbref.com/en/players/90b70194/Perparim-Hetemaj"
"5703","Riccardo Improta_2021",2021,"Benevento","Serie A","Riccardo Improta","ITA","DF,MF","26",1993,25.9,39,23,25,8,6,21,45,46.7,24,23,4,19,28,67,47,0,"https://fbref.com/en/players/f6dfa5b8/Riccardo-Improta"
"5704","Roberto Insigne_2021",2021,"Benevento","Serie A","Roberto Insigne","ITA","MF,FW","26",1994,17.8,16,10,8,3,5,7,27,25.9,20,10,0,10,7,23,9,0,"https://fbref.com/en/players/8faf7b3c/Roberto-Insigne"
"5705","Artur Ioniță_2021",2021,"Benevento","Serie A","Artur Ioniță","MDA","MF","29",1990,31.5,47,22,11,31,5,17,63,27,46,38,14,24,19,66,28,0,"https://fbref.com/en/players/cedb3e36/Artur-Ionita"
"5706","Gianluca Lapadula_2021",2021,"Benevento","Serie A","Gianluca Lapadula","PER","FW","30",1990,28.5,22,12,3,13,6,6,25,24,19,18,3,15,5,27,16,0,"https://fbref.com/en/players/2ead2809/Gianluca-Lapadula"
"5707","Gaetano Letizia_2021",2021,"Benevento","Serie A","Gaetano Letizia","ITA","DF","30",1990,17.4,36,25,19,13,4,17,36,47.2,19,15,3,12,20,56,42,1,"https://fbref.com/en/players/3dd45b70/Gaetano-Letizia"
"5708","Christian Maggio_2021",2021,"Benevento","Serie A","Christian Maggio","ITA","DF","38",1982,3.3,9,4,2,7,0,3,9,33.3,6,4,1,3,2,11,6,0,"https://fbref.com/en/players/31d7f557/Christian-Maggio"
"5709","Niccolò Manfredini_2021",2021,"Benevento","Serie A","Niccolò Manfredini","ITA","GK","32",1988,1,0,0,0,0,0,0,0,NA,0,0,0,0,0,0,2,1,"https://fbref.com/en/players/e4b39692/Niccolo-Manfredini"
"5710","Gabriele Moncini_2021",2021,"Benevento","Serie A","Gabriele Moncini","ITA","FW,MF","24",1996,4,2,1,2,0,0,0,1,0,1,2,0,2,2,4,4,0,"https://fbref.com/en/players/c4efe2b4/Gabriele-Moncini"
"5711","Lorenzo Montipò_2021",2021,"Benevento","Serie A","Lorenzo Montipò","ITA","GK","24",1996,37,0,0,0,0,0,0,0,NA,0,1,0,1,0,0,16,3,"https://fbref.com/en/players/c1d95617/Lorenzo-Montipo"
"5712","Christian Pastina_2021",2021,"Benevento","Serie A","Christian Pastina","ITA","DF","19",2001,1.3,0,0,0,0,0,0,1,0,1,1,0,1,1,1,8,0,"https://fbref.com/en/players/38bf62b5/Christian-Pastina"
"5713","Siriki Sanogo_2021",2021,"Benevento","Serie A","Siriki Sanogo","CIV","MF","18",2001,0.1,0,0,0,0,0,0,0,NA,0,0,0,0,0,0,0,0,"https://fbref.com/en/players/ff120e44/Siriki-Sanogo"
"5714","Marco Sau_2021",2021,"Benevento","Serie A","Marco Sau","ITA","MF,FW","32",1987,8.7,6,2,0,6,0,1,16,6.3,15,7,0,7,5,11,3,0,"https://fbref.com/en/players/1ad1f50d/Marco-Sau"
"5715","Pasquale Schiattarella_2021",2021,"Benevento","Serie A","Pasquale Schiattarella","ITA","MF","33",1987,25,37,22,25,12,0,19,47,40.4,28,19,5,14,32,69,29,2,"https://fbref.com/en/players/bd84fc61/Pasquale-Schiattarella"
"5716","Andrés Tello_2021",2021,"Benevento","Serie A","Andrés Tello","COL","DF,MF","23",1996,4.6,9,6,8,0,1,5,20,25,15,8,1,7,6,15,6,0,"https://fbref.com/en/players/5f951ef1/Andres-Tello"
"5717","Alessandro Tuia_2021",2021,"Benevento","Serie A","Alessandro Tuia","ITA","DF","30",1990,19.6,39,17,34,4,1,15,25,60,10,22,10,12,36,75,91,1,"https://fbref.com/en/players/26c54058/Alessandro-Tuia"
"5718","Nicolas Viola_2021",2021,"Benevento","Serie A","Nicolas Viola","ITA","MF","30",1989,11.5,16,9,2,11,3,6,28,21.4,22,10,3,7,9,25,7,0,"https://fbref.com/en/players/45392b06/Nicolas-Viola"
"5719","Paul Akouokou_2021",2021,"Betis","La Liga","Paul Akouokou","CIV","MF","22",1997,4.2,11,8,2,8,1,5,8,62.5,3,3,1,2,6,17,7,0,"https://fbref.com/en/players/31f5b89b/Paul-Akouokou"
"5720","Marc Bartra_2021",2021,"Betis","La Liga","Marc Bartra","ESP","DF","29",1991,18.8,27,16,18,8,1,12,22,54.5,10,19,5,14,40,67,74,3,"https://fbref.com/en/players/b742cc0d/Marc-Bartra"
"5721","Claudio Bravo_2021",2021,"Betis","La Liga","Claudio Bravo","CHI","GK","37",1983,20,0,0,0,0,0,0,1,0,1,0,0,0,0,0,11,0,"https://fbref.com/en/players/10072610/Claudio-Bravo"
"5722","Sergio Canales_2021",2021,"Betis","La Liga","Sergio Canales","ESP","MF,FW","29",1991,27.8,16,9,9,6,1,3,21,14.3,18,18,0,18,13,29,5,0,"https://fbref.com/en/players/a6de370d/Sergio-Canales"
"5723","William Carvalho_2021",2021,"Betis","La Liga","William Carvalho","POR","MF","28",1992,13.6,19,12,7,11,1,5,21,23.8,16,11,3,8,11,30,14,1,"https://fbref.com/en/players/dee86451/William-Carvalho"
"5724","Emerson_2021",2021,"Betis","La Liga","Emerson","BRA","DF","21",1999,33.2,91,52,62,25,4,43,78,55.1,35,33,6,27,61,152,102,2,"https://fbref.com/en/players/df8b52a5/Emerson"
"5725","Nabil Fekir_2021",2021,"Betis","La Liga","Nabil Fekir","FRA","MF,FW","27",1993,29.1,45,23,9,22,14,7,43,16.3,36,31,2,29,8,53,2,0,"https://fbref.com/en/players/bece776f/Nabil-Fekir"
"5726","Andrés Guardado_2021",2021,"Betis","La Liga","Andrés Guardado","MEX","MF","33",1986,14.6,25,12,10,11,4,10,25,40,15,13,3,10,18,43,19,0,"https://fbref.com/en/players/ef322658/Andres-Guardado"
"5727","Borja Iglesias_2021",2021,"Betis","La Liga","Borja Iglesias","ESP","FW","27",1993,15.7,1,1,0,0,1,1,8,12.5,7,7,2,5,3,4,9,0,"https://fbref.com/en/players/75645f0e/Borja-Iglesias"
"5728","Joaquín_2021",2021,"Betis","La Liga","Joaquín","ESP","FW,MF","39",1981,14.3,9,3,1,5,3,4,12,33.3,8,8,0,8,17,26,11,0,"https://fbref.com/en/players/4c5b14d2/Joaquin"
"5729","Juanmi_2021",2021,"Betis","La Liga","Juanmi","ESP","FW,MF","27",1993,6.7,13,9,3,5,5,4,18,22.2,14,4,0,4,2,15,4,0,"https://fbref.com/en/players/84399660/Juanmi"
"5730","Diego Lainez_2021",2021,"Betis","La Liga","Diego Lainez","MEX","FW,MF","20",2000,9.6,9,4,3,5,1,6,16,37.5,10,15,0,15,11,20,6,0,"https://fbref.com/en/players/bf12926c/Diego-Lainez"
"5731","Aïssa Mandi_2021",2021,"Betis","La Liga","Aïssa Mandi","ALG","DF","28",1991,26.6,30,17,20,10,0,10,16,62.5,6,21,13,8,39,69,90,0,"https://fbref.com/en/players/fbd6378b/Aissa-Mandi"
"5732","Juan Miranda_2021",2021,"Betis","La Liga","Juan Miranda","ESP","DF","20",2000,18.4,27,11,16,9,2,16,32,50,16,18,2,16,29,56,58,1,"https://fbref.com/en/players/ead61f73/Juan-Miranda"
"5733","Martín Montoya_2021",2021,"Betis","La Liga","Martín Montoya","ESP","DF","29",1991,2.7,6,3,2,2,2,1,3,33.3,2,1,1,0,2,8,6,0,"https://fbref.com/en/players/5cec2487/Martin-Montoya"
"5734","Álex Moreno_2021",2021,"Betis","La Liga","Álex Moreno","ESP","DF","27",1993,19.8,42,26,25,12,5,20,43,46.5,23,18,4,14,35,77,48,0,"https://fbref.com/en/players/16e9d0ea/Alex-Moreno"
"5735","Loren Morón_2021",2021,"Betis","La Liga","Loren Morón","ESP","FW","26",1993,11,11,7,2,6,3,1,16,6.3,15,11,0,11,3,14,14,0,"https://fbref.com/en/players/3aa4a3be/Loren-Moron"
"5736","Joel Robles_2021",2021,"Betis","La Liga","Joel Robles","ESP","GK","30",1990,18,0,0,0,0,0,0,1,0,1,1,0,1,0,0,11,2,"https://fbref.com/en/players/cda0b317/Joel-Robles"
"5737","Rodri_2021",2021,"Betis","La Liga","Rodri","ESP","FW,MF","20",2000,6,3,3,1,2,0,1,6,16.7,5,7,0,7,2,5,0,0,"https://fbref.com/en/players/85bed4ee/Rodri"
"5738","Guido Rodríguez_2021",2021,"Betis","La Liga","Guido Rodríguez","ARG","MF","26",1994,31.8,98,56,52,40,6,40,85,47.1,45,52,14,38,68,166,58,2,"https://fbref.com/en/players/34e393f2/Guido-Rodriguez"
"5739","Aitor Ruibal_2021",2021,"Betis","La Liga","Aitor Ruibal","ESP","FW,MF","24",1996,17.7,32,18,14,14,4,10,35,28.6,25,26,0,26,11,43,8,0,"https://fbref.com/en/players/a55d8df5/Aitor-Ruibal"
"5740","Víctor Ruiz_2021",2021,"Betis","La Liga","Víctor Ruiz","ESP","DF","31",1989,24,11,7,7,4,0,4,13,30.8,9,17,13,4,44,55,85,0,"https://fbref.com/en/players/b3dc6eca/Victor-Ruiz"
"5741","Antonio Sanabria_2021",2021,"Betis","La Liga","Antonio Sanabria","PAR","FW","24",1996,10.4,5,5,0,4,1,0,2,0,2,8,1,7,3,8,9,0,"https://fbref.com/en/players/0a447501/Antonio-Sanabria"
"5742","Sidnei_2021",2021,"Betis","La Liga","Sidnei","BRA","DF","30",1989,7.7,9,3,6,3,0,4,9,44.4,5,6,4,2,16,25,28,0,"https://fbref.com/en/players/b14d0c5d/Sidnei"
"5743","Cristian Tello_2021",2021,"Betis","La Liga","Cristian Tello","ESP","FW,MF","28",1991,14.3,16,10,5,9,2,4,22,18.2,18,14,0,14,11,27,8,0,"https://fbref.com/en/players/72a99e38/Cristian-Tello"
"5744","Wisdom Amey_2021",2021,"Bologna","Serie A","Wisdom Amey","ITA","DF","14",2005,0,0,0,0,0,0,0,0,NA,0,0,0,0,0,0,0,0,"https://fbref.com/en/players/35b4bc62/Wisdom-Amey"
"5745","Valentin Antov_2021",2021,"Bologna","Serie A","Valentin Antov","BUL","DF","19",2000,2.6,4,2,3,1,0,3,10,30,7,6,5,1,4,8,13,0,"https://fbref.com/en/players/8f68aa41/Valentin-Antov"
"5746","Musa Barrow_2021",2021,"Bologna","Serie A","Musa Barrow","GAM","FW,MF","21",1998,32.5,26,10,8,10,8,10,25,40,15,37,2,35,11,37,15,0,"https://fbref.com/en/players/e5bf73f3/Musa-Barrow"
"5747","Arturo Calabresi_2021",2021,"Bologna","Serie A","Arturo Calabresi","ITA","DF,FW","24",1996,0.2,0,0,0,0,0,0,0,NA,0,0,0,0,0,0,2,0,"https://fbref.com/en/players/34bb6fbd/Arturo-Calabresi"
"5748","Angelo da Costa Júnior_2021",2021,"Bologna","Serie A","Angelo da Costa Júnior","BRA","GK","36",1983,6,0,0,0,0,0,0,0,NA,0,0,0,0,0,0,2,3,"https://fbref.com/en/players/18736214/Angelo-da-Costa-Junior"
"5749","Lorenzo De Silvestri_2021",2021,"Bologna","Serie A","Lorenzo De Silvestri","ITA","DF","32",1988,23.8,34,24,18,13,3,16,37,43.2,21,37,10,27,30,64,62,3,"https://fbref.com/en/players/e74f0e59/Lorenzo-De-Silvestri"
"5750","Stefano Denswil_2021",2021,"Bologna","Serie A","Stefano Denswil","NED","DF","27",1993,1.3,2,1,1,1,0,0,1,0,1,1,0,1,1,3,1,0,"https://fbref.com/en/players/5832ebfe/Stefano-Denswil"
"5751","Mitchell Dijks_2021",2021,"Bologna","Serie A","Mitchell Dijks","NED","DF","27",1993,16.5,21,14,15,5,1,12,21,57.1,9,17,2,15,17,38,35,0,"https://fbref.com/en/players/0a3065c8/Mitchell-Dijks"
"5752","Nicolás Domínguez_2021",2021,"Bologna","Serie A","Nicolás Domínguez","ARG","MF","22",1998,13.9,48,28,26,17,5,15,37,40.5,22,26,7,19,24,72,20,0,"https://fbref.com/en/players/20b3a502/Nicolas-Dominguez"
"5753","Andri Fannar Baldursson_2021",2021,"Bologna","Serie A","Andri Fannar Baldursson","ISL","MF","18",2002,2.4,6,6,1,2,3,1,3,33.3,2,3,1,2,3,9,7,0,"https://fbref.com/en/players/61f2f56a/Andri-Fannar-Baldursson"
"5754","Paolo Faragò_2021",2021,"Bologna","Serie A","Paolo Faragò","ITA","DF","27",1993,0.3,1,1,1,0,0,1,2,50,1,1,0,1,0,1,0,0,"https://fbref.com/en/players/9085dd7c/Paolo-Farago"
"5755","Aaron Hickey_2021",2021,"Bologna","Serie A","Aaron Hickey","SCO","DF","18",2002,8.4,12,8,10,2,0,7,17,41.2,10,6,1,5,15,27,15,1,"https://fbref.com/en/players/1780bb4a/Aaron-Hickey"
"5756","Musa Juwara_2021",2021,"Bologna","Serie A","Musa Juwara","GAM","MF,DF","18",2001,0.5,2,2,2,0,0,1,3,33.3,2,1,0,1,0,2,0,0,"https://fbref.com/en/players/7737dee2/Musa-Juwara"
"5757","Omar Khailoti_2021",2021,"Bologna","Serie A","Omar Khailoti","ITA","DF","18",2001,0.3,0,0,0,0,0,0,0,NA,0,2,0,2,1,1,0,0,"https://fbref.com/en/players/19d1c41f/Omar-Khailoti"
"5758","Danilo Larangeira_2021",2021,"Bologna","Serie A","Danilo Larangeira","BRA","DF","36",1984,34.8,33,24,23,10,0,8,29,27.6,21,58,36,22,51,84,127,2,"https://fbref.com/en/players/fed5f993/Danilo-Larangeira"
"5759","Ibrahima Mbaye_2021",2021,"Bologna","Serie A","Ibrahima Mbaye","SEN","DF","25",1994,4.8,6,5,5,1,0,3,5,60,2,5,3,2,1,7,10,0,"https://fbref.com/en/players/cfbf9881/Ibrahima-Mbaye"
"5760","Gary Medel_2021",2021,"Bologna","Serie A","Gary Medel","CHI","DF,MF","32",1987,5.7,12,9,6,5,1,4,10,40,6,8,6,2,7,19,10,0,"https://fbref.com/en/players/563a68ad/Gary-Medel"
"5761","Riccardo Orsolini_2021",2021,"Bologna","Serie A","Riccardo Orsolini","ITA","FW,MF","23",1997,19.5,37,18,13,12,12,16,39,41,23,22,3,19,10,47,22,0,"https://fbref.com/en/players/e14ec482/Riccardo-Orsolini"
"5762","Mattia Pagliuca_2021",2021,"Bologna","Serie A","Mattia Pagliuca","ITA","MF","18",2002,0.1,0,0,0,0,0,0,0,NA,0,0,0,0,1,1,0,0,"https://fbref.com/en/players/ad84294f/Mattia-Pagliuca"
"5763","Rodrigo Palacio_2021",2021,"Bologna","Serie A","Rodrigo Palacio","ARG","FW","38",1982,27.8,13,6,2,3,8,1,15,6.7,14,18,0,18,7,20,29,0,"https://fbref.com/en/players/8d8178ac/Rodrigo-Palacio"
"5764","Nehuén Paz_2021",2021,"Bologna","Serie A","Nehuén Paz","ARG","DF","27",1993,4,9,4,4,5,0,6,7,85.7,1,4,2,2,11,20,16,0,"https://fbref.com/en/players/42b1a58a/Nehuen-Paz"
"5765","Andrea Poli_2021",2021,"Bologna","Serie A","Andrea Poli","ITA","MF","30",1989,4.3,9,7,4,2,3,6,12,50,6,7,1,6,7,16,7,0,"https://fbref.com/en/players/b3fd7075/Andrea-Poli"
"5766","Simone Rabbi_2021",2021,"Bologna","Serie A","Simone Rabbi","ITA","FW,DF","18",2001,0.4,0,0,0,0,0,0,1,0,1,0,0,0,0,0,0,0,"https://fbref.com/en/players/3688af6c/Simone-Rabbi"
"5767","Antonio Raimondo_2021",2021,"Bologna","Serie A","Antonio Raimondo","ITA","FW","16",2004,0,0,0,0,0,0,0,0,NA,0,0,0,0,0,0,0,0,"https://fbref.com/en/players/ce1a6c7e/Antonio-Raimondo"
"5768","Federico Ravaglia_2021",2021,"Bologna","Serie A","Federico Ravaglia","ITA","GK","20",1999,4,0,0,0,0,0,0,1,0,1,0,0,0,0,0,2,0,"https://fbref.com/en/players/6662d731/Federico-Ravaglia"
"5769","Nicola Sansone_2021",2021,"Bologna","Serie A","Nicola Sansone","ITA","FW,MF","28",1991,13,22,11,7,12,3,10,31,32.3,21,15,0,15,9,31,7,0,"https://fbref.com/en/players/7eb97a8e/Nicola-Sansone"
"5770","Federico Santander_2021",2021,"Bologna","Serie A","Federico Santander","PAR","FW","29",1991,0.4,0,0,0,0,0,0,0,NA,0,0,0,0,0,0,0,0,"https://fbref.com/en/players/df85d472/Federico-Santander"
"5771","Jerdy Schouten_2021",2021,"Bologna","Serie A","Jerdy Schouten","NED","MF","23",1997,27.9,50,25,23,25,2,16,37,43.2,21,36,13,23,79,129,37,6,"https://fbref.com/en/players/2cfae697/Jerdy-Schouten"
"5772","Łukasz Skorupski_2021",2021,"Bologna","Serie A","Łukasz Skorupski","POL","GK","29",1991,28,1,1,1,0,0,1,4,25,3,0,0,0,0,1,23,5,"https://fbref.com/en/players/ab4449d6/Lukasz-Skorupski"
"5773","Andreas Skov Olsen_2021",2021,"Bologna","Serie A","Andreas Skov Olsen","DEN","FW,DF","20",1999,13.1,19,10,11,4,4,11,21,52.4,10,15,0,15,3,22,25,0,"https://fbref.com/en/players/c50cee19/Andreas-Skov-Olsen"
"5774","Roberto Soriano_2021",2021,"Bologna","Serie A","Roberto Soriano","ITA","MF","29",1991,36.1,48,26,15,20,13,15,64,23.4,49,31,8,23,18,66,43,0,"https://fbref.com/en/players/9d4c45d6/Roberto-Soriano"
"5775","Adama Soumaoro_2021",2021,"Bologna","Serie A","Adama Soumaoro","FRA","DF","28",1992,19.5,24,14,17,7,0,6,12,50,6,28,23,5,20,44,72,0,"https://fbref.com/en/players/7b075c75/Adama-Soumaoro"
"5776","Mattias Svanberg_2021",2021,"Bologna","Serie A","Mattias Svanberg","SWE","MF","21",1999,20.6,38,17,21,9,8,16,45,35.6,29,25,4,21,30,68,25,1,"https://fbref.com/en/players/92d83c27/Mattias-Svanberg"
"5777","Takehiro Tomiyasu_2021",2021,"Bologna","Serie A","Takehiro Tomiyasu","JPN","DF","21",1998,30.2,47,31,27,14,6,21,34,61.8,13,37,19,18,54,101,106,0,"https://fbref.com/en/players/b3af9be1/Takehiro-Tomiyasu"
"5778","Kacper Urbanski_2021",2021,"Bologna","Serie A","Kacper Urbanski","POL","FW","15",2004,0,0,0,0,0,0,0,0,NA,0,0,0,0,0,0,0,0,"https://fbref.com/en/players/2d9d9e42/Kacper-Urbanski"
"5779","Edoardo Vergani_2021",2021,"Bologna","Serie A","Edoardo Vergani","ITA","FW","19",2001,0.1,0,0,0,0,0,0,0,NA,0,0,0,0,0,0,0,0,"https://fbref.com/en/players/2873973b/Edoardo-Vergani"
"5780","Emanuel Vignato_2021",2021,"Bologna","Serie A","Emanuel Vignato","ITA","FW,MF","19",2000,13.4,18,9,9,6,3,3,15,20,12,6,1,5,10,28,7,0,"https://fbref.com/en/players/ec5dae45/Emanuel-Vignato"
"5781","Yacine Adli_2021",2021,"Bordeaux","Ligue 1","Yacine Adli","FRA","MF","20",2000,26.9,74,37,30,33,11,35,92,38,57,27,2,25,39,113,17,2,"https://fbref.com/en/players/26777636/Yacine-Adli"
"5782","Dilane Bakwa_2021",2021,"Bordeaux","Ligue 1","Dilane Bakwa","FRA","FW,MF","17",2002,0.6,2,2,1,1,0,0,1,0,1,2,0,2,1,3,0,0,"https://fbref.com/en/players/2b5a35e5/Dilane-Bakwa"
"5783","Toma Bašić_2021",2021,"Bordeaux","Ligue 1","Toma Bašić","CRO","MF","23",1996,28.9,33,22,15,16,2,16,58,27.6,42,21,5,16,32,65,42,1,"https://fbref.com/en/players/80556f08/Toma-Basic"
"5784","Paul Baysse_2021",2021,"Bordeaux","Ligue 1","Paul Baysse","FRA","DF","32",1988,29,35,18,21,13,1,16,21,76.2,5,33,24,9,52,87,123,1,"https://fbref.com/en/players/2515040a/Paul-Baysse"
"5785","Hatem Ben Arfa_2021",2021,"Bordeaux","Ligue 1","Hatem Ben Arfa","FRA","MF,FW","33",1987,18.9,11,7,1,7,3,2,9,22.2,7,3,0,3,2,13,0,0,"https://fbref.com/en/players/74dc806c/Hatem-Ben-Arfa"
"5786","Loris Benito_2021",2021,"Bordeaux","Ligue 1","Loris Benito","SUI","DF","28",1992,29.5,42,26,27,12,3,22,48,45.8,26,33,10,23,42,84,70,0,"https://fbref.com/en/players/f5b6fb78/Loris-Benito"
"5787","Loïc Bessile_2021",2021,"Bordeaux","Ligue 1","Loïc Bessile","TOG","DF","21",1999,1,0,0,0,0,0,0,0,NA,0,2,1,1,1,1,3,0,"https://fbref.com/en/players/4e9957ff/Loic-Bessile"
"5788","Jimmy Briand_2021",2021,"Bordeaux","Ligue 1","Jimmy Briand","FRA","FW","34",1985,6.3,7,3,3,2,2,1,1,100,0,2,0,2,1,8,3,0,"https://fbref.com/en/players/f83c8d6c/Jimmy-Briand"
"5789","Benoît Costil_2021",2021,"Bordeaux","Ligue 1","Benoît Costil","FRA","GK","33",1987,38,1,1,1,0,0,1,3,33.3,2,1,0,1,1,2,17,0,"https://fbref.com/en/players/2434f24a/Benoit-Costil"
"5790","Samuel Kalu_2021",2021,"Bordeaux","Ligue 1","Samuel Kalu","NGA","FW,MF","22",1997,10.7,21,12,11,8,2,4,13,30.8,9,14,0,14,9,30,2,0,"https://fbref.com/en/players/b8d22478/Samuel-Kalu"
"5791","Laurent Koscielny_2021",2021,"Bordeaux","Ligue 1","Laurent Koscielny","FRA","DF","34",1985,24.6,29,17,18,11,0,16,24,66.7,8,44,34,10,54,83,115,1,"https://fbref.com/en/players/f5efb153/Laurent-Koscielny"
"5792","Enock Kwateng_2021",2021,"Bordeaux","Ligue 1","Enock Kwateng","FRA","DF","23",1997,11.5,21,12,15,4,2,14,27,51.9,13,15,3,12,26,47,27,0,"https://fbref.com/en/players/4bf69118/Enock-Kwateng"
"5793","Tom Lacoux_2021",2021,"Bordeaux","Ligue 1","Tom Lacoux","FRA","MF","18",2002,5.8,22,14,10,11,1,9,21,42.9,12,12,3,9,12,34,7,0,"https://fbref.com/en/players/295ba708/Tom-Lacoux"
"5794","Josh Maja_2021",2021,"Bordeaux","Ligue 1","Josh Maja","NGA","FW","21",1998,8.9,8,2,3,3,2,3,14,21.4,11,3,0,3,6,14,9,0,"https://fbref.com/en/players/bc0bfc64/Josh-Maja"
"5795","Sekou Mara_2021",2021,"Bordeaux","Ligue 1","Sekou Mara","FRA","FW,MF","18",2002,2.5,5,3,1,3,1,2,10,20,8,0,0,0,1,6,1,0,"https://fbref.com/en/players/3544641e/Sekou-Mara"
"5796","Mexer_2021",2021,"Bordeaux","Ligue 1","Mexer","MOZ","DF","31",1988,7.9,9,6,8,0,1,5,10,50,5,8,5,3,17,26,22,0,"https://fbref.com/en/players/ce492295/Mexer"
"5797","Otávio_2021",2021,"Bordeaux","Ligue 1","Otávio","BRA","MF","26",1994,17.3,54,31,33,19,2,26,55,47.3,29,20,5,15,26,80,36,0,"https://fbref.com/en/players/243f4a0b/Otavio"
"5798","Remi Oudin_2021",2021,"Bordeaux","Ligue 1","Remi Oudin","FRA","FW,MF","23",1996,26.9,34,16,22,7,5,15,36,41.7,21,22,2,20,51,85,40,1,"https://fbref.com/en/players/ea02beaf/Remi-Oudin"
"5799","Pablo_2021",2021,"Bordeaux","Ligue 1","Pablo","BRA","DF","29",1991,12,17,11,13,4,0,8,14,57.1,6,17,12,5,25,42,46,1,"https://fbref.com/en/players/29d8ad3f/Pablo"
"5800","Rubén Pardo_2021",2021,"Bordeaux","Ligue 1","Rubén Pardo","ESP","MF","27",1992,0.3,0,0,0,0,0,0,0,NA,0,0,0,0,1,1,0,0,"https://fbref.com/en/players/2306bfde/Ruben-Pardo"
"5801","Maxime Poundjé_2021",2021,"Bordeaux","Ligue 1","Maxime Poundjé","FRA","DF","27",1992,5.5,10,7,9,1,0,2,6,33.3,4,7,3,4,11,21,5,0,"https://fbref.com/en/players/b92edde2/Maxime-Poundje"
"5802","Nicolas de Préville_2021",2021,"Bordeaux","Ligue 1","Nicolas de Préville","FRA","FW,MF","29",1991,17.9,19,14,7,6,6,9,42,21.4,33,15,0,15,13,32,7,0,"https://fbref.com/en/players/b0547a87/Nicolas-de-Preville"
"5803","Youssouf Sabaly_2021",2021,"Bordeaux","Ligue 1","Youssouf Sabaly","SEN","DF","27",1993,32.3,47,33,24,17,6,27,45,60,18,31,8,23,49,96,57,2,"https://fbref.com/en/players/fbbb9269/Youssouf-Sabaly"
"5804","Jean Seri_2021",2021,"Bordeaux","Ligue 1","Jean Seri","CIV","MF","29",1991,7.9,17,9,3,12,2,4,15,26.7,11,8,2,6,12,29,7,0,"https://fbref.com/en/players/10efd0e1/Jean-Seri"
"5805","Issouf Sissokho_2021",2021,"Bordeaux","Ligue 1","Issouf Sissokho","MLI","MF,DF","18",2002,0.9,6,4,4,2,0,3,6,50,3,2,0,2,1,7,0,0,"https://fbref.com/en/players/792a9d41/Issouf-Sissokho"
"5806","Amadou Traore_2021",2021,"Bordeaux","Ligue 1","Amadou Traore","FRA","FW,MF","18",2002,3.4,6,1,2,2,2,2,9,22.2,7,9,0,9,1,7,2,0,"https://fbref.com/en/players/4eb0686f/Amadou-Traore"
"5807","Hwang Ui-jo_2021",2021,"Bordeaux","Ligue 1","Hwang Ui-jo","KOR","FW,MF","27",1992,27.8,14,6,5,8,1,6,25,24,19,17,2,15,8,22,14,0,"https://fbref.com/en/players/a2d873dd/Hwang-Ui-jo"
"5808","Mehdi Zerkane_2021",2021,"Bordeaux","Ligue 1","Mehdi Zerkane","ALG","MF,FW","21",1999,13.2,23,15,7,10,6,5,18,27.8,13,15,2,13,9,32,5,0,"https://fbref.com/en/players/53f6306f/Mehdi-Zerkane"
"5809","Ludovic Baal_2021",2021,"Brest","Ligue 1","Ludovic Baal","GUF","DF,MF","34",1986,3.3,6,5,4,1,1,2,5,40,3,4,1,3,5,11,5,0,"https://fbref.com/en/players/d3ce9f1f/Ludovic-Baal"
"5810","Cristian Battocchio_2021",2021,"Brest","Ligue 1","Cristian Battocchio","ITA","MF","28",1992,3.9,5,2,1,4,0,2,9,22.2,7,0,0,0,4,9,5,0,"https://fbref.com/en/players/0f9b8301/Cristian-Battocchio"
"5811","Haris Belkebla_2021",2021,"Brest","Ligue 1","Haris Belkebla","ALG","MF","26",1994,30.3,69,39,32,28,9,31,66,47,35,26,5,21,57,126,34,0,"https://fbref.com/en/players/2b1bed19/Haris-Belkebla"
"5812","Lilian Brassier_2021",2021,"Brest","Ligue 1","Lilian Brassier","FRA","DF","20",1999,10.7,19,10,12,4,3,7,11,63.6,4,13,6,7,23,42,38,1,"https://fbref.com/en/players/5b146df3/Lilian-Brassier"
"5813","Irvin Cardona_2021",2021,"Brest","Ligue 1","Irvin Cardona","FRA","FW","22",1997,22.5,10,5,3,6,1,4,22,18.2,18,17,3,14,9,19,23,2,"https://fbref.com/en/players/5e080f73/Irvin-Cardona"
"5814","Gaëtan Charbonnier_2021",2021,"Brest","Ligue 1","Gaëtan Charbonnier","FRA","MF,FW","31",1988,17.4,24,15,6,11,7,12,32,37.5,20,15,1,14,9,33,19,0,"https://fbref.com/en/players/18ebca4b/Gaetan-Charbonnier"
"5815","Brendan Chardonnet_2021",2021,"Brest","Ligue 1","Brendan Chardonnet","FRA","DF","25",1994,30.2,51,29,31,19,1,27,41,65.9,14,54,41,13,64,115,151,0,"https://fbref.com/en/players/16aa7d4c/Brendan-Chardonnet"
"5816","Sébastien Cibois_2021",2021,"Brest","Ligue 1","Sébastien Cibois","FRA","GK","22",1998,3,0,0,0,0,0,0,0,NA,0,0,0,0,0,0,0,1,"https://fbref.com/en/players/2b9b37b2/Sebastien-Cibois"
"5817","Ibrahima Diallo_2021",2021,"Brest","Ligue 1","Ibrahima Diallo","FRA","MF","21",1999,4.9,14,9,2,9,3,4,8,50,4,4,0,4,3,17,3,0,"https://fbref.com/en/players/11ff3d56/Ibrahima-Diallo"
"5818","Jean-Kevin Duverne_2021",2021,"Brest","Ligue 1","Jean-Kevin Duverne","FRA","DF","23",1997,22.5,38,21,24,14,0,15,32,46.9,17,24,16,8,30,68,70,0,"https://fbref.com/en/players/0cbc8baa/Jean-Kevin-Duverne"
"5819","Bandiougou Fadiga_2021",2021,"Brest","Ligue 1","Bandiougou Fadiga","FRA","MF,FW","19",2001,0.5,0,0,0,0,0,0,2,0,2,0,0,0,0,0,0,0,"https://fbref.com/en/players/45bb4303/Bandiougou-Fadiga"
"5820","Romain Faivre_2021",2021,"Brest","Ligue 1","Romain Faivre","FRA","MF,FW","22",1998,32.1,54,27,26,23,5,21,54,38.9,33,30,0,30,30,84,18,0,"https://fbref.com/en/players/745ca0a3/Romain-Faivre"
"5821","Julien Faussurier_2021",2021,"Brest","Ligue 1","Julien Faussurier","FRA","DF","33",1987,10.6,16,11,6,8,2,11,25,44,14,12,4,8,9,25,10,0,"https://fbref.com/en/players/767212e6/Julien-Faussurier"
"5822","Christophe Hérelle_2021",2021,"Brest","Ligue 1","Christophe Hérelle","MTQ","DF","27",1992,15.3,19,13,12,6,1,10,12,83.3,2,13,9,4,31,50,41,2,"https://fbref.com/en/players/3681cfff/Christophe-Herelle"
"5823","Franck Honorat_2021",2021,"Brest","Ligue 1","Franck Honorat","FRA","MF,FW","23",1996,27.3,28,13,12,10,6,14,37,37.8,23,15,3,12,11,39,24,0,"https://fbref.com/en/players/db7849ca/Franck-Honorat"
"5824","Gautier Larsonneur_2021",2021,"Brest","Ligue 1","Gautier Larsonneur","FRA","GK","23",1997,35,1,1,1,0,0,1,1,100,0,2,0,2,0,1,16,3,"https://fbref.com/en/players/b49729cb/Gautier-Larsonneur"
"5825","Paul Lasne_2021",2021,"Brest","Ligue 1","Paul Lasne","FRA","MF","31",1989,18.7,46,26,25,19,2,17,40,42.5,23,25,5,20,47,93,17,2,"https://fbref.com/en/players/542cc80f/Paul-Lasne"
"5826","Jérémy Le Douaron_2021",2021,"Brest","Ligue 1","Jérémy Le Douaron","FRA","FW,MF","22",1998,9.1,15,10,9,4,2,7,21,33.3,14,14,1,13,8,23,11,0,"https://fbref.com/en/players/88c4d190/Jeremy-Le-Douaron"
"5827","Jean Lucas_2021",2021,"Brest","Ligue 1","Jean Lucas","BRA","MF,FW","22",1998,11.2,19,13,10,9,0,8,29,27.6,21,7,0,7,8,27,10,1,"https://fbref.com/en/players/a99138af/Jean-Lucas"
"5828","Hugo Magnetti_2021",2021,"Brest","Ligue 1","Hugo Magnetti","FRA","MF","22",1998,6.7,24,12,10,13,1,20,40,50,20,6,1,5,14,38,8,0,"https://fbref.com/en/players/d4d35152/Hugo-Magnetti"
"5829","Hianga Mananga Mbock_2021",2021,"Brest","Ligue 1","Hianga Mananga Mbock","FRA","MF,FW","20",1999,5.1,4,3,2,2,0,2,9,22.2,7,2,0,2,3,7,6,0,"https://fbref.com/en/players/0f86995c/Hianga-Mananga-Mbock"
"5830","Steve Mounié_2021",2021,"Brest","Ligue 1","Steve Mounié","BEN","FW","25",1994,29.8,15,11,3,11,1,3,28,10.7,25,18,3,15,12,27,40,0,"https://fbref.com/en/players/19ba6c6d/Steve-Mounie"
"5831","Romain Perraud_2021",2021,"Brest","Ligue 1","Romain Perraud","FRA","DF","22",1997,34.9,60,34,42,16,2,24,45,53.3,21,36,3,33,45,105,76,0,"https://fbref.com/en/players/6dfd8f05/Romain-Perraud"
"5832","Romain Philippoteaux_2021",2021,"Brest","Ligue 1","Romain Philippoteaux","FRA","MF,FW","32",1988,6.5,11,6,6,3,2,6,9,66.7,3,4,0,4,10,21,2,0,"https://fbref.com/en/players/f98b15f0/Romain-Philippoteaux"
"5833","Ronaël Pierre-Gabriel_2021",2021,"Brest","Ligue 1","Ronaël Pierre-Gabriel","FRA","DF","22",1998,25.6,60,40,42,16,2,35,52,67.3,17,17,7,10,30,90,57,0,"https://fbref.com/en/players/64ba07c0/Ronael-Pierre-Gabriel"
"5834","Heriberto Tavares_2021",2021,"Brest","Ligue 1","Heriberto Tavares","POR","FW,MF","23",1997,0.5,2,0,0,0,2,1,3,33.3,2,0,0,0,1,3,1,0,"https://fbref.com/en/players/2d9f280e/Heriberto-Tavares"
"5835","Steven Alzate_2021",2021,"Brighton","Premier League","Steven Alzate","COL","MF","21",1998,10,17,8,10,4,3,6,15,40,9,8,1,7,8,25,10,0,"https://fbref.com/en/players/ad1f61f3/Steven-Alzate"
"5836","Bernardo_2021",2021,"Brighton","Premier League","Bernardo","BRA","DF,MF","25",1995,2.3,10,8,8,1,1,4,6,66.7,2,2,0,2,1,11,1,0,"https://fbref.com/en/players/17370b95/Bernardo"
"5837","Yves Bissouma_2021",2021,"Brighton","Premier League","Yves Bissouma","MLI","MF","23",1996,34.6,104,68,50,48,6,33,67,49.3,34,42,6,36,64,168,67,0,"https://fbref.com/en/players/6c203af0/Yves-Bissouma"
"5838","Dan Burn_2021",2021,"Brighton","Premier League","Dan Burn","ENG","DF","28",1992,22.9,50,26,33,14,3,27,53,50.9,26,30,7,23,31,81,75,0,"https://fbref.com/en/players/b2d31e83/Dan-Burn"
"5839","Aaron Connolly_2021",2021,"Brighton","Premier League","Aaron Connolly","IRL","FW","20",2000,8.8,6,3,1,3,2,0,2,0,2,4,0,4,0,6,2,0,"https://fbref.com/en/players/27c01749/Aaron-Connolly"
"5840","Lewis Dunk_2021",2021,"Brighton","Premier League","Lewis Dunk","ENG","DF","28",1991,32.6,30,15,20,8,2,16,23,69.6,7,29,20,9,32,62,106,0,"https://fbref.com/en/players/282f75f3/Lewis-Dunk"
"5841","Pascal Groß_2021",2021,"Brighton","Premier League","Pascal Groß","GER","MF,DF","29",1991,27.6,45,24,24,15,6,24,53,45.3,29,25,4,21,23,68,18,1,"https://fbref.com/en/players/8aec0537/Pascal-Gross"
"5842","José Izquierdo_2021",2021,"Brighton","Premier League","José Izquierdo","COL","DF","28",1992,0.1,0,0,0,0,0,0,0,NA,0,0,0,0,0,0,0,0,"https://fbref.com/en/players/ca2bc3df/Jose-Izquierdo"
"5843","Alireza Jahanbakhsh_2021",2021,"Brighton","Premier League","Alireza Jahanbakhsh","IRN","FW,MF","26",1993,5.9,9,7,3,5,1,2,12,16.7,10,8,0,8,8,17,1,0,"https://fbref.com/en/players/08452314/Alireza-Jahanbakhsh"
"5844","Reda Khadra_2021",2021,"Brighton","Premier League","Reda Khadra","GER","MF","19",2001,0.1,0,0,0,0,0,0,0,NA,0,0,0,0,0,0,0,0,"https://fbref.com/en/players/88acf83f/Reda-Khadra"
"5845","Adam Lallana_2021",2021,"Brighton","Premier League","Adam Lallana","ENG","MF,FW","32",1988,17.7,28,13,11,13,4,8,39,20.5,31,18,3,15,15,43,13,0,"https://fbref.com/en/players/99813635/Adam-Lallana"
"5846","Tariq Lamptey_2021",2021,"Brighton","Premier League","Tariq Lamptey","GHA","DF,MF","19",2000,9.8,17,9,7,6,4,6,13,46.2,7,8,1,7,19,36,12,1,"https://fbref.com/en/players/f4e433d4/Tariq-Lamptey"
"5847","Alexis Mac Allister_2021",2021,"Brighton","Premier League","Alexis Mac Allister","ARG","MF,FW","21",1998,12.4,26,12,6,16,4,11,38,28.9,27,25,4,21,9,35,4,0,"https://fbref.com/en/players/83d074ff/Alexis-Mac-Allister"
"5848","Solly March_2021",2021,"Brighton","Premier League","Solly March","ENG","DF,MF","26",1994,18.6,49,23,24,15,10,18,34,52.9,16,30,5,25,22,71,30,0,"https://fbref.com/en/players/bb5fbd2b/Solly-March"
"5849","Neal Maupay_2021",2021,"Brighton","Premier League","Neal Maupay","FRA","FW,MF","23",1996,27.9,20,8,9,7,4,4,24,16.7,20,20,0,20,13,33,6,0,"https://fbref.com/en/players/4bcf39f6/Neal-Maupay"
"5850","Jakub Moder_2021",2021,"Brighton","Premier League","Jakub Moder","POL","DF,MF","21",1999,7.2,15,7,5,7,3,7,20,35,13,12,1,11,3,18,9,0,"https://fbref.com/en/players/f230bc30/Jakub-Moder"
"5851","Jayson Molumby_2021",2021,"Brighton","Premier League","Jayson Molumby","IRL","MF","20",1999,0,0,0,0,0,0,0,0,NA,0,0,0,0,0,0,0,0,"https://fbref.com/en/players/c908a1bc/Jayson-Molumby"
"5852","Davy Pröpper_2021",2021,"Brighton","Premier League","Davy Pröpper","NED","MF","28",1991,2.4,6,5,0,6,0,2,5,40,3,3,0,3,1,7,0,0,"https://fbref.com/en/players/fdd85f94/Davy-Propper"
"5853","Mathew Ryan_2021",2021,"Brighton","Premier League","Mathew Ryan","AUS","GK","28",1992,11,1,0,1,0,0,0,0,NA,0,0,0,0,0,1,4,0,"https://fbref.com/en/players/4535e4bb/Mathew-Ryan"
"5854","Robert Sánchez_2021",2021,"Brighton","Premier League","Robert Sánchez","ESP","GK","22",1997,27,1,0,1,0,0,1,1,100,0,1,0,1,1,2,11,2,"https://fbref.com/en/players/6a713852/Robert-Sanchez"
"5855","Percy Tau_2021",2021,"Brighton","Premier League","Percy Tau","RSA","FW","26",1994,1.1,1,1,1,0,0,0,2,0,2,1,0,1,0,1,1,0,"https://fbref.com/en/players/4d0eb7d2/Percy-Tau"
"5856","Leandro Trossard_2021",2021,"Brighton","Premier League","Leandro Trossard","BEL","MF,FW","25",1994,29,33,14,11,16,6,10,36,27.8,26,34,2,32,26,59,7,1,"https://fbref.com/en/players/38ceb24a/Leandro-Trossard"
"5857","Joël Veltman_2021",2021,"Brighton","Premier League","Joël Veltman","NED","DF","28",1992,25.3,67,33,34,25,8,29,57,50.9,28,24,5,19,33,100,64,0,"https://fbref.com/en/players/dad4b285/Joel-Veltman"
"5858","Adam Webster_2021",2021,"Brighton","Premier League","Adam Webster","ENG","DF","25",1995,28.8,29,16,15,10,4,12,25,48,13,29,16,13,47,76,92,3,"https://fbref.com/en/players/c40b6180/Adam-Webster"
"5859","Danny Welbeck_2021",2021,"Brighton","Premier League","Danny Welbeck","ENG","FW","29",1990,17.2,12,6,2,6,4,7,19,36.8,12,17,0,17,7,19,13,0,"https://fbref.com/en/players/ce5143da/Danny-Welbeck"
"5860","Ben White_2021",2021,"Brighton","Premier League","Ben White","ENG","DF,MF","22",1997,35.5,49,26,21,24,4,24,57,42.1,33,46,22,24,62,111,56,0,"https://fbref.com/en/players/35e413f1/Ben-White"
"5861","Andi Zeqiri_2021",2021,"Brighton","Premier League","Andi Zeqiri","SUI","FW,DF","21",1999,1.9,3,2,0,2,1,1,2,50,1,1,0,1,0,3,2,0,"https://fbref.com/en/players/d01231f0/Andi-Zeqiri"
"5862","Phil Bardsley_2021",2021,"Burnley","Premier League","Phil Bardsley","SCO","DF","35",1985,3,6,5,4,2,0,3,6,50,3,3,1,2,6,12,12,0,"https://fbref.com/en/players/1ae30132/Phil-Bardsley"
"5863","Ashley Barnes_2021",2021,"Burnley","Premier League","Ashley Barnes","ENG","FW","30",1989,14.8,12,6,2,6,4,3,13,23.1,10,14,2,12,5,17,11,0,"https://fbref.com/en/players/2691c772/Ashley-Barnes"
"5864","Josh Benson_2021",2021,"Burnley","Premier League","Josh Benson","ENG","MF","20",1999,2.9,5,1,3,0,2,1,6,16.7,5,3,0,3,3,8,2,0,"https://fbref.com/en/players/bf3aeb61/Josh-Benson"
"5865","Jóhann Berg Guðmundsson_2021",2021,"Burnley","Premier League","Jóhann Berg Guðmundsson","ISL","MF","29",1990,15.1,19,11,6,9,4,11,23,47.8,12,11,2,9,17,36,19,0,"https://fbref.com/en/players/f72293fc/Johann-Berg-Gudmundsson"
"5866","Robbie Brady_2021",2021,"Burnley","Premier League","Robbie Brady","IRL","MF","28",1992,11.7,22,15,12,6,4,12,35,34.3,23,16,0,16,9,31,29,1,"https://fbref.com/en/players/96bb8cc2/Robbie-Brady"
"5867","Josh Brownhill_2021",2021,"Burnley","Premier League","Josh Brownhill","ENG","MF","24",1995,31.3,45,27,9,29,7,15,44,34.1,29,33,11,22,69,114,39,0,"https://fbref.com/en/players/47369df8/Josh-Brownhill"
"5868","Jack Cork_2021",2021,"Burnley","Premier League","Jack Cork","ENG","MF","31",1989,15,26,10,5,17,4,11,31,35.5,20,15,4,11,16,42,20,0,"https://fbref.com/en/players/74e12f1e/Jack-Cork"
"5869","Jimmy Dunne_2021",2021,"Burnley","Premier League","Jimmy Dunne","IRL","DF","22",1997,3,3,3,2,1,0,1,2,50,1,3,2,1,6,9,16,1,"https://fbref.com/en/players/1fdfd6da/Jimmy-Dunne"
"5870","Kevin Long_2021",2021,"Burnley","Premier League","Kevin Long","IRL","DF","29",1990,7.1,11,6,9,2,0,7,9,77.8,2,11,7,4,6,17,24,0,"https://fbref.com/en/players/5a4280b1/Kevin-Long"
"5871","Matthew Lowton_2021",2021,"Burnley","Premier League","Matthew Lowton","ENG","DF","31",1989,34,54,32,31,22,1,32,73,43.8,41,36,13,23,56,110,91,1,"https://fbref.com/en/players/9a9c05db/Matthew-Lowton"
"5872","Dwight McNeil_2021",2021,"Burnley","Premier League","Dwight McNeil","ENG","MF","20",1999,34.1,47,24,24,18,5,18,56,32.1,38,44,6,38,32,79,32,1,"https://fbref.com/en/players/fc15fb84/Dwight-McNeil"
"5873","Ben Mee_2021",2021,"Burnley","Premier League","Ben Mee","ENG","DF","30",1989,29.9,32,15,16,14,2,14,29,48.3,15,54,45,9,43,75,148,2,"https://fbref.com/en/players/8df7a2fb/Ben-Mee"
"5874","Joel Mumbongo_2021",2021,"Burnley","Premier League","Joel Mumbongo","SWE","FW","21",1999,0.4,0,0,0,0,0,0,0,NA,0,1,0,1,0,0,0,0,"https://fbref.com/en/players/f8e588df/Joel-Mumbongo"
"5875","Will Norris_2021",2021,"Burnley","Premier League","Will Norris","ENG","GK","26",1993,2,0,0,0,0,0,0,0,NA,0,0,0,0,0,0,0,0,"https://fbref.com/en/players/c73ada83/Will-Norris"
"5876","Bailey Peacock-Farrell_2021",2021,"Burnley","Premier League","Bailey Peacock-Farrell","NIR","GK","23",1996,4,0,0,0,0,0,0,0,NA,0,0,0,0,0,0,0,0,"https://fbref.com/en/players/4879f8cb/Bailey-Peacock-Farrell"
"5877","Erik Pieters_2021",2021,"Burnley","Premier League","Erik Pieters","NED","DF,MF","31",1988,14.1,30,21,18,9,3,19,39,48.7,20,30,9,21,12,42,34,0,"https://fbref.com/en/players/1ef37668/Erik-Pieters"
"5878","Nick Pope_2021",2021,"Burnley","Premier League","Nick Pope","ENG","GK","28",1992,32,1,1,1,0,0,0,1,0,1,0,0,0,2,3,29,2,"https://fbref.com/en/players/4b40d9ca/Nick-Pope"
"5879","Lewis Richardson_2021",2021,"Burnley","Premier League","Lewis Richardson","ENG","FW,MF","17",2003,0,0,0,0,0,0,0,0,NA,0,0,0,0,0,0,0,0,"https://fbref.com/en/players/4fa62ae4/Lewis-Richardson"
"5880","Jay Rodriguez_2021",2021,"Burnley","Premier League","Jay Rodriguez","ENG","FW","31",1989,14.1,25,16,5,15,5,13,28,46.4,15,25,4,21,2,27,7,0,"https://fbref.com/en/players/4ab53cdb/Jay-Rodriguez"
"5881","Dale Stephens_2021",2021,"Burnley","Premier League","Dale Stephens","ENG","MF","31",1989,2.9,11,6,2,7,2,3,6,50,3,3,0,3,8,19,2,0,"https://fbref.com/en/players/653ee42d/Dale-Stephens"
"5882","James Tarkowski_2021",2021,"Burnley","Premier League","James Tarkowski","ENG","DF","27",1992,36,66,39,52,11,3,25,49,51,24,54,42,12,44,110,163,1,"https://fbref.com/en/players/15ea812b/James-Tarkowski"
"5883","Charlie Taylor_2021",2021,"Burnley","Premier League","Charlie Taylor","ENG","DF","26",1993,27,48,28,30,15,3,25,46,54.3,21,36,19,17,29,77,87,2,"https://fbref.com/en/players/cc2d7ad5/Charlie-Taylor"
"5884","Matěj Vydra_2021",2021,"Burnley","Premier League","Matěj Vydra","CZE","FW","28",1992,15.2,9,5,2,4,3,1,8,12.5,7,8,1,7,6,15,5,0,"https://fbref.com/en/players/0d4ceb32/Matej-Vydra"
"5885","Ashley Westwood_2021",2021,"Burnley","Premier League","Ashley Westwood","ENG","MF","30",1990,37.9,23,15,6,12,5,10,42,23.8,32,26,9,17,44,67,33,0,"https://fbref.com/en/players/495945ef/Ashley-Westwood"
"5886","Chris Wood_2021",2021,"Burnley","Premier League","Chris Wood","NZL","FW","28",1991,30.5,12,7,2,4,6,5,18,27.8,13,14,3,11,1,13,21,0,"https://fbref.com/en/players/4e9a0555/Chris-Wood"
"5887","Kwadwo Asamoah_2021",2021,"Cagliari","Serie A","Kwadwo Asamoah","GHA","DF,MF","31",1988,2.5,4,3,2,2,0,2,3,66.7,1,5,1,4,4,8,2,1,"https://fbref.com/en/players/089550f5/Kwadwo-Asamoah"
"5888","Arturo Calabresi_2021",2021,"Cagliari","Serie A","Arturo Calabresi","ITA","DF","24",1996,0.2,0,0,0,0,0,0,1,0,1,0,0,0,0,0,0,0,"https://fbref.com/en/players/34bb6fbd/Arturo-Calabresi"
"5889","Fabrizio Caligara_2021",2021,"Cagliari","Serie A","Fabrizio Caligara","ITA","MF,FW","20",2000,2,6,4,2,2,2,6,9,66.7,3,9,2,7,3,9,3,0,"https://fbref.com/en/players/22ca11f1/Fabrizio-Caligara"
"5890","Andrea Carboni_2021",2021,"Cagliari","Serie A","Andrea Carboni","ITA","DF","19",2001,12.1,34,23,23,11,0,15,28,53.6,13,15,4,11,14,48,52,0,"https://fbref.com/en/players/f7e2af2c/Andrea-Carboni"
"5891","Luca Ceppitelli_2021",2021,"Cagliari","Serie A","Luca Ceppitelli","ITA","DF","30",1989,16.3,25,19,13,10,2,14,26,53.8,12,23,12,11,25,50,58,1,"https://fbref.com/en/players/7d50454d/Luca-Ceppitelli"
"5892","Alberto Cerri_2021",2021,"Cagliari","Serie A","Alberto Cerri","ITA","FW","24",1996,4.1,3,2,0,2,1,0,5,0,5,4,2,2,2,5,6,0,"https://fbref.com/en/players/1079c685/Alberto-Cerri"
"5893","Alessio Cragno_2021",2021,"Cagliari","Serie A","Alessio Cragno","ITA","GK","26",1994,34,0,0,0,0,0,0,1,0,1,0,0,0,1,1,10,0,"https://fbref.com/en/players/f554e29b/Alessio-Cragno"
"5894","Alessandro Deiola_2021",2021,"Cagliari","Serie A","Alessandro Deiola","ITA","MF","24",1995,6.8,13,5,5,4,4,8,23,34.8,15,7,2,5,11,24,11,0,"https://fbref.com/en/players/7f267d66/Alessandro-Deiola"
"5895","Kiril Despodov_2021",2021,"Cagliari","Serie A","Kiril Despodov","BUL","FW","23",1996,0.1,1,1,0,1,0,1,1,100,0,0,0,0,0,1,0,0,"https://fbref.com/en/players/13c8e5f6/Kiril-Despodov"
"5896","Alfred Duncan_2021",2021,"Cagliari","Serie A","Alfred Duncan","GHA","MF","27",1993,11.9,18,10,8,9,1,4,21,19,17,8,0,8,16,34,8,1,"https://fbref.com/en/players/528492ea/Alfred-Duncan"
"5897","Paolo Faragò_2021",2021,"Cagliari","Serie A","Paolo Faragò","ITA","DF","27",1993,4.1,13,9,10,3,0,9,20,45,11,3,2,1,6,19,15,0,"https://fbref.com/en/players/9085dd7c/Paolo-Farago"
"5898","Diego Godín_2021",2021,"Cagliari","Serie A","Diego Godín","URU","DF","34",1986,27.9,60,32,51,9,0,24,39,61.5,15,41,24,17,56,116,117,0,"https://fbref.com/en/players/fc4f85b1/Diego-Godin"
"5899","Ragnar Klavan_2021",2021,"Cagliari","Serie A","Ragnar Klavan","EST","DF","34",1985,8.6,15,9,9,5,1,7,11,63.6,4,9,4,5,8,23,34,0,"https://fbref.com/en/players/008a6e6d/Ragnar-Klavan"
"5900","Charalambos Lykogiannis_2021",2021,"Cagliari","Serie A","Charalambos Lykogiannis","GRE","DF","26",1993,26.9,34,21,22,9,3,22,38,57.9,16,34,13,21,32,66,94,0,"https://fbref.com/en/players/5efc5389/Charalambos-Lykogiannis"
"5901","Răzvan Marin_2021",2021,"Cagliari","Serie A","Răzvan Marin","ROU","MF","24",1996,32.9,54,33,26,22,6,27,53,50.9,26,29,10,19,29,83,15,0,"https://fbref.com/en/players/7fac99d4/Razvan-Marin"
"5902","Radja Nainggolan_2021",2021,"Cagliari","Serie A","Radja Nainggolan","BEL","MF","32",1988,20.5,41,26,22,14,5,19,34,55.9,15,18,0,18,15,56,15,1,"https://fbref.com/en/players/1f9328da/Radja-Nainggolan"
"5903","Nahitan Nández_2021",2021,"Cagliari","Serie A","Nahitan Nández","URU","MF,DF","24",1995,30.4,56,28,23,23,10,25,68,36.8,43,26,4,22,23,79,49,0,"https://fbref.com/en/players/95facda1/Nahitan-Nandez"
"5904","Christian Oliva_2021",2021,"Cagliari","Serie A","Christian Oliva","URU","MF","24",1996,4.3,10,4,6,3,1,6,17,35.3,11,11,1,10,8,18,7,0,"https://fbref.com/en/players/d3b888e3/Christian-Oliva"
"5905","Adam Ounas_2021",2021,"Cagliari","Serie A","Adam Ounas","ALG","MF,FW","23",1996,3.4,3,2,3,0,0,0,11,0,11,5,0,5,3,6,0,0,"https://fbref.com/en/players/ed90babd/Adam-Ounas"
"5906","Leonardo Pavoletti_2021",2021,"Cagliari","Serie A","Leonardo Pavoletti","ITA","FW","31",1988,17.6,7,3,2,5,0,1,20,5,19,4,2,2,4,11,32,0,"https://fbref.com/en/players/d37b0350/Leonardo-Pavoletti"
"5907","João Pedro_2021",2021,"Cagliari","Serie A","João Pedro","ITA","FW,MF","28",1992,36.1,13,6,2,6,5,2,27,7.4,25,32,6,26,13,26,28,0,"https://fbref.com/en/players/81255c03/Joao-Pedro"
"5908","Gastón Pereiro_2021",2021,"Cagliari","Serie A","Gastón Pereiro","URU","MF,DF","25",1995,3,3,1,2,1,0,1,2,50,1,2,0,2,1,4,2,1,"https://fbref.com/en/players/7ec7738e/Gaston-Pereiro"
"5909","Fabio Pisacane_2021",2021,"Cagliari","Serie A","Fabio Pisacane","ITA","DF","34",1986,2.5,3,2,2,1,0,3,7,42.9,4,8,5,3,1,4,9,1,"https://fbref.com/en/players/56400c01/Fabio-Pisacane"
"5910","Marko Rog_2021",2021,"Cagliari","Serie A","Marko Rog","CRO","MF","25",1995,12.9,40,24,15,22,3,16,37,43.2,21,17,6,11,19,59,15,0,"https://fbref.com/en/players/b6b2b820/Marko-Rog"
"5911","Daniele Rugani_2021",2021,"Cagliari","Serie A","Daniele Rugani","ITA","DF","26",1994,11.1,24,11,10,12,2,10,20,50,10,15,10,5,15,39,46,0,"https://fbref.com/en/players/14b8fcdf/Daniele-Rugani"
"5912","Giovanni Simeone_2021",2021,"Cagliari","Serie A","Giovanni Simeone","ARG","FW","25",1995,19.3,24,11,2,15,7,7,31,22.6,24,23,1,22,10,34,18,0,"https://fbref.com/en/players/343c0d52/Giovanni-Simeone"
"5913","Riccardo Sottil_2021",2021,"Cagliari","Serie A","Riccardo Sottil","ITA","FW,MF","21",1999,13.2,7,3,2,3,2,0,7,0,7,4,0,4,5,12,3,0,"https://fbref.com/en/players/94816803/Riccardo-Sottil"
"5914","Mattéo Tramoni_2021",2021,"Cagliari","Serie A","Mattéo Tramoni","FRA","MF,FW","20",2000,0.8,4,2,2,1,1,1,2,50,1,5,0,5,1,5,2,0,"https://fbref.com/en/players/2e0ae188/Matteo-Tramoni"
"5915","Alessandro Tripaldelli_2021",2021,"Cagliari","Serie A","Alessandro Tripaldelli","ITA","DF","21",1999,3.3,13,6,5,6,2,5,6,83.3,1,6,1,5,3,16,15,0,"https://fbref.com/en/players/4571fa88/Alessandro-Tripaldelli"
"5916","Guglielmo Vicario_2021",2021,"Cagliari","Serie A","Guglielmo Vicario","ITA","GK","23",1996,4,0,0,0,0,0,0,0,NA,0,0,0,0,0,0,1,0,"https://fbref.com/en/players/77d6fd4d/Guglielmo-Vicario"
"5917","Sebastian Walukiewicz_2021",2021,"Cagliari","Serie A","Sebastian Walukiewicz","POL","DF","20",2000,18,27,19,11,13,3,12,30,40,18,22,14,8,36,63,60,0,"https://fbref.com/en/players/217875a4/Sebastian-Walukiewicz"
"5918","Gabriele Zappa_2021",2021,"Cagliari","Serie A","Gabriele Zappa","ITA","DF","20",1999,26.6,34,17,16,15,3,22,49,44.9,27,36,4,32,24,58,50,0,"https://fbref.com/en/players/ca3db240/Gabriele-Zappa"
"5919","Joseph Aidoo_2021",2021,"Celta Vigo","La Liga","Joseph Aidoo","GHA","DF","24",1995,14.3,26,17,17,9,0,12,21,57.1,9,7,4,3,25,51,88,1,"https://fbref.com/en/players/18abe173/Joseph-Aidoo"
"5920","Alfon_2021",2021,"Celta Vigo","La Liga","Alfon","ESP","MF","21",1999,0.4,0,0,0,0,0,0,0,NA,0,0,0,0,0,0,0,0,"https://fbref.com/en/players/1c772b46/Alfon"
"5921","Néstor Araujo_2021",2021,"Celta Vigo","La Liga","Néstor Araujo","MEX","DF","28",1991,27,24,16,14,9,1,7,15,46.7,8,23,18,5,43,67,89,2,"https://fbref.com/en/players/27a013f7/Nestor-Araujo"
"5922","Iago Aspas_2021",2021,"Celta Vigo","La Liga","Iago Aspas","ESP","FW","32",1987,31.8,11,3,2,7,2,2,23,8.7,21,25,2,23,16,27,21,0,"https://fbref.com/en/players/7dcf86f6/Iago-Aspas"
"5923","Miguel Baeza_2021",2021,"Celta Vigo","La Liga","Miguel Baeza","ESP","MF,FW","20",2000,6,7,6,5,2,0,5,13,38.5,8,3,0,3,3,10,2,0,"https://fbref.com/en/players/a98f3cbf/Miguel-Baeza"
"5924","Fran Beltrán_2021",2021,"Celta Vigo","La Liga","Fran Beltrán","ESP","MF,FW","21",1999,15.5,30,22,15,12,3,8,24,33.3,16,14,1,13,16,46,24,0,"https://fbref.com/en/players/ed5c5fa3/Fran-Beltran"
"5925","Rubén Blanco_2021",2021,"Celta Vigo","La Liga","Rubén Blanco","ESP","GK","25",1995,18.2,0,0,0,0,0,0,0,NA,0,0,0,0,0,0,7,3,"https://fbref.com/en/players/967f34d3/Ruben-Blanco"
"5926","Sergio Carreira_2021",2021,"Celta Vigo","La Liga","Sergio Carreira","ESP","DF","19",2000,2.9,3,0,2,1,0,1,1,100,0,2,0,2,1,4,7,0,"https://fbref.com/en/players/8d6a9c93/Sergio-Carreira"
"5927","Carlos Dominguez_2021",2021,"Celta Vigo","La Liga","Carlos Dominguez","ESP","DF","19",2001,4,5,4,4,1,0,3,6,50,3,5,3,2,6,11,24,0,"https://fbref.com/en/players/3521abfe/Carlos-Dominguez"
"5928","Facundo Ferreyra_2021",2021,"Celta Vigo","La Liga","Facundo Ferreyra","ARG","FW","29",1991,3.3,4,3,1,2,1,0,2,0,2,5,0,5,2,6,2,0,"https://fbref.com/en/players/b39a793e/Facundo-Ferreyra"
"5929","José Fontán_2021",2021,"Celta Vigo","La Liga","José Fontán","ESP","DF","20",2000,7.2,12,9,8,4,0,5,11,45.5,6,4,3,1,13,25,27,0,"https://fbref.com/en/players/1827a42d/Jose-Fontan"
"5930","Jordan Holsgrove_2021",2021,"Celta Vigo","La Liga","Jordan Holsgrove","SCO","MF","20",1999,1.6,6,4,4,1,1,5,8,62.5,3,2,0,2,2,8,1,0,"https://fbref.com/en/players/8a6daac3/Jordan-Holsgrove"
"5931","Lauti_2021",2021,"Celta Vigo","La Liga","Lauti","URU","FW","19",2001,0.2,NA,0,NA,NA,NA,NA,NA,NA,NA,NA,NA,NA,0,NA,NA,NA,"https://fbref.com/en/players/f934c5c9/Lauti"
"5932","Hugo Mallo_2021",2021,"Celta Vigo","La Liga","Hugo Mallo","ESP","DF","29",1991,28.9,58,40,34,23,1,24,52,46.2,28,42,11,31,37,95,77,0,"https://fbref.com/en/players/cb574619/Hugo-Mallo"
"5933","Aarón Martín_2021",2021,"Celta Vigo","La Liga","Aarón Martín","ESP","DF","23",1997,17.1,34,20,15,16,3,10,33,30.3,23,15,4,11,13,47,37,0,"https://fbref.com/en/players/2f3e911a/Aaron-Martin"
"5934","Brais Méndez_2021",2021,"Celta Vigo","La Liga","Brais Méndez","ESP","MF,FW","23",1997,29.7,59,31,23,27,9,16,65,24.6,49,27,2,25,32,91,34,0,"https://fbref.com/en/players/c9e39d91/Brais-Mendez"
"5935","Santi Mina_2021",2021,"Celta Vigo","La Liga","Santi Mina","ESP","FW","24",1995,26.8,31,13,9,12,10,6,37,16.2,31,15,3,12,6,37,17,0,"https://fbref.com/en/players/0b90bb97/Santi-Mina"
"5936","Emre Mor_2021",2021,"Celta Vigo","La Liga","Emre Mor","TUR","FW,MF","23",1997,5.6,8,4,1,3,4,0,3,0,3,5,0,5,5,13,0,0,"https://fbref.com/en/players/0c3f7197/Emre-Mor"
"5937","Jeison Murillo_2021",2021,"Celta Vigo","La Liga","Jeison Murillo","COL","DF","28",1992,30,45,21,35,9,1,24,44,54.5,20,29,17,12,36,81,100,2,"https://fbref.com/en/players/b233e8e4/Jeison-Murillo"
"5938","Nolito_2021",2021,"Celta Vigo","La Liga","Nolito","ESP","MF,FW","33",1986,28.9,70,36,30,30,10,32,92,34.8,60,46,2,44,22,92,19,0,"https://fbref.com/en/players/b2d0ec1b/Nolito"
"5939","Lucas Olaza_2021",2021,"Celta Vigo","La Liga","Lucas Olaza","URU","DF","26",1994,17.9,25,16,12,12,1,10,18,55.6,8,15,1,14,24,49,34,0,"https://fbref.com/en/players/4cee5954/Lucas-Olaza"
"5940","Miguel Rodríguez_2021",2021,"Celta Vigo","La Liga","Miguel Rodríguez","ESP","FW,DF","17",2003,0.3,1,1,0,1,0,0,0,NA,0,0,0,0,0,1,0,0,"https://fbref.com/en/players/958d67bb/Miguel-Rodriguez"
"5941","Augusto Solari_2021",2021,"Celta Vigo","La Liga","Augusto Solari","ARG","MF","28",1992,5.4,18,13,9,8,1,6,26,23.1,20,13,1,12,6,24,5,0,"https://fbref.com/en/players/3ca6106c/Augusto-Solari"
"5942","Hugo Sotelo_2021",2021,"Celta Vigo","La Liga","Hugo Sotelo","ESP","MF","16",2003,0,0,0,0,0,0,0,0,NA,0,0,0,0,0,0,0,0,"https://fbref.com/en/players/3aa74860/Hugo-Sotelo"
"5943","Denis Suárez_2021",2021,"Celta Vigo","La Liga","Denis Suárez","ESP","MF","26",1994,31.7,64,32,22,30,12,21,94,22.3,73,30,2,28,22,86,15,2,"https://fbref.com/en/players/12c50af5/Denis-Suarez"
"5944","Renato Tapia_2021",2021,"Celta Vigo","La Liga","Renato Tapia","PER","MF","25",1995,30,93,44,50,34,9,32,83,38.6,51,56,13,43,53,146,75,2,"https://fbref.com/en/players/34269bdf/Renato-Tapia"
"5945","Kevin Vázquez_2021",2021,"Celta Vigo","La Liga","Kevin Vázquez","ESP","DF","27",1993,6.2,11,5,9,2,0,3,9,33.3,6,8,0,8,9,20,18,0,"https://fbref.com/en/players/ee923664/Kevin-Vazquez"
"5946","Gabriel Veiga_2021",2021,"Celta Vigo","La Liga","Gabriel Veiga","ESP","MF,DF","18",2002,1.3,3,0,3,0,0,1,4,25,3,3,0,3,3,6,0,0,"https://fbref.com/en/players/35a6e5c7/Gabriel-Veiga"
"5947","Iván Villar_2021",2021,"Celta Vigo","La Liga","Iván Villar","ESP","GK","23",1997,19.8,0,0,0,0,0,0,1,0,1,0,0,0,0,0,18,0,"https://fbref.com/en/players/cde52ef5/Ivan-Villar"
"5948","Okay Yokuşlu_2021",2021,"Celta Vigo","La Liga","Okay Yokuşlu","TUR","MF","26",1994,5.1,14,8,8,4,2,5,9,55.6,4,5,2,3,10,24,9,0,"https://fbref.com/en/players/e49ce451/Okay-Yokuslu"
"5949","Tammy Abraham_2021",2021,"Chelsea","Premier League","Tammy Abraham","ENG","FW","22",1997,11.6,7,5,3,3,1,1,7,14.3,6,6,0,6,5,12,17,0,"https://fbref.com/en/players/f586779e/Tammy-Abraham"
"5950","Marcos Alonso_2021",2021,"Chelsea","Premier League","Marcos Alonso","ESP","DF","29",1990,10.7,13,3,6,4,3,7,14,50,7,12,1,11,12,25,30,0,"https://fbref.com/en/players/f4290206/Marcos-Alonso"
"5951","Kepa Arrizabalaga_2021",2021,"Chelsea","Premier League","Kepa Arrizabalaga","ESP","GK","25",1994,6.5,0,0,0,0,0,0,1,0,1,0,0,0,0,0,0,3,"https://fbref.com/en/players/28d596a0/Kepa-Arrizabalaga"
"5952","César Azpilicueta_2021",2021,"Chelsea","Premier League","César Azpilicueta","ESP","DF","30",1989,24.3,53,28,22,24,7,19,37,51.4,18,30,5,25,28,81,62,2,"https://fbref.com/en/players/53cad200/Cesar-Azpilicueta"
"5953","Ross Barkley_2021",2021,"Chelsea","Premier League","Ross Barkley","ENG","FW,MF","26",1993,0.5,0,0,0,0,0,0,0,NA,0,0,0,0,0,0,0,0,"https://fbref.com/en/players/3a24769f/Ross-Barkley"
"5954","Willy Caballero_2021",2021,"Chelsea","Premier League","Willy Caballero","ARG","GK","38",1981,1,0,0,0,0,0,0,0,NA,0,0,0,0,0,0,0,0,"https://fbref.com/en/players/a179d516/Willy-Caballero"
"5955","Ben Chilwell_2021",2021,"Chelsea","Premier League","Ben Chilwell","ENG","DF","23",1996,25.4,42,22,16,22,4,15,33,45.5,18,28,3,25,24,66,58,0,"https://fbref.com/en/players/d2424d1b/Ben-Chilwell"
"5956","Andreas Christensen_2021",2021,"Chelsea","Premier League","Andreas Christensen","DEN","DF","24",1996,15.2,11,6,8,3,0,0,8,0,8,19,14,5,20,31,51,1,"https://fbref.com/en/players/1cb49278/Andreas-Christensen"
"5957","Billy Gilmour_2021",2021,"Chelsea","Premier League","Billy Gilmour","SCO","MF","19",2001,2.9,4,2,1,2,1,2,7,28.6,5,3,2,1,3,7,1,0,"https://fbref.com/en/players/df10e27c/Billy-Gilmour"
"5958","Olivier Giroud_2021",2021,"Chelsea","Premier League","Olivier Giroud","FRA","FW","33",1986,8.3,4,2,0,1,3,1,7,14.3,6,4,1,3,5,9,10,0,"https://fbref.com/en/players/16ceb862/Olivier-Giroud"
"5959","Kai Havertz_2021",2021,"Chelsea","Premier League","Kai Havertz","GER","MF,FW","21",1999,16.9,18,9,6,10,2,6,27,22.2,21,25,0,25,4,22,22,1,"https://fbref.com/en/players/fed7cb61/Kai-Havertz"
"5960","Callum Hudson-Odoi_2021",2021,"Chelsea","Premier League","Callum Hudson-Odoi","ENG","FW,DF","19",2000,11.8,23,15,11,7,5,8,21,38.1,13,15,1,14,6,29,6,0,"https://fbref.com/en/players/15f3ec41/Callum-Hudson-Odoi"
"5961","Reece James_2021",2021,"Chelsea","Premier League","Reece James","ENG","DF","20",1999,26.4,55,35,24,22,9,21,44,47.7,23,36,7,29,17,72,52,0,"https://fbref.com/en/players/1265a93a/Reece-James"
"5962","Jorginho_2021",2021,"Chelsea","Premier League","Jorginho","ITA","MF","28",1991,22.3,57,30,22,31,4,31,76,40.8,45,33,5,28,40,97,21,3,"https://fbref.com/en/players/45db685d/Jorginho"
"5963","N'Golo Kanté_2021",2021,"Chelsea","Premier League","N'Golo Kanté","FRA","MF","29",1991,23.8,79,42,39,35,5,27,56,48.2,29,42,4,38,59,138,34,0,"https://fbref.com/en/players/b9fbae28/NGolo-Kante"
"5964","Mateo Kovačić_2021",2021,"Chelsea","Premier League","Mateo Kovačić","CRO","MF","26",1994,20.2,46,28,19,24,3,17,32,53.1,15,18,1,17,15,61,11,2,"https://fbref.com/en/players/79c0821a/Mateo-Kovacic"
"5965","Ruben Loftus-Cheek_2021",2021,"Chelsea","Premier League","Ruben Loftus-Cheek","ENG","FW","24",1996,0.7,0,0,0,0,0,0,0,NA,0,0,0,0,0,0,0,0,"https://fbref.com/en/players/e97fd090/Ruben-Loftus-Cheek"
"5966","Edouard Mendy_2021",2021,"Chelsea","Premier League","Edouard Mendy","SEN","GK","28",1992,30.5,0,0,0,0,0,0,1,0,1,0,0,0,1,1,9,3,"https://fbref.com/en/players/33887998/Edouard-Mendy"
"5967","Mason Mount_2021",2021,"Chelsea","Premier League","Mason Mount","ENG","MF","21",1999,32.1,75,35,22,38,15,25,69,36.2,44,40,2,38,31,106,14,0,"https://fbref.com/en/players/9674002f/Mason-Mount"
"5968","Emerson Palmieri_2021",2021,"Chelsea","Premier League","Emerson Palmieri","ITA","DF","25",1994,1,3,3,2,0,1,1,3,33.3,2,0,0,0,1,4,6,0,"https://fbref.com/en/players/e0bc6fdc/Emerson-Palmieri"
"5969","Christian Pulisic_2021",2021,"Chelsea","Premier League","Christian Pulisic","USA","FW,MF","21",1998,19.3,19,11,8,10,1,8,21,38.1,13,25,2,23,12,31,9,0,"https://fbref.com/en/players/1bf33a9a/Christian-Pulisic"
"5970","Antonio Rüdiger_2021",2021,"Chelsea","Premier League","Antonio Rüdiger","GER","DF","27",1993,19,31,23,16,14,1,12,15,80,3,17,10,7,18,49,51,0,"https://fbref.com/en/players/18b896d6/Antonio-Rudiger"
"5971","Thiago Silva_2021",2021,"Chelsea","Premier League","Thiago Silva","BRA","DF","35",1984,21.5,20,12,11,8,1,14,21,66.7,7,21,13,8,33,53,86,1,"https://fbref.com/en/players/86e7deaf/Thiago-Silva"
"5972","Fikayo Tomori_2021",2021,"Chelsea","Premier League","Fikayo Tomori","ENG","DF","22",1997,0.5,2,1,2,0,0,0,0,NA,0,1,1,0,2,4,8,0,"https://fbref.com/en/players/7edfbb8a/Fikayo-Tomori"
"5973","Timo Werner_2021",2021,"Chelsea","Premier League","Timo Werner","GER","FW,MF","24",1996,28.9,20,9,6,11,3,7,43,16.3,36,23,1,22,8,28,8,0,"https://fbref.com/en/players/49fe9070/Timo-Werner"
"5974","Hakim Ziyech_2021",2021,"Chelsea","Premier League","Hakim Ziyech","MAR","MF,FW","27",1993,13,14,10,5,7,2,5,19,26.3,14,9,1,8,10,24,2,0,"https://fbref.com/en/players/6622454d/Hakim-Ziyech"
"5975","Kurt Zouma_2021",2021,"Chelsea","Premier League","Kurt Zouma","FRA","DF","25",1994,22.5,16,10,8,6,2,4,8,50,4,13,9,4,28,44,93,0,"https://fbref.com/en/players/ce4246f5/Kurt-Zouma"
"5976","Ahmad Benali_2021",2021,"Crotone","Serie A","Ahmad Benali","LBY","MF","28",1992,13.5,19,11,10,9,0,11,38,28.9,27,15,2,13,6,25,15,0,"https://fbref.com/en/players/a128b07e/Ahmad-Benali"
"5977","Luca Cigarini_2021",2021,"Crotone","Serie A","Luca Cigarini","ITA","MF","34",1986,10.3,26,14,11,12,3,12,28,42.9,16,10,1,9,12,38,9,0,"https://fbref.com/en/players/ae64d449/Luca-Cigarini"
"5978","Alex Cordaz_2021",2021,"Crotone","Serie A","Alex Cordaz","ITA","GK","37",1983,36,0,0,0,0,0,0,0,NA,0,0,0,0,1,1,7,2,"https://fbref.com/en/players/e66ebabb/Alex-Cordaz"
"5979","Gian Crespi_2021",2021,"Crotone","Serie A","Gian Crespi","ITA","GK","19",2001,1,0,0,0,0,0,0,0,NA,0,0,0,0,0,0,0,0,"https://fbref.com/en/players/4dea2f2c/Gian-Crespi"
"5980","Giovanni Crociata_2021",2021,"Crotone","Serie A","Giovanni Crociata","ITA","DF","22",1997,0.3,1,0,0,1,0,0,1,0,1,1,0,1,0,1,0,0,"https://fbref.com/en/players/8c964914/Giovanni-Crociata"
"5981","Giuseppe Cuomo_2021",2021,"Crotone","Serie A","Giuseppe Cuomo","ITA","DF","22",1998,8.9,26,19,17,9,0,9,14,64.3,5,10,2,8,18,44,19,1,"https://fbref.com/en/players/ae5b04fe/Giuseppe-Cuomo"
"5982","Samuel Di Carmine_2021",2021,"Crotone","Serie A","Samuel Di Carmine","ITA","FW","31",1988,5.3,2,2,1,0,1,1,3,33.3,2,2,0,2,0,2,5,0,"https://fbref.com/en/players/ef94dc2f/Samuel-Di-Carmine"
"5983","Koffi Djidji_2021",2021,"Crotone","Serie A","Koffi Djidji","CIV","DF","27",1992,16.9,39,28,30,8,1,10,20,50,10,35,20,15,28,67,73,0,"https://fbref.com/en/players/933d3b51/Koffi-Djidji"
"5984","Denis Drăguș_2021",2021,"Crotone","Serie A","Denis Drăguș","ROU","FW,MF","21",1999,2,3,1,0,0,3,0,4,0,4,4,0,4,1,4,0,0,"https://fbref.com/en/players/0e490f6e/Denis-Dragus"
"5985","Marco Festa_2021",2021,"Crotone","Serie A","Marco Festa","ITA","GK","28",1992,1,0,0,0,0,0,0,0,NA,0,0,0,0,0,0,0,0,"https://fbref.com/en/players/c195ae4a/Marco-Festa"
"5986","Vladimir Golemić_2021",2021,"Crotone","Serie A","Vladimir Golemić","SVN","DF","29",1991,26,33,16,17,13,3,14,19,73.7,5,38,26,12,40,73,97,2,"https://fbref.com/en/players/1db295e5/Vladimir-Golemic"
"5987","Tomislav Gomelt_2021",2021,"Crotone","Serie A","Tomislav Gomelt","CRO","MF","25",1995,0.2,1,1,0,1,0,0,0,NA,0,0,0,0,1,2,0,0,"https://fbref.com/en/players/a5055b1b/Tomislav-Gomelt"
"5988","Eduardo Henrique_2021",2021,"Crotone","Serie A","Eduardo Henrique","BRA","MF","25",1995,10.3,5,2,1,4,0,3,12,25,9,6,1,5,7,12,7,1,"https://fbref.com/en/players/1bd5fc78/Eduardo-Henrique"
"5989","Augustus Kargbo_2021",2021,"Crotone","Serie A","Augustus Kargbo","SLE","FW","20",1999,0.4,0,0,0,0,0,0,0,NA,0,0,0,0,0,0,0,0,"https://fbref.com/en/players/0c8f27b5/Augustus-Kargbo"
"5990","Sebastiano Luperto_2021",2021,"Crotone","Serie A","Sebastiano Luperto","ITA","DF","23",1996,20.9,38,20,28,8,2,16,27,59.3,11,17,7,10,27,65,74,1,"https://fbref.com/en/players/997fff07/Sebastiano-Luperto"
"5991","Lisandro Magallán_2021",2021,"Crotone","Serie A","Lisandro Magallán","ARG","DF","26",1993,24.2,54,31,28,24,2,17,42,40.5,25,29,15,14,44,98,78,1,"https://fbref.com/en/players/01a49bd2/Lisandro-Magallan"
"5992","Luca Marrone_2021",2021,"Crotone","Serie A","Luca Marrone","ITA","DF","30",1990,17.6,25,18,16,9,0,13,21,61.9,8,22,11,11,26,51,56,1,"https://fbref.com/en/players/ea468ea8/Luca-Marrone"
"5993","Antonio Mazzotta_2021",2021,"Crotone","Serie A","Antonio Mazzotta","ITA","DF","30",1989,0.6,1,1,0,1,0,0,0,NA,0,0,0,0,0,1,1,0,"https://fbref.com/en/players/4366d5e9/Antonio-Mazzotta"
"5994","Junior Messias_2021",2021,"Crotone","Serie A","Junior Messias","BRA","MF,FW","29",1991,35.7,60,35,26,24,10,22,70,31.4,48,32,12,20,35,95,40,0,"https://fbref.com/en/players/f49c4ae9/Junior-Messias"
"5995","Salvatore Molina_2021",2021,"Crotone","Serie A","Salvatore Molina","ITA","MF,DF","28",1992,25.7,39,22,18,14,7,29,45,64.4,16,30,8,22,17,56,41,0,"https://fbref.com/en/players/54ab971f/Salvatore-Molina"
"5996","Simeon Nwankwo_2021",2021,"Crotone","Serie A","Simeon Nwankwo","NGA","FW","28",1992,32.7,9,2,2,6,1,3,22,13.6,19,21,5,16,6,15,51,0,"https://fbref.com/en/players/80dbbd10/Simeon-Nwankwo"
"5997","Adam Ounas_2021",2021,"Crotone","Serie A","Adam Ounas","ALG","FW,MF","23",1996,13.3,9,4,4,4,1,0,7,0,7,12,1,11,3,12,4,0,"https://fbref.com/en/players/ed90babd/Adam-Ounas"
"5998","Pedro Pereira_2021",2021,"Crotone","Serie A","Pedro Pereira","POR","DF","22",1998,28.3,50,32,29,17,4,21,40,52.5,19,33,11,22,19,69,61,0,"https://fbref.com/en/players/c77be0cf/Pedro-Pereira"
"5999","Jacopo Petriccione_2021",2021,"Crotone","Serie A","Jacopo Petriccione","ITA","MF","25",1995,10.6,14,8,6,7,1,9,24,37.5,15,11,2,9,8,22,11,0,"https://fbref.com/en/players/909bce7f/Jacopo-Petriccione"
"6000","Arkadiusz Reca_2021",2021,"Crotone","Serie A","Arkadiusz Reca","POL","DF","25",1995,25.7,34,16,15,11,8,10,45,22.2,35,30,3,27,50,84,64,0,"https://fbref.com/en/players/6213fd82/Arkadiusz-Reca"
"6001","Andrea Rispoli_2021",2021,"Crotone","Serie A","Andrea Rispoli","ITA","DF","31",1988,7.2,6,3,2,3,1,2,7,28.6,5,12,3,9,5,11,15,1,"https://fbref.com/en/players/39ee6cb6/Andrea-Rispoli"
"6002","Emmanuel Rivière_2021",2021,"Crotone","Serie A","Emmanuel Rivière","FRA","FW","30",1990,7.1,2,1,2,0,0,0,3,0,3,5,1,4,1,3,0,0,"https://fbref.com/en/players/2bae5658/Emmanuel-Riviere"
"6003","Luis Rojas_2021",2021,"Crotone","Serie A","Luis Rojas","CHI","MF,FW","18",2002,1.2,1,0,0,1,0,1,2,50,1,2,0,2,1,2,0,0,"https://fbref.com/en/players/11e0904f/Luis-Rojas"
"6004","Luca Siligardi_2021",2021,"Crotone","Serie A","Luca Siligardi","ITA","MF,FW","32",1988,0.5,4,2,0,3,1,1,5,20,4,0,0,0,0,4,0,0,"https://fbref.com/en/players/1cac99dc/Luca-Siligardi"
"6005","Miloš Vulić_2021",2021,"Crotone","Serie A","Miloš Vulić","SRB","MF","23",1996,14.5,15,8,9,1,5,8,21,38.1,13,10,1,9,8,23,8,0,"https://fbref.com/en/players/5944af8f/Milos-Vulic"
"6006","Niccolò Zanellato_2021",2021,"Crotone","Serie A","Niccolò Zanellato","ITA","MF","22",1998,18.2,24,14,16,6,2,13,36,36.1,23,19,5,14,16,40,12,2,"https://fbref.com/en/players/741e058f/Niccolo-Zanellato"
"6007","Patrick van Aanholt_2021",2021,"Crystal Palace","Premier League","Patrick van Aanholt","NED","DF","29",1990,19.7,35,22,18,17,0,19,43,44.2,24,18,6,12,30,65,40,2,"https://fbref.com/en/players/5f09991f/Patrick-van-Aanholt"
"6008","Jordan Ayew_2021",2021,"Crystal Palace","Premier League","Jordan Ayew","GHA","FW,MF","28",1991,23.3,38,26,8,16,14,16,44,36.4,28,28,2,26,16,54,12,0,"https://fbref.com/en/players/da052c14/Jordan-Ayew"
"6009","Michy Batshuayi_2021",2021,"Crystal Palace","Premier League","Michy Batshuayi","BEL","FW","26",1993,8.1,5,3,1,2,2,1,9,11.1,8,5,1,4,4,9,5,0,"https://fbref.com/en/players/2973d8ff/Michy-Batshuayi"
"6010","Christian Benteke_2021",2021,"Crystal Palace","Premier League","Christian Benteke","BEL","FW","29",1990,20.2,15,7,1,7,7,2,9,22.2,7,17,6,11,4,19,39,0,"https://fbref.com/en/players/ab070c55/Christian-Benteke"
"6011","Jack Butland_2021",2021,"Crystal Palace","Premier League","Jack Butland","ENG","GK","27",1993,1,0,0,0,0,0,0,0,NA,0,0,0,0,0,0,0,0,"https://fbref.com/en/players/cc70a1d5/Jack-Butland"
"6012","Gary Cahill_2021",2021,"Crystal Palace","Premier League","Gary Cahill","ENG","DF","34",1985,20,13,9,10,3,0,7,11,63.6,4,27,22,5,13,26,88,0,"https://fbref.com/en/players/7914b9fe/Gary-Cahill"
"6013","Nathaniel Clyne_2021",2021,"Crystal Palace","Premier League","Nathaniel Clyne","ENG","DF","29",1991,12.7,17,10,8,8,1,9,16,56.3,7,7,2,5,18,35,25,1,"https://fbref.com/en/players/0442183b/Nathaniel-Clyne"
"6014","Scott Dann_2021",2021,"Crystal Palace","Premier League","Scott Dann","ENG","DF","33",1987,15,6,4,5,1,0,4,11,36.4,7,16,14,2,18,24,59,1,"https://fbref.com/en/players/52105203/Scott-Dann"
"6015","Eberechi Eze_2021",2021,"Crystal Palace","Premier League","Eberechi Eze","ENG","MF","22",1998,28.4,27,14,11,13,3,16,35,45.7,19,19,3,16,24,51,9,1,"https://fbref.com/en/players/ae4fc6a4/Eberechi-Eze"
"6016","Vicente Guaita_2021",2021,"Crystal Palace","Premier League","Vicente Guaita","ESP","GK","33",1987,37,1,1,1,0,0,1,1,100,0,0,0,0,1,2,11,1,"https://fbref.com/en/players/ab13a5aa/Vicente-Guaita"
"6017","Martin Kelly_2021",2021,"Crystal Palace","Premier League","Martin Kelly","ENG","DF","30",1990,0,1,0,1,0,0,1,1,100,0,0,0,0,0,1,0,0,"https://fbref.com/en/players/d7492450/Martin-Kelly"
"6018","Cheikhou Kouyaté_2021",2021,"Crystal Palace","Premier League","Cheikhou Kouyaté","SEN","DF","30",1989,34.7,58,37,44,12,2,25,43,58.1,18,42,26,16,32,90,125,2,"https://fbref.com/en/players/8d3c902d/Cheikhou-Kouyate"
"6019","Jean-Philippe Mateta_2021",2021,"Crystal Palace","Premier League","Jean-Philippe Mateta","FRA","FW","23",1997,2.5,1,1,0,1,0,1,3,33.3,2,1,0,1,0,1,2,0,"https://fbref.com/en/players/50e6dc35/Jean-Philippe-Mateta"
"6020","James McArthur_2021",2021,"Crystal Palace","Premier League","James McArthur","SCO","MF","32",1987,16.3,57,32,25,27,5,15,39,38.5,24,28,3,25,23,80,31,0,"https://fbref.com/en/players/cee31595/James-McArthur"
"6021","James McCarthy_2021",2021,"Crystal Palace","Premier League","James McCarthy","IRL","MF","29",1990,9.1,16,12,9,7,0,8,21,38.1,13,15,7,8,8,24,12,0,"https://fbref.com/en/players/64b08de7/James-McCarthy"
"6022","Luka Milivojević_2021",2021,"Crystal Palace","Premier League","Luka Milivojević","SRB","MF","29",1991,26.2,65,34,25,31,9,42,77,54.5,35,29,6,23,35,100,47,2,"https://fbref.com/en/players/2ce2508a/Luka-Milivojevic"
"6023","Tyrick Mitchell_2021",2021,"Crystal Palace","Premier League","Tyrick Mitchell","ENG","DF","20",1999,19,64,35,48,9,7,23,40,57.5,17,29,10,19,21,85,62,1,"https://fbref.com/en/players/5cbd1eb0/Tyrick-Mitchell"
"6024","Jaïro Riedewald_2021",2021,"Crystal Palace","Premier League","Jaïro Riedewald","NED","MF","23",1996,20.2,34,15,13,17,4,16,36,44.4,20,39,7,32,29,63,25,0,"https://fbref.com/en/players/7a1f2c08/Jairo-Riedewald"
"6025","Mamadou Sakho_2021",2021,"Crystal Palace","Premier League","Mamadou Sakho","FRA","DF","30",1990,3.1,3,2,1,2,0,3,3,100,0,3,2,1,3,6,11,0,"https://fbref.com/en/players/87935cf3/Mamadou-Sakho"
"6026","Jeffrey Schlupp_2021",2021,"Crystal Palace","Premier League","Jeffrey Schlupp","GHA","MF","27",1992,15.9,29,16,14,12,3,6,23,26.1,17,24,8,16,22,51,16,0,"https://fbref.com/en/players/3312f911/Jeffrey-Schlupp"
"6027","James Tomkins_2021",2021,"Crystal Palace","Premier League","James Tomkins","ENG","DF","31",1989,6.1,4,2,4,0,0,3,4,75,1,4,3,1,4,8,45,0,"https://fbref.com/en/players/e7ca0439/James-Tomkins"
"6028","Andros Townsend_2021",2021,"Crystal Palace","Premier League","Andros Townsend","ENG","MF,FW","29",1991,25.1,78,41,45,20,13,30,79,38,49,48,2,46,41,119,19,0,"https://fbref.com/en/players/b28bbd58/Andros-Townsend"
"6029","Joel Ward_2021",2021,"Crystal Palace","Premier League","Joel Ward","ENG","DF","30",1989,25.1,43,25,29,14,0,24,42,57.1,18,27,8,19,41,84,87,2,"https://fbref.com/en/players/8a7ff278/Joel-Ward"
"6030","Wilfried Zaha_2021",2021,"Crystal Palace","Premier League","Wilfried Zaha","CIV","FW","27",1992,29,26,18,8,15,3,11,30,36.7,19,21,0,21,9,35,4,0,"https://fbref.com/en/players/b2bc3b1f/Wilfried-Zaha"
"6031","Bobby Adekanye_2021",2021,"Cádiz","La Liga","Bobby Adekanye","NED","FW,MF","21",1999,0.4,0,0,0,0,0,0,1,0,1,0,0,0,0,0,1,0,"https://fbref.com/en/players/3ed84b2c/Bobby-Adekanye"
"6032","Carlos Akapo_2021",2021,"Cádiz","La Liga","Carlos Akapo","EQG","DF","27",1993,9.6,18,14,14,4,0,10,18,55.6,8,16,3,13,19,37,33,0,"https://fbref.com/en/players/f2a68b97/Carlos-Akapo"
"6033","Pedro Alcalá_2021",2021,"Cádiz","La Liga","Pedro Alcalá","ESP","DF","31",1989,10.1,8,4,6,2,0,3,5,60,2,19,13,6,16,24,50,0,"https://fbref.com/en/players/ba71d071/Pedro-Alcala"
"6034","Iván Alejo_2021",2021,"Cádiz","La Liga","Iván Alejo","ESP","MF,FW","25",1995,9.2,14,10,8,4,2,4,23,17.4,19,14,1,13,3,17,10,0,"https://fbref.com/en/players/3d7e48ce/Ivan-Alejo"
"6035","Jon Ander Garrido_2021",2021,"Cádiz","La Liga","Jon Ander Garrido","ESP","MF","30",1989,8.9,18,10,8,7,3,10,26,38.5,16,12,4,8,14,32,13,0,"https://fbref.com/en/players/c46736ab/Jon-Ander-Garrido"
"6036","Marc Baró_2021",2021,"Cádiz","La Liga","Marc Baró","ESP","DF","20",1999,1,2,1,2,0,0,0,2,0,2,1,0,1,2,4,2,1,"https://fbref.com/en/players/74aa6ab7/Marc-Baro"
"6037","Álvaro Bastida_2021",2021,"Cádiz","La Liga","Álvaro Bastida","ESP","MF","16",2004,0.4,0,0,0,0,0,0,0,NA,0,0,0,0,0,0,0,0,"https://fbref.com/en/players/42a028c5/Alvaro-Bastida"
"6038","Yann Bodiger_2021",2021,"Cádiz","La Liga","Yann Bodiger","FRA","MF","25",1995,2.8,2,2,1,1,0,1,6,16.7,5,7,3,4,8,10,4,0,"https://fbref.com/en/players/8c2c48a9/Yann-Bodiger"
"6039","Cala_2021",2021,"Cádiz","La Liga","Cala","ESP","DF","30",1989,25.2,21,12,15,6,0,11,21,52.4,10,18,8,10,35,56,91,0,"https://fbref.com/en/players/fe05804b/Cala"
"6040","Isaac Carcelen_2021",2021,"Cádiz","La Liga","Isaac Carcelen","ESP","DF","27",1993,28.7,68,43,36,25,7,33,60,55,27,37,12,25,49,117,89,0,"https://fbref.com/en/players/c4b888df/Isaac-Carcelen"
"6041","Alberto Cifuentes_2021",2021,"Cádiz","La Liga","Alberto Cifuentes","ESP","GK","41",1979,2,0,0,0,0,0,0,0,NA,0,0,0,0,0,0,0,0,"https://fbref.com/en/players/94084f83/Alberto-Cifuentes"
"6042","Alfonso Espino_2021",2021,"Cádiz","La Liga","Alfonso Espino","URU","DF","28",1992,28.9,92,48,63,28,1,43,85,50.6,42,30,5,25,41,133,74,0,"https://fbref.com/en/players/db001fa9/Alfonso-Espino"
"6043","Fali_2021",2021,"Cádiz","La Liga","Fali","ESP","DF,MF","26",1993,29.3,42,25,24,15,3,16,37,43.2,21,28,15,13,32,74,119,0,"https://fbref.com/en/players/72a84002/Fali"
"6044","Álex Fernández_2021",2021,"Cádiz","La Liga","Álex Fernández","ESP","MF","27",1992,21.6,19,9,8,8,3,8,30,26.7,22,14,1,13,22,41,15,0,"https://fbref.com/en/players/aa677a35/Alex-Fernandez"
"6045","Augusto Fernández_2021",2021,"Cádiz","La Liga","Augusto Fernández","ARG","MF","34",1986,4.1,11,3,5,6,0,2,13,15.4,11,5,1,4,9,20,5,0,"https://fbref.com/en/players/78c40e94/Augusto-Fernandez"
"6046","David Gil_2021",2021,"Cádiz","La Liga","David Gil","ESP","GK","26",1994,4,0,0,0,0,0,0,1,0,1,0,0,0,0,0,2,0,"https://fbref.com/en/players/fea23125/David-Gil"
"6047","Álvaro Giménez_2021",2021,"Cádiz","La Liga","Álvaro Giménez","ESP","FW","29",1991,4.5,4,2,2,2,0,0,3,0,3,2,0,2,2,6,3,0,"https://fbref.com/en/players/18017beb/Alvaro-Gimenez"
"6048","Sergio González_2021",2021,"Cádiz","La Liga","Sergio González","ESP","MF,DF","23",1997,1,1,0,0,1,0,1,2,50,1,0,0,0,2,3,0,0,"https://fbref.com/en/players/5dd16ace/Sergio-Gonzalez"
"6049","Marcos Mauro López Gutiérrez_2021",2021,"Cádiz","La Liga","Marcos Mauro López Gutiérrez","ARG","DF","29",1991,20.3,23,15,15,8,0,15,24,62.5,9,18,12,6,22,45,78,0,"https://fbref.com/en/players/b3b62f94/Marcos-Mauro-Lopez-Gutierrez"
"6050","Jairo Izquierdo_2021",2021,"Cádiz","La Liga","Jairo Izquierdo","ESP","MF,DF","26",1993,14.2,21,13,13,8,0,12,31,38.7,19,7,1,6,14,35,12,0,"https://fbref.com/en/players/2ceb58ab/Jairo-Izquierdo"
"6051","Jens Jønsson_2021",2021,"Cádiz","La Liga","Jens Jønsson","DEN","MF","27",1993,29.1,55,29,25,25,5,22,52,42.3,30,39,7,32,51,106,45,0,"https://fbref.com/en/players/53520a67/Jens-Jonsson"
"6052","Jeremías Ledesma_2021",2021,"Cádiz","La Liga","Jeremías Ledesma","ARG","GK","27",1993,32,1,0,1,0,0,1,1,100,0,1,0,1,0,1,22,6,"https://fbref.com/en/players/6c4776b1/Jeremias-Ledesma"
"6053","Anthony Lozano_2021",2021,"Cádiz","La Liga","Anthony Lozano","HON","FW","27",1993,16.9,12,4,1,5,6,2,13,15.4,11,3,1,2,3,15,8,0,"https://fbref.com/en/players/38699c72/Anthony-Lozano"
"6054","Filip Malbašić_2021",2021,"Cádiz","La Liga","Filip Malbašić","SRB","FW,MF","27",1992,9.6,12,7,4,5,3,6,18,33.3,12,10,0,10,4,16,2,0,"https://fbref.com/en/players/04981123/Filip-Malbasic"
"6055","José Mari_2021",2021,"Cádiz","La Liga","José Mari","ESP","MF","32",1987,16.1,32,17,13,18,1,14,31,45.2,17,16,7,9,27,59,33,1,"https://fbref.com/en/players/6f4c734d/Jose-Mari"
"6056","Álex Martín_2021",2021,"Cádiz","La Liga","Álex Martín","ESP","DF","22",1998,1.1,2,0,1,1,0,2,4,50,2,1,1,0,0,2,6,0,"https://fbref.com/en/players/80153344/Alex-Martin"
"6057","Nano_2021",2021,"Cádiz","La Liga","Nano","ESP","FW","25",1995,0.1,0,0,0,0,0,0,0,NA,0,0,0,0,0,0,0,0,"https://fbref.com/en/players/217011a0/Nano"
"6058","Álvaro Negredo_2021",2021,"Cádiz","La Liga","Álvaro Negredo","ESP","FW","34",1985,24.4,11,5,3,4,4,5,11,45.5,6,7,2,5,3,14,19,0,"https://fbref.com/en/players/63b0ca6b/Alvaro-Negredo"
"6059","Nieto_2021",2021,"Cádiz","La Liga","Nieto","ESP","FW,DF","22",1998,0.2,1,1,0,1,0,0,0,NA,0,0,0,0,0,1,1,0,"https://fbref.com/en/players/3afeb49f/Nieto"
"6060","Alberto Perea_2021",2021,"Cádiz","La Liga","Alberto Perea","ESP","MF","29",1990,17.2,28,17,12,10,6,9,35,25.7,26,26,1,25,21,49,9,0,"https://fbref.com/en/players/5496cc91/Alberto-Perea"
"6061","Jorge Pombo_2021",2021,"Cádiz","La Liga","Jorge Pombo","ESP","FW,MF","26",1994,5.8,7,3,3,2,2,1,8,12.5,7,2,0,2,2,9,3,0,"https://fbref.com/en/players/0a8bcb23/Jorge-Pombo"
"6062","Salvi_2021",2021,"Cádiz","La Liga","Salvi","ESP","MF,FW","29",1991,21.5,18,10,14,3,1,8,26,30.8,18,14,1,13,20,38,24,0,"https://fbref.com/en/players/405f267a/Salvi"
"6063","Ivan Šaponjić_2021",2021,"Cádiz","La Liga","Ivan Šaponjić","SRB","FW","22",1997,4.3,1,0,0,1,0,0,2,0,2,2,0,2,1,2,4,0,"https://fbref.com/en/players/d2aea9ac/Ivan-Saponjic"
"6064","Rubén Sobrino_2021",2021,"Cádiz","La Liga","Rubén Sobrino","ESP","FW,MF","28",1992,12.4,29,13,8,16,5,8,18,44.4,10,19,0,19,15,44,11,0,"https://fbref.com/en/players/19b776e9/Ruben-Sobrino"
"6065","Saturnin Allagbé_2021",2021,"Dijon","Ligue 1","Saturnin Allagbé","BEN","GK","26",1993,12,0,0,0,0,0,0,1,0,1,0,0,0,0,0,9,3,"https://fbref.com/en/players/b052b8bf/Saturnin-Allagbe"
"6066","Romain Amalfitano_2021",2021,"Dijon","Ligue 1","Romain Amalfitano","FRA","FW,DF","30",1989,1.3,4,2,3,1,0,1,3,33.3,2,2,1,1,1,5,1,0,"https://fbref.com/en/players/d7bf3d19/Romain-Amalfitano"
"6067","Roger Assalé_2021",2021,"Dijon","Ligue 1","Roger Assalé","CIV","FW,MF","26",1993,9.2,10,8,3,5,2,4,12,33.3,8,7,3,4,2,12,2,0,"https://fbref.com/en/players/5d5219b1/Roger-Assale"
"6068","Erwan Belhadji_2021",2021,"Dijon","Ligue 1","Erwan Belhadji","FRA","MF","19",2001,0.3,3,0,3,0,0,3,5,60,2,1,0,1,0,3,0,0,"https://fbref.com/en/players/7615f332/Erwan-Belhadji"
"6069","Yassine Benzia_2021",2021,"Dijon","Ligue 1","Yassine Benzia","ALG","MF,FW","25",1994,4.5,10,5,5,3,2,2,10,20,8,3,0,3,6,16,2,0,"https://fbref.com/en/players/6fbde63a/Yassine-Benzia"
"6070","Sacha Boey_2021",2021,"Dijon","Ligue 1","Sacha Boey","FRA","DF","19",2000,20.7,54,40,30,23,1,27,55,49.1,28,25,5,20,41,95,62,0,"https://fbref.com/en/players/6c8ddd52/Sacha-Boey"
"6071","Bersant Celina_2021",2021,"Dijon","Ligue 1","Bersant Celina","KVX","MF,FW","23",1996,25.5,20,12,8,8,4,7,38,18.4,31,20,2,18,8,28,10,0,"https://fbref.com/en/players/3043d33f/Bersant-Celina"
"6072","Fouad Chafik_2021",2021,"Dijon","Ligue 1","Fouad Chafik","MAR","DF","33",1986,18,39,24,29,8,2,16,35,45.7,19,19,10,9,21,60,41,0,"https://fbref.com/en/players/edd1466a/Fouad-Chafik"
"6073","Aníbal Chalá_2021",2021,"Dijon","Ligue 1","Aníbal Chalá","ECU","DF","24",1996,8.3,10,7,6,3,1,6,12,50,6,5,3,2,14,24,15,1,"https://fbref.com/en/players/84c0768a/Anibal-Chala"
"6074","Pape Cheikh Diop_2021",2021,"Dijon","Ligue 1","Pape Cheikh Diop","SEN","MF","22",1997,12.1,24,14,15,6,3,13,33,39.4,20,14,2,12,6,30,6,0,"https://fbref.com/en/players/873ce3a2/Pape-Cheikh-Diop"
"6075","Mounir Chouiar_2021",2021,"Dijon","Ligue 1","Mounir Chouiar","FRA","FW,MF","21",1999,14.3,22,12,10,9,3,6,18,33.3,12,10,0,10,11,33,8,0,"https://fbref.com/en/players/45c1c326/Mounir-Chouiar"
"6076","Charles Costes_2021",2021,"Dijon","Ligue 1","Charles Costes","FRA","MF","17",2002,0,0,0,0,0,0,0,0,NA,0,0,0,0,0,0,0,0,"https://fbref.com/en/players/aa67d758/Charles-Costes"
"6077","Senou Coulibaly_2021",2021,"Dijon","Ligue 1","Senou Coulibaly","MLI","DF","25",1994,21.5,33,21,23,10,0,12,24,50,12,18,12,6,30,63,89,0,"https://fbref.com/en/players/67b7357e/Senou-Coulibaly"
"6078","Junior Dina Ebimbe_2021",2021,"Dijon","Ligue 1","Junior Dina Ebimbe","FRA","FW,MF","19",2000,23.8,38,25,14,19,5,15,45,33.3,30,17,1,16,14,52,9,0,"https://fbref.com/en/players/95bb6ddc/Junior-Dina-Ebimbe"
"6079","Mihai Dobre_2021",2021,"Dijon","Ligue 1","Mihai Dobre","ROU","FW","21",1998,5.9,12,5,6,2,4,7,14,50,7,5,0,5,10,22,3,0,"https://fbref.com/en/players/a1f3f5a0/Mihai-Dobre"
"6080","Bruno Ecuele Manga_2021",2021,"Dijon","Ligue 1","Bruno Ecuele Manga","GAB","DF","32",1988,38,52,38,46,6,0,29,40,72.5,11,50,33,17,57,109,165,3,"https://fbref.com/en/players/72a0fb65/Bruno-Ecuele-Manga"
"6081","Alfred Gomis_2021",2021,"Dijon","Ligue 1","Alfred Gomis","SEN","GK","26",1993,5,1,0,1,0,0,1,2,50,1,0,0,0,1,2,7,0,"https://fbref.com/en/players/cecbce23/Alfred-Gomis"
"6082","Didier Ibrahim Ndong_2021",2021,"Dijon","Ligue 1","Didier Ibrahim Ndong","GAB","MF","26",1994,29,53,32,22,30,1,25,70,35.7,45,35,7,28,37,90,40,0,"https://fbref.com/en/players/885b7aa7/Didier-Ibrahim-Ndong"
"6083","Aboubakar Kamara_2021",2021,"Dijon","Ligue 1","Aboubakar Kamara","MTN","FW,MF","25",1995,6.2,3,1,0,2,1,1,7,14.3,6,1,0,1,0,3,2,0,"https://fbref.com/en/players/4047c976/Aboubakar-Kamara"
"6084","Moussa Konaté_2021",2021,"Dijon","Ligue 1","Moussa Konaté","SEN","FW","27",1993,13.3,5,3,1,2,2,2,11,18.2,9,4,1,3,5,10,8,0,"https://fbref.com/en/players/fcbcbd94/Moussa-Konate"
"6085","Wesley Lautoa_2021",2021,"Dijon","Ligue 1","Wesley Lautoa","NCL","MF,DF","32",1987,17.9,36,20,20,13,3,11,37,29.7,26,17,8,9,29,65,33,1,"https://fbref.com/en/players/6e5b5a45/Wesley-Lautoa"
"6086","Jordan Marié_2021",2021,"Dijon","Ligue 1","Jordan Marié","FRA","MF","28",1991,15.9,34,17,9,23,2,23,56,41.1,33,14,5,9,23,57,12,2,"https://fbref.com/en/players/0d2158d5/Jordan-Marie"
"6087","Muzinga Ngonda_2021",2021,"Dijon","Ligue 1","Muzinga Ngonda","COD","DF","25",1994,25.6,59,40,37,21,1,30,50,60,20,28,3,25,72,131,58,0,"https://fbref.com/en/players/b748968d/Muzinga-Ngonda"
"6088","Ahmad Ngouyamsa_2021",2021,"Dijon","Ligue 1","Ahmad Ngouyamsa","CMR","DF","19",2000,1.7,6,4,5,1,0,4,8,50,4,2,1,1,2,8,8,0,"https://fbref.com/en/players/8413ceb1/Ahmad-Ngouyamsa"
"6089","Jonathan Panzo_2021",2021,"Dijon","Ligue 1","Jonathan Panzo","ENG","DF","19",2000,20,17,12,13,4,0,8,11,72.7,3,27,13,14,59,76,91,2,"https://fbref.com/en/players/c795c408/Jonathan-Panzo"
"6090","Rayan Philippe_2021",2021,"Dijon","Ligue 1","Rayan Philippe","FRA","FW","19",2000,1,3,1,1,1,1,2,2,100,0,0,0,0,0,3,0,0,"https://fbref.com/en/players/a046fc35/Rayan-Philippe"
"6091","Anthony Racioppi_2021",2021,"Dijon","Ligue 1","Anthony Racioppi","SUI","GK","21",1998,21,0,0,0,0,0,0,2,0,2,0,0,0,2,2,12,4,"https://fbref.com/en/players/abc06eb3/Anthony-Racioppi"
"6092","Mama Samba Baldé_2021",2021,"Dijon","Ligue 1","Mama Samba Baldé","GNB","FW","24",1995,24,23,9,4,13,6,9,22,40.9,13,16,1,15,4,27,26,0,"https://fbref.com/en/players/fb14aa28/Mama-Samba-Balde"
"6093","Frédéric Sammaritano_2021",2021,"Dijon","Ligue 1","Frédéric Sammaritano","FRA","FW,MF","34",1986,12.6,15,10,9,5,1,9,26,34.6,17,6,0,6,9,24,3,0,"https://fbref.com/en/players/8802c1d5/Frederic-Sammaritano"
"6094","Aurélien Scheidler_2021",2021,"Dijon","Ligue 1","Aurélien Scheidler","FRA","FW","22",1998,3.8,2,0,0,2,0,0,2,0,2,0,0,0,1,3,5,0,"https://fbref.com/en/players/bc9479b9/Aurelien-Scheidler"
"6095","Jacques Siwe_2021",2021,"Dijon","Ligue 1","Jacques Siwe","FRA","FW","19",2001,1.9,4,1,1,1,2,0,1,0,1,1,0,1,1,5,1,0,"https://fbref.com/en/players/c39b09e3/Jacques-Siwe"
"6096","Wilitty Younoussa_2021",2021,"Dijon","Ligue 1","Wilitty Younoussa","CMR","MF","18",2001,0.9,6,3,3,3,0,3,7,42.9,4,3,0,3,2,8,0,0,"https://fbref.com/en/players/2736b85e/Wilitty-Younoussa"
"6097","Arthur Zagre_2021",2021,"Dijon","Ligue 1","Arthur Zagre","FRA","DF,MF","18",2001,1.4,3,1,2,1,0,2,2,100,0,1,1,0,3,6,1,0,"https://fbref.com/en/players/3225654e/Arthur-Zagre"
"6098","Manuel Akanji_2021",2021,"Dortmund","Bundesliga","Manuel Akanji","SUI","DF","25",1995,26.1,41,22,23,12,6,19,31,61.3,12,23,10,13,49,90,70,1,"https://fbref.com/en/players/89ac64a6/Manuel-Akanji"
"6099","Jude Bellingham_2021",2021,"Dortmund","Bundesliga","Jude Bellingham","ENG","MF","17",2003,18.9,49,31,11,29,9,19,46,41.3,27,37,5,32,24,73,13,0,"https://fbref.com/en/players/57d88cf9/Jude-Bellingham"
"6100","Julian Brandt_2021",2021,"Dortmund","Bundesliga","Julian Brandt","GER","FW,MF","24",1996,16.6,27,14,13,9,5,12,43,27.9,31,25,1,24,17,44,7,1,"https://fbref.com/en/players/a167537f/Julian-Brandt"
"6101","Roman Bürki_2021",2021,"Dortmund","Bundesliga","Roman Bürki","SUI","GK","29",1990,18.5,0,0,0,0,0,0,0,NA,0,0,0,0,0,0,5,1,"https://fbref.com/en/players/9d12e142/Roman-Burki"
"6102","Emre Can_2021",2021,"Dortmund","Bundesliga","Emre Can","GER","DF,MF","26",1994,23.7,43,34,20,20,3,20,37,54.1,17,35,10,25,48,91,52,0,"https://fbref.com/en/players/a65ce836/Emre-Can"
"6103","Mahmoud Dahoud_2021",2021,"Dortmund","Bundesliga","Mahmoud Dahoud","GER","MF","24",1996,14,30,18,9,20,1,14,38,36.8,24,23,5,18,18,48,11,1,"https://fbref.com/en/players/db4ed67b/Mahmoud-Dahoud"
"6104","Thomas Delaney_2021",2021,"Dortmund","Bundesliga","Thomas Delaney","DEN","MF","28",1991,14.3,40,30,15,20,5,11,31,35.5,20,28,10,18,22,62,15,1,"https://fbref.com/en/players/fe641c1a/Thomas-Delaney"
"6105","Raphaël Guerreiro_2021",2021,"Dortmund","Bundesliga","Raphaël Guerreiro","POR","DF","26",1993,24.6,30,13,14,8,8,16,31,51.6,15,21,4,17,28,58,31,1,"https://fbref.com/en/players/048a1cbc/Raphael-Guerreiro"
"6106","Erling Haaland_2021",2021,"Dortmund","Bundesliga","Erling Haaland","NOR","FW","20",2000,26.7,7,2,1,3,3,1,4,25,3,19,4,15,4,11,16,0,"https://fbref.com/en/players/1f44ac21/Erling-Haaland"
"6107","Thorgan Hazard_2021",2021,"Dortmund","Bundesliga","Thorgan Hazard","BEL","MF,FW","27",1993,7.3,8,2,6,1,1,3,13,23.1,10,4,0,4,10,18,1,0,"https://fbref.com/en/players/50871bcc/Thorgan-Hazard"
"6108","Marwin Hitz_2021",2021,"Dortmund","Bundesliga","Marwin Hitz","SUI","GK","32",1987,15.5,1,1,1,0,0,1,1,100,0,0,0,0,0,1,7,1,"https://fbref.com/en/players/2e7ff968/Marwin-Hitz"
"6109","Mats Hummels_2021",2021,"Dortmund","Bundesliga","Mats Hummels","GER","DF","31",1988,31.3,58,40,34,18,6,26,42,61.9,16,31,22,9,73,131,122,2,"https://fbref.com/en/players/05d548d8/Mats-Hummels"
"6110","Ansgar Knauff_2021",2021,"Dortmund","Bundesliga","Ansgar Knauff","GER","MF,FW","18",2002,0.8,0,0,0,0,0,0,1,0,1,3,1,2,0,0,0,0,"https://fbref.com/en/players/19a967ab/Ansgar-Knauff"
"6111","Thomas Meunier_2021",2021,"Dortmund","Bundesliga","Thomas Meunier","BEL","DF","28",1991,16.4,30,21,19,6,5,20,29,69,9,16,6,10,18,48,29,2,"https://fbref.com/en/players/e162b013/Thomas-Meunier"
"6112","Mateu Morey_2021",2021,"Dortmund","Bundesliga","Mateu Morey","ESP","DF","20",2000,9.2,13,7,4,7,2,9,12,75,3,6,1,5,18,31,7,1,"https://fbref.com/en/players/5fd5e542/Mateu-Morey"
"6113","Youssoufa Moukoko_2021",2021,"Dortmund","Bundesliga","Youssoufa Moukoko","GER","FW,MF","15",2004,4.7,3,2,1,1,1,0,0,NA,0,3,0,3,0,3,2,0,"https://fbref.com/en/players/6ce43701/Youssoufa-Moukoko"
"6114","Felix Passlack_2021",2021,"Dortmund","Bundesliga","Felix Passlack","GER","DF","22",1998,4,9,6,4,2,3,4,8,50,4,11,1,10,3,12,2,0,"https://fbref.com/en/players/5c899683/Felix-Passlack"
"6115","Łukasz Piszczek_2021",2021,"Dortmund","Bundesliga","Łukasz Piszczek","POL","DF","35",1985,5.1,10,7,6,4,0,5,12,41.7,7,5,1,4,5,15,12,0,"https://fbref.com/en/players/fe2db476/Lukasz-Piszczek"
"6116","Reinier_2021",2021,"Dortmund","Bundesliga","Reinier","BRA","MF,FW","18",2002,2.9,9,4,6,1,2,2,4,50,2,4,1,3,2,11,0,0,"https://fbref.com/en/players/6b21b7b5/Reinier"
"6117","Marco Reus_2021",2021,"Dortmund","Bundesliga","Marco Reus","GER","MF,FW","31",1989,25.3,33,16,9,16,8,9,33,27.3,24,22,2,20,14,47,13,0,"https://fbref.com/en/players/36a3ff67/Marco-Reus"
"6118","Gio Reyna_2021",2021,"Dortmund","Bundesliga","Gio Reyna","USA","MF,FW","17",2002,22,24,13,9,8,7,9,25,36,16,14,1,13,10,34,11,0,"https://fbref.com/en/players/7fa4e703/Gio-Reyna"
"6119","Jadon Sancho_2021",2021,"Dortmund","Bundesliga","Jadon Sancho","ENG","FW,MF","20",2000,22.9,18,11,4,10,4,7,16,43.8,9,20,1,19,16,34,9,0,"https://fbref.com/en/players/dbf053da/Jadon-Sancho"
"6120","Nico Schulz_2021",2021,"Dortmund","Bundesliga","Nico Schulz","GER","DF","27",1993,6.8,9,6,4,3,2,2,11,18.2,9,12,4,8,6,15,10,0,"https://fbref.com/en/players/fa274d97/Nico-Schulz"
"6121","Steffen Tigges_2021",2021,"Dortmund","Bundesliga","Steffen Tigges","GER","FW,DF","22",1998,0.6,4,4,0,1,3,2,3,66.7,1,1,0,1,0,4,1,0,"https://fbref.com/en/players/6b8887c2/Steffen-Tigges"
"6122","Axel Witsel_2021",2021,"Dortmund","Bundesliga","Axel Witsel","BEL","MF","31",1989,12.6,18,12,6,11,1,8,16,50,8,13,3,10,22,40,13,0,"https://fbref.com/en/players/5dfc6ad5/Axel-Witsel"
"6123","Dan-Axel Zagadou_2021",2021,"Dortmund","Bundesliga","Dan-Axel Zagadou","FRA","DF","21",1999,3.1,2,2,2,0,0,0,0,NA,0,3,2,1,6,8,13,0,"https://fbref.com/en/players/a4effc55/Dan-Axel-Zagadou"
"6124","Sergio Álvarez_2021",2021,"Eibar","La Liga","Sergio Álvarez","ESP","MF,DF","28",1992,17.4,42,25,13,26,3,8,22,36.4,14,22,5,17,22,64,24,2,"https://fbref.com/en/players/88d91621/Sergio-Alvarez"
"6125","José Ángel_2021",2021,"Eibar","La Liga","José Ángel","ESP","DF","30",1989,10,15,8,9,4,2,8,12,66.7,4,7,0,7,13,28,17,1,"https://fbref.com/en/players/3024e383/Jose-Angel"
"6126","Anaitz Arbilla_2021",2021,"Eibar","La Liga","Anaitz Arbilla","ESP","DF","33",1987,31.2,45,26,31,11,3,27,54,50,27,36,11,25,69,114,73,1,"https://fbref.com/en/players/850c0a0d/Anaitz-Arbilla"
"6127","Unai Arietaleanizbeaskoa_2021",2021,"Eibar","La Liga","Unai Arietaleanizbeaskoa","ESP","FW,MF","21",1999,0.5,1,0,0,0,1,0,0,NA,0,0,0,0,0,1,0,0,"https://fbref.com/en/players/74d9a90b/Unai-Arietaleanizbeaskoa"
"6128","Miguel Atienza_2021",2021,"Eibar","La Liga","Miguel Atienza","ESP","MF","21",1999,9.3,20,9,5,15,0,8,23,34.8,15,14,1,13,9,29,12,0,"https://fbref.com/en/players/12eda7be/Miguel-Atienza"
"6129","Pedro Bigas_2021",2021,"Eibar","La Liga","Pedro Bigas","ESP","DF","29",1990,17,11,9,7,4,0,7,14,50,7,12,6,6,23,34,54,0,"https://fbref.com/en/players/697295b1/Pedro-Bigas"
"6130","Esteban Burgos_2021",2021,"Eibar","La Liga","Esteban Burgos","ARG","DF","28",1992,12.3,7,6,4,3,0,1,5,20,4,8,7,1,23,30,54,2,"https://fbref.com/en/players/40449bbd/Esteban-Burgos"
"6131","Rober Correa_2021",2021,"Eibar","La Liga","Rober Correa","ESP","DF","27",1992,12.6,16,9,8,6,2,8,12,66.7,4,9,1,8,20,36,31,0,"https://fbref.com/en/players/46bd3a5b/Rober-Correa"
"6132","Sergio Cubero Ezcurra_2021",2021,"Eibar","La Liga","Sergio Cubero Ezcurra","ESP","MF","20",1999,0,0,0,0,0,0,0,0,NA,0,0,0,0,0,0,0,0,"https://fbref.com/en/players/d858d079/Sergio-Cubero-Ezcurra"
"6133","Papakouli Diop_2021",2021,"Eibar","La Liga","Papakouli Diop","SEN","MF","34",1986,25.8,43,29,15,22,6,12,41,29.3,29,23,5,18,39,82,34,1,"https://fbref.com/en/players/7329018e/Papakouli-Diop"
"6134","Marko Dmitrović_2021",2021,"Eibar","La Liga","Marko Dmitrović","SRB","GK","28",1992,34.7,4,3,4,0,0,2,4,50,2,0,0,0,0,4,16,2,"https://fbref.com/en/players/ac295d9e/Marko-Dmitrovic"
"6135","Unai Dufur_2021",2021,"Eibar","La Liga","Unai Dufur","ESP","DF","21",1999,0.7,2,2,2,0,0,2,4,50,2,0,0,0,1,3,0,0,"https://fbref.com/en/players/c261b5dd/Unai-Dufur"
"6136","Sergi Enrich_2021",2021,"Eibar","La Liga","Sergi Enrich","ESP","FW","30",1990,15.6,21,15,6,7,8,9,22,40.9,13,11,0,11,6,27,5,0,"https://fbref.com/en/players/bb4b1242/Sergi-Enrich"
"6137","Edu Expósito_2021",2021,"Eibar","La Liga","Edu Expósito","ESP","MF","23",1996,27.3,51,30,16,31,4,20,66,30.3,46,25,4,21,22,73,17,0,"https://fbref.com/en/players/283c7121/Edu-Exposito"
"6138","Aleix García_2021",2021,"Eibar","La Liga","Aleix García","ESP","MF","23",1997,4.9,5,4,2,2,1,1,10,10,9,5,0,5,8,13,2,0,"https://fbref.com/en/players/a10361d2/Aleix-Garcia"
"6139","Bryan Gil_2021",2021,"Eibar","La Liga","Bryan Gil","ESP","MF,FW","19",2001,25.2,28,18,12,11,5,6,23,26.1,17,20,0,20,17,45,6,0,"https://fbref.com/en/players/7b5ab7f2/Bryan-Gil"
"6140","Takashi Inui_2021",2021,"Eibar","La Liga","Takashi Inui","JPN","MF,FW","32",1988,20.2,13,8,6,3,4,3,12,25,9,19,0,19,12,25,7,0,"https://fbref.com/en/players/61bd33d0/Takashi-Inui"
"6141","Damian Kądzior_2021",2021,"Eibar","La Liga","Damian Kądzior","POL","FW,MF","28",1992,2.2,1,0,0,1,0,1,5,20,4,1,0,1,0,1,0,0,"https://fbref.com/en/players/bb6c6331/Damian-Kadzior"
"6142","Kike_2021",2021,"Eibar","La Liga","Kike","ESP","FW","30",1989,34.3,24,18,5,7,12,6,22,27.3,16,24,1,23,7,31,29,0,"https://fbref.com/en/players/e897d8ba/Kike"
"6143","Pedro León_2021",2021,"Eibar","La Liga","Pedro León","ESP","MF,FW","33",1986,10.4,9,8,3,3,3,3,17,17.6,14,11,0,11,7,16,2,0,"https://fbref.com/en/players/d66b9872/Pedro-Leon"
"6144","Eñaut Mendía_2021",2021,"Eibar","La Liga","Eñaut Mendía","ESP","FW","21",1999,0.7,2,1,2,0,0,1,2,50,1,1,1,0,0,2,0,0,"https://fbref.com/en/players/aa7da569/Enaut-Mendia"
"6145","Yoshinori Mutō_2021",2021,"Eibar","La Liga","Yoshinori Mutō","JPN","FW,MF","28",1992,12.5,12,7,1,4,7,3,8,37.5,5,5,0,5,3,15,2,0,"https://fbref.com/en/players/5343eb4e/Yoshinori-Muto"
"6146","Paulo Oliveira_2021",2021,"Eibar","La Liga","Paulo Oliveira","POR","DF","28",1992,29.3,42,21,32,8,2,19,36,52.8,17,39,14,25,59,101,112,0,"https://fbref.com/en/players/a8fbae1d/Paulo-Oliveira"
"6147","Alejandro Pozo Pozo_2021",2021,"Eibar","La Liga","Alejandro Pozo Pozo","ESP","DF,MF","21",1999,24.3,38,22,17,15,6,17,38,44.7,21,35,2,33,27,65,40,1,"https://fbref.com/en/players/3c16d927/Alejandro-Pozo-Pozo"
"6148","Quique_2021",2021,"Eibar","La Liga","Quique","ESP","FW,MF","30",1990,1.9,0,0,0,0,0,0,1,0,1,2,0,2,0,0,0,0,"https://fbref.com/en/players/c966fce1/Quique"
"6149","Recio_2021",2021,"Eibar","La Liga","Recio","ESP","MF","29",1991,8.2,17,5,4,8,5,8,18,44.4,10,6,0,6,4,21,1,0,"https://fbref.com/en/players/54073b28/Recio"
"6150","Kévin Rodrigues_2021",2021,"Eibar","La Liga","Kévin Rodrigues","POR","DF,MF","26",1994,12.2,16,8,8,5,3,7,23,30.4,16,10,1,9,20,36,15,1,"https://fbref.com/en/players/f1bed920/Kevin-Rodrigues"
"6151","Rafa Soares_2021",2021,"Eibar","La Liga","Rafa Soares","POR","DF","25",1995,12.6,28,17,16,8,4,15,21,71.4,6,14,4,10,20,48,32,0,"https://fbref.com/en/players/062fc2e6/Rafa-Soares"
"6152","Álvaro Tejero_2021",2021,"Eibar","La Liga","Álvaro Tejero","ESP","DF","24",1996,1.2,1,1,0,0,1,1,3,33.3,2,1,0,1,3,4,6,0,"https://fbref.com/en/players/868ce848/Alvaro-Tejero"
"6153","Yoel_2021",2021,"Eibar","La Liga","Yoel","ESP","GK","31",1988,3.3,0,0,0,0,0,0,0,NA,0,0,0,0,0,0,2,0,"https://fbref.com/en/players/61bb7498/Yoel"
"6154","David Abraham_2021",2021,"Eint Frankfurt","Bundesliga","David Abraham","ARG","DF","34",1986,13.6,18,12,13,3,2,11,17,64.7,6,13,4,9,17,35,34,0,"https://fbref.com/en/players/565bf0da/David-Abraham"
"6155","Ragnar Ache_2021",2021,"Eint Frankfurt","Bundesliga","Ragnar Ache","GER","FW,DF","22",1998,1.1,2,0,0,1,1,0,0,NA,0,1,0,1,1,3,1,0,"https://fbref.com/en/players/dc38e3bc/Ragnar-Ache"
"6156","Aymen Barkok_2021",2021,"Eint Frankfurt","Bundesliga","Aymen Barkok","MAR","MF,DF","22",1998,10.9,29,15,11,9,9,10,31,32.3,21,15,1,14,10,39,9,1,"https://fbref.com/en/players/a2a85828/Aymen-Barkok"
"6157","Elias Bördner_2021",2021,"Eint Frankfurt","Bundesliga","Elias Bördner","GER","GK","18",2002,1,1,0,1,0,0,1,1,100,0,0,0,0,2,3,1,0,"https://fbref.com/en/players/8758ddf4/Elias-Bordner"
"6158","Timothy Chandler_2021",2021,"Eint Frankfurt","Bundesliga","Timothy Chandler","USA","DF","30",1990,4.8,4,0,2,1,1,1,4,25,3,5,2,3,3,7,5,0,"https://fbref.com/en/players/b3b7f5a6/Timothy-Chandler"
"6159","Danny da Costa_2021",2021,"Eint Frankfurt","Bundesliga","Danny da Costa","GER","DF","27",1993,1.2,0,0,0,0,0,0,1,0,1,3,1,2,0,0,4,0,"https://fbref.com/en/players/5ddb8f9f/Danny-da-Costa"
"6160","Bas Dost_2021",2021,"Eint Frankfurt","Bundesliga","Bas Dost","NED","FW","31",1989,9.1,3,2,1,1,1,2,5,40,3,5,1,4,2,5,8,0,"https://fbref.com/en/players/dc90cfbe/Bas-Dost"
"6161","Erik Durm_2021",2021,"Eint Frankfurt","Bundesliga","Erik Durm","GER","DF","28",1992,16.4,17,13,7,9,1,8,21,38.1,13,19,5,14,29,46,26,0,"https://fbref.com/en/players/cf623c78/Erik-Durm"
"6162","Makoto Hasebe_2021",2021,"Eint Frankfurt","Bundesliga","Makoto Hasebe","JPN","DF,MF","36",1984,25.4,43,29,21,20,2,25,51,49,26,31,12,19,31,74,68,2,"https://fbref.com/en/players/9ab16552/Makoto-Hasebe"
"6163","Martin Hinteregger_2021",2021,"Eint Frankfurt","Bundesliga","Martin Hinteregger","AUT","DF","27",1992,28.1,77,49,53,22,2,37,63,58.7,26,31,12,19,44,121,92,0,"https://fbref.com/en/players/080440a4/Martin-Hinteregger"
"6164","Ajdin Hrustic_2021",2021,"Eint Frankfurt","Bundesliga","Ajdin Hrustic","AUS","MF,DF","24",1996,3,6,5,2,3,1,3,10,30,7,2,0,2,4,10,3,0,"https://fbref.com/en/players/1f2d714c/Ajdin-Hrustic"
"6165","Stefan Ilsanker_2021",2021,"Eint Frankfurt","Bundesliga","Stefan Ilsanker","AUT","MF,DF","31",1989,17.5,33,20,17,15,1,21,42,50,21,30,8,22,30,63,51,2,"https://fbref.com/en/players/8494acc4/Stefan-Ilsanker"
"6166","Luka Jović_2021",2021,"Eint Frankfurt","Bundesliga","Luka Jović","SRB","FW","22",1997,9.9,2,0,0,2,0,0,4,0,4,3,0,3,1,3,7,0,"https://fbref.com/en/players/4d8cd038/Luka-Jovic"
"6167","Daichi Kamada_2021",2021,"Eint Frankfurt","Bundesliga","Daichi Kamada","JPN","MF","23",1996,26.2,48,28,21,16,11,16,49,32.7,33,18,1,17,14,62,22,0,"https://fbref.com/en/players/15b287da/Daichi-Kamada"
"6168","Dominik Kohr_2021",2021,"Eint Frankfurt","Bundesliga","Dominik Kohr","GER","MF,DF","26",1994,2.9,11,7,0,7,4,4,9,44.4,5,5,1,4,9,20,9,0,"https://fbref.com/en/players/0fbecd11/Dominik-Kohr"
"6169","Filip Kostić_2021",2021,"Eint Frankfurt","Bundesliga","Filip Kostić","SRB","DF","27",1992,28.2,54,31,22,23,9,22,54,40.7,32,43,6,37,26,80,28,2,"https://fbref.com/en/players/b1cd37e6/Filip-Kostic"
"6170","Obite N'Dicka_2021",2021,"Eint Frankfurt","Bundesliga","Obite N'Dicka","FRA","DF","20",1999,22.7,31,23,16,15,0,16,28,57.1,12,27,6,21,47,78,85,0,"https://fbref.com/en/players/441197b8/Obite-NDicka"
"6171","Sebastian Rode_2021",2021,"Eint Frankfurt","Bundesliga","Sebastian Rode","GER","MF","29",1990,18.1,44,25,21,16,7,14,46,30.4,32,30,3,27,47,91,18,0,"https://fbref.com/en/players/e12b0b5b/Sebastian-Rode"
"6172","André Silva_2021",2021,"Eint Frankfurt","Bundesliga","André Silva","POR","FW","24",1995,30.7,11,2,0,7,4,6,13,46.2,7,11,1,10,3,14,15,0,"https://fbref.com/en/players/3effaa34/Andre-Silva"
"6173","Djibril Sow_2021",2021,"Eint Frankfurt","Bundesliga","Djibril Sow","SUI","MF","23",1997,24.2,58,33,19,32,7,18,41,43.9,23,31,8,23,51,109,17,0,"https://fbref.com/en/players/4c6facae/Djibril-Sow"
"6174","Almamy Touré_2021",2021,"Eint Frankfurt","Bundesliga","Almamy Touré","MLI","DF","24",1996,7.8,18,12,8,7,3,10,14,71.4,4,5,1,4,8,26,22,0,"https://fbref.com/en/players/c8c60119/Almamy-Toure"
"6175","Kevin Trapp_2021",2021,"Eint Frankfurt","Bundesliga","Kevin Trapp","GER","GK","30",1990,33,0,0,0,0,0,0,1,0,1,1,0,1,3,3,11,3,"https://fbref.com/en/players/ce17b5eb/Kevin-Trapp"
"6176","Tuta_2021",2021,"Eint Frankfurt","Bundesliga","Tuta","BRA","DF","21",1999,16.2,35,20,22,13,0,24,43,55.8,19,19,2,17,29,64,53,0,"https://fbref.com/en/players/35d64857/Tuta"
"6177","Amin Younes_2021",2021,"Eint Frankfurt","Bundesliga","Amin Younes","GER","MF","26",1993,15.5,25,14,8,10,7,6,32,18.8,26,19,1,18,13,38,4,0,"https://fbref.com/en/players/228f73ae/Amin-Younes"
"6178","Steven Zuber_2021",2021,"Eint Frankfurt","Bundesliga","Steven Zuber","SUI","DF,MF","28",1991,6.5,24,12,8,13,3,8,16,50,8,4,1,3,4,28,1,0,"https://fbref.com/en/players/b6a6e0a7/Steven-Zuber"
"6179","Jony Álamo_2021",2021,"Elche","La Liga","Jony Álamo","ESP","MF","18",2001,0.8,2,1,1,0,1,0,1,0,1,0,0,0,1,3,0,0,"https://fbref.com/en/players/788be7f9/Jony-Alamo"
"6180","Édgar Badía_2021",2021,"Elche","La Liga","Édgar Badía","ESP","GK","28",1992,30,1,0,1,0,0,1,3,33.3,2,0,0,0,0,1,17,3,"https://fbref.com/en/players/e4346678/Edgar-Badia"
"6181","Antonio Barragán_2021",2021,"Elche","La Liga","Antonio Barragán","ESP","DF","33",1987,24.8,28,14,21,5,2,12,21,57.1,9,22,8,14,33,61,67,1,"https://fbref.com/en/players/487d9b09/Antonio-Barragan"
"6182","Lucas Boyé_2021",2021,"Elche","La Liga","Lucas Boyé","ARG","FW","24",1996,29.9,47,31,13,27,7,10,49,20.4,39,37,2,35,19,66,21,0,"https://fbref.com/en/players/d49f3e6b/Lucas-Boye"
"6183","Dani Calvo_2021",2021,"Elche","La Liga","Dani Calvo","ESP","DF","26",1994,19.8,20,13,13,7,0,7,10,70,3,18,12,6,11,31,71,0,"https://fbref.com/en/players/dd672e1f/Dani-Calvo"
"6184","Guido Carrillo_2021",2021,"Elche","La Liga","Guido Carrillo","ARG","FW","29",1991,11.1,9,8,1,7,1,2,8,25,6,2,1,1,4,13,14,0,"https://fbref.com/en/players/8f898ba8/Guido-Carrillo"
"6185","Cifu_2021",2021,"Elche","La Liga","Cifu","ESP","DF","29",1990,5,10,7,7,3,0,7,13,53.8,6,5,1,4,8,18,10,0,"https://fbref.com/en/players/90f83973/Cifu"
"6186","John Donald_2021",2021,"Elche","La Liga","John Donald","ESP","DF,MF","19",2000,0.6,0,0,0,0,0,0,0,NA,0,0,0,0,0,0,1,0,"https://fbref.com/en/players/5e95c000/John-Donald"
"6187","Fidel_2021",2021,"Elche","La Liga","Fidel","ESP","MF,DF","30",1989,26.6,46,30,28,15,3,25,64,39.1,39,22,2,20,16,62,14,0,"https://fbref.com/en/players/eb82b6f1/Fidel"
"6188","Ramón Folch_2021",2021,"Elche","La Liga","Ramón Folch","ESP","MF","30",1989,0,0,0,0,0,0,0,0,NA,0,0,0,0,0,0,0,0,"https://fbref.com/en/players/dc56efc9/Ramon-Folch"
"6189","Paulo Gazzaniga_2021",2021,"Elche","La Liga","Paulo Gazzaniga","ARG","GK","28",1992,8,1,1,1,0,0,0,0,NA,0,0,0,0,1,2,4,0,"https://fbref.com/en/players/63d17038/Paulo-Gazzaniga"
"6190","Diego González_2021",2021,"Elche","La Liga","Diego González","ESP","DF","25",1995,14.2,11,7,7,3,1,5,11,45.5,6,16,9,7,20,31,49,1,"https://fbref.com/en/players/4ac7608e/Diego-Gonzalez"
"6191","Raúl Guti_2021",2021,"Elche","La Liga","Raúl Guti","ESP","MF","23",1996,31.8,48,28,21,22,5,16,52,30.8,36,25,3,22,49,97,25,0,"https://fbref.com/en/players/0b2c8585/Raul-Guti"
"6192","Josan_2021",2021,"Elche","La Liga","Josan","ESP","MF,DF","30",1989,21.4,34,18,23,11,0,13,39,33.3,26,24,1,23,21,55,26,1,"https://fbref.com/en/players/5b28b2f6/Josan"
"6193","Josema_2021",2021,"Elche","La Liga","Josema","ESP","DF","24",1996,21.8,43,28,33,10,0,10,18,55.6,8,17,7,10,37,80,92,0,"https://fbref.com/en/players/ed3f5f4c/Josema"
"6194","Youssouf Koné_2021",2021,"Elche","La Liga","Youssouf Koné","MLI","DF,MF","25",1995,0.8,2,0,1,0,1,0,1,0,1,0,0,0,0,2,0,0,"https://fbref.com/en/players/e6eadfb8/Youssouf-Kone"
"6195","Jeison Lucumí_2021",2021,"Elche","La Liga","Jeison Lucumí","COL","MF","25",1995,0.5,1,1,0,1,0,0,0,NA,0,1,0,1,0,1,0,0,"https://fbref.com/en/players/8abefbcf/Jeison-Lucumi"
"6196","Luismi_2021",2021,"Elche","La Liga","Luismi","ESP","MF,DF","28",1992,1.9,4,2,1,3,0,1,2,50,1,2,0,2,4,8,0,0,"https://fbref.com/en/players/c2cfbfc9/Luismi"
"6197","Iván Marcone_2021",2021,"Elche","La Liga","Iván Marcone","ARG","MF","30",1990,29.4,64,41,42,17,5,35,84,41.7,49,27,8,19,36,100,33,3,"https://fbref.com/en/players/b14f755d/Ivan-Marcone"
"6198","Omenuke Mfulu_2021",2021,"Elche","La Liga","Omenuke Mfulu","COD","MF","26",1994,8.8,18,12,10,8,0,5,15,33.3,10,7,1,6,11,29,18,0,"https://fbref.com/en/players/bdc14559/Omenuke-Mfulu"
"6199","Pere Milla_2021",2021,"Elche","La Liga","Pere Milla","ESP","FW,MF","27",1992,22,24,17,12,10,2,8,37,21.6,29,17,5,12,13,37,17,1,"https://fbref.com/en/players/335039a2/Pere-Milla"
"6200","Johan Mojica_2021",2021,"Elche","La Liga","Johan Mojica","COL","DF","27",1992,13.4,21,10,15,5,1,8,18,44.4,10,15,4,11,15,36,27,0,"https://fbref.com/en/players/608f2092/Johan-Mojica"
"6201","Tete Morente_2021",2021,"Elche","La Liga","Tete Morente","ESP","MF,FW","23",1996,22.4,31,17,17,9,5,9,39,23.1,30,20,0,20,13,44,28,0,"https://fbref.com/en/players/004d185e/Tete-Morente"
"6202","Nino_2021",2021,"Elche","La Liga","Nino","ESP","FW,MF","40",1980,3.2,0,0,0,0,0,0,1,0,1,1,0,1,0,0,0,0,"https://fbref.com/en/players/03dc5b1f/Nino"
"6203","Helibelton Palacios_2021",2021,"Elche","La Liga","Helibelton Palacios","COL","DF","27",1993,8.3,20,10,16,3,1,8,13,61.5,5,9,1,8,5,25,21,0,"https://fbref.com/en/players/ac8b2421/Helibelton-Palacios"
"6204","Pablo Piatti_2021",2021,"Elche","La Liga","Pablo Piatti","ARG","MF,FW","31",1989,4,8,6,3,3,2,3,12,25,9,5,0,5,2,10,1,0,"https://fbref.com/en/players/48e89655/Pablo-Piatti"
"6205","Emiliano Rigoni_2021",2021,"Elche","La Liga","Emiliano Rigoni","ARG","MF","27",1993,12.7,12,7,3,8,1,3,15,20,12,16,1,15,6,18,9,0,"https://fbref.com/en/players/a1216563/Emiliano-Rigoni"
"6206","Víctor Rodríguez_2021",2021,"Elche","La Liga","Víctor Rodríguez","ESP","MF","31",1989,4.7,4,3,3,1,0,0,9,0,9,5,1,4,5,9,4,0,"https://fbref.com/en/players/15781606/Victor-Rodriguez"
"6207","Juan Sánchez Miño_2021",2021,"Elche","La Liga","Juan Sánchez Miño","ARG","DF,MF","30",1990,5.5,8,5,5,3,0,6,14,42.9,8,4,0,4,4,12,7,0,"https://fbref.com/en/players/3ae7e4ea/Juan-Sanchez-Mino"
"6208","Gonzalo Verdú_2021",2021,"Elche","La Liga","Gonzalo Verdú","ESP","DF","31",1988,32.7,34,19,26,8,0,16,28,57.1,12,40,30,10,52,86,113,0,"https://fbref.com/en/players/1c2c55fc/Gonzalo-Verdu"
"6209","Allan_2021",2021,"Everton","Premier League","Allan","BRA","MF","29",1991,22.8,80,45,39,37,4,28,95,29.5,67,31,12,19,19,99,25,1,"https://fbref.com/en/players/cc700722/Allan"
"6210","Bernard_2021",2021,"Everton","Premier League","Bernard","BRA","MF,FW","27",1992,5.1,8,3,3,3,2,7,15,46.7,8,5,0,5,8,16,6,0,"https://fbref.com/en/players/ab4b3e35/Bernard"
"6211","Nathan Broadhead_2021",2021,"Everton","Premier League","Nathan Broadhead","WAL","FW","22",1998,0,1,1,0,1,0,0,0,NA,0,0,0,0,0,1,0,0,"https://fbref.com/en/players/43309491/Nathan-Broadhead"
"6212","Dominic Calvert-Lewin_2021",2021,"Everton","Premier League","Dominic Calvert-Lewin","ENG","FW","23",1997,31.9,17,8,1,8,8,6,12,50,6,22,6,16,6,23,33,0,"https://fbref.com/en/players/59e6e5bf/Dominic-Calvert-Lewin"
"6213","Séamus Coleman_2021",2021,"Everton","Premier League","Séamus Coleman","IRL","DF,MF","31",1988,17.9,39,26,21,14,4,21,30,70,9,22,6,16,13,52,37,2,"https://fbref.com/en/players/0420d84f/Seamus-Coleman"
"6214","Tom Davies_2021",2021,"Everton","Premier League","Tom Davies","ENG","MF","22",1998,15.8,31,18,17,12,2,16,39,41,23,15,9,6,34,65,21,2,"https://fbref.com/en/players/9228b07c/Tom-Davies"
"6215","Fabian Delph_2021",2021,"Everton","Premier League","Fabian Delph","ENG","MF,DF","30",1989,3,5,2,3,2,0,1,3,33.3,2,2,0,2,4,9,8,1,"https://fbref.com/en/players/111c3236/Fabian-Delph"
"6216","Lucas Digne_2021",2021,"Everton","Premier League","Lucas Digne","FRA","DF,MF","27",1993,29.8,63,38,40,16,7,29,54,53.7,25,42,4,38,31,94,87,0,"https://fbref.com/en/players/1b84dbe1/Lucas-Digne"
"6217","Abdoulaye Doucouré_2021",2021,"Everton","Premier League","Abdoulaye Doucouré","MLI","MF","27",1993,27.1,52,32,25,19,8,14,43,32.6,29,24,7,17,39,91,31,1,"https://fbref.com/en/players/02b29014/Abdoulaye-Doucoure"
"6218","Jean-Philippe Gbamin_2021",2021,"Everton","Premier League","Jean-Philippe Gbamin","CIV","MF","24",1995,0.1,1,0,0,1,0,0,0,NA,0,1,0,1,0,1,1,0,"https://fbref.com/en/players/6bd603db/Jean-Philippe-Gbamin"
"6219","Ben Godfrey_2021",2021,"Everton","Premier League","Ben Godfrey","ENG","DF","22",1998,29.8,55,33,37,15,3,27,41,65.9,14,56,37,19,33,88,120,0,"https://fbref.com/en/players/9f7c837d/Ben-Godfrey"
"6220","André Gomes_2021",2021,"Everton","Premier League","André Gomes","POR","MF","27",1993,17.4,35,23,16,16,3,17,58,29.3,41,19,1,18,10,45,12,1,"https://fbref.com/en/players/1961b2aa/Andre-Gomes"
"6221","Anthony Gordon_2021",2021,"Everton","Premier League","Anthony Gordon","ENG","FW,MF","19",2001,1,3,3,3,0,0,0,2,0,2,1,0,1,1,4,3,0,"https://fbref.com/en/players/2bd83368/Anthony-Gordon"
"6222","Mason Holgate_2021",2021,"Everton","Premier League","Mason Holgate","ENG","DF","23",1996,25.4,56,36,31,18,7,20,50,40,30,37,13,24,35,91,90,3,"https://fbref.com/en/players/d0042ab9/Mason-Holgate"
"6223","Alex Iwobi_2021",2021,"Everton","Premier League","Alex Iwobi","NGA","FW,MF","24",1996,17.1,27,10,10,14,3,13,25,52,12,20,1,19,16,43,14,0,"https://fbref.com/en/players/6ca5ec4b/Alex-Iwobi"
"6224","Moise Kean_2021",2021,"Everton","Premier League","Moise Kean","ITA","FW,MF","20",2000,0.2,0,0,0,0,0,0,0,NA,0,0,0,0,0,0,0,0,"https://fbref.com/en/players/3d50bcdb/Moise-Kean"
"6225","Michael Keane_2021",2021,"Everton","Premier League","Michael Keane","ENG","DF","27",1993,33.2,28,15,20,8,0,14,31,45.2,17,46,33,13,51,79,161,0,"https://fbref.com/en/players/c5b7c315/Michael-Keane"
"6226","Jonjoe Kenny_2021",2021,"Everton","Premier League","Jonjoe Kenny","ENG","DF","23",1997,0.9,2,1,1,0,1,2,2,100,0,0,0,0,1,3,3,0,"https://fbref.com/en/players/099e666f/Jonjoe-Kenny"
"6227","Joshua King_2021",2021,"Everton","Premier League","Joshua King","NOR","MF,FW","28",1992,1.6,4,1,2,1,1,0,0,NA,0,3,0,3,1,5,1,0,"https://fbref.com/en/players/43458538/Joshua-King"
"6228","Yerry Mina_2021",2021,"Everton","Premier League","Yerry Mina","COL","DF","25",1994,21.5,21,14,17,4,0,8,12,66.7,4,30,23,7,24,45,110,1,"https://fbref.com/en/players/6d5701f2/Yerry-Mina"
"6229","Niels Nkounkou_2021",2021,"Everton","Premier League","Niels Nkounkou","FRA","DF,FW","19",2000,0.9,4,3,1,2,1,3,8,37.5,5,4,0,4,0,4,4,0,"https://fbref.com/en/players/f5b281e7/Niels-Nkounkou"
"6230","Robin Olsen_2021",2021,"Everton","Premier League","Robin Olsen","SWE","GK","30",1990,7,0,0,0,0,0,0,0,NA,0,0,0,0,0,0,4,1,"https://fbref.com/en/players/e7ee38c3/Robin-Olsen"
"6231","Jordan Pickford_2021",2021,"Everton","Premier League","Jordan Pickford","ENG","GK","26",1994,30.5,0,0,0,0,0,0,2,0,2,2,0,2,3,3,16,4,"https://fbref.com/en/players/4806ec67/Jordan-Pickford"
"6232","Richarlison_2021",2021,"Everton","Premier League","Richarlison","BRA","FW","23",1997,31.8,50,32,21,22,7,16,51,31.4,35,28,3,25,14,64,36,1,"https://fbref.com/en/players/fa031b34/Richarlison"
"6233","James Rodríguez_2021",2021,"Everton","Premier League","James Rodríguez","COL","FW,MF","29",1991,19.6,28,17,8,15,5,11,46,23.9,35,17,0,17,15,43,3,0,"https://fbref.com/en/players/715bf047/James-Rodriguez"
"6234","Gylfi Sigurðsson_2021",2021,"Everton","Premier League","Gylfi Sigurðsson","ISL","MF,FW","30",1989,25,30,20,9,14,7,13,44,29.5,31,31,2,29,34,64,21,1,"https://fbref.com/en/players/76dd1480/Gylfi-Sigurdsson"
"6235","Cenk Tosun_2021",2021,"Everton","Premier League","Cenk Tosun","TUR","FW","29",1991,0.5,0,0,0,0,0,0,1,0,1,0,0,0,0,0,0,0,"https://fbref.com/en/players/9a104dee/Cenk-Tosun"
"6236","João Virgínia_2021",2021,"Everton","Premier League","João Virgínia","POR","GK","20",1999,0.5,0,0,0,0,0,0,0,NA,0,0,0,0,0,0,0,0,"https://fbref.com/en/players/728e9b2e/Joao-Virginia"
"6237","Theo Walcott_2021",2021,"Everton","Premier League","Theo Walcott","ENG","FW","31",1989,0.1,0,0,0,0,0,0,0,NA,0,0,0,0,0,0,0,0,"https://fbref.com/en/players/1ecb65be/Theo-Walcott"
"6238","Sofyan Amrabat_2021",2021,"Fiorentina","Serie A","Sofyan Amrabat","MAR","MF","23",1996,27.1,39,22,11,24,4,18,48,37.5,30,30,5,25,23,62,12,0,"https://fbref.com/en/players/5a2cb25d/Sofyan-Amrabat"
"6239","Antonio Barreca_2021",2021,"Fiorentina","Serie A","Antonio Barreca","ITA","DF","25",1995,0.9,1,0,0,1,0,1,1,100,0,0,0,0,0,1,1,0,"https://fbref.com/en/players/6a189491/Antonio-Barreca"
"6240","Cristiano Biraghi_2021",2021,"Fiorentina","Serie A","Cristiano Biraghi","ITA","DF","27",1992,31.1,42,23,19,15,8,27,45,60,18,23,9,14,27,69,56,3,"https://fbref.com/en/players/9e1577aa/Cristiano-Biraghi"
"6241","Giacomo Bonaventura_2021",2021,"Fiorentina","Serie A","Giacomo Bonaventura","ITA","MF","30",1989,25.1,34,19,16,13,5,16,53,30.2,37,26,2,24,39,73,12,0,"https://fbref.com/en/players/d995ed27/Giacomo-Bonaventura"
"6242","Martín Cáceres_2021",2021,"Fiorentina","Serie A","Martín Cáceres","URU","DF","33",1987,24.9,28,12,16,11,1,15,35,42.9,20,20,14,6,14,42,52,1,"https://fbref.com/en/players/e94d79e3/Martin-Caceres"
"6243","José Callejón_2021",2021,"Fiorentina","Serie A","José Callejón","ESP","FW,MF","33",1987,7.4,10,7,0,6,4,5,9,55.6,4,4,1,3,4,14,5,0,"https://fbref.com/en/players/78841da9/Jose-Callejon"
"6244","Gaetano Castrovilli_2021",2021,"Fiorentina","Serie A","Gaetano Castrovilli","ITA","MF","23",1997,25.9,33,19,15,11,7,11,42,26.2,31,25,2,23,34,67,14,0,"https://fbref.com/en/players/0728bebe/Gaetano-Castrovilli"
"6245","Federico Ceccherini_2021",2021,"Fiorentina","Serie A","Federico Ceccherini","ITA","DF","28",1992,3,4,1,1,3,0,1,1,100,0,6,5,1,7,11,15,0,"https://fbref.com/en/players/d9624b51/Federico-Ceccherini"
"6246","Federico Chiesa_2021",2021,"Fiorentina","Serie A","Federico Chiesa","ITA","DF","22",1997,2.7,6,2,2,2,2,3,8,37.5,5,3,1,2,1,7,3,0,"https://fbref.com/en/players/b0f7e36c/Federico-Chiesa"
"6247","Patrick Cutrone_2021",2021,"Fiorentina","Serie A","Patrick Cutrone","ITA","FW","22",1998,2.2,4,3,1,2,1,1,2,50,1,1,0,1,1,5,0,0,"https://fbref.com/en/players/a4fe8cda/Patrick-Cutrone"
"6248","Bartłomiej Drągowski_2021",2021,"Fiorentina","Serie A","Bartłomiej Drągowski","POL","GK","22",1997,35,1,0,1,0,0,1,1,100,0,0,0,0,1,2,13,1,"https://fbref.com/en/players/085e71a7/Bartlomiej-Dragowski"
"6249","Alfred Duncan_2021",2021,"Fiorentina","Serie A","Alfred Duncan","GHA","MF","27",1993,1.8,3,0,1,1,1,0,2,0,2,2,0,2,2,5,0,0,"https://fbref.com/en/players/528492ea/Alfred-Duncan"
"6250","Valentin Eysseric_2021",2021,"Fiorentina","Serie A","Valentin Eysseric","FRA","MF,FW","28",1992,8.1,14,8,6,7,1,5,11,45.5,6,11,0,11,7,21,8,0,"https://fbref.com/en/players/ae82fa48/Valentin-Eysseric"
"6251","Igor_2021",2021,"Fiorentina","Serie A","Igor","BRA","DF","22",1998,13,15,9,9,6,0,7,12,58.3,5,17,9,8,23,38,34,0,"https://fbref.com/en/players/a4e85758/Igor"
"6252","Aleksandr Kokorin_2021",2021,"Fiorentina","Serie A","Aleksandr Kokorin","RUS","FW,MF","29",1991,1,1,0,0,1,0,0,1,0,1,1,0,1,0,1,0,0,"https://fbref.com/en/players/fec5accc/Aleksandr-Kokorin"
"6253","Christian Kouamé_2021",2021,"Fiorentina","Serie A","Christian Kouamé","CIV","FW","22",1997,11.1,9,4,2,4,3,4,12,33.3,8,9,1,8,5,14,4,0,"https://fbref.com/en/players/58e933d2/Christian-Kouame"
"6254","Pol Lirola_2021",2021,"Fiorentina","Serie A","Pol Lirola","ESP","DF,FW","22",1997,5.5,13,8,8,2,3,6,12,50,6,6,3,3,6,19,9,0,"https://fbref.com/en/players/ff800ed8/Pol-Lirola"
"6255","Kévin Malcuit_2021",2021,"Fiorentina","Serie A","Kévin Malcuit","MAR","DF","29",1991,2.3,5,3,2,2,1,0,1,0,1,5,0,5,3,8,6,0,"https://fbref.com/en/players/d6a889ea/Kevin-Malcuit"
"6256","Lucas Martínez Quarta_2021",2021,"Fiorentina","Serie A","Lucas Martínez Quarta","ARG","DF","24",1996,16.5,32,20,17,11,4,18,41,43.9,23,27,9,18,39,71,48,0,"https://fbref.com/en/players/3ec3c1c9/Lucas-Martinez-Quarta"
"6257","Nikola Milenković_2021",2021,"Fiorentina","Serie A","Nikola Milenković","SRB","DF","22",1997,33.7,49,29,33,14,2,21,33,63.6,12,42,33,9,44,93,122,1,"https://fbref.com/en/players/bee704fc/Nikola-Milenkovic"
"6258","Cristóbal Montiel_2021",2021,"Fiorentina","Serie A","Cristóbal Montiel","ESP","MF,FW","20",2000,0,0,0,0,0,0,0,1,0,1,0,0,0,0,0,0,0,"https://fbref.com/en/players/dd52d069/Cristobal-Montiel"
"6259","Maximiliano Olivera_2021",2021,"Fiorentina","Serie A","Maximiliano Olivera","URU","DF","28",1992,1,2,0,1,1,0,1,1,100,0,3,1,2,0,2,8,0,"https://fbref.com/en/players/32a33c68/Maximiliano-Olivera"
"6260","Germán Pezzella_2021",2021,"Fiorentina","Serie A","Germán Pezzella","ARG","DF","29",1991,30.5,34,20,22,12,0,18,32,56.3,14,26,14,12,36,70,109,1,"https://fbref.com/en/players/8c725b43/German-Pezzella"
"6261","Erick Pulgar_2021",2021,"Fiorentina","Serie A","Erick Pulgar","CHI","MF","26",1994,22.2,41,18,17,23,1,22,49,44.9,27,24,10,14,41,82,45,1,"https://fbref.com/en/players/4611e028/Erick-Pulgar"
"6262","Franck Ribéry_2021",2021,"Fiorentina","Serie A","Franck Ribéry","FRA","FW","37",1983,23.9,24,11,4,9,11,5,29,17.2,24,11,2,9,3,27,1,0,"https://fbref.com/en/players/f61c7c4e/Franck-Ribery"
"6263","Riccardo Saponara_2021",2021,"Fiorentina","Serie A","Riccardo Saponara","ITA","MF","28",1991,0.6,2,1,0,2,0,1,3,33.3,2,0,0,0,1,3,0,0,"https://fbref.com/en/players/3bb7af3b/Riccardo-Saponara"
"6264","Pietro Terracciano_2021",2021,"Fiorentina","Serie A","Pietro Terracciano","ITA","GK","30",1990,3,0,0,0,0,0,0,0,NA,0,0,0,0,0,0,1,0,"https://fbref.com/en/players/e1b0a70d/Pietro-Terracciano"
"6265","Borja Valero_2021",2021,"Fiorentina","Serie A","Borja Valero","ESP","MF,FW","35",1985,5.5,13,9,7,4,2,3,15,20,12,6,1,5,6,19,2,0,"https://fbref.com/en/players/0e21fc3c/Borja-Valero"
"6266","Lorenzo Venuti_2021",2021,"Fiorentina","Serie A","Lorenzo Venuti","ITA","DF","25",1995,19.5,24,11,14,7,3,14,28,50,14,18,3,15,17,41,24,0,"https://fbref.com/en/players/983ff2c7/Lorenzo-Venuti"
"6267","Dušan Vlahović_2021",2021,"Fiorentina","Serie A","Dušan Vlahović","SRB","FW","20",2000,32.5,13,4,3,4,6,5,16,31.3,11,16,2,14,4,17,15,0,"https://fbref.com/en/players/79443529/Dusan-Vlahovic"
"6268","Amir Abrashi_2021",2021,"Freiburg","Bundesliga","Amir Abrashi","ALB","MF,DF","30",1990,0.7,1,1,1,0,0,0,0,NA,0,1,1,0,2,3,1,0,"https://fbref.com/en/players/1c08a3c8/Amir-Abrashi"
"6269","Nishan Burkart_2021",2021,"Freiburg","Bundesliga","Nishan Burkart","SUI","MF","20",2000,0.2,0,0,0,0,0,0,1,0,1,0,0,0,0,0,0,0,"https://fbref.com/en/players/c59b67ed/Nishan-Burkart"
"6270","Kwon Chang-hoon_2021",2021,"Freiburg","Bundesliga","Kwon Chang-hoon","KOR","MF,FW","26",1994,2.4,3,1,1,0,2,1,3,33.3,2,3,1,2,7,10,2,1,"https://fbref.com/en/players/7961f7aa/Kwon-Chang-hoon"
"6271","Ermedin Demirović_2021",2021,"Freiburg","Bundesliga","Ermedin Demirović","BIH","FW","22",1998,16.6,15,9,4,6,5,2,16,12.5,14,29,5,24,0,15,27,0,"https://fbref.com/en/players/ed79b7d3/Ermedin-Demirovic"
"6272","Mark Flekken_2021",2021,"Freiburg","Bundesliga","Mark Flekken","NED","GK","27",1993,3,0,0,0,0,0,0,0,NA,0,0,0,0,0,0,1,0,"https://fbref.com/en/players/a92ab7be/Mark-Flekken"
"6273","Vincenzo Grifo_2021",2021,"Freiburg","Bundesliga","Vincenzo Grifo","ITA","MF,FW","27",1993,25.7,18,7,6,7,5,14,34,41.2,20,13,0,13,27,45,18,1,"https://fbref.com/en/players/54e4866f/Vincenzo-Grifo"
"6274","Manuel Gulde_2021",2021,"Freiburg","Bundesliga","Manuel Gulde","GER","DF","29",1991,21.7,27,15,12,12,3,5,21,23.8,16,25,15,10,37,64,64,0,"https://fbref.com/en/players/25ab9c9c/Manuel-Gulde"
"6275","Christian Günter_2021",2021,"Freiburg","Bundesliga","Christian Günter","GER","DF,MF","27",1993,34,34,19,18,13,3,15,43,34.9,28,38,9,29,29,63,40,0,"https://fbref.com/en/players/8593f88c/Christian-Gunter"
"6276","Janik Haberer_2021",2021,"Freiburg","Bundesliga","Janik Haberer","GER","MF,FW","26",1994,5.4,7,4,4,3,0,3,15,20,12,4,1,3,7,14,9,0,"https://fbref.com/en/players/70dcf94d/Janik-Haberer"
"6277","Dominique Heintz_2021",2021,"Freiburg","Bundesliga","Dominique Heintz","GER","DF","26",1993,15.2,22,11,19,3,0,10,19,52.6,9,10,8,2,35,57,49,0,"https://fbref.com/en/players/699fb8db/Dominique-Heintz"
"6278","Nicolas Höfler_2021",2021,"Freiburg","Bundesliga","Nicolas Höfler","GER","MF","30",1990,30.3,54,28,16,31,7,23,59,39,36,34,10,24,66,120,41,2,"https://fbref.com/en/players/5d8e331f/Nicolas-Hofler"
"6279","Lucas Höler_2021",2021,"Freiburg","Bundesliga","Lucas Höler","GER","FW,MF","26",1994,23.2,36,24,13,19,4,12,32,37.5,20,19,2,17,16,52,14,0,"https://fbref.com/en/players/ca618d23/Lucas-Holer"
"6280","Yannik Keitel_2021",2021,"Freiburg","Bundesliga","Yannik Keitel","GER","MF","20",2000,5.5,12,8,7,4,1,7,9,77.8,2,9,3,6,10,22,8,0,"https://fbref.com/en/players/d2c580ce/Yannik-Keitel"
"6281","Lukas Kübler_2021",2021,"Freiburg","Bundesliga","Lukas Kübler","GER","DF,MF","27",1992,9.8,15,8,9,5,1,9,14,64.3,5,9,3,6,21,36,31,0,"https://fbref.com/en/players/2a29eb9b/Lukas-Kubler"
"6282","Philipp Lienhart_2021",2021,"Freiburg","Bundesliga","Philipp Lienhart","AUT","DF","24",1996,33.3,21,13,12,7,2,9,20,45,11,30,21,9,42,63,100,0,"https://fbref.com/en/players/302527b2/Philipp-Lienhart"
"6283","Florian Müller_2021",2021,"Freiburg","Bundesliga","Florian Müller","GER","GK","22",1997,31,0,0,0,0,0,0,3,0,3,1,0,1,2,2,10,1,"https://fbref.com/en/players/cbac6ec9/Florian-Muller"
"6284","Nils Petersen_2021",2021,"Freiburg","Bundesliga","Nils Petersen","GER","FW","31",1988,14.5,11,7,2,6,3,3,21,14.3,18,25,1,24,9,20,28,0,"https://fbref.com/en/players/f93e6e94/Nils-Petersen"
"6285","Roland Sallai_2021",2021,"Freiburg","Bundesliga","Roland Sallai","HUN","MF,FW","23",1997,18.5,18,14,7,9,2,5,13,38.5,8,11,1,10,11,29,8,0,"https://fbref.com/en/players/bf075f6b/Roland-Sallai"
"6286","Baptiste Santamaria_2021",2021,"Freiburg","Bundesliga","Baptiste Santamaria","FRA","MF","25",1995,24.5,51,38,19,24,8,20,54,37,34,36,7,29,52,103,34,1,"https://fbref.com/en/players/5e22e2a4/Baptiste-Santamaria"
"6287","Keven Schlotterbeck_2021",2021,"Freiburg","Bundesliga","Keven Schlotterbeck","GER","DF","23",1997,18.4,31,10,16,15,0,10,23,43.5,13,26,18,8,36,67,89,2,"https://fbref.com/en/players/f6bdc830/Keven-Schlotterbeck"
"6288","Jonathan Schmid_2021",2021,"Freiburg","Bundesliga","Jonathan Schmid","FRA","MF,DF","30",1990,26.6,37,19,17,13,7,16,30,53.3,14,26,10,16,28,65,38,0,"https://fbref.com/en/players/088ca1bd/Jonathan-Schmid"
"6289","Lino Tempelmann_2021",2021,"Freiburg","Bundesliga","Lino Tempelmann","GER","MF","21",1999,3,5,3,2,2,1,0,4,0,4,6,1,5,2,7,6,0,"https://fbref.com/en/players/4e3a947f/Lino-Tempelmann"
"6290","Guus Til_2021",2021,"Freiburg","Bundesliga","Guus Til","NED","FW","22",1997,1.4,4,3,2,1,1,2,3,66.7,1,2,0,2,2,6,2,0,"https://fbref.com/en/players/6e44569a/Guus-Til"
"6291","Jeong Woo-yeong_2021",2021,"Freiburg","Bundesliga","Jeong Woo-yeong","KOR","FW,MF","20",1999,9.1,9,5,1,6,2,2,11,18.2,9,8,1,7,11,20,11,0,"https://fbref.com/en/players/6190474d/Jeong-Woo-yeong"
"6292","Tosin Adarabioyo_2021",2021,"Fulham","Premier League","Tosin Adarabioyo","ENG","DF","22",1997,32.8,37,19,30,6,1,19,40,47.5,21,26,20,6,42,79,197,2,"https://fbref.com/en/players/c81d773d/Tosin-Adarabioyo"
"6293","Ola Aina_2021",2021,"Fulham","Premier League","Ola Aina","NGA","DF","23",1996,29.6,37,20,22,7,8,21,43,48.8,22,22,6,16,45,82,94,2,"https://fbref.com/en/players/246d153b/Ola-Aina"
"6294","Joachim Andersen_2021",2021,"Fulham","Premier League","Joachim Andersen","DEN","DF","24",1996,30.3,33,19,18,11,4,15,28,53.6,13,24,13,11,44,77,151,1,"https://fbref.com/en/players/e34fc66d/Joachim-Andersen"
"6295","Alphonse Areola_2021",2021,"Fulham","Premier League","Alphonse Areola","FRA","GK","27",1993,36,1,0,1,0,0,1,5,20,4,0,0,0,1,2,13,3,"https://fbref.com/en/players/2f965a72/Alphonse-Areola"
"6296","Joe Bryan_2021",2021,"Fulham","Premier League","Joe Bryan","ENG","DF,MF","26",1993,7.4,15,8,7,5,3,7,12,58.3,5,8,2,6,14,29,16,0,"https://fbref.com/en/players/af69e7f0/Joe-Bryan"
"6297","Tom Cairney_2021",2021,"Fulham","Premier League","Tom Cairney","SCO","MF","29",1991,8.4,9,3,1,4,4,1,4,25,3,6,0,6,0,9,3,0,"https://fbref.com/en/players/a8748947/Tom-Cairney"
"6298","Fabio Carvalho_2021",2021,"Fulham","Premier League","Fabio Carvalho","POR","MF,FW","17",2002,2.8,9,6,4,4,1,5,9,55.6,4,2,0,2,1,10,1,1,"https://fbref.com/en/players/966e28d0/Fabio-Carvalho"
"6299","Ivan Cavaleiro_2021",2021,"Fulham","Premier League","Ivan Cavaleiro","POR","FW","26",1993,27.5,23,14,9,11,3,12,34,35.3,22,25,1,24,19,42,14,0,"https://fbref.com/en/players/979b811d/Ivan-Cavaleiro"
"6300","Tyrese Francois_2021",2021,"Fulham","Premier League","Tyrese Francois","AUS","DF","20",2000,0.2,0,0,0,0,0,0,0,NA,0,0,0,0,0,0,0,0,"https://fbref.com/en/players/6722d4f0/Tyrese-Francois"
"6301","Michael Hector_2021",2021,"Fulham","Premier League","Michael Hector","JAM","DF","28",1992,2.9,3,2,1,2,0,1,6,16.7,5,4,2,2,0,3,6,0,"https://fbref.com/en/players/5f1a2f31/Michael-Hector"
"6302","Aboubakar Kamara_2021",2021,"Fulham","Premier League","Aboubakar Kamara","MTN","FW,MF","25",1995,3.5,2,2,1,1,0,0,5,0,5,6,0,6,1,3,0,0,"https://fbref.com/en/players/4047c976/Aboubakar-Kamara"
"6303","Neeskens Kebano_2021",2021,"Fulham","Premier League","Neeskens Kebano","COD","FW,MF","28",1992,1.3,0,0,0,0,0,0,1,0,1,3,0,3,0,0,0,0,"https://fbref.com/en/players/18b999f4/Neeskens-Kebano"
"6304","Terence Kongolo_2021",2021,"Fulham","Premier League","Terence Kongolo","NED","DF","26",1994,1,3,2,1,2,0,1,1,100,0,0,0,0,2,5,3,0,"https://fbref.com/en/players/1f9a3a04/Terence-Kongolo"
"6305","Maxime Le Marchand_2021",2021,"Fulham","Premier League","Maxime Le Marchand","FRA","DF","30",1989,1.4,2,2,2,0,0,2,2,100,0,0,0,0,0,2,3,0,"https://fbref.com/en/players/321a71a7/Maxime-Le-Marchand"
"6306","Mario Lemina_2021",2021,"Fulham","Premier League","Mario Lemina","GAB","MF","26",1993,18.9,62,35,25,30,7,23,44,52.3,21,26,5,21,30,92,21,0,"https://fbref.com/en/players/2b471f99/Mario-Lemina"
"6307","Ruben Loftus-Cheek_2021",2021,"Fulham","Premier League","Ruben Loftus-Cheek","ENG","MF,FW","24",1996,21.2,25,14,7,15,3,7,23,30.4,16,20,2,18,7,32,18,0,"https://fbref.com/en/players/e97fd090/Ruben-Loftus-Cheek"
"6308","Ademola Lookman_2021",2021,"Fulham","Premier League","Ademola Lookman","NGA","FW,MF","22",1997,30.5,35,11,18,9,8,13,44,29.5,31,31,1,30,20,55,9,0,"https://fbref.com/en/players/7c104bb7/Ademola-Lookman"
"6309","Josh Maja_2021",2021,"Fulham","Premier League","Josh Maja","NGA","FW","21",1998,9,7,4,0,3,4,4,10,40,6,3,1,2,4,11,1,0,"https://fbref.com/en/players/bc0bfc64/Josh-Maja"
"6310","Aleksandar Mitrović_2021",2021,"Fulham","Premier League","Aleksandar Mitrović","SRB","FW","25",1994,15.6,7,4,0,3,4,2,8,25,6,12,3,9,3,10,8,0,"https://fbref.com/en/players/3925dbd6/Aleksandar-Mitrovic"
"6311","Denis Odoi_2021",2021,"Fulham","Premier League","Denis Odoi","GHA","DF","32",1988,3,3,3,2,1,0,1,4,25,3,3,1,2,5,8,5,0,"https://fbref.com/en/players/f7750aa0/Denis-Odoi"
"6312","Josh Onomah_2021",2021,"Fulham","Premier League","Josh Onomah","ENG","MF","23",1997,4.2,11,8,1,6,4,0,5,0,5,4,2,2,2,13,1,0,"https://fbref.com/en/players/6612cd8c/Josh-Onomah"
"6313","Tim Ream_2021",2021,"Fulham","Premier League","Tim Ream","USA","DF","32",1987,7,12,5,9,3,0,8,11,72.7,3,8,5,3,6,18,26,1,"https://fbref.com/en/players/28b40c9c/Tim-Ream"
"6314","Harrison Reed_2021",2021,"Fulham","Premier League","Harrison Reed","ENG","MF","25",1995,25,63,38,28,28,7,29,73,39.7,44,34,11,23,50,113,31,1,"https://fbref.com/en/players/803ae100/Harrison-Reed"
"6315","Bobby Reid_2021",2021,"Fulham","Premier League","Bobby Reid","JAM","MF,FW","27",1993,26.4,31,15,17,10,4,18,39,46.2,21,19,5,14,21,52,39,0,"https://fbref.com/en/players/0f7533cd/Bobby-Reid"
"6316","Antonee Robinson_2021",2021,"Fulham","Premier League","Antonee Robinson","USA","DF","22",1997,24,45,28,24,16,5,27,44,61.4,17,21,4,17,37,82,68,0,"https://fbref.com/en/players/289601e6/Antonee-Robinson"
"6317","Marek Rodák_2021",2021,"Fulham","Premier League","Marek Rodák","SVK","GK","23",1996,2,0,0,0,0,0,0,0,NA,0,0,0,0,0,0,0,0,"https://fbref.com/en/players/17acc2ed/Marek-Rodak"
"6318","Kenny Tete_2021",2021,"Fulham","Premier League","Kenny Tete","NED","DF,MF","24",1995,16.5,48,30,27,16,5,10,18,55.6,8,14,5,9,27,75,49,0,"https://fbref.com/en/players/77d7c96f/Kenny-Tete"
"6319","Andre-Frank Zambo Anguissa_2021",2021,"Fulham","Premier League","Andre-Frank Zambo Anguissa","CMR","MF","24",1995,28.7,78,37,27,38,13,27,68,39.7,41,35,6,29,56,134,17,2,"https://fbref.com/en/players/6bb2c084/Andre-Frank-Zambo-Anguissa"
"6320","Milan Badelj_2021",2021,"Genoa","Serie A","Milan Badelj","CRO","MF","31",1989,26.8,56,27,27,22,7,26,84,31,58,51,10,41,87,143,45,1,"https://fbref.com/en/players/e8c930bb/Milan-Badelj"
"6321","Mattia Bani_2021",2021,"Genoa","Serie A","Mattia Bani","ITA","DF","26",1993,10.2,10,5,5,5,0,5,12,41.7,7,16,11,5,27,37,44,0,"https://fbref.com/en/players/0821331c/Mattia-Bani"
"6322","Valon Behrami_2021",2021,"Genoa","Serie A","Valon Behrami","SUI","MF","35",1985,9.9,21,9,9,10,2,9,26,34.6,17,13,5,8,9,30,13,0,"https://fbref.com/en/players/d3d758d8/Valon-Behrami"
"6323","Davide Biraschi_2021",2021,"Genoa","Serie A","Davide Biraschi","ITA","DF","26",1994,10.2,17,9,12,5,0,5,10,50,5,12,6,6,21,38,26,0,"https://fbref.com/en/players/64cd167d/Davide-Biraschi"
"6324","Giuseppe Caso_2021",2021,"Genoa","Serie A","Giuseppe Caso","ITA","DF,FW","21",1998,0.6,0,0,0,0,0,0,0,NA,0,0,0,0,0,0,0,0,"https://fbref.com/en/players/099a2de5/Giuseppe-Caso"
"6325","Francesco Cassata_2021",2021,"Genoa","Serie A","Francesco Cassata","ITA","DF,FW","23",1997,2.5,7,6,7,0,0,4,7,57.1,3,0,0,0,3,10,1,0,"https://fbref.com/en/players/96960855/Francesco-Cassata"
"6326","Domenico Criscito_2021",2021,"Genoa","Serie A","Domenico Criscito","ITA","DF","33",1986,19.2,43,22,29,11,3,22,39,56.4,17,27,14,13,44,87,51,0,"https://fbref.com/en/players/35dd6d80/Domenico-Criscito"
"6327","Lennart-Marten Czyborra_2021",2021,"Genoa","Serie A","Lennart-Marten Czyborra","GER","DF","21",1999,13,19,10,7,7,5,11,19,57.9,8,6,1,5,17,36,27,0,"https://fbref.com/en/players/7ba1f1ef/Lennart-Marten-Czyborra"
"6328","Mattia Destro_2021",2021,"Genoa","Serie A","Mattia Destro","ITA","FW","29",1991,17.8,6,3,0,3,3,2,9,22.2,7,11,0,11,4,10,8,0,"https://fbref.com/en/players/d7d32194/Mattia-Destro"
"6329","Steeve-Mike Ebongue_2021",2021,"Genoa","Serie A","Steeve-Mike Ebongue","FRA","MF","19",2001,0.6,2,1,1,0,1,0,3,0,3,1,0,1,0,2,0,0,"https://fbref.com/en/players/9d5ab351/Steeve-Mike-Ebongue"
"6330","Paolo Ghiglione_2021",2021,"Genoa","Serie A","Paolo Ghiglione","ITA","DF,MF","23",1997,15.1,27,15,17,8,2,13,28,46.4,15,14,2,12,13,40,25,0,"https://fbref.com/en/players/71dc23da/Paolo-Ghiglione"
"6331","Edoardo Goldaniga_2021",2021,"Genoa","Serie A","Edoardo Goldaniga","ITA","DF","26",1993,20.6,28,18,21,7,0,14,23,60.9,9,17,7,10,38,66,62,1,"https://fbref.com/en/players/4b029b31/Edoardo-Goldaniga"
"6332","Yayah Kallon_2021",2021,"Genoa","Serie A","Yayah Kallon","SLE","FW","19",2001,0.5,0,0,0,0,0,0,0,NA,0,0,0,0,0,0,0,0,"https://fbref.com/en/players/f95f49d2/Yayah-Kallon"
"6333","Lukas Lerager_2021",2021,"Genoa","Serie A","Lukas Lerager","DEN","MF","27",1993,12.9,24,13,14,9,1,11,30,36.7,19,13,3,10,14,38,25,1,"https://fbref.com/en/players/1b82f8df/Lukas-Lerager"
"6334","Federico Marchetti_2021",2021,"Genoa","Serie A","Federico Marchetti","ITA","GK","37",1983,3.7,1,0,1,0,0,1,1,100,0,0,0,0,0,1,2,1,"https://fbref.com/en/players/f794b426/Federico-Marchetti"
"6335","Andrea Masiello_2021",2021,"Genoa","Serie A","Andrea Masiello","ITA","DF","34",1986,28.5,38,22,29,6,3,23,48,47.9,25,32,13,19,53,91,107,3,"https://fbref.com/en/players/e0314d87/Andrea-Masiello"
"6336","Filippo Melegoni_2021",2021,"Genoa","Serie A","Filippo Melegoni","ITA","MF,DF","21",1999,4.3,7,6,2,5,0,3,6,50,3,5,0,5,5,12,8,0,"https://fbref.com/en/players/6604165d/Filippo-Melegoni"
"6337","Jérôme Onguéné_2021",2021,"Genoa","Serie A","Jérôme Onguéné","CMR","DF","22",1997,2,2,1,2,0,0,2,7,28.6,5,2,0,2,2,4,8,0,"https://fbref.com/en/players/e81f0356/Jerome-Onguene"
"6338","Alberto Paleari_2021",2021,"Genoa","Serie A","Alberto Paleari","ITA","GK","27",1992,2.3,0,0,0,0,0,0,0,NA,0,0,0,0,0,0,1,0,"https://fbref.com/en/players/94a3606c/Alberto-Paleari"
"6339","Goran Pandev_2021",2021,"Genoa","Serie A","Goran Pandev","MKD","FW,MF","37",1983,15.6,9,5,1,6,2,4,10,40,6,6,0,6,2,11,7,1,"https://fbref.com/en/players/d711d04f/Goran-Pandev"
"6340","Vittorio Parigini_2021",2021,"Genoa","Serie A","Vittorio Parigini","ITA","MF,DF","24",1996,0.6,5,2,4,0,1,0,1,0,1,0,0,0,0,5,0,0,"https://fbref.com/en/players/75efed2e/Vittorio-Parigini"
"6341","Luca Pellegrini_2021",2021,"Genoa","Serie A","Luca Pellegrini","ITA","DF,MF","21",1999,7.1,9,6,6,2,1,4,10,40,6,11,2,9,8,17,13,1,"https://fbref.com/en/players/3b61c9ec/Luca-Pellegrini"
"6342","Mattia Perin_2021",2021,"Genoa","Serie A","Mattia Perin","ITA","GK","27",1992,32,0,0,0,0,0,0,0,NA,0,0,0,0,1,1,6,0,"https://fbref.com/en/players/4c62d0c8/Mattia-Perin"
"6343","Marko Pjaca_2021",2021,"Genoa","Serie A","Marko Pjaca","CRO","FW,MF","25",1995,15.8,13,6,6,3,4,4,16,25,12,7,2,5,7,20,12,0,"https://fbref.com/en/players/2c38b327/Marko-Pjaca"
"6344","Manolo Portanova_2021",2021,"Genoa","Serie A","Manolo Portanova","ITA","MF,FW","20",2000,0.7,3,3,1,1,1,0,2,0,2,3,1,2,1,4,2,0,"https://fbref.com/en/players/c8c0dccd/Manolo-Portanova"
"6345","Ivan Radovanović_2021",2021,"Genoa","Serie A","Ivan Radovanović","SRB","DF,MF","31",1988,24.8,18,15,13,5,0,12,31,38.7,19,39,21,18,37,55,114,2,"https://fbref.com/en/players/023937a9/Ivan-Radovanovic"
"6346","Nicolò Rovella_2021",2021,"Genoa","Serie A","Nicolò Rovella","ITA","MF","18",2001,13.2,29,16,15,11,3,9,32,28.1,23,11,0,11,20,49,19,1,"https://fbref.com/en/players/e58cbfd5/Nicolo-Rovella"
"6347","Gianluca Scamacca_2021",2021,"Genoa","Serie A","Gianluca Scamacca","ITA","FW","21",1999,15,19,10,6,7,6,7,19,36.8,12,21,4,17,9,28,12,0,"https://fbref.com/en/players/8790f988/Gianluca-Scamacca"
"6348","Eldor Shomurodov_2021",2021,"Genoa","Serie A","Eldor Shomurodov","UZB","FW","25",1995,18.6,28,14,7,13,8,9,37,24.3,28,17,2,15,6,34,11,0,"https://fbref.com/en/players/57469b2d/Eldor-Shomurodov"
"6349","Kevin Strootman_2021",2021,"Genoa","Serie A","Kevin Strootman","NED","MF","30",1990,14.6,30,18,13,15,2,14,32,43.8,18,35,3,32,25,55,18,0,"https://fbref.com/en/players/ef2e5e1a/Kevin-Strootman"
"6350","Stefano Sturaro_2021",2021,"Genoa","Serie A","Stefano Sturaro","ITA","MF","27",1993,4.9,11,5,3,6,2,3,15,20,12,5,0,5,7,18,2,0,"https://fbref.com/en/players/2334478a/Stefano-Sturaro"
"6351","Miha Zajc_2021",2021,"Genoa","Serie A","Miha Zajc","SVN","MF","26",1994,20.7,22,14,9,10,3,13,39,33.3,26,30,4,26,27,49,19,0,"https://fbref.com/en/players/83e4643e/Miha-Zajc"
"6352","Cristián Zapata_2021",2021,"Genoa","Serie A","Cristián Zapata","COL","DF","33",1986,10.8,18,12,11,7,0,10,14,71.4,4,15,11,4,15,33,56,0,"https://fbref.com/en/players/b1deecf8/Cristian-Zapata"
"6353","Davide Zappacosta_2021",2021,"Genoa","Serie A","Davide Zappacosta","ITA","DF","28",1992,22.7,33,16,15,13,5,15,30,50,15,17,1,16,18,51,41,0,"https://fbref.com/en/players/7fe90ccd/Davide-Zappacosta"
"6354","Sabit Abdulai_2021",2021,"Getafe","La Liga","Sabit Abdulai","GHA","MF","21",1999,0.7,2,0,1,1,0,1,3,33.3,2,0,0,0,0,2,0,0,"https://fbref.com/en/players/9f9e1b9c/Sabit-Abdulai"
"6355","Carles Aleñá_2021",2021,"Getafe","La Liga","Carles Aleñá","ESP","MF,FW","22",1998,15.2,15,10,3,9,3,7,25,28,18,14,1,13,2,17,2,0,"https://fbref.com/en/players/6c811eb7/Carles-Alena"
"6356","Emmanuel Amankwaa Akurugu_2021",2021,"Getafe","La Liga","Emmanuel Amankwaa Akurugu","GHA","DF","18",2001,0.5,0,0,0,0,0,0,1,0,1,1,0,1,2,2,1,0,"https://fbref.com/en/players/69c5633e/Emmanuel-Amankwaa-Akurugu"
"6357","José Antonio Miranda_2021",2021,"Getafe","La Liga","José Antonio Miranda","EQG","MF,DF","22",1998,0.3,0,0,0,0,0,0,1,0,1,1,0,1,0,0,0,0,"https://fbref.com/en/players/683788fd/Jose-Antonio-Miranda"
"6358","Mauro Arambarri_2021",2021,"Getafe","La Liga","Mauro Arambarri","URU","MF","24",1995,33.1,64,39,22,35,7,23,80,28.8,57,40,5,35,42,106,28,0,"https://fbref.com/en/players/58afe001/Mauro-Arambarri"
"6359","Erick Cabaco_2021",2021,"Getafe","La Liga","Erick Cabaco","URU","DF","25",1995,14.7,24,14,11,12,1,12,22,54.5,10,8,6,2,13,37,51,1,"https://fbref.com/en/players/e7ab4179/Erick-Cabaco"
"6360","Sofian Chakla_2021",2021,"Getafe","La Liga","Sofian Chakla","MAR","DF","26",1993,10,12,8,10,1,1,5,7,71.4,2,3,2,1,14,26,48,1,"https://fbref.com/en/players/37f04799/Sofian-Chakla"
"6361","Chema_2021",2021,"Getafe","La Liga","Chema","ESP","DF,MF","28",1992,6.2,11,5,6,5,0,5,7,71.4,2,1,0,1,10,21,23,0,"https://fbref.com/en/players/7f203b54/Chema"
"6362","Cucho_2021",2021,"Getafe","La Liga","Cucho","COL","FW,MF","21",1999,16.3,19,10,1,14,4,2,23,8.7,21,18,1,17,6,25,8,0,"https://fbref.com/en/players/71b47ab9/Cucho"
"6363","Marc Cucurella_2021",2021,"Getafe","La Liga","Marc Cucurella","ESP","MF","22",1998,36,64,51,19,40,5,25,66,37.9,41,45,4,41,40,104,27,0,"https://fbref.com/en/players/1daec722/Marc-Cucurella"
"6364","Abdoulay Diaby_2021",2021,"Getafe","La Liga","Abdoulay Diaby","MLI","DF","29",1991,0.2,2,0,0,2,0,0,0,NA,0,2,0,2,0,2,0,0,"https://fbref.com/en/players/23c5db70/Abdoulay-Diaby"
"6365","Djené_2021",2021,"Getafe","La Liga","Djené","TOG","DF","28",1991,32.7,61,39,31,26,4,26,34,76.5,8,24,11,13,42,103,96,0,"https://fbref.com/en/players/a4971d84/Djene"
"6366","Xabier Etxeita_2021",2021,"Getafe","La Liga","Xabier Etxeita","ESP","DF","32",1987,9.8,8,4,5,3,0,7,14,50,7,6,3,3,13,21,38,0,"https://fbref.com/en/players/4a895384/Xabier-Etxeita"
"6367","Iglesias_2021",2021,"Getafe","La Liga","Iglesias","ESP","DF,MF","22",1998,6.7,27,15,14,10,3,11,19,57.9,8,11,1,10,17,44,19,0,"https://fbref.com/en/players/974322dc/Iglesias"
"6368","John Joe_2021",2021,"Getafe","La Liga","John Joe","IRL","MF,FW","16",2003,0.7,2,0,0,2,0,0,0,NA,0,0,0,0,0,2,0,0,"https://fbref.com/en/players/fd01216a/John-Joe"
"6369","Takefusa Kubo_2021",2021,"Getafe","La Liga","Takefusa Kubo","JPN","MF,FW","19",2001,8.9,7,4,2,3,2,1,14,7.1,13,14,0,14,14,21,4,0,"https://fbref.com/en/players/16aa3654/Takefusa-Kubo"
"6370","Nemanja Maksimović_2021",2021,"Getafe","La Liga","Nemanja Maksimović","SRB","MF","25",1995,30.3,50,28,22,24,4,19,46,41.3,27,40,9,31,57,107,46,1,"https://fbref.com/en/players/00b28772/Nemanja-Maksimovic"
"6371","Jaime Mata_2021",2021,"Getafe","La Liga","Jaime Mata","ESP","FW","31",1988,22.6,12,7,1,3,8,3,18,16.7,15,13,2,11,6,18,16,0,"https://fbref.com/en/players/02319ad7/Jaime-Mata"
"6372","Victor Mollejo_2021",2021,"Getafe","La Liga","Victor Mollejo","ESP","MF,DF","19",2001,0.8,2,1,1,0,1,0,1,0,1,0,0,0,0,2,0,0,"https://fbref.com/en/players/23fffc06/Victor-Mollejo"
"6373","Mamor Niang_2021",2021,"Getafe","La Liga","Mamor Niang","SEN","MF,FW","18",2002,0.2,1,1,0,1,0,0,0,NA,0,1,0,1,0,1,0,0,"https://fbref.com/en/players/64a76620/Mamor-Niang"
"6374","Allan Nyom_2021",2021,"Getafe","La Liga","Allan Nyom","CMR","MF,DF","32",1988,25.8,38,23,14,19,5,15,30,50,15,16,2,14,22,60,42,0,"https://fbref.com/en/players/97572117/Allan-Nyom"
"6375","Mathías Olivera_2021",2021,"Getafe","La Liga","Mathías Olivera","URU","DF","22",1997,29,61,33,31,21,9,32,56,57.1,24,33,3,30,31,92,55,0,"https://fbref.com/en/players/41c12f75/Mathias-Olivera"
"6376","Ante Palaversa_2021",2021,"Getafe","La Liga","Ante Palaversa","CRO","MF","20",2000,0.1,0,0,0,0,0,0,1,0,1,0,0,0,0,0,0,0,"https://fbref.com/en/players/cd9b37a3/Ante-Palaversa"
"6377","Francisco Portillo_2021",2021,"Getafe","La Liga","Francisco Portillo","ESP","MF,FW","30",1990,4.6,5,3,1,4,0,2,14,14.3,12,3,0,3,5,10,1,0,"https://fbref.com/en/players/8e010ff4/Francisco-Portillo"
"6378","Darío Poveda_2021",2021,"Getafe","La Liga","Darío Poveda","ESP","FW","23",1997,0.1,0,0,0,0,0,0,0,NA,0,1,0,1,0,0,0,0,"https://fbref.com/en/players/cbdf7d5c/Dario-Poveda"
"6379","Ángel Rodríguez_2021",2021,"Getafe","La Liga","Ángel Rodríguez","ESP","FW,MF","33",1987,15.3,7,4,1,4,2,1,16,6.3,15,7,0,7,2,9,8,0,"https://fbref.com/en/players/8cfc2f69/Angel-Rodriguez"
"6380","David Soria_2021",2021,"Getafe","La Liga","David Soria","ESP","GK","27",1993,28,2,2,2,0,0,1,3,33.3,2,0,0,0,1,3,12,0,"https://fbref.com/en/players/8f8c6934/David-Soria"
"6381","Damián Suárez_2021",2021,"Getafe","La Liga","Damián Suárez","URU","DF","32",1988,27,59,39,29,23,7,30,81,37,51,43,2,41,31,90,42,0,"https://fbref.com/en/players/ba5004e1/Damian-Suarez"
"6382","David Timor_2021",2021,"Getafe","La Liga","David Timor","ESP","MF,DF","30",1989,15.5,13,9,5,6,2,9,21,42.9,12,5,1,4,19,32,32,1,"https://fbref.com/en/players/174651c8/David-Timor"
"6383","Enes Ünal_2021",2021,"Getafe","La Liga","Enes Ünal","TUR","FW","23",1997,14.6,11,3,0,8,3,4,15,26.7,11,11,0,11,2,13,14,0,"https://fbref.com/en/players/f8eca1b6/Enes-Unal"
"6384","Rubén Yáñez_2021",2021,"Getafe","La Liga","Rubén Yáñez","ESP","GK","26",1993,10,0,0,0,0,0,0,1,0,1,0,0,0,2,2,2,0,"https://fbref.com/en/players/039ae103/Ruben-Yanez"
"6385","Ángel_2021",2021,"Granada","La Liga","Ángel","ESP","GK","18",2002,1,0,0,0,0,0,0,0,NA,0,0,0,0,0,0,1,0,"https://fbref.com/en/players/b1e5bbec/Angel"
"6386","Ramon Azeez_2021",2021,"Granada","La Liga","Ramon Azeez","NGA","MF","27",1992,1.1,1,1,0,1,0,0,0,NA,0,0,0,0,1,2,1,0,"https://fbref.com/en/players/0cc474e7/Ramon-Azeez"
"6387","Barcia_2021",2021,"Granada","La Liga","Barcia","ESP","DF","19",2000,1,1,1,1,0,0,0,0,NA,0,1,1,0,3,4,9,0,"https://fbref.com/en/players/0c717ae6/Barcia"
"6388","Álvaro Bravo_2021",2021,"Granada","La Liga","Álvaro Bravo","ESP","MF","22",1998,0.2,1,1,1,0,0,1,2,50,1,0,0,0,1,2,0,0,"https://fbref.com/en/players/b3f97139/Alvaro-Bravo"
"6389","Yan Brice Eteki_2021",2021,"Granada","La Liga","Yan Brice Eteki","CMR","MF","22",1997,14.7,23,15,10,12,1,8,19,42.1,11,13,3,10,13,36,16,1,"https://fbref.com/en/players/3d688b46/Yan-Brice-Eteki"
"6390","Juan Brunet_2021",2021,"Granada","La Liga","Juan Brunet","ARG","MF","22",1998,0.3,0,0,0,0,0,0,0,NA,0,0,0,0,0,0,1,0,"https://fbref.com/en/players/c960cfdb/Juan-Brunet"
"6391","Víctor Díaz_2021",2021,"Granada","La Liga","Víctor Díaz","ESP","DF","32",1988,9.2,21,10,13,6,2,10,19,52.6,9,14,8,6,16,37,39,0,"https://fbref.com/en/players/3624ce4c/Victor-Diaz"
"6392","Domingos Duarte_2021",2021,"Granada","La Liga","Domingos Duarte","POR","DF","25",1995,26.3,32,20,18,12,2,14,21,66.7,7,29,20,9,29,61,86,0,"https://fbref.com/en/players/93090f69/Domingos-Duarte"
"6393","Aarón Escandell_2021",2021,"Granada","La Liga","Aarón Escandell","ESP","GK","24",1995,5,1,1,1,0,0,1,1,100,0,0,0,0,0,1,6,0,"https://fbref.com/en/players/67669ce7/Aaron-Escandell"
"6394","Kingsley Fobi_2021",2021,"Granada","La Liga","Kingsley Fobi","GHA","DF","21",1998,0.5,0,0,0,0,0,0,0,NA,0,0,0,0,1,1,1,0,"https://fbref.com/en/players/954c26c9/Kingsley-Fobi"
"6395","Dimitri Foulquier_2021",2021,"Granada","La Liga","Dimitri Foulquier","FRA","DF","27",1993,29.6,35,21,20,12,3,15,26,57.7,11,24,7,17,26,61,60,0,"https://fbref.com/en/players/45e17712/Dimitri-Foulquier"
"6396","Maxime Gonalons_2021",2021,"Granada","La Liga","Maxime Gonalons","FRA","MF","31",1989,16.4,53,37,18,33,2,15,37,40.5,22,17,0,17,25,78,21,1,"https://fbref.com/en/players/b8c1de25/Maxime-Gonalons"
"6397","Yangel Herrera_2021",2021,"Granada","La Liga","Yangel Herrera","VEN","MF","22",1998,25.7,59,26,19,32,8,11,41,26.8,30,53,17,36,26,85,32,1,"https://fbref.com/en/players/e778654a/Yangel-Herrera"
"6398","Luis Javier Suárez_2021",2021,"Granada","La Liga","Luis Javier Suárez","COL","FW,MF","22",1997,18.5,19,11,5,7,7,6,17,35.3,11,10,1,9,8,27,11,0,"https://fbref.com/en/players/eeba07f8/Luis-Javier-Suarez"
"6399","Kenedy_2021",2021,"Granada","La Liga","Kenedy","BRA","FW,MF","24",1996,16.3,22,12,10,7,5,5,25,20,20,21,4,17,26,48,15,1,"https://fbref.com/en/players/5eebbfdf/Kenedy"
"6400","Darwin Machís_2021",2021,"Granada","La Liga","Darwin Machís","VEN","FW,MF","27",1993,22.5,30,17,12,10,8,6,19,31.6,13,21,2,19,22,52,13,0,"https://fbref.com/en/players/ed6ea4d9/Darwin-Machis"
"6401","Adrián Marín_2021",2021,"Granada","La Liga","Adrián Marín","ESP","DF,MF","23",1997,3,5,2,1,3,1,2,3,66.7,1,5,2,3,4,9,9,0,"https://fbref.com/en/players/b7f2edff/Adrian-Marin"
"6402","Luis Milla_2021",2021,"Granada","La Liga","Luis Milla","ESP","MF","25",1994,13.9,22,11,11,10,1,6,28,21.4,22,10,0,10,24,46,16,1,"https://fbref.com/en/players/19c36442/Luis-Milla"
"6403","Jorge Molina_2021",2021,"Granada","La Liga","Jorge Molina","ESP","FW","38",1982,17.9,11,4,3,5,3,8,22,36.4,14,5,1,4,3,14,19,0,"https://fbref.com/en/players/43f71e77/Jorge-Molina"
"6404","Ángel Montoro_2021",2021,"Granada","La Liga","Ángel Montoro","ESP","MF","32",1988,15.1,15,9,7,7,1,4,16,25,12,13,3,10,22,37,21,0,"https://fbref.com/en/players/719384c1/Angel-Montoro"
"6405","Carlos Neva_2021",2021,"Granada","La Liga","Carlos Neva","ESP","DF","24",1996,20,12,6,6,6,0,6,11,54.5,5,16,4,12,27,39,58,0,"https://fbref.com/en/players/8d47bb39/Carlos-Neva"
"6406","Nehuén Pérez_2021",2021,"Granada","La Liga","Nehuén Pérez","ARG","DF","20",2000,8.2,6,3,6,0,0,4,6,66.7,2,5,4,1,12,18,33,0,"https://fbref.com/en/players/f7c491f1/Nehuen-Perez"
"6407","Dani Plomer_2021",2021,"Granada","La Liga","Dani Plomer","ESP","FW","21",1998,0.5,0,0,0,0,0,0,1,0,1,0,0,0,0,0,1,0,"https://fbref.com/en/players/0d298637/Dani-Plomer"
"6408","Antonio Puertas_2021",2021,"Granada","La Liga","Antonio Puertas","ESP","FW,MF","28",1992,24.1,27,13,9,12,6,10,32,31.3,22,24,5,19,12,39,25,0,"https://fbref.com/en/players/c77a8043/Antonio-Puertas"
"6409","Domingos Quina_2021",2021,"Granada","La Liga","Domingos Quina","POR","MF","20",1999,3.8,5,5,1,3,1,3,6,50,3,8,0,8,2,7,0,0,"https://fbref.com/en/players/41fb0f4e/Domingos-Quina"
"6410","Quini_2021",2021,"Granada","La Liga","Quini","ESP","DF","30",1989,13.2,33,22,23,7,3,19,36,52.8,17,15,6,9,15,48,39,0,"https://fbref.com/en/players/7a538238/Quini"
"6411","Isma Ruiz_2021",2021,"Granada","La Liga","Isma Ruiz","ESP","MF","19",2001,0.7,1,0,0,1,0,0,1,0,1,0,0,0,0,1,3,0,"https://fbref.com/en/players/6e36226f/Isma-Ruiz"
"6412","Germán Sánchez_2021",2021,"Granada","La Liga","Germán Sánchez","ESP","DF","33",1986,29.3,24,11,13,9,2,11,23,47.8,12,28,26,2,38,62,130,1,"https://fbref.com/en/players/ea9b2ef9/German-Sanchez"
"6413","Pepe Sánchez_2021",2021,"Granada","La Liga","Pepe Sánchez","ESP","DF","20",2000,2.8,4,2,2,2,0,3,4,75,1,5,2,3,4,8,9,0,"https://fbref.com/en/players/6583a8a9/Pepe-Sanchez"
"6414","Rui Silva_2021",2021,"Granada","La Liga","Rui Silva","POR","GK","26",1994,32,1,0,1,0,0,1,3,33.3,2,0,0,0,2,3,14,0,"https://fbref.com/en/players/ea83bfa6/Rui-Silva"
"6415","Roberto Soldado_2021",2021,"Granada","La Liga","Roberto Soldado","ESP","FW","35",1985,16,7,4,1,4,2,2,11,18.2,9,8,0,8,4,11,13,1,"https://fbref.com/en/players/9d66fbe3/Roberto-Soldado"
"6416","Alberto Soro_2021",2021,"Granada","La Liga","Alberto Soro","ESP","FW,MF","21",1999,4.4,7,2,2,4,1,4,10,40,6,7,0,7,1,8,2,0,"https://fbref.com/en/players/452c3055/Alberto-Soro"
"6417","Jesús Vallejo_2021",2021,"Granada","La Liga","Jesús Vallejo","ESP","DF","23",1997,15,11,6,7,3,1,7,18,38.9,11,21,11,10,13,24,55,0,"https://fbref.com/en/players/c2111b45/Jesus-Vallejo"
"6418","Fede Vico_2021",2021,"Granada","La Liga","Fede Vico","ESP","MF,FW","26",1994,8.5,10,6,5,5,0,3,10,30,7,15,1,14,12,22,5,0,"https://fbref.com/en/players/f681a8ef/Fede-Vico"
"6419","Philip Ankhrah_2021",2021,"Hellas Verona","Serie A","Philip Ankhrah","GHA","MF","17",2002,0.1,0,0,0,0,0,0,0,NA,0,1,0,1,0,0,0,0,"https://fbref.com/en/players/f5409698/Philip-Ankhrah"
"6420","Antonín Barák_2021",2021,"Hellas Verona","Serie A","Antonín Barák","CZE","MF","25",1994,30.7,30,19,8,16,6,14,47,29.8,33,26,7,19,12,42,38,1,"https://fbref.com/en/players/01efac19/Antonin-Barak"
"6421","Alessandro Berardi_2021",2021,"Hellas Verona","Serie A","Alessandro Berardi","ITA","GK","29",1991,0.3,0,0,0,0,0,0,0,NA,0,0,0,0,0,0,0,0,"https://fbref.com/en/players/ec1f737d/Alessandro-Berardi"
"6422","Daniel Bessa_2021",2021,"Hellas Verona","Serie A","Daniel Bessa","ITA","MF","27",1993,6.8,15,8,3,11,1,6,14,42.9,8,5,1,4,2,17,0,0,"https://fbref.com/en/players/88895312/Daniel-Bessa"
"6423","Federico Ceccherini_2021",2021,"Hellas Verona","Serie A","Federico Ceccherini","ITA","DF","28",1992,19.3,16,12,10,6,0,2,7,28.6,5,15,8,7,40,56,60,0,"https://fbref.com/en/players/d9624b51/Federico-Ceccherini"
"6424","Ebrima Colley_2021",2021,"Hellas Verona","Serie A","Ebrima Colley","GAM","MF,FW","20",2000,8.2,11,4,2,6,3,3,11,27.3,8,6,0,6,6,17,1,0,"https://fbref.com/en/players/bf356094/Ebrima-Colley"
"6425","Andrea Danzi_2021",2021,"Hellas Verona","Serie A","Andrea Danzi","ITA","DF","21",1999,1.2,0,0,0,0,0,0,1,0,1,0,0,0,3,3,1,0,"https://fbref.com/en/players/263b855a/Andrea-Danzi"
"6426","Paweł Dawidowicz_2021",2021,"Hellas Verona","Serie A","Paweł Dawidowicz","POL","DF","25",1995,20.7,42,28,30,10,2,14,24,58.3,10,28,19,9,27,69,62,1,"https://fbref.com/en/players/16bb656a/Pawel-Dawidowicz"
"6427","Samuel Di Carmine_2021",2021,"Hellas Verona","Serie A","Samuel Di Carmine","ITA","FW","31",1988,5.6,1,2,0,1,0,0,3,0,3,1,0,1,0,1,5,0,"https://fbref.com/en/players/ef94dc2f/Samuel-Di-Carmine"
"6428","Federico Dimarco_2021",2021,"Hellas Verona","Serie A","Federico Dimarco","ITA","DF","22",1997,29,32,19,23,7,2,13,28,46.4,15,18,9,9,47,79,50,1,"https://fbref.com/en/players/970b8574/Federico-Dimarco"
"6429","Alan Empereur_2021",2021,"Hellas Verona","Serie A","Alan Empereur","BRA","DF","26",1994,2.4,0,0,0,0,0,0,0,NA,0,1,1,0,6,6,7,1,"https://fbref.com/en/players/825b8997/Alan-Empereur"
"6430","Davide Faraoni_2021",2021,"Hellas Verona","Serie A","Davide Faraoni","ITA","DF","28",1991,32.1,62,33,36,19,7,28,51,54.9,23,48,17,31,49,111,83,1,"https://fbref.com/en/players/aae9d04a/Davide-Faraoni"
"6431","Andrea Favilli_2021",2021,"Hellas Verona","Serie A","Andrea Favilli","ITA","FW","23",1997,3.8,3,1,0,1,2,2,3,66.7,1,2,0,2,0,3,2,0,"https://fbref.com/en/players/44510fde/Andrea-Favilli"
"6432","Koray Günter_2021",2021,"Hellas Verona","Serie A","Koray Günter","GER","DF","25",1994,19.6,20,10,10,9,1,4,9,44.4,5,27,21,6,70,90,87,0,"https://fbref.com/en/players/f1f1f238/Koray-Gunter"
"6433","Ivan Ilić_2021",2021,"Hellas Verona","Serie A","Ivan Ilić","SRB","MF","19",2001,20.4,26,14,11,11,4,7,21,33.3,14,17,5,12,27,53,26,0,"https://fbref.com/en/players/bb376bed/Ivan-Ilic"
"6434","Nikola Kalinić_2021",2021,"Hellas Verona","Serie A","Nikola Kalinić","CRO","FW","32",1988,11.8,5,1,2,2,1,0,3,0,3,6,0,6,1,6,7,0,"https://fbref.com/en/players/d4931a5a/Nikola-Kalinic"
"6435","Kevin Lasagna_2021",2021,"Hellas Verona","Serie A","Kevin Lasagna","ITA","FW","27",1992,14.1,7,3,0,5,2,1,5,20,4,12,1,11,1,8,11,0,"https://fbref.com/en/players/09538fdb/Kevin-Lasagna"
"6436","Darko Lazović_2021",2021,"Hellas Verona","Serie A","Darko Lazović","SRB","DF,MF","29",1990,27.8,29,17,8,17,4,20,42,47.6,22,17,7,10,20,49,29,0,"https://fbref.com/en/players/5128bde4/Darko-Lazovic"
"6437","Matteo Lovato_2021",2021,"Hellas Verona","Serie A","Matteo Lovato","ITA","DF","20",2000,15.4,21,12,14,5,2,10,21,47.6,11,20,10,10,37,58,48,1,"https://fbref.com/en/players/5fa57166/Matteo-Lovato"
"6438","Giangiacomo Magnani_2021",2021,"Hellas Verona","Serie A","Giangiacomo Magnani","ITA","DF","24",1995,16.8,26,15,14,9,3,9,16,56.3,7,25,16,9,44,70,105,1,"https://fbref.com/en/players/cce9f582/Giangiacomo-Magnani"
"6439","Yıldırım Mert Çetin_2021",2021,"Hellas Verona","Serie A","Yıldırım Mert Çetin","TUR","DF","23",1997,4.6,8,4,3,5,0,2,6,33.3,4,7,5,2,14,22,11,1,"https://fbref.com/en/players/c730da00/Yildirim-Mert-Cetin"
"6440","Ivor Pandur_2021",2021,"Hellas Verona","Serie A","Ivor Pandur","CRO","GK","20",2000,3.7,0,0,0,0,0,0,0,NA,0,0,0,0,0,0,0,0,"https://fbref.com/en/players/457cb02f/Ivor-Pandur"
"6441","Kevin Rüegg_2021",2021,"Hellas Verona","Serie A","Kevin Rüegg","SUI","DF,MF","21",1998,2.3,0,0,0,0,0,0,0,NA,0,3,0,3,2,2,3,0,"https://fbref.com/en/players/90573602/Kevin-Ruegg"
"6442","Eddie Salcedo_2021",2021,"Hellas Verona","Serie A","Eddie Salcedo","ITA","MF,FW","18",2001,8.4,6,2,3,2,1,3,3,100,0,6,0,6,6,12,6,0,"https://fbref.com/en/players/0489bb30/Eddie-Salcedo"
"6443","Marco Silvestri_2021",2021,"Hellas Verona","Serie A","Marco Silvestri","ITA","GK","29",1991,34,0,0,0,0,0,0,0,NA,0,0,0,0,0,0,14,1,"https://fbref.com/en/players/0d422df7/Marco-Silvestri"
"6444","Stefano Sturaro_2021",2021,"Hellas Verona","Serie A","Stefano Sturaro","ITA","MF","27",1993,4.7,4,3,3,0,1,2,8,25,6,5,1,4,5,9,10,0,"https://fbref.com/en/players/2334478a/Stefano-Sturaro"
"6445","Adrien Tameze_2021",2021,"Hellas Verona","Serie A","Adrien Tameze","CMR","MF","26",1994,25.6,39,25,23,15,1,11,27,40.7,16,31,8,23,32,71,46,2,"https://fbref.com/en/players/8da74c05/Adrien-Tameze"
"6446","Ľubomír Tupta_2021",2021,"Hellas Verona","Serie A","Ľubomír Tupta","SVK","FW","22",1998,0.6,0,0,0,0,0,0,0,NA,0,0,0,0,0,0,0,0,"https://fbref.com/en/players/b02af64f/Lubomir-Tupta"
"6447","Iyenoma Udogie_2021",2021,"Hellas Verona","Serie A","Iyenoma Udogie","ITA","DF,MF","17",2002,1.9,6,4,2,2,2,2,2,100,0,3,0,3,2,8,4,0,"https://fbref.com/en/players/7cd520e8/Iyenoma-Udogie"
"6448","Miguel Veloso_2021",2021,"Hellas Verona","Serie A","Miguel Veloso","POR","MF","34",1986,14.6,24,17,10,10,4,12,34,35.3,22,12,1,11,12,36,25,0,"https://fbref.com/en/players/ab1ca213/Miguel-Veloso"
"6449","Ronaldo Vieira_2021",2021,"Hellas Verona","Serie A","Ronaldo Vieira","GNB","MF","22",1998,2.5,NA,3,NA,NA,NA,NA,NA,NA,NA,NA,NA,NA,0,NA,NA,NA,"https://fbref.com/en/players/75e60d75/Ronaldo-Vieira"
"6450","Mattia Zaccagni_2021",2021,"Hellas Verona","Serie A","Mattia Zaccagni","ITA","MF","25",1995,29,27,13,8,11,8,8,25,32,17,28,4,24,27,54,13,1,"https://fbref.com/en/players/d85c238b/Mattia-Zaccagni"
"6451","Omar Alderete_2021",2021,"Hertha BSC","Bundesliga","Omar Alderete","PAR","DF","23",1996,14.4,16,10,11,5,0,7,16,43.8,9,14,10,4,21,37,61,1,"https://fbref.com/en/players/bb08bce9/Omar-Alderete"
"6452","Santiago Ascacíbar_2021",2021,"Hertha BSC","Bundesliga","Santiago Ascacíbar","ARG","MF","23",1997,8.5,30,15,15,14,1,15,28,53.6,13,23,2,21,13,43,14,0,"https://fbref.com/en/players/e26fcca3/Santiago-Ascacibar"
"6453","Dedryck Boyata_2021",2021,"Hertha BSC","Bundesliga","Dedryck Boyata","BEL","DF","29",1990,17.2,14,7,10,3,1,7,15,46.7,8,23,20,3,26,40,68,1,"https://fbref.com/en/players/7c473e12/Dedryck-Boyata"
"6454","Jhon Córdoba_2021",2021,"Hertha BSC","Bundesliga","Jhon Córdoba","COL","FW","27",1993,17.1,9,4,1,5,3,2,4,50,2,13,2,11,6,15,4,0,"https://fbref.com/en/players/9f381d8b/Jhon-Cordoba"
"6455","Matheus Cunha_2021",2021,"Hertha BSC","Bundesliga","Matheus Cunha","BRA","FW,MF","21",1999,23.9,36,16,10,19,7,13,49,26.5,36,29,2,27,31,67,9,0,"https://fbref.com/en/players/dc62b55d/Matheus-Cunha"
"6456","Márton Dárdai_2021",2021,"Hertha BSC","Bundesliga","Márton Dárdai","GER","DF,MF","18",2002,9.1,17,10,10,6,1,9,16,56.3,7,7,3,4,16,33,31,0,"https://fbref.com/en/players/41bff4fa/Marton-Dardai"
"6457","Vladimír Darida_2021",2021,"Hertha BSC","Bundesliga","Vladimír Darida","CZE","MF","29",1990,21.1,34,19,11,19,4,9,31,29,22,34,2,32,27,61,18,0,"https://fbref.com/en/players/3eb0f2df/Vladimir-Darida"
"6458","Javairô Dilrosun_2021",2021,"Hertha BSC","Bundesliga","Javairô Dilrosun","NED","FW,MF","22",1998,5.9,5,3,2,2,1,1,6,16.7,5,5,0,5,4,9,3,0,"https://fbref.com/en/players/34a0f5ff/Javairo-Dilrosun"
"6459","Mattéo Guendouzi_2021",2021,"Hertha BSC","Bundesliga","Mattéo Guendouzi","FRA","MF","21",1999,20.2,24,13,10,12,2,9,25,36,16,15,4,11,21,45,24,1,"https://fbref.com/en/players/5ea8ef20/Matteo-Guendouzi"
"6460","Rune Jarstein_2021",2021,"Hertha BSC","Bundesliga","Rune Jarstein","NOR","GK","35",1984,8,0,0,0,0,0,0,0,NA,0,0,0,0,0,0,7,1,"https://fbref.com/en/players/27d2618c/Rune-Jarstein"
"6461","Sami Khedira_2021",2021,"Hertha BSC","Bundesliga","Sami Khedira","GER","MF","33",1987,4.4,11,6,3,7,1,6,12,50,6,4,0,4,9,20,7,0,"https://fbref.com/en/players/38ac43d3/Sami-Khedira"
"6462","Lukas Klünter_2021",2021,"Hertha BSC","Bundesliga","Lukas Klünter","GER","DF","24",1996,11,10,5,6,4,0,5,10,50,5,3,1,2,11,21,29,1,"https://fbref.com/en/players/92948149/Lukas-Klunter"
"6463","Mathew Leckie_2021",2021,"Hertha BSC","Bundesliga","Mathew Leckie","AUS","FW,DF","29",1991,5.6,12,3,5,5,2,4,11,36.4,7,8,0,8,13,25,9,0,"https://fbref.com/en/players/b93b7882/Mathew-Leckie"
"6464","Eduard Löwen_2021",2021,"Hertha BSC","Bundesliga","Eduard Löwen","GER","MF,DF","23",1997,0.9,5,1,3,1,1,2,5,40,3,1,0,1,1,6,1,0,"https://fbref.com/en/players/70678132/Eduard-Lowen"
"6465","Dodi Lukebakio_2021",2021,"Hertha BSC","Bundesliga","Dodi Lukebakio","BEL","FW,MF","22",1997,20.6,21,14,13,5,3,9,20,45,11,14,1,13,12,33,8,0,"https://fbref.com/en/players/0c61c77c/Dodi-Lukebakio"
"6466","Arne Maier_2021",2021,"Hertha BSC","Bundesliga","Arne Maier","GER","MF","21",1999,0.3,1,1,0,1,0,0,1,0,1,0,0,0,0,1,0,0,"https://fbref.com/en/players/ab700320/Arne-Maier"
"6467","Jonas Michel Dirkner_2021",2021,"Hertha BSC","Bundesliga","Jonas Michel Dirkner","GER","MF","18",2002,0.2,0,0,0,0,0,0,0,NA,0,0,0,0,0,0,0,0,"https://fbref.com/en/players/d699d8ef/Jonas-Michel-Dirkner"
"6468","Jonas Michelbrink_2021",2021,"Hertha BSC","Bundesliga","Jonas Michelbrink","GER","MF","19",2001,0.4,0,0,0,0,0,0,0,NA,0,0,0,0,0,0,0,0,"https://fbref.com/en/players/f95d2f9d/Jonas-Michelbrink"
"6469","Maximilian Mittelstädt_2021",2021,"Hertha BSC","Bundesliga","Maximilian Mittelstädt","GER","DF,FW","23",1997,20,66,39,42,21,3,35,72,48.6,37,34,5,29,55,121,61,1,"https://fbref.com/en/players/88d4144a/Maximilian-Mittelstadt"
"6470","Luca Netz_2021",2021,"Hertha BSC","Bundesliga","Luca Netz","GER","DF,FW","17",2003,3.4,14,8,12,2,0,6,17,35.3,11,3,0,3,6,20,8,0,"https://fbref.com/en/players/e79269bd/Luca-Netz"
"6471","Jessic Ngankam_2021",2021,"Hertha BSC","Bundesliga","Jessic Ngankam","GER","FW","20",2000,3.3,5,2,1,2,2,1,3,33.3,2,6,1,5,0,5,1,0,"https://fbref.com/en/players/bc249af8/Jessic-Ngankam"
"6472","Peter Pekarík_2021",2021,"Hertha BSC","Bundesliga","Peter Pekarík","SVK","DF","33",1986,18.8,24,18,17,7,0,17,31,54.8,14,19,8,11,27,51,41,0,"https://fbref.com/en/players/c18d22f5/Peter-Pekarik"
"6473","Krzysztof Piątek_2021",2021,"Hertha BSC","Bundesliga","Krzysztof Piątek","POL","FW","25",1995,18.1,9,4,1,7,1,3,22,13.6,19,11,0,11,6,15,14,0,"https://fbref.com/en/players/17f3620a/Krzysztof-Piatek"
"6474","Marvin Plattenhardt_2021",2021,"Hertha BSC","Bundesliga","Marvin Plattenhardt","GER","DF","28",1992,11.9,15,10,6,7,2,5,9,55.6,4,9,1,8,1,16,19,1,"https://fbref.com/en/players/f7aa75bd/Marvin-Plattenhardt"
"6475","Nemanja Radonjić_2021",2021,"Hertha BSC","Bundesliga","Nemanja Radonjić","SRB","FW,MF","24",1996,6.8,5,3,2,2,1,1,5,20,4,1,0,1,2,7,1,0,"https://fbref.com/en/players/0630eb63/Nemanja-Radonjic"
"6476","Daishawn Redan_2021",2021,"Hertha BSC","Bundesliga","Daishawn Redan","NED","FW,MF","19",2001,1.1,0,0,0,0,0,0,0,NA,0,1,0,1,0,0,0,0,"https://fbref.com/en/players/16b4260e/Daishawn-Redan"
"6477","Alexander Schwolow_2021",2021,"Hertha BSC","Bundesliga","Alexander Schwolow","GER","GK","28",1992,26,0,0,0,0,0,0,0,NA,0,1,0,1,0,0,6,0,"https://fbref.com/en/players/0d55d942/Alexander-Schwolow"
"6478","Niklas Stark_2021",2021,"Hertha BSC","Bundesliga","Niklas Stark","GER","DF,MF","25",1995,31,49,28,20,27,2,13,31,41.9,18,43,16,27,42,91,101,0,"https://fbref.com/en/players/aad48be9/Niklas-Stark"
"6479","Jordan Torunarigha_2021",2021,"Hertha BSC","Bundesliga","Jordan Torunarigha","GER","DF","22",1997,10.8,7,4,7,0,0,5,8,62.5,3,8,2,6,15,22,54,1,"https://fbref.com/en/players/f86cabbd/Jordan-Torunarigha"
"6480","Lucas Tousart_2021",2021,"Hertha BSC","Bundesliga","Lucas Tousart","FRA","MF","23",1997,23.2,33,18,16,15,2,13,27,48.1,14,33,6,27,40,73,52,0,"https://fbref.com/en/players/71ec39ef/Lucas-Tousart"
"6481","Marten Winkler_2021",2021,"Hertha BSC","Bundesliga","Marten Winkler","GER","FW","17",2002,0,0,0,0,0,0,0,0,NA,0,0,0,0,0,0,0,0,"https://fbref.com/en/players/e0d515ef/Marten-Winkler"
"6482","Deyovaisio Zeefuik_2021",2021,"Hertha BSC","Bundesliga","Deyovaisio Zeefuik","NED","DF,FW","22",1998,10.1,13,9,8,3,2,8,19,42.1,11,15,3,12,12,25,36,0,"https://fbref.com/en/players/58a2e9f6/Deyovaisio-Zeefuik"
"6483","Sargis Adamyan_2021",2021,"Hoffenheim","Bundesliga","Sargis Adamyan","ARM","FW,MF","27",1993,5.3,9,4,4,3,2,7,14,50,7,2,0,2,6,15,1,0,"https://fbref.com/en/players/22919e97/Sargis-Adamyan"
"6484","Kevin Akpoguma_2021",2021,"Hoffenheim","Bundesliga","Kevin Akpoguma","NGA","DF","25",1995,13.2,18,12,11,6,1,8,14,57.1,6,28,15,13,13,31,32,2,"https://fbref.com/en/players/6ec6fde0/Kevin-Akpoguma"
"6485","Oliver Baumann_2021",2021,"Hoffenheim","Bundesliga","Oliver Baumann","GER","GK","30",1990,31,0,0,0,0,0,0,1,0,1,0,0,0,2,2,14,0,"https://fbref.com/en/players/47064058/Oliver-Baumann"
"6486","Christoph Baumgartner_2021",2021,"Hoffenheim","Bundesliga","Christoph Baumgartner","AUT","MF,FW","20",1999,26.3,44,31,13,24,7,14,51,27.5,37,40,8,32,24,68,24,0,"https://fbref.com/en/players/437f2b00/Christoph-Baumgartner"
"6487","Ihlas Bebou_2021",2021,"Hoffenheim","Bundesliga","Ihlas Bebou","TOG","FW,MF","26",1994,24.4,24,9,5,10,9,8,14,57.1,6,18,4,14,17,41,16,0,"https://fbref.com/en/players/a53b661f/Ihlas-Bebou"
"6488","Maximilian Beier_2021",2021,"Hoffenheim","Bundesliga","Maximilian Beier","GER","FW,DF","17",2002,0.1,0,0,0,0,0,0,1,0,1,0,0,0,0,0,0,0,"https://fbref.com/en/players/5db45ee5/Maximilian-Beier"
"6489","Ishak Belfodil_2021",2021,"Hoffenheim","Bundesliga","Ishak Belfodil","ALG","FW,MF","28",1992,6.6,3,2,0,0,3,0,2,0,2,1,0,1,1,4,3,0,"https://fbref.com/en/players/ff182fdc/Ishak-Belfodil"
"6490","Ermin Bičakčić_2021",2021,"Hoffenheim","Bundesliga","Ermin Bičakčić","BIH","DF","30",1990,1.4,1,1,0,1,0,1,1,100,0,1,1,0,3,4,9,0,"https://fbref.com/en/players/7aac47fe/Ermin-Bicakcic"
"6491","Melayro Bogarde_2021",2021,"Hoffenheim","Bundesliga","Melayro Bogarde","NED","DF,MF","18",2002,3.1,7,3,3,3,1,5,9,55.6,4,0,0,0,5,12,1,0,"https://fbref.com/en/players/1fda91b3/Melayro-Bogarde"
"6492","Joshua Brenet_2021",2021,"Hoffenheim","Bundesliga","Joshua Brenet","NED","DF","26",1994,0,0,0,0,0,0,0,0,NA,0,0,0,0,0,0,0,0,"https://fbref.com/en/players/2b5527c4/Joshua-Brenet"
"6493","Jacob Bruun Larsen_2021",2021,"Hoffenheim","Bundesliga","Jacob Bruun Larsen","DEN","MF,FW","21",1998,1,0,0,0,0,0,0,0,NA,0,0,0,0,0,0,0,0,"https://fbref.com/en/players/4e204552/Jacob-Bruun-Larsen"
"6494","Moanes Dabbur_2021",2021,"Hoffenheim","Bundesliga","Moanes Dabbur","ISR","FW,MF","28",1992,11.1,6,3,3,1,2,1,13,7.7,12,6,0,6,9,15,7,0,"https://fbref.com/en/players/eac044ad/Moanes-Dabbur"
"6495","Mijat Gaćinović_2021",2021,"Hoffenheim","Bundesliga","Mijat Gaćinović","SRB","DF,MF","25",1995,9.1,18,10,6,11,1,9,24,37.5,15,13,0,13,18,36,15,0,"https://fbref.com/en/players/16daec92/Mijat-Gacinovic"
"6496","Dennis Geiger_2021",2021,"Hoffenheim","Bundesliga","Dennis Geiger","GER","MF","22",1998,7.3,13,10,3,8,2,5,8,62.5,3,10,0,10,3,16,0,0,"https://fbref.com/en/players/37f606f0/Dennis-Geiger"
"6497","Florian Grillitsch_2021",2021,"Hoffenheim","Bundesliga","Florian Grillitsch","AUT","MF,DF","24",1995,20.9,37,21,21,13,3,19,52,36.5,33,38,7,31,51,88,47,1,"https://fbref.com/en/players/ffbbc83b/Florian-Grillitsch"
"6498","Marco John_2021",2021,"Hoffenheim","Bundesliga","Marco John","GER","DF","18",2002,11.1,21,15,9,5,7,10,22,45.5,12,18,1,17,16,37,21,0,"https://fbref.com/en/players/d9e196bf/Marco-John"
"6499","Pavel Kadeřábek_2021",2021,"Hoffenheim","Bundesliga","Pavel Kadeřábek","CZE","DF,FW","28",1992,17.6,15,12,7,6,2,6,15,40,9,12,3,9,18,33,31,0,"https://fbref.com/en/players/79c90e45/Pavel-Kaderabek"
"6500","Klauss_2021",2021,"Hoffenheim","Bundesliga","Klauss","BRA","MF,FW","23",1997,0.6,1,0,0,0,1,0,1,0,1,0,0,0,0,1,0,0,"https://fbref.com/en/players/f5ae006d/Klauss"
"6501","Andrej Kramarić_2021",2021,"Hoffenheim","Bundesliga","Andrej Kramarić","CRO","FW,MF","29",1991,26.4,7,4,4,0,3,3,8,37.5,5,8,1,7,7,14,5,1,"https://fbref.com/en/players/603cb947/Andrej-Kramaric"
"6502","Håvard Nordtveit_2021",2021,"Hoffenheim","Bundesliga","Håvard Nordtveit","NOR","DF","30",1990,7.8,6,2,5,1,0,6,8,75,2,4,2,2,13,19,42,0,"https://fbref.com/en/players/6cafd68d/Havard-Nordtveit"
"6503","Kasim Nuhu_2021",2021,"Hoffenheim","Bundesliga","Kasim Nuhu","GHA","DF","25",1995,11,13,7,9,4,0,6,10,60,4,8,3,5,15,28,38,0,"https://fbref.com/en/players/93a50d2c/Kasim-Nuhu"
"6504","Philipp Pentke_2021",2021,"Hoffenheim","Bundesliga","Philipp Pentke","GER","GK","35",1985,3,0,0,0,0,0,0,0,NA,0,0,0,0,0,0,0,0,"https://fbref.com/en/players/c41f7379/Philipp-Pentke"
"6505","Stefan Posch_2021",2021,"Hoffenheim","Bundesliga","Stefan Posch","AUT","DF","23",1997,23.5,52,24,29,17,6,27,47,57.4,20,27,8,19,37,89,73,1,"https://fbref.com/en/players/7f609bfc/Stefan-Posch"
"6506","Chris Richards_2021",2021,"Hoffenheim","Bundesliga","Chris Richards","USA","DF","20",2000,10.5,19,8,12,6,1,10,16,62.5,6,13,4,9,21,40,40,1,"https://fbref.com/en/players/0a3d6d2b/Chris-Richards"
"6507","Sebastian Rudy_2021",2021,"Hoffenheim","Bundesliga","Sebastian Rudy","GER","MF,FW","30",1990,18.6,35,26,15,15,5,16,45,35.6,29,24,4,20,13,48,21,1,"https://fbref.com/en/players/80f36c88/Sebastian-Rudy"
"6508","Georginio Rutter_2021",2021,"Hoffenheim","Bundesliga","Georginio Rutter","FRA","FW","18",2002,2.7,4,4,2,2,0,1,2,50,1,2,0,2,0,4,2,0,"https://fbref.com/en/players/c64c01fc/Georginio-Rutter"
"6509","Diadie Samassékou_2021",2021,"Hoffenheim","Bundesliga","Diadie Samassékou","MLI","MF","24",1996,28.5,71,41,22,42,7,33,90,36.7,57,41,12,29,78,149,50,0,"https://fbref.com/en/players/08593525/Diadie-Samassekou"
"6510","Ryan Sessegnon_2021",2021,"Hoffenheim","Bundesliga","Ryan Sessegnon","ENG","DF,FW","20",2000,17.5,47,25,26,13,8,15,34,44.1,19,26,3,23,30,77,46,0,"https://fbref.com/en/players/6aa3e78b/Ryan-Sessegnon"
"6511","Robert Skov_2021",2021,"Hoffenheim","Bundesliga","Robert Skov","DEN","FW,MF","24",1996,12.9,19,10,9,7,3,7,16,43.8,9,9,2,7,15,34,10,1,"https://fbref.com/en/players/ff98492b/Robert-Skov"
"6512","Kevin Vogt_2021",2021,"Hoffenheim","Bundesliga","Kevin Vogt","GER","DF","28",1991,20.5,18,12,11,6,1,12,21,57.1,9,21,12,9,16,34,71,0,"https://fbref.com/en/players/1d8e9add/Kevin-Vogt"
"6513","Juan Carlos_2021",2021,"Huesca","La Liga","Juan Carlos","ESP","MF,FW","29",1991,3.2,5,3,4,1,0,2,15,13.3,13,7,0,7,1,6,1,0,"https://fbref.com/en/players/82803509/Juan-Carlos"
"6514","Idrissa Doumbia_2021",2021,"Huesca","La Liga","Idrissa Doumbia","CIV","MF","22",1998,8.7,15,8,6,7,2,5,13,38.5,8,6,3,3,7,22,9,0,"https://fbref.com/en/players/685857dc/Idrissa-Doumbia"
"6515","Dani Escriche_2021",2021,"Huesca","La Liga","Dani Escriche","ESP","FW,MF","22",1998,9.5,9,7,5,2,2,3,10,30,7,11,0,11,8,17,5,0,"https://fbref.com/en/players/5a36f180/Dani-Escriche"
"6516","Álvaro Fernández_2021",2021,"Huesca","La Liga","Álvaro Fernández","ESP","GK","22",1998,22,1,1,0,1,0,1,3,33.3,2,0,0,0,2,3,7,0,"https://fbref.com/en/players/f127d782/Alvaro-Fernandez"
"6517","Andrés Fernández_2021",2021,"Huesca","La Liga","Andrés Fernández","ESP","GK","33",1986,16,0,0,0,0,0,0,0,NA,0,0,0,0,0,0,3,2,"https://fbref.com/en/players/307fcd26/Andres-Fernandez"
"6518","David Ferreiro_2021",2021,"Huesca","La Liga","David Ferreiro","ESP","MF,FW","32",1988,28.1,25,12,12,8,5,8,49,16.3,41,21,1,20,25,50,15,0,"https://fbref.com/en/players/8970907e/David-Ferreiro"
"6519","Javi Galán_2021",2021,"Huesca","La Liga","Javi Galán","ESP","DF","25",1994,34.1,88,54,47,35,6,46,72,63.9,26,30,4,26,39,127,61,0,"https://fbref.com/en/players/a4b00319/Javi-Galan"
"6520","Borja García_2021",2021,"Huesca","La Liga","Borja García","ESP","MF,FW","29",1990,12.4,13,7,4,6,3,6,12,50,6,12,0,12,10,23,4,1,"https://fbref.com/en/players/e7f4603c/Borja-Garcia"
"6521","Sergio Gómez_2021",2021,"Huesca","La Liga","Sergio Gómez","ESP","MF,FW","19",2000,8.8,29,10,17,9,3,11,22,50,11,15,0,15,14,43,9,0,"https://fbref.com/en/players/01e5f06e/Sergio-Gomez"
"6522","Pablo Insua_2021",2021,"Huesca","La Liga","Pablo Insua","ESP","DF","26",1993,17.6,37,18,26,9,2,14,31,45.2,17,14,8,6,24,61,68,0,"https://fbref.com/en/players/4b5e7e90/Pablo-Insua"
"6523","Pedro López Muñoz_2021",2021,"Huesca","La Liga","Pedro López Muñoz","ESP","DF","36",1983,11.9,23,15,10,8,5,15,22,68.2,7,10,4,6,16,39,23,1,"https://fbref.com/en/players/a60823a4/Pedro-Lopez-Munoz"
"6524","Luisinho_2021",2021,"Huesca","La Liga","Luisinho","POR","DF","35",1985,2,3,3,2,1,0,1,3,33.3,2,3,0,3,4,7,7,0,"https://fbref.com/en/players/a7f00c8c/Luisinho"
"6525","Pablo Maffeo_2021",2021,"Huesca","La Liga","Pablo Maffeo","ESP","DF","23",1997,21.8,26,17,21,4,1,12,26,46.2,14,18,6,12,35,61,27,0,"https://fbref.com/en/players/5db04597/Pablo-Maffeo"
"6526","Rafa Mir_2021",2021,"Huesca","La Liga","Rafa Mir","ESP","FW","23",1997,32,15,9,4,4,7,7,22,31.8,15,14,2,12,15,30,25,0,"https://fbref.com/en/players/bbf5c11b/Rafa-Mir"
"6527","Pedro Mosquera_2021",2021,"Huesca","La Liga","Pedro Mosquera","ESP","MF","32",1988,22.8,38,18,19,18,1,13,53,24.5,40,23,6,17,31,69,38,1,"https://fbref.com/en/players/c5fa58ea/Pedro-Mosquera"
"6528","Joaquín Muñoz_2021",2021,"Huesca","La Liga","Joaquín Muñoz","ESP","FW","21",1999,0.5,0,0,0,0,0,0,2,0,2,0,0,0,1,1,0,0,"https://fbref.com/en/players/e9fbcc21/Joaquin-Munoz"
"6529","Kelechi Nwakali_2021",2021,"Huesca","La Liga","Kelechi Nwakali","NGA","MF,FW","22",1998,1.6,4,3,1,2,1,0,4,0,4,1,0,1,1,5,1,0,"https://fbref.com/en/players/877f31c2/Kelechi-Nwakali"
"6530","Shinji Okazaki_2021",2021,"Huesca","La Liga","Shinji Okazaki","JPN","FW,MF","34",1986,12.5,7,5,5,0,2,0,5,0,5,5,0,5,4,11,6,0,"https://fbref.com/en/players/68796d61/Shinji-Okazaki"
"6531","Javier Ontiveros_2021",2021,"Huesca","La Liga","Javier Ontiveros","ESP","FW,MF","22",1997,10.2,21,14,10,10,1,9,26,34.6,17,12,0,12,9,30,6,0,"https://fbref.com/en/players/a83d8b0c/Javier-Ontiveros"
"6532","Jorge Pulido_2021",2021,"Huesca","La Liga","Jorge Pulido","ESP","DF","29",1991,32.1,39,24,31,8,0,17,29,58.6,12,32,18,14,52,91,98,0,"https://fbref.com/en/players/978cd030/Jorge-Pulido"
"6533","Sandro Ramírez_2021",2021,"Huesca","La Liga","Sandro Ramírez","ESP","FW","25",1995,14.3,13,9,3,8,2,4,11,36.4,7,11,1,10,10,23,2,0,"https://fbref.com/en/players/833fb62e/Sandro-Ramirez"
"6534","Mikel Rico_2021",2021,"Huesca","La Liga","Mikel Rico","ESP","MF","35",1984,24.3,24,12,14,8,2,11,34,32.4,23,20,3,17,23,47,22,0,"https://fbref.com/en/players/def69cd0/Mikel-Rico"
"6535","Jaime Seoane_2021",2021,"Huesca","La Liga","Jaime Seoane","ESP","MF","23",1997,22.9,50,30,20,23,7,24,65,36.9,41,27,6,21,17,67,14,0,"https://fbref.com/en/players/a62b4888/Jaime-Seoane"
"6536","Gastón Silva_2021",2021,"Huesca","La Liga","Gastón Silva","URU","DF","26",1994,6.7,16,12,11,5,0,8,14,57.1,6,10,4,6,11,27,16,0,"https://fbref.com/en/players/47d493c3/Gaston-Silva"
"6537","Dimitris Siovas_2021",2021,"Huesca","La Liga","Dimitris Siovas","GRE","DF","31",1988,34.1,46,24,34,10,2,20,30,66.7,10,38,17,21,62,108,125,2,"https://fbref.com/en/players/92d38e6c/Dimitris-Siovas"
"6538","Eugeni Valderrama_2021",2021,"Huesca","La Liga","Eugeni Valderrama","ESP","MF,FW","26",1994,1.3,2,2,1,0,1,0,1,0,1,0,0,0,5,7,3,0,"https://fbref.com/en/players/a75b4071/Eugeni-Valderrama"
"6539","Denis Vavro_2021",2021,"Huesca","La Liga","Denis Vavro","SVK","DF","24",1996,6.8,7,4,2,4,1,2,5,40,3,2,0,2,11,18,21,0,"https://fbref.com/en/players/08990838/Denis-Vavro"
"6540","Nicolò Barella_2021",2021,"Inter","Serie A","Nicolò Barella","ITA","MF","23",1997,32.2,58,31,23,29,6,23,72,31.9,49,29,4,25,26,84,14,0,"https://fbref.com/en/players/6928979a/Nicolo-Barella"
"6541","Alessandro Bastoni_2021",2021,"Inter","Serie A","Alessandro Bastoni","ITA","DF","21",1999,32.5,36,22,13,21,2,17,27,63,10,34,16,18,40,76,75,0,"https://fbref.com/en/players/75b86fb3/Alessandro-Bastoni"
"6542","Marcelo Brozović_2021",2021,"Inter","Serie A","Marcelo Brozović","CRO","MF","27",1992,28.7,54,29,23,24,7,20,61,32.8,41,43,17,26,40,94,38,0,"https://fbref.com/en/players/33b8d077/Marcelo-Brozovic"
"6543","Danilo D'Ambrosio_2021",2021,"Inter","Serie A","Danilo D'Ambrosio","ITA","DF","31",1988,7.8,15,9,6,7,2,6,15,40,9,9,7,2,4,19,15,0,"https://fbref.com/en/players/44eb9093/Danilo-DAmbrosio"
"6544","Matteo Darmian_2021",2021,"Inter","Serie A","Matteo Darmian","ITA","DF","30",1989,12.9,30,16,12,7,11,16,28,57.1,12,9,2,7,17,47,35,0,"https://fbref.com/en/players/96e0490d/Matteo-Darmian"
"6545","Christian Eriksen_2021",2021,"Inter","Serie A","Christian Eriksen","DEN","MF","28",1992,15.4,12,6,6,4,2,7,20,35,13,16,1,15,9,21,13,1,"https://fbref.com/en/players/980522ec/Christian-Eriksen"
"6546","Roberto Gagliardini_2021",2021,"Inter","Serie A","Roberto Gagliardini","ITA","MF","26",1994,13.7,30,17,17,8,5,5,28,17.9,23,15,3,12,19,49,16,0,"https://fbref.com/en/players/ce30bfc8/Roberto-Gagliardini"
"6547","Achraf Hakimi_2021",2021,"Inter","Serie A","Achraf Hakimi","MAR","DF","21",1998,29.6,53,32,23,19,11,23,48,47.9,25,31,1,30,22,75,23,1,"https://fbref.com/en/players/e42d61c7/Achraf-Hakimi"
"6548","Samir Handanović_2021",2021,"Inter","Serie A","Samir Handanović","SVN","GK","36",1984,36,1,0,1,0,0,1,1,100,0,0,0,0,0,1,6,3,"https://fbref.com/en/players/74419746/Samir-Handanovic"
"6549","Aleksandar Kolarov_2021",2021,"Inter","Serie A","Aleksandar Kolarov","SRB","DF","34",1985,4.3,4,4,0,4,0,1,2,50,1,2,0,2,7,11,8,0,"https://fbref.com/en/players/eda40760/Aleksandar-Kolarov"
"6550","Romelu Lukaku_2021",2021,"Inter","Serie A","Romelu Lukaku","BEL","FW","27",1993,32,11,1,1,6,4,6,14,42.9,8,11,1,10,3,14,34,0,"https://fbref.com/en/players/5eae500a/Romelu-Lukaku"
"6551","Lautaro Martínez_2021",2021,"Inter","Serie A","Lautaro Martínez","ARG","FW","22",1997,28.5,25,12,5,11,9,7,24,29.2,17,31,1,30,27,52,16,0,"https://fbref.com/en/players/f7036e1c/Lautaro-Martinez"
"6552","Radja Nainggolan_2021",2021,"Inter","Serie A","Radja Nainggolan","BEL","MF","32",1988,0.5,0,0,0,0,0,0,0,NA,0,0,0,0,1,1,0,0,"https://fbref.com/en/players/1f9328da/Radja-Nainggolan"
"6553","Daniele Padelli_2021",2021,"Inter","Serie A","Daniele Padelli","ITA","GK","34",1985,0.5,0,0,0,0,0,0,0,NA,0,0,0,0,0,0,0,0,"https://fbref.com/en/players/cf1c23d8/Daniele-Padelli"
"6554","Ivan Perišić_2021",2021,"Inter","Serie A","Ivan Perišić","CRO","DF,FW","31",1989,19.9,22,13,11,6,5,12,33,36.4,21,33,4,29,19,41,36,1,"https://fbref.com/en/players/6fe90922/Ivan-Perisic"
"6555","Andrea Pinamonti_2021",2021,"Inter","Serie A","Andrea Pinamonti","ITA","FW","21",1999,1.9,0,0,0,0,0,0,0,NA,0,1,0,1,1,1,2,0,"https://fbref.com/en/players/08aa9cd1/Andrea-Pinamonti"
"6556","Ionuț Radu_2021",2021,"Inter","Serie A","Ionuț Radu","ROU","GK","23",1997,1.5,0,0,0,0,0,0,0,NA,0,0,0,0,0,0,1,0,"https://fbref.com/en/players/67f649be/Ionut-Radu"
"6557","Andrea Ranocchia_2021",2021,"Inter","Serie A","Andrea Ranocchia","ITA","DF","32",1988,7.8,13,10,6,6,1,7,8,87.5,1,5,3,2,12,25,19,0,"https://fbref.com/en/players/539230cf/Andrea-Ranocchia"
"6558","Alexis Sánchez_2021",2021,"Inter","Serie A","Alexis Sánchez","CHI","FW","31",1988,12.7,14,8,4,4,6,5,18,27.8,13,11,0,11,7,21,1,1,"https://fbref.com/en/players/2c0f8e9e/Alexis-Sanchez"
"6559","Stefano Sensi_2021",2021,"Inter","Serie A","Stefano Sensi","ITA","MF","24",1995,6.7,9,6,3,5,1,4,11,36.4,7,6,1,5,7,16,1,0,"https://fbref.com/en/players/b70bde8f/Stefano-Sensi"
"6560","Milan Škriniar_2021",2021,"Inter","Serie A","Milan Škriniar","SVK","DF","25",1995,30.9,48,32,29,16,3,23,34,67.6,11,30,19,11,30,78,89,1,"https://fbref.com/en/players/30f5ffa9/Milan-Skriniar"
"6561","Matías Vecino_2021",2021,"Inter","Serie A","Matías Vecino","URU","MF","28",1991,3.1,1,1,0,0,1,0,5,0,5,7,1,6,4,5,3,0,"https://fbref.com/en/players/44ac04e9/Matias-Vecino"
"6562","Arturo Vidal_2021",2021,"Inter","Serie A","Arturo Vidal","CHI","MF","33",1987,12.6,27,14,8,13,6,12,41,29.3,29,23,3,20,29,56,11,0,"https://fbref.com/en/players/67cdbc0e/Arturo-Vidal"
"6563","Stefan de Vrij_2021",2021,"Inter","Serie A","Stefan de Vrij","NED","DF","28",1992,30.4,28,16,15,12,1,15,24,62.5,9,24,18,6,41,69,95,0,"https://fbref.com/en/players/d0d8dd44/Stefan-de-Vrij"
"6564","Ashley Young_2021",2021,"Inter","Serie A","Ashley Young","ENG","DF","35",1985,15.8,15,7,8,4,3,3,13,23.1,10,13,0,13,6,21,31,0,"https://fbref.com/en/players/be927d03/Ashley-Young"
"6565","Rodrigo Bentancur_2021",2021,"Juventus","Serie A","Rodrigo Bentancur","URU","MF","23",1997,25.8,63,33,21,37,5,20,59,33.9,39,35,12,23,47,110,46,1,"https://fbref.com/en/players/3b8674e6/Rodrigo-Bentancur"
"6566","Federico Bernardeschi_2021",2021,"Juventus","Serie A","Federico Bernardeschi","ITA","MF,DF","26",1994,10.8,9,4,3,5,1,4,20,20,16,6,2,4,14,23,7,1,"https://fbref.com/en/players/ee93c1a9/Federico-Bernardeschi"
"6567","Leonardo Bonucci_2021",2021,"Juventus","Serie A","Leonardo Bonucci","ITA","DF","33",1987,22.5,19,14,10,8,1,6,14,42.9,8,24,13,11,33,52,67,0,"https://fbref.com/en/players/52ec54d0/Leonardo-Bonucci"
"6568","Gianluigi Buffon_2021",2021,"Juventus","Serie A","Gianluigi Buffon","ITA","GK","42",1978,8,0,0,0,0,0,0,0,NA,0,0,0,0,0,0,3,1,"https://fbref.com/en/players/e40d028b/Gianluigi-Buffon"
"6569","Giorgio Chiellini_2021",2021,"Juventus","Serie A","Giorgio Chiellini","ITA","DF","35",1984,15.4,12,9,9,3,0,5,11,45.5,6,18,13,5,27,39,56,0,"https://fbref.com/en/players/e85fb9b8/Giorgio-Chiellini"
"6570","Federico Chiesa_2021",2021,"Juventus","Serie A","Federico Chiesa","ITA","MF,DF","22",1997,24.6,47,26,21,14,12,19,50,38,31,23,1,22,12,59,16,0,"https://fbref.com/en/players/b0f7e36c/Federico-Chiesa"
"6571","Félix Correia_2021",2021,"Juventus","Serie A","Félix Correia","POR","MF","19",2001,0.1,0,0,0,0,0,0,0,NA,0,0,0,0,0,0,1,0,"https://fbref.com/en/players/c803c92a/Felix-Correia"
"6572","Douglas Costa_2021",2021,"Juventus","Serie A","Douglas Costa","BRA","MF,FW","29",1990,0.5,1,0,1,0,0,1,3,33.3,2,0,0,0,0,1,0,0,"https://fbref.com/en/players/4fa7cb9b/Douglas-Costa"
"6573","Juan Cuadrado_2021",2021,"Juventus","Serie A","Juan Cuadrado","COL","DF,MF","32",1988,24.2,43,25,22,15,6,29,60,48.3,31,16,2,14,43,86,22,2,"https://fbref.com/en/players/0ab1f153/Juan-Cuadrado"
"6574","Danilo_2021",2021,"Juventus","Serie A","Danilo","BRA","DF,MF","29",1991,32.4,62,31,37,16,9,35,66,53,31,32,12,20,66,128,68,2,"https://fbref.com/en/players/94b2001f/Danilo"
"6575","Mattia De Sciglio_2021",2021,"Juventus","Serie A","Mattia De Sciglio","ITA","DF","27",1992,0.3,0,0,0,0,0,0,0,NA,0,0,0,0,0,0,1,0,"https://fbref.com/en/players/ae4e2852/Mattia-De-Sciglio"
"6576","Merih Demiral_2021",2021,"Juventus","Serie A","Merih Demiral","TUR","DF","22",1998,10.4,12,9,8,4,0,5,13,38.5,8,16,9,7,21,33,40,0,"https://fbref.com/en/players/e3cceee6/Merih-Demiral"
"6577","Alessandro Di Pardo_2021",2021,"Juventus","Serie A","Alessandro Di Pardo","ITA","FW,DF","21",1999,0.2,0,0,0,0,0,0,0,NA,0,1,1,0,0,0,0,0,"https://fbref.com/en/players/e0ce7038/Alessandro-Di-Pardo"
"6578","Radu Drăgușin_2021",2021,"Juventus","Serie A","Radu Drăgușin","ROU","DF","18",2002,0,0,0,0,0,0,0,0,NA,0,0,0,0,0,0,0,0,"https://fbref.com/en/players/620922ed/Radu-Dragusin"
"6579","Paulo Dybala_2021",2021,"Juventus","Serie A","Paulo Dybala","ARG","FW","26",1993,12.6,14,8,3,4,7,2,14,14.3,12,15,0,15,1,15,1,0,"https://fbref.com/en/players/e0921a4f/Paulo-Dybala"
"6580","Nicolò Fagioli_2021",2021,"Juventus","Serie A","Nicolò Fagioli","ITA","MF","19",2001,0.2,0,0,0,0,0,0,0,NA,0,0,0,0,0,0,1,0,"https://fbref.com/en/players/366be751/Nicolo-Fagioli"
"6581","Gianluca Frabotta_2021",2021,"Juventus","Serie A","Gianluca Frabotta","ITA","DF,MF","21",1999,7.7,7,4,5,0,2,5,12,41.7,7,9,1,8,14,21,15,0,"https://fbref.com/en/players/d80b1835/Gianluca-Frabotta"
"6582","Dejan Kulusevski_2021",2021,"Juventus","Serie A","Dejan Kulusevski","SWE","MF,FW","20",2000,21.4,33,19,12,10,11,14,43,32.6,29,22,0,22,9,42,2,1,"https://fbref.com/en/players/df3cda47/Dejan-Kulusevski"
"6583","Matthijs de Ligt_2021",2021,"Juventus","Serie A","Matthijs de Ligt","NED","DF","20",1999,24.7,37,19,20,16,1,18,28,64.3,10,42,21,21,31,68,64,0,"https://fbref.com/en/players/d6e53a3a/Matthijs-de-Ligt"
"6584","Weston McKennie_2021",2021,"Juventus","Serie A","Weston McKennie","USA","MF","21",1998,18.9,34,19,9,20,5,12,33,36.4,21,21,3,18,28,62,26,0,"https://fbref.com/en/players/01c3aff5/Weston-McKennie"
"6585","Arthur Melo_2021",2021,"Juventus","Serie A","Arthur Melo","BRA","MF","23",1996,12.9,17,9,7,10,0,12,31,38.7,19,6,1,5,18,35,9,1,"https://fbref.com/en/players/48b3dd60/Arthur-Melo"
"6586","Álvaro Morata_2021",2021,"Juventus","Serie A","Álvaro Morata","ESP","FW","27",1992,22.4,17,12,2,10,5,4,28,14.3,24,22,2,20,5,22,21,0,"https://fbref.com/en/players/129af0db/Alvaro-Morata"
"6587","Carlo Pinsoglio_2021",2021,"Juventus","Serie A","Carlo Pinsoglio","ITA","GK","30",1990,0.3,0,0,0,0,0,0,0,NA,0,0,0,0,0,0,0,0,"https://fbref.com/en/players/f6a06749/Carlo-Pinsoglio"
"6588","Manolo Portanova_2021",2021,"Juventus","Serie A","Manolo Portanova","ITA","MF","20",2000,0.8,2,0,2,0,0,0,2,0,2,4,1,3,0,2,1,0,"https://fbref.com/en/players/c8c0dccd/Manolo-Portanova"
"6589","Adrien Rabiot_2021",2021,"Juventus","Serie A","Adrien Rabiot","FRA","MF","25",1995,25.7,72,42,24,41,7,28,60,46.7,32,32,11,21,43,115,29,1,"https://fbref.com/en/players/8794e251/Adrien-Rabiot"
"6590","Aaron Ramsey_2021",2021,"Juventus","Serie A","Aaron Ramsey","WAL","MF","29",1990,12.1,22,14,8,13,1,8,25,32,17,13,2,11,7,29,8,2,"https://fbref.com/en/players/ef619b0b/Aaron-Ramsey"
"6591","Cristiano Ronaldo_2021",2021,"Juventus","Serie A","Cristiano Ronaldo","POR","FW","35",1985,31.1,6,3,1,3,2,3,15,20,12,11,3,8,5,11,15,1,"https://fbref.com/en/players/dea698d9/Cristiano-Ronaldo"
"6592","Alex Sandro_2021",2021,"Juventus","Serie A","Alex Sandro","BRA","DF","29",1991,20.6,37,23,19,13,5,13,25,52,12,20,4,16,31,68,57,0,"https://fbref.com/en/players/0d82903c/Alex-Sandro"
"6593","Wojciech Szczęsny_2021",2021,"Juventus","Serie A","Wojciech Szczęsny","POL","GK","30",1990,29.7,0,0,0,0,0,0,0,NA,0,2,0,2,3,3,5,1,"https://fbref.com/en/players/01b8a2b2/Wojciech-Szczesny"
"6594","Giacomo Vrioni_2021",2021,"Juventus","Serie A","Giacomo Vrioni","ALB","FW","21",1998,0,0,0,0,0,0,0,0,NA,0,0,0,0,0,0,0,0,"https://fbref.com/en/players/bf4d31d3/Giacomo-Vrioni"
"6595","Sebastian Andersson_2021",2021,"Köln","Bundesliga","Sebastian Andersson","SWE","FW","29",1991,12.5,3,2,0,3,0,1,8,12.5,7,10,3,7,2,5,9,0,"https://fbref.com/en/players/b4cf5806/Sebastian-Andersson"
"6596","Toluwalase Arokodare_2021",2021,"Köln","Bundesliga","Toluwalase Arokodare","NGA","FW,MF","19",2000,1.2,1,1,0,0,1,0,0,NA,0,1,0,1,1,2,0,0,"https://fbref.com/en/players/a42760bc/Toluwalase-Arokodare"
"6597","Sebastiaan Bornauw_2021",2021,"Köln","Bundesliga","Sebastiaan Bornauw","BEL","DF","21",1999,23.1,29,20,25,4,0,14,25,56,11,33,26,7,40,69,104,0,"https://fbref.com/en/players/01834aa0/Sebastiaan-Bornauw"
"6598","Sava Cestic_2021",2021,"Köln","Bundesliga","Sava Cestic","SRB","DF","19",2001,10,20,9,12,6,2,8,17,47.1,9,13,4,9,18,38,40,0,"https://fbref.com/en/players/0b7dae21/Sava-Cestic"
"6599","Rafael Czichos_2021",2021,"Köln","Bundesliga","Rafael Czichos","GER","DF","30",1990,25.1,48,24,33,13,2,23,42,54.8,19,25,9,16,53,101,109,0,"https://fbref.com/en/players/b0a0698b/Rafael-Czichos"
"6600","Emmanuel Dennis_2021",2021,"Köln","Bundesliga","Emmanuel Dennis","NGA","FW","22",1997,5.3,13,7,6,5,2,1,6,16.7,5,6,0,6,0,13,0,1,"https://fbref.com/en/players/2c44a35d/Emmanuel-Dennis"
"6601","Dominick Drexler_2021",2021,"Köln","Bundesliga","Dominick Drexler","GER","MF,FW","30",1990,13.7,36,26,15,18,3,12,30,40,18,5,1,4,14,50,15,0,"https://fbref.com/en/players/809940aa/Dominick-Drexler"
"6602","Ondrej Duda_2021",2021,"Köln","Bundesliga","Ondrej Duda","SVK","FW,MF","25",1994,28.2,36,14,13,18,5,8,39,20.5,31,28,2,26,19,55,20,0,"https://fbref.com/en/players/79ca3e23/Ondrej-Duda"
"6603","Kingsley Ehizibue_2021",2021,"Köln","Bundesliga","Kingsley Ehizibue","NED","DF","25",1995,12.6,32,19,22,9,1,10,17,58.8,7,19,5,14,18,50,42,0,"https://fbref.com/en/players/76b2817e/Kingsley-Ehizibue"
"6604","Jonas Hector_2021",2021,"Köln","Bundesliga","Jonas Hector","GER","MF,FW","30",1990,14.3,34,22,8,21,5,15,35,42.9,20,24,5,19,19,53,20,1,"https://fbref.com/en/players/c2009df3/Jonas-Hector"
"6605","Marco Höger_2021",2021,"Köln","Bundesliga","Marco Höger","GER","DF,MF","30",1989,0.6,1,0,0,1,0,1,2,50,1,2,0,2,2,3,1,0,"https://fbref.com/en/players/4114f306/Marco-Hoger"
"6606","Jannes Horn_2021",2021,"Köln","Bundesliga","Jannes Horn","GER","DF","23",1997,19.6,35,19,23,11,1,23,31,74.2,8,19,2,17,10,45,45,0,"https://fbref.com/en/players/2b83fa49/Jannes-Horn"
"6607","Timo Horn_2021",2021,"Köln","Bundesliga","Timo Horn","GER","GK","27",1993,33.4,1,0,1,0,0,1,4,25,3,1,0,1,0,1,11,2,"https://fbref.com/en/players/3cd9e95a/Timo-Horn"
"6608","Ismail Jakobs_2021",2021,"Köln","Bundesliga","Ismail Jakobs","SEN","MF,FW","20",1999,19.2,25,10,17,4,4,11,21,52.4,10,18,1,17,16,41,36,0,"https://fbref.com/en/players/a0415710/Ismail-Jakobs"
"6609","Florian Kainz_2021",2021,"Köln","Bundesliga","Florian Kainz","AUT","MF,FW","27",1992,5,4,2,0,4,0,2,8,25,6,7,0,7,3,7,3,0,"https://fbref.com/en/players/94c18565/Florian-Kainz"
"6610","Noah Katterbach_2021",2021,"Köln","Bundesliga","Noah Katterbach","GER","DF,MF","19",2001,12.3,18,11,11,6,1,13,21,61.9,8,7,3,4,23,41,22,0,"https://fbref.com/en/players/e27de4fa/Noah-Katterbach"
"6611","Dimitris Limnios_2021",2021,"Köln","Bundesliga","Dimitris Limnios","GRE","MF,FW","22",1998,4.2,9,6,3,5,1,5,6,83.3,1,5,0,5,2,11,1,0,"https://fbref.com/en/players/62c7067a/Dimitris-Limnios"
"6612","Jorge Meré_2021",2021,"Köln","Bundesliga","Jorge Meré","ESP","DF","23",1997,14.4,13,6,9,3,1,6,13,46.2,7,14,11,3,15,28,63,0,"https://fbref.com/en/players/9f979eb2/Jorge-Mere"
"6613","Max Meyer_2021",2021,"Köln","Bundesliga","Max Meyer","GER","MF","24",1995,3.9,7,4,3,3,1,4,8,50,4,4,1,3,3,10,1,0,"https://fbref.com/en/players/eba42d2b/Max-Meyer"
"6614","Anthony Modeste_2021",2021,"Köln","Bundesliga","Anthony Modeste","FRA","FW","32",1988,2.5,2,0,0,2,0,0,1,0,1,0,0,0,0,2,2,0,"https://fbref.com/en/players/34e4343c/Anthony-Modeste"
"6615","Salih Özcan_2021",2021,"Köln","Bundesliga","Salih Özcan","TUR","MF","22",1998,15.2,21,13,11,10,0,12,33,36.4,21,11,2,9,20,41,14,1,"https://fbref.com/en/players/15413fa5/Salih-Ozcan"
"6616","Elvis Rexhbeçaj_2021",2021,"Köln","Bundesliga","Elvis Rexhbeçaj","GER","MF,FW","22",1997,20.4,53,32,17,27,9,19,53,35.8,34,32,7,25,26,79,18,0,"https://fbref.com/en/players/1ae836b1/Elvis-Rexhbecaj"
"6617","Benno Schmitz_2021",2021,"Köln","Bundesliga","Benno Schmitz","GER","DF","25",1994,4.6,14,7,6,7,1,7,13,53.8,6,8,2,6,6,20,7,0,"https://fbref.com/en/players/ad00b1a8/Benno-Schmitz"
"6618","Ellyes Skhiri_2021",2021,"Köln","Bundesliga","Ellyes Skhiri","TUN","MF","25",1995,30.9,83,48,44,31,8,33,65,50.8,32,49,13,36,82,165,38,2,"https://fbref.com/en/players/c2211709/Ellyes-Skhiri"
"6619","Frederik Sørensen_2021",2021,"Köln","Bundesliga","Frederik Sørensen","DEN","DF","28",1992,1.1,2,1,0,2,0,1,1,100,0,2,0,2,0,2,0,0,"https://fbref.com/en/players/68635c10/Frederik-Sorensen"
"6620","Jan Thielmann_2021",2021,"Köln","Bundesliga","Jan Thielmann","GER","FW,MF","18",2002,11.4,11,6,1,8,2,5,9,55.6,4,10,1,9,9,20,2,0,"https://fbref.com/en/players/fd53759d/Jan-Thielmann"
"6621","Marius Wolf_2021",2021,"Köln","Bundesliga","Marius Wolf","GER","MF,DF","25",1995,28.3,35,19,19,13,3,13,38,34.2,25,29,3,26,28,63,47,1,"https://fbref.com/en/players/fa661778/Marius-Wolf"
"6622","Ron-Robert Zieler_2021",2021,"Köln","Bundesliga","Ron-Robert Zieler","GER","GK","31",1989,0.6,0,0,0,0,0,0,0,NA,0,0,0,0,0,0,0,0,"https://fbref.com/en/players/a0606ae8/Ron-Robert-Zieler"
"6623","Francesco Acerbi_2021",2021,"Lazio","Serie A","Francesco Acerbi","ITA","DF","32",1988,31.3,51,32,34,13,4,18,40,45,22,24,15,9,76,127,121,2,"https://fbref.com/en/players/b96b595c/Francesco-Acerbi"
"6624","Jean-Daniel Akpa-Akpro_2021",2021,"Lazio","Serie A","Jean-Daniel Akpa-Akpro","CIV","MF","27",1992,11.7,38,25,13,22,3,8,27,29.6,19,24,6,18,18,56,13,0,"https://fbref.com/en/players/fdf4b948/Jean-Daniel-Akpa-Akpro"
"6625","Luis Alberto_2021",2021,"Lazio","Serie A","Luis Alberto","ESP","MF","27",1992,29.1,43,24,15,19,9,15,73,20.5,58,41,2,39,13,56,11,1,"https://fbref.com/en/players/5294a83f/Luis-Alberto"
"6626","Djavan Anderson_2021",2021,"Lazio","Serie A","Djavan Anderson","NED","DF","25",1995,0.8,0,0,0,0,0,0,1,0,1,1,0,1,1,1,0,0,"https://fbref.com/en/players/ca241ad3/Djavan-Anderson"
"6627","Nicolò Armini_2021",2021,"Lazio","Serie A","Nicolò Armini","ITA","DF","19",2001,0.1,0,0,0,0,0,0,0,NA,0,0,0,0,0,0,0,0,"https://fbref.com/en/players/2f7407fa/Nicolo-Armini"
"6628","Bastos_2021",2021,"Lazio","Serie A","Bastos","ANG","DF","29",1991,0.7,3,1,2,0,1,3,5,60,2,1,0,1,0,3,3,0,"https://fbref.com/en/players/c01c66d9/Bastos"
"6629","Marco Bertini_2021",2021,"Lazio","Serie A","Marco Bertini","ITA","MF","17",2002,0.1,1,0,1,0,0,0,0,NA,0,0,0,0,0,1,0,0,"https://fbref.com/en/players/4b520f96/Marco-Bertini"
"6630","Felipe Caicedo_2021",2021,"Lazio","Serie A","Felipe Caicedo","ECU","FW","31",1988,10.3,10,7,4,4,2,1,8,12.5,7,7,0,7,4,14,2,0,"https://fbref.com/en/players/93b891d1/Felipe-Caicedo"
"6631","Danilo Cataldi_2021",2021,"Lazio","Serie A","Danilo Cataldi","ITA","MF","25",1994,6.3,7,2,1,5,1,4,18,22.2,14,3,1,2,9,16,7,0,"https://fbref.com/en/players/ba3d3bea/Danilo-Cataldi"
"6632","Joaquín Correa_2021",2021,"Lazio","Serie A","Joaquín Correa","ARG","FW","25",1994,21.5,21,12,6,11,4,7,25,28,18,14,0,14,7,28,12,0,"https://fbref.com/en/players/45b9b619/Joaquin-Correa"
"6633","Gonzalo Escalante_2021",2021,"Lazio","Serie A","Gonzalo Escalante","ARG","MF","27",1993,8.1,26,13,11,14,1,8,28,28.6,20,10,3,7,19,45,13,0,"https://fbref.com/en/players/3f79a1c8/Gonzalo-Escalante"
"6634","Mohamed Fares_2021",2021,"Lazio","Serie A","Mohamed Fares","ALG","DF","24",1996,12.7,20,15,9,7,4,11,19,57.9,8,14,1,13,16,36,21,0,"https://fbref.com/en/players/b7a5bc86/Mohamed-Fares"
"6635","Luiz Felipe_2021",2021,"Lazio","Serie A","Luiz Felipe","ITA","DF","23",1997,10.1,32,20,19,11,2,16,24,66.7,8,20,9,11,21,53,29,1,"https://fbref.com/en/players/15d0c248/Luiz-Felipe"
"6636","Wesley Hoedt_2021",2021,"Lazio","Serie A","Wesley Hoedt","NED","DF","26",1994,10.6,22,16,18,4,0,10,17,58.8,7,9,5,4,17,39,48,1,"https://fbref.com/en/players/875898c7/Wesley-Hoedt"
"6637","Ciro Immobile_2021",2021,"Lazio","Serie A","Ciro Immobile","ITA","FW","30",1990,31.7,14,13,4,6,4,7,22,31.8,15,13,1,12,6,20,9,0,"https://fbref.com/en/players/4431aed2/Ciro-Immobile"
"6638","Manuel Lazzari_2021",2021,"Lazio","Serie A","Manuel Lazzari","ITA","DF","26",1993,29,24,14,15,4,5,14,39,35.9,25,22,3,19,18,42,28,0,"https://fbref.com/en/players/02caf6e0/Manuel-Lazzari"
"6639","Lucas Leiva_2021",2021,"Lazio","Serie A","Lucas Leiva","BRA","MF","33",1987,23.7,68,32,38,28,2,30,86,34.9,56,21,0,21,57,125,21,0,"https://fbref.com/en/players/4c78b5ed/Lucas-Leiva"
"6640","Senad Lulić_2021",2021,"Lazio","Serie A","Senad Lulić","BIH","DF","34",1986,8,14,7,6,5,3,7,15,46.7,8,10,1,9,4,18,13,0,"https://fbref.com/en/players/7fd58fe3/Senad-Lulic"
"6641","Adam Marušić_2021",2021,"Lazio","Serie A","Adam Marušić","MNE","DF","27",1992,33,38,22,22,15,1,20,40,50,20,38,6,32,40,78,54,0,"https://fbref.com/en/players/d4535821/Adam-Marusic"
"6642","Sergej Milinković-Savić_2021",2021,"Lazio","Serie A","Sergej Milinković-Savić","SRB","MF","25",1995,30.5,59,40,20,30,9,27,84,32.1,57,52,12,40,33,92,47,0,"https://fbref.com/en/players/4e6dbac4/Sergej-Milinkovic-Savic"
"6643","Raúl Moro_2021",2021,"Lazio","Serie A","Raúl Moro","ESP","FW","17",2002,0.1,0,0,0,0,0,0,1,0,1,0,0,0,0,0,0,0,"https://fbref.com/en/players/919dd4b1/Raul-Moro"
"6644","Vedat Muriqi_2021",2021,"Lazio","Serie A","Vedat Muriqi","KVX","FW","26",1994,9.2,3,1,0,2,1,0,8,0,8,9,2,7,3,6,20,0,"https://fbref.com/en/players/0cadc46d/Vedat-Muriqi"
"6645","Mateo Musacchio_2021",2021,"Lazio","Serie A","Mateo Musacchio","ARG","DF","29",1990,2.5,1,1,1,0,0,0,0,NA,0,5,2,3,2,3,5,0,"https://fbref.com/en/players/91899ca8/Mateo-Musacchio"
"6646","Marco Parolo_2021",2021,"Lazio","Serie A","Marco Parolo","ITA","DF,MF","35",1985,7.3,21,8,8,11,2,8,20,40,12,20,6,14,14,35,31,0,"https://fbref.com/en/players/ed5886d2/Marco-Parolo"
"6647","Patric_2021",2021,"Lazio","Serie A","Patric","ESP","DF","27",1993,17.7,30,16,15,11,4,13,24,54.2,11,13,3,10,18,48,51,1,"https://fbref.com/en/players/f7223718/Patric"
"6648","Andreas Pereira_2021",2021,"Lazio","Serie A","Andreas Pereira","BRA","FW,MF","24",1996,6,5,0,1,3,1,2,12,16.7,10,6,0,6,1,6,4,0,"https://fbref.com/en/players/6639e500/Andreas-Pereira"
"6649","Ștefan Radu_2021",2021,"Lazio","Serie A","Ștefan Radu","ROU","DF","33",1986,27.3,43,24,20,19,4,25,40,62.5,15,27,14,13,45,88,73,1,"https://fbref.com/en/players/53de807a/Stefan-Radu"
"6650","Pepe Reina_2021",2021,"Lazio","Serie A","Pepe Reina","ESP","GK","37",1982,29,0,0,0,0,0,0,1,0,1,0,0,0,1,1,6,0,"https://fbref.com/en/players/e358587b/Pepe-Reina"
"6651","Thomas Strakosha_2021",2021,"Lazio","Serie A","Thomas Strakosha","ALB","GK","25",1995,9,1,1,1,0,0,0,0,NA,0,0,0,0,1,2,4,0,"https://fbref.com/en/players/339fe0e8/Thomas-Strakosha"
"6652","Denis Vavro_2021",2021,"Lazio","Serie A","Denis Vavro","SVK","DF","24",1996,0.4,0,0,0,0,0,0,1,0,1,0,0,0,1,1,3,0,"https://fbref.com/en/players/08990838/Denis-Vavro"
"6653","Ezgjan Alioski_2021",2021,"Leeds United","Premier League","Ezgjan Alioski","MKD","DF,MF","28",1992,27.3,74,31,38,28,8,32,74,43.2,42,17,2,15,23,97,50,2,"https://fbref.com/en/players/1a7fcf39/Ezgjan-Alioski"
"6654","Luke Ayling_2021",2021,"Leeds United","Premier League","Luke Ayling","ENG","DF","28",1991,37.8,108,61,69,30,9,49,87,56.3,38,53,36,17,36,144,96,5,"https://fbref.com/en/players/420d7c7d/Luke-Ayling"
"6655","Patrick Bamford_2021",2021,"Leeds United","Premier League","Patrick Bamford","ENG","FW","26",1993,33.9,21,9,2,11,8,8,27,29.6,19,14,4,10,10,31,37,0,"https://fbref.com/en/players/93feac6e/Patrick-Bamford"
"6656","Gaetano Berardi_2021",2021,"Leeds United","Premier League","Gaetano Berardi","SUI","DF","31",1988,1.3,2,2,1,0,1,0,0,NA,0,2,1,1,1,3,2,0,"https://fbref.com/en/players/5348aada/Gaetano-Berardi"
"6657","Ian Carlo Poveda_2021",2021,"Leeds United","Premier League","Ian Carlo Poveda","ENG","MF","20",2000,3.9,5,4,3,0,2,1,7,14.3,6,5,1,4,1,6,2,0,"https://fbref.com/en/players/55b4f1d6/Ian-Carlo-Poveda"
"6658","Kiko Casilla_2021",2021,"Leeds United","Premier League","Kiko Casilla","ESP","GK","33",1986,3,0,0,0,0,0,0,0,NA,0,0,0,0,0,0,0,0,"https://fbref.com/en/players/58bc7d18/Kiko-Casilla"
"6659","Liam Cooper_2021",2021,"Leeds United","Premier League","Liam Cooper","SCO","DF","28",1991,24.3,68,45,39,27,2,37,59,62.7,22,39,32,7,61,129,70,1,"https://fbref.com/en/players/dc64b8b3/Liam-Cooper"
"6660","Hélder Costa_2021",2021,"Leeds United","Premier League","Hélder Costa","ANG","MF,FW","26",1994,12.8,25,11,12,5,8,11,32,34.4,21,11,0,11,3,28,5,1,"https://fbref.com/en/players/f13d02a6/Helder-Costa"
"6661","Stuart Dallas_2021",2021,"Leeds United","Premier League","Stuart Dallas","NIR","MF,DF","29",1991,37.9,74,45,46,22,6,30,88,34.1,58,41,3,38,44,118,52,1,"https://fbref.com/en/players/67ca8566/Stuart-Dallas"
"6662","Leif Davis_2021",2021,"Leeds United","Premier League","Leif Davis","ENG","DF","20",2000,0.4,0,0,0,0,0,0,3,0,3,1,0,1,1,1,0,0,"https://fbref.com/en/players/8574c61f/Leif-Davis"
"6663","Jack Harrison_2021",2021,"Leeds United","Premier League","Jack Harrison","ENG","MF,FW","23",1996,31.6,63,38,20,30,13,26,59,44.1,33,30,2,28,15,78,21,0,"https://fbref.com/en/players/aa849a12/Jack-Harrison"
"6664","Pablo Hernández_2021",2021,"Leeds United","Premier League","Pablo Hernández","ESP","MF","35",1985,4.7,5,3,2,1,2,5,16,31.3,11,2,0,2,0,5,0,1,"https://fbref.com/en/players/c0398aca/Pablo-Hernandez"
"6665","Niall Huggins_2021",2021,"Leeds United","Premier League","Niall Huggins","WAL","DF","19",2000,0.4,0,0,0,0,0,0,1,0,1,0,0,0,0,0,1,0,"https://fbref.com/en/players/6d646ff7/Niall-Huggins"
"6666","Mateusz Klich_2021",2021,"Leeds United","Premier League","Mateusz Klich","POL","MF","30",1990,26.6,38,20,14,20,4,14,61,23,47,13,4,9,11,49,16,0,"https://fbref.com/en/players/282679b4/Mateusz-Klich"
"6667","Robin Koch_2021",2021,"Leeds United","Premier League","Robin Koch","GER","DF,MF","24",1996,12.6,27,16,17,10,0,10,19,52.6,9,18,12,6,27,54,34,2,"https://fbref.com/en/players/ea6bc03a/Robin-Koch"
"6668","Diego Llorente_2021",2021,"Leeds United","Premier League","Diego Llorente","ESP","DF","26",1993,13.4,34,21,21,13,0,19,32,59.4,13,18,13,5,20,54,40,2,"https://fbref.com/en/players/bba30585/Diego-Llorente"
"6669","Illan Meslier_2021",2021,"Leeds United","Premier League","Illan Meslier","FRA","GK","20",2000,35,0,0,0,0,0,0,1,0,1,0,0,0,0,0,17,8,"https://fbref.com/en/players/6b625ac2/Illan-Meslier"
"6670","Kalvin Phillips_2021",2021,"Leeds United","Premier League","Kalvin Phillips","ENG","MF","24",1995,27,74,38,38,29,7,26,62,41.9,36,49,14,35,45,119,53,3,"https://fbref.com/en/players/4f565d77/Kalvin-Phillips"
"6671","Raphinha_2021",2021,"Leeds United","Premier League","Raphinha","BRA","MF,FW","23",1996,26.2,34,17,13,16,5,12,58,20.7,46,31,1,30,29,63,27,0,"https://fbref.com/en/players/3423f250/Raphinha"
"6672","Tyler Roberts_2021",2021,"Leeds United","Premier League","Tyler Roberts","WAL","MF,FW","21",1999,14.9,15,13,1,11,3,5,22,22.7,17,17,2,15,9,24,12,0,"https://fbref.com/en/players/6c17e046/Tyler-Roberts"
"6673","Rodrigo_2021",2021,"Leeds United","Premier League","Rodrigo","ESP","MF,FW","29",1991,14.3,14,7,8,3,3,4,22,18.2,18,7,0,7,5,19,16,0,"https://fbref.com/en/players/1fb1c435/Rodrigo"
"6674","Jamie Shackleton_2021",2021,"Leeds United","Premier League","Jamie Shackleton","ENG","MF,DF","20",1999,5.1,10,6,6,4,0,4,11,36.4,7,3,1,2,9,19,3,0,"https://fbref.com/en/players/8d03ca5a/Jamie-Shackleton"
"6675","Pascal Struijk_2021",2021,"Leeds United","Premier League","Pascal Struijk","NED","DF,MF","20",1999,23.1,49,30,28,19,2,17,28,60.7,11,35,21,14,47,96,92,0,"https://fbref.com/en/players/f4d296e4/Pascal-Struijk"
"6676","Marc Albrighton_2021",2021,"Leicester City","Premier League","Marc Albrighton","ENG","DF,FW","30",1989,19.4,33,19,14,15,4,16,45,35.6,29,29,3,26,17,50,27,1,"https://fbref.com/en/players/b827d5b3/Marc-Albrighton"
"6677","Daniel Amartey_2021",2021,"Leicester City","Premier League","Daniel Amartey","GHA","DF","25",1994,8,11,7,6,4,1,8,12,66.7,4,8,4,4,12,23,26,0,"https://fbref.com/en/players/1a4ef233/Daniel-Amartey"
"6678","Harvey Barnes_2021",2021,"Leicester City","Premier League","Harvey Barnes","ENG","FW,MF","22",1997,21.6,19,9,11,3,5,5,22,22.7,17,16,3,13,8,27,11,0,"https://fbref.com/en/players/3ea50f67/Harvey-Barnes"
"6679","Timothy Castagne_2021",2021,"Leicester City","Premier League","Timothy Castagne","BEL","DF","24",1995,26.1,52,32,29,18,5,24,44,54.5,20,29,5,24,29,81,62,1,"https://fbref.com/en/players/197640fd/Timothy-Castagne"
"6680","Hamza Choudhury_2021",2021,"Leicester City","Premier League","Hamza Choudhury","ENG","MF","22",1997,3.5,8,7,3,5,0,4,10,40,6,4,1,3,4,12,9,1,"https://fbref.com/en/players/7d2d3329/Hamza-Choudhury"
"6681","Jonny Evans_2021",2021,"Leicester City","Premier League","Jonny Evans","NIR","DF","32",1988,27.5,25,12,22,2,1,14,20,70,6,8,3,5,46,71,98,1,"https://fbref.com/en/players/f8fcd2a5/Jonny-Evans"
"6682","Wesley Fofana_2021",2021,"Leicester City","Premier League","Wesley Fofana","FRA","DF","19",2000,25.1,51,37,27,22,2,31,46,67.4,15,28,16,12,61,112,94,0,"https://fbref.com/en/players/132a82f1/Wesley-Fofana"
"6683","Christian Fuchs_2021",2021,"Leicester City","Premier League","Christian Fuchs","AUT","DF","34",1986,7.8,18,7,15,2,1,8,15,53.3,7,6,4,2,16,34,34,1,"https://fbref.com/en/players/a67a09fb/Christian-Fuchs"
"6684","Demarai Gray_2021",2021,"Leicester City","Premier League","Demarai Gray","JAM","FW","24",1996,0.2,1,1,1,0,0,0,0,NA,0,0,0,0,0,1,0,0,"https://fbref.com/en/players/4468ec10/Demarai-Gray"
"6685","Kelechi Iheanacho_2021",2021,"Leicester City","Premier League","Kelechi Iheanacho","NGA","FW","23",1996,16.2,12,5,2,4,6,4,17,23.5,13,14,0,14,2,14,1,1,"https://fbref.com/en/players/c92e1a31/Kelechi-Iheanacho"
"6686","James Justin_2021",2021,"Leicester City","Premier League","James Justin","ENG","DF","22",1998,23,61,37,38,18,5,20,41,48.8,21,36,10,26,30,91,58,1,"https://fbref.com/en/players/fb614c44/James-Justin"
"6687","Khanya Leshabela_2021",2021,"Leicester City","Premier League","Khanya Leshabela","RSA","MF","20",1999,0.1,0,0,0,0,0,0,0,NA,0,0,0,0,0,0,0,0,"https://fbref.com/en/players/383e68b1/Khanya-Leshabela"
"6688","James Maddison_2021",2021,"Leicester City","Premier League","James Maddison","ENG","MF","23",1996,23.3,32,16,5,16,11,14,41,34.1,27,14,1,13,9,41,5,0,"https://fbref.com/en/players/ee38d9c5/James-Maddison"
"6689","Nampalys Mendy_2021",2021,"Leicester City","Premier League","Nampalys Mendy","SEN","MF","28",1992,16.2,26,17,18,6,2,7,20,35,13,12,1,11,14,40,8,0,"https://fbref.com/en/players/1598599e/Nampalys-Mendy"
"6690","Wes Morgan_2021",2021,"Leicester City","Premier League","Wes Morgan","JAM","DF","36",1984,0.2,0,0,0,0,0,0,0,NA,0,0,0,0,0,0,1,0,"https://fbref.com/en/players/80c31c97/Wes-Morgan"
"6691","Wilfred Ndidi_2021",2021,"Leicester City","Premier League","Wilfred Ndidi","NGA","MF,DF","23",1996,24.2,96,63,45,44,7,26,66,39.4,40,38,11,27,61,157,55,0,"https://fbref.com/en/players/6b47c5db/Wilfred-Ndidi"
"6692","Ricardo Pereira_2021",2021,"Leicester City","Premier League","Ricardo Pereira","POR","DF,FW","26",1993,10.7,31,22,16,8,7,14,35,40,21,24,1,23,15,46,23,0,"https://fbref.com/en/players/75a72a99/Ricardo-Pereira"
"6693","Ayoze Pérez_2021",2021,"Leicester City","Premier League","Ayoze Pérez","ESP","MF,FW","27",1993,14.8,32,15,6,20,6,13,48,27.1,35,28,0,28,10,42,7,0,"https://fbref.com/en/players/819aa8e7/Ayoze-Perez"
"6694","Dennis Praet_2021",2021,"Leicester City","Premier League","Dennis Praet","BEL","MF","26",1994,8,14,7,4,7,3,6,15,40,9,12,2,10,7,21,3,0,"https://fbref.com/en/players/86695068/Dennis-Praet"
"6695","Kasper Schmeichel_2021",2021,"Leicester City","Premier League","Kasper Schmeichel","DEN","GK","33",1986,38,0,0,0,0,0,0,0,NA,0,0,0,0,0,0,10,0,"https://fbref.com/en/players/53af52f3/Kasper-Schmeichel"
"6696","Islam Slimani_2021",2021,"Leicester City","Premier League","Islam Slimani","ALG","FW","32",1988,0.2,0,0,0,0,0,0,0,NA,0,0,0,0,0,0,0,0,"https://fbref.com/en/players/ffec9769/Islam-Slimani"
"6697","Çağlar Söyüncü_2021",2021,"Leicester City","Premier League","Çağlar Söyüncü","TUR","DF","24",1996,20.2,27,17,13,14,0,17,30,56.7,13,12,9,3,28,55,80,1,"https://fbref.com/en/players/21166ff4/Caglar-Soyuncu"
"6698","Sidnei Tavares_2021",2021,"Leicester City","Premier League","Sidnei Tavares","POR","MF","18",2001,0.9,1,1,0,1,0,0,0,NA,0,1,1,0,0,1,0,0,"https://fbref.com/en/players/3add8ed8/Sidnei-Tavares"
"6699","Luke Thomas_2021",2021,"Leicester City","Premier League","Luke Thomas","ENG","DF","19",2001,10.8,23,14,11,5,7,14,21,66.7,7,15,2,13,17,40,21,0,"https://fbref.com/en/players/fc027d02/Luke-Thomas"
"6700","Youri Tielemans_2021",2021,"Leicester City","Premier League","Youri Tielemans","BEL","MF","23",1997,37.3,86,45,32,38,16,45,108,41.7,63,35,8,27,46,132,20,1,"https://fbref.com/en/players/56f7a928/Youri-Tielemans"
"6701","Cengiz Ünder_2021",2021,"Leicester City","Premier League","Cengiz Ünder","TUR","FW,MF","23",1997,3.1,4,1,0,3,1,3,5,60,2,3,0,3,2,6,0,0,"https://fbref.com/en/players/1880614f/Cengiz-Under"
"6702","Jamie Vardy_2021",2021,"Leicester City","Premier League","Jamie Vardy","ENG","FW","33",1987,31.6,18,12,1,8,9,2,15,13.3,13,14,5,9,4,22,32,0,"https://fbref.com/en/players/45963054/Jamie-Vardy"
"6703","Loïc Bade_2021",2021,"Lens","Ligue 1","Loïc Bade","FRA","DF","20",2000,29,57,34,47,10,0,30,55,54.5,25,43,17,26,74,131,135,2,"https://fbref.com/en/players/114bbdee/Loic-Bade"
"6704","Simon Banza_2021",2021,"Lens","Ligue 1","Simon Banza","FRA","FW","23",1996,15.2,13,6,0,4,9,1,14,7.1,13,16,1,15,7,20,15,0,"https://fbref.com/en/players/be47b750/Simon-Banza"
"6705","Ismaëlben Boura_2021",2021,"Lens","Ligue 1","Ismaëlben Boura","FRA","DF","19",2000,9.1,11,7,8,2,1,3,9,33.3,6,7,2,5,21,32,12,0,"https://fbref.com/en/players/62e02107/Ismaelben-Boura"
"6706","Yannick Cahuzac_2021",2021,"Lens","Ligue 1","Yannick Cahuzac","FRA","MF","35",1985,25,26,12,12,10,4,9,27,33.3,18,18,5,13,33,59,72,0,"https://fbref.com/en/players/677ee102/Yannick-Cahuzac"
"6707","Jonathan Clauss_2021",2021,"Lens","Ligue 1","Jonathan Clauss","FRA","DF","27",1992,28,43,20,12,20,11,17,38,44.7,21,24,1,23,45,88,46,0,"https://fbref.com/en/players/5219ab4a/Jonathan-Clauss"
"6708","David Pereira da Costa_2021",2021,"Lens","Ligue 1","David Pereira da Costa","POR","MF,FW","19",2001,1.8,4,4,1,2,1,2,3,66.7,1,2,0,2,0,4,4,0,"https://fbref.com/en/players/59948ef7/David-Pereira-da-Costa"
"6709","Cheick Doucouré_2021",2021,"Lens","Ligue 1","Cheick Doucouré","MLI","MF","20",2000,29.2,87,47,40,42,5,32,65,49.2,33,20,4,16,52,139,26,1,"https://fbref.com/en/players/ce4f40c7/Cheick-Doucoure"
"6710","Wuilker Faríñez_2021",2021,"Lens","Ligue 1","Wuilker Faríñez","VEN","GK","22",1998,1.2,0,0,0,0,0,0,0,NA,0,0,0,0,0,0,1,0,"https://fbref.com/en/players/2c127b6f/Wuilker-Farinez"
"6711","Seko Fofana_2021",2021,"Lens","Ligue 1","Seko Fofana","CIV","MF","25",1995,25.7,16,8,3,10,3,4,26,15.4,22,16,5,11,34,50,23,1,"https://fbref.com/en/players/5313ed43/Seko-Fofana"
"6712","Steven Fortes_2021",2021,"Lens","Ligue 1","Steven Fortes","CPV","DF","28",1992,15.9,33,20,20,10,3,16,22,72.7,6,25,10,15,27,60,52,0,"https://fbref.com/en/players/574aa9ec/Steven-Fortes"
"6713","Ignatius Ganago_2021",2021,"Lens","Ligue 1","Ignatius Ganago","CMR","FW","21",1999,14.5,4,3,0,2,2,3,12,25,9,7,1,6,6,10,3,0,"https://fbref.com/en/players/23c63b7f/Ignatius-Ganago"
"6714","Jonathan Gradit_2021",2021,"Lens","Ligue 1","Jonathan Gradit","FRA","DF","27",1992,31.4,60,39,26,28,6,22,38,57.9,16,37,19,18,56,116,81,1,"https://fbref.com/en/players/06c48679/Jonathan-Gradit"
"6715","Massadio Haïdara_2021",2021,"Lens","Ligue 1","Massadio Haïdara","MLI","DF","27",1992,23.7,48,32,21,21,6,23,37,62.2,14,29,6,23,35,83,60,0,"https://fbref.com/en/players/5167c97e/Massadio-Haidara"
"6716","Corentin Jean_2021",2021,"Lens","Ligue 1","Corentin Jean","FRA","FW,MF","25",1995,6.4,4,3,1,1,2,0,5,0,5,4,0,4,2,6,2,0,"https://fbref.com/en/players/7d9b37bf/Corentin-Jean"
"6717","Gaël Kakuta_2021",2021,"Lens","Ligue 1","Gaël Kakuta","COD","MF,FW","29",1991,26.6,38,23,10,18,10,8,44,18.2,36,24,3,21,17,55,4,0,"https://fbref.com/en/players/5b1bf5e3/Gael-Kakuta"
"6718","Arnaud Kalimuendo_2021",2021,"Lens","Ligue 1","Arnaud Kalimuendo","FRA","FW,MF","18",2002,13.5,8,2,2,2,4,1,7,14.3,6,11,0,11,2,10,2,0,"https://fbref.com/en/players/bf4c41f9/Arnaud-Kalimuendo"
"6719","Jean-Louis Leca_2021",2021,"Lens","Ligue 1","Jean-Louis Leca","FRA","GK","34",1985,36.8,3,2,3,0,0,3,5,60,2,0,0,0,1,4,14,4,"https://fbref.com/en/players/edbe46dc/Jean-Louis-Leca"
"6720","Adrien Louveau_2021",2021,"Lens","Ligue 1","Adrien Louveau","FRA","MF","20",2000,0.1,0,0,0,0,0,0,0,NA,0,0,0,0,0,0,1,0,"https://fbref.com/en/players/85847c67/Adrien-Louveau"
"6721","Tony Mauricio_2021",2021,"Lens","Ligue 1","Tony Mauricio","FRA","MF","26",1994,5.6,19,12,7,8,4,11,17,64.7,6,8,1,7,3,22,4,0,"https://fbref.com/en/players/96e5168e/Tony-Mauricio"
"6722","Facundo Medina_2021",2021,"Lens","Ligue 1","Facundo Medina","ARG","DF","21",1999,22.3,39,22,22,15,2,24,38,63.2,14,25,9,16,39,78,51,3,"https://fbref.com/en/players/6f5ec8bb/Facundo-Medina"
"6723","Clément Michelin_2021",2021,"Lens","Ligue 1","Clément Michelin","FRA","DF","23",1997,12.8,25,19,13,9,3,9,16,56.3,7,13,4,9,25,50,32,0,"https://fbref.com/en/players/cb9ec45d/Clement-Michelin"
"6724","Manuel Perez_2021",2021,"Lens","Ligue 1","Manuel Perez","FRA","MF,FW","29",1991,1.4,1,0,1,0,0,0,8,0,8,2,0,2,2,3,2,0,"https://fbref.com/en/players/88970207/Manuel-Perez"
"6725","Aleksandar Radovanović_2021",2021,"Lens","Ligue 1","Aleksandar Radovanović","SRB","DF","26",1993,1,1,1,0,1,0,0,0,NA,0,2,1,1,0,1,2,0,"https://fbref.com/en/players/09507ffa/Aleksandar-Radovanovic"
"6726","Florian Sotoca_2021",2021,"Lens","Ligue 1","Florian Sotoca","FRA","FW","29",1990,26.8,31,20,3,20,8,6,22,27.3,16,27,0,27,9,40,24,0,"https://fbref.com/en/players/7a42d0df/Florian-Sotoca"
"6727","Ansou Sow_2021",2021,"Lens","Ligue 1","Ansou Sow","FRA","MF","20",2000,0.1,0,0,0,0,0,0,0,NA,0,1,0,1,0,0,0,0,"https://fbref.com/en/players/754d5c33/Ansou-Sow"
"6728","Issiaga Sylla_2021",2021,"Lens","Ligue 1","Issiaga Sylla","GUI","DF,MF","26",1994,12.4,28,20,11,17,0,11,21,52.4,10,13,3,10,16,44,21,0,"https://fbref.com/en/players/b99bec05/Issiaga-Sylla"
"6729","Cheick Traoré_2021",2021,"Lens","Ligue 1","Cheick Traoré","MLI","DF","25",1995,0.4,2,2,1,1,0,2,4,50,2,1,0,1,2,4,1,0,"https://fbref.com/en/players/bfcef334/Cheick-Traore"
"6730","Enis Bardhi_2021",2021,"Levante","La Liga","Enis Bardhi","MKD","MF","25",1995,18.7,28,12,8,16,4,10,36,27.8,26,8,2,6,21,49,14,0,"https://fbref.com/en/players/cac2537b/Enis-Bardhi"
"6731","Alejandro Blesa_2021",2021,"Levante","La Liga","Alejandro Blesa","ESP","MF","18",2002,0.1,0,0,0,0,0,0,0,NA,0,0,0,0,0,0,0,0,"https://fbref.com/en/players/d2ed99b4/Alejandro-Blesa"
"6732","José Campaña_2021",2021,"Levante","La Liga","José Campaña","ESP","MF","27",1993,8.3,14,6,3,6,5,5,14,35.7,9,2,0,2,13,27,4,0,"https://fbref.com/en/players/61220da2/Jose-Campana"
"6733","Álex Cantero_2021",2021,"Levante","La Liga","Álex Cantero","ESP","FW","20",2000,2.6,2,1,0,2,0,1,2,50,1,1,0,1,0,2,3,0,"https://fbref.com/en/players/4aa253fd/Alex-Cantero"
"6734","Cárdenas_2021",2021,"Levante","La Liga","Cárdenas","ESP","GK","23",1997,8,0,0,0,0,0,0,1,0,1,0,0,0,3,3,5,1,"https://fbref.com/en/players/e1846dde/Cardenas"
"6735","Carlos Clerc_2021",2021,"Levante","La Liga","Carlos Clerc","ESP","DF","28",1992,30.9,56,29,33,16,7,22,39,56.4,17,26,4,22,37,93,55,1,"https://fbref.com/en/players/33a61a52/Carlos-Clerc"
"6736","Coke_2021",2021,"Levante","La Liga","Coke","ESP","DF","33",1987,9.3,24,10,14,7,3,14,27,51.9,13,13,1,12,14,38,27,0,"https://fbref.com/en/players/6d8f8441/Coke"
"6737","Cheick Doukouré_2021",2021,"Levante","La Liga","Cheick Doukouré","CIV","MF,FW","27",1992,1.1,5,4,2,1,2,3,4,75,1,2,0,2,3,8,0,0,"https://fbref.com/en/players/e208bcc8/Cheick-Doukoure"
"6738","Óscar Duarte_2021",2021,"Levante","La Liga","Óscar Duarte","CRC","DF","31",1989,22.9,22,13,17,5,0,10,18,55.6,8,23,15,8,36,58,97,1,"https://fbref.com/en/players/aa0ac32d/Oscar-Duarte"
"6739","Aitor Fernández_2021",2021,"Levante","La Liga","Aitor Fernández","ESP","GK","29",1991,29,0,0,0,0,0,0,0,NA,0,0,0,0,2,2,17,1,"https://fbref.com/en/players/a01c3d54/Aitor-Fernandez"
"6740","Jorge de Frutos_2021",2021,"Levante","La Liga","Jorge de Frutos","ESP","MF","23",1997,24.3,48,24,21,21,6,11,41,26.8,30,25,2,23,16,64,18,0,"https://fbref.com/en/players/38ce1150/Jorge-de-Frutos"
"6741","Dani Gómez_2021",2021,"Levante","La Liga","Dani Gómez","ESP","FW","22",1998,18.5,4,3,2,1,1,0,11,0,11,3,0,3,2,6,4,0,"https://fbref.com/en/players/0e5ddc7c/Dani-Gomez"
"6742","Giorgi Kochorashvili_2021",2021,"Levante","La Liga","Giorgi Kochorashvili","GEO","MF","21",1999,0.3,1,0,1,0,0,0,0,NA,0,0,0,0,0,1,0,0,"https://fbref.com/en/players/3da1b6ed/Giorgi-Kochorashvili"
"6743","Sergio León_2021",2021,"Levante","La Liga","Sergio León","ESP","FW","31",1989,8.3,6,2,0,4,2,2,8,25,6,4,0,4,3,9,2,0,"https://fbref.com/en/players/0a0cc13c/Sergio-Leon"
"6744","José Luis Morales_2021",2021,"Levante","La Liga","José Luis Morales","ESP","MF,FW","33",1987,27.1,18,10,7,9,2,8,36,22.2,28,17,0,17,11,29,11,0,"https://fbref.com/en/players/4a478107/Jose-Luis-Morales"
"6745","Mickael Malsa_2021",2021,"Levante","La Liga","Mickael Malsa","MTQ","MF","24",1995,26,55,26,28,24,3,23,51,45.1,28,38,9,29,43,98,36,2,"https://fbref.com/en/players/bbc19252/Mickael-Malsa"
"6746","Roger Martí_2021",2021,"Levante","La Liga","Roger Martí","ESP","FW","29",1991,24.4,11,7,5,4,2,6,23,26.1,17,10,3,7,4,15,6,0,"https://fbref.com/en/players/0ae4e09a/Roger-Marti"
"6747","Gonzalo Melero_2021",2021,"Levante","La Liga","Gonzalo Melero","ESP","MF,FW","26",1994,20.6,24,15,11,6,7,10,39,25.6,29,14,5,9,18,42,22,1,"https://fbref.com/en/players/3902e91b/Gonzalo-Melero"
"6748","Jorge Miramón_2021",2021,"Levante","La Liga","Jorge Miramón","ESP","DF","31",1989,19.2,32,22,26,6,0,21,35,60,14,22,2,20,27,59,54,0,"https://fbref.com/en/players/7f4c7c9f/Jorge-Miramon"
"6749","Sergio Postigo_2021",2021,"Levante","La Liga","Sergio Postigo","ESP","DF","31",1988,18,16,12,12,3,1,7,18,38.9,11,21,10,11,33,49,84,1,"https://fbref.com/en/players/474ecac8/Sergio-Postigo"
"6750","Nemanja Radoja_2021",2021,"Levante","La Liga","Nemanja Radoja","SRB","MF","27",1993,12.5,23,15,12,10,1,5,19,26.3,14,9,3,6,19,42,12,1,"https://fbref.com/en/players/b5dd3469/Nemanja-Radoja"
"6751","Rober_2021",2021,"Levante","La Liga","Rober","ESP","DF,MF","25",1995,15.8,14,7,8,3,3,8,18,44.4,10,24,16,8,35,49,52,1,"https://fbref.com/en/players/c00097d2/Rober"
"6752","Rubén Rochina_2021",2021,"Levante","La Liga","Rubén Rochina","ESP","MF","29",1991,15.6,38,28,12,23,3,12,35,34.3,23,22,2,20,22,60,7,0,"https://fbref.com/en/players/ecd8c01e/Ruben-Rochina"
"6753","Edgar Sevikyan_2021",2021,"Levante","La Liga","Edgar Sevikyan","RUS","MF","18",2001,0.1,0,0,0,0,0,0,0,NA,0,0,0,0,0,0,0,0,"https://fbref.com/en/players/3e8bb8ce/Edgar-Sevikyan"
"6754","Son_2021",2021,"Levante","La Liga","Son","ESP","DF,MF","26",1994,12.3,18,10,11,6,1,9,19,47.4,10,11,2,9,12,30,20,0,"https://fbref.com/en/players/037dbd30/Son"
"6755","Toño_2021",2021,"Levante","La Liga","Toño","ESP","DF,FW","30",1989,8.1,4,0,4,0,0,0,2,0,2,10,1,9,7,11,12,0,"https://fbref.com/en/players/d4ef9ac5/Tono"
"6756","Koke Vegas_2021",2021,"Levante","La Liga","Koke Vegas","ESP","GK","24",1995,1,0,0,0,0,0,0,0,NA,0,0,0,0,0,0,1,1,"https://fbref.com/en/players/bfb15d99/Koke-Vegas"
"6757","Rúben Vezo_2021",2021,"Levante","La Liga","Rúben Vezo","POR","DF","26",1994,25.7,34,19,26,7,1,12,29,41.4,17,22,11,11,46,80,106,3,"https://fbref.com/en/players/c67cd65c/Ruben-Vezo"
"6758","Nikola Vukčević_2021",2021,"Levante","La Liga","Nikola Vukčević","MNE","MF","28",1991,9,14,7,5,8,1,9,18,50,9,8,5,3,8,22,12,1,"https://fbref.com/en/players/4442fbcd/Nikola-Vukcevic"
"6759","Lucas Alario_2021",2021,"Leverkusen","Bundesliga","Lucas Alario","ARG","FW","27",1992,13.8,8,2,2,5,1,2,4,50,2,9,1,8,2,10,10,0,"https://fbref.com/en/players/834d0be5/Lucas-Alario"
"6760","Nadiem Amiri_2021",2021,"Leverkusen","Bundesliga","Nadiem Amiri","GER","MF","23",1996,21,12,7,4,8,0,7,33,21.2,26,18,3,15,12,24,7,0,"https://fbref.com/en/players/555d5edd/Nadiem-Amiri"
"6761","Charles Aránguiz_2021",2021,"Leverkusen","Bundesliga","Charles Aránguiz","CHI","MF","31",1989,18.5,41,23,16,21,4,17,43,39.5,26,32,4,28,33,74,17,0,"https://fbref.com/en/players/56413b1f/Charles-Aranguiz"
"6762","Santiago Arias_2021",2021,"Leverkusen","Bundesliga","Santiago Arias","COL","DF","28",1992,1,2,1,0,1,1,1,1,100,0,0,0,0,1,3,4,0,"https://fbref.com/en/players/fdd60087/Santiago-Arias"
"6763","Leon Bailey_2021",2021,"Leverkusen","Bundesliga","Leon Bailey","JAM","FW,MF","22",1997,23.8,14,8,3,7,4,4,15,26.7,11,13,0,13,9,23,3,0,"https://fbref.com/en/players/3a233281/Leon-Bailey"
"6764","Julian Baumgartlinger_2021",2021,"Leverkusen","Bundesliga","Julian Baumgartlinger","AUT","MF","32",1988,11.9,43,20,14,26,3,16,31,51.6,15,12,0,12,12,55,10,1,"https://fbref.com/en/players/69374ff5/Julian-Baumgartlinger"
"6765","Karim Bellarabi_2021",2021,"Leverkusen","Bundesliga","Karim Bellarabi","GER","FW,MF","30",1990,8.9,12,10,3,4,5,4,17,23.5,13,12,0,12,12,24,4,0,"https://fbref.com/en/players/bee0bab1/Karim-Bellarabi"
"6766","Lars Bender_2021",2021,"Leverkusen","Bundesliga","Lars Bender","GER","DF","31",1989,10.4,19,13,12,6,1,9,21,42.9,12,19,5,14,16,35,19,0,"https://fbref.com/en/players/c50281a0/Lars-Bender"
"6767","Sven Bender_2021",2021,"Leverkusen","Bundesliga","Sven Bender","GER","DF","31",1989,13,17,9,8,8,1,7,20,35,13,20,9,11,21,38,41,1,"https://fbref.com/en/players/070ec0b1/Sven-Bender"
"6768","Kerem Demirbay_2021",2021,"Leverkusen","Bundesliga","Kerem Demirbay","GER","MF","27",1993,19.4,46,31,15,26,5,19,38,50,19,21,4,17,8,54,6,1,"https://fbref.com/en/players/54b4dc4e/Kerem-Demirbay"
"6769","Moussa Diaby_2021",2021,"Leverkusen","Bundesliga","Moussa Diaby","FRA","FW,MF","21",1999,26.5,10,6,4,5,1,6,20,30,14,11,0,11,12,22,5,0,"https://fbref.com/en/players/aeed5c06/Moussa-Diaby"
"6770","Aleksandar Dragović_2021",2021,"Leverkusen","Bundesliga","Aleksandar Dragović","AUT","DF","29",1991,12.6,11,7,5,5,1,9,13,69.2,4,17,5,12,13,24,33,0,"https://fbref.com/en/players/6fd8a334/Aleksandar-Dragovic"
"6771","Timothy Fosu-Mensah_2021",2021,"Leverkusen","Bundesliga","Timothy Fosu-Mensah","NED","DF","22",1998,4.5,4,2,1,2,1,2,4,50,2,7,3,4,7,11,4,0,"https://fbref.com/en/players/a9142dc3/Timothy-Fosu-Mensah"
"6772","Jeremie Frimpong_2021",2021,"Leverkusen","Bundesliga","Jeremie Frimpong","NED","DF,FW","19",2000,4.8,7,4,4,3,0,4,8,50,4,4,0,4,1,8,7,0,"https://fbref.com/en/players/74f2e748/Jeremie-Frimpong"
"6773","Emrehan Gedikli_2021",2021,"Leverkusen","Bundesliga","Emrehan Gedikli","GER","FW","17",2003,0.3,0,0,0,0,0,0,0,NA,0,0,0,0,0,0,0,0,"https://fbref.com/en/players/62f94e47/Emrehan-Gedikli"
"6774","Demarai Gray_2021",2021,"Leverkusen","Bundesliga","Demarai Gray","JAM","FW","24",1996,4.9,3,2,1,2,0,1,1,100,0,3,0,3,4,7,3,0,"https://fbref.com/en/players/4468ec10/Demarai-Gray"
"6775","Lennart Grill_2021",2021,"Leverkusen","Bundesliga","Lennart Grill","GER","GK","21",1999,4,0,0,0,0,0,0,0,NA,0,0,0,0,0,0,2,0,"https://fbref.com/en/players/37998008/Lennart-Grill"
"6776","Lukáš Hrádecký_2021",2021,"Leverkusen","Bundesliga","Lukáš Hrádecký","FIN","GK","30",1989,28.5,0,0,0,0,0,0,1,0,1,0,0,0,1,1,11,3,"https://fbref.com/en/players/ad3389d5/Lukas-Hradecky"
"6777","Tin Jedvaj_2021",2021,"Leverkusen","Bundesliga","Tin Jedvaj","CRO","DF","24",1995,1.7,5,2,2,3,0,1,3,33.3,2,2,1,1,2,7,9,0,"https://fbref.com/en/players/f820504e/Tin-Jedvaj"
"6778","Niklas Lomb_2021",2021,"Leverkusen","Bundesliga","Niklas Lomb","GER","GK","27",1993,1.5,0,0,0,0,0,0,0,NA,0,0,0,0,0,0,0,2,"https://fbref.com/en/players/9321b8ed/Niklas-Lomb"
"6779","Exequiel Palacios_2021",2021,"Leverkusen","Bundesliga","Exequiel Palacios","ARG","MF","21",1998,6.4,31,17,12,16,3,17,30,56.7,13,13,0,13,12,43,7,0,"https://fbref.com/en/players/e82adcab/Exequiel-Palacios"
"6780","Paulinho_2021",2021,"Leverkusen","Bundesliga","Paulinho","BRA","FW","20",2000,0.7,0,0,0,0,0,0,0,NA,0,0,0,0,0,0,0,0,"https://fbref.com/en/players/53070b63/Paulinho"
"6781","Joel Pohjanpalo_2021",2021,"Leverkusen","Bundesliga","Joel Pohjanpalo","FIN","MF","25",1994,0.1,0,0,0,0,0,0,0,NA,0,0,0,0,0,0,0,0,"https://fbref.com/en/players/ea003d07/Joel-Pohjanpalo"
"6782","Patrik Schick_2021",2021,"Leverkusen","Bundesliga","Patrik Schick","CZE","FW","24",1996,20.7,7,2,0,5,2,1,4,25,3,5,2,3,3,10,20,0,"https://fbref.com/en/players/5d4f7d61/Patrik-Schick"
"6783","Daley Sinkgraven_2021",2021,"Leverkusen","Bundesliga","Daley Sinkgraven","NED","DF","25",1995,17.4,32,17,13,16,3,18,35,51.4,17,22,5,17,23,55,23,0,"https://fbref.com/en/players/73000a79/Daley-Sinkgraven"
"6784","Jonathan Tah_2021",2021,"Leverkusen","Bundesliga","Jonathan Tah","GER","DF","24",1996,24.7,30,17,19,9,2,11,21,52.4,10,19,12,7,33,63,89,1,"https://fbref.com/en/players/bd142efb/Jonathan-Tah"
"6785","Edmond Tapsoba_2021",2021,"Leverkusen","Bundesliga","Edmond Tapsoba","BFA","DF","21",1999,29.5,54,28,35,18,1,21,45,46.7,24,55,29,26,48,102,96,0,"https://fbref.com/en/players/a73c8f95/Edmond-Tapsoba"
"6786","Mitchell Weiser_2021",2021,"Leverkusen","Bundesliga","Mitchell Weiser","GER","DF","26",1994,2.5,4,1,1,2,1,2,4,50,2,1,0,1,3,7,4,0,"https://fbref.com/en/players/30c220c3/Mitchell-Weiser"
"6787","Wendell_2021",2021,"Leverkusen","Bundesliga","Wendell","BRA","DF","27",1993,16.2,53,35,27,18,8,23,49,46.9,26,26,3,23,25,78,39,1,"https://fbref.com/en/players/f9acca3a/Wendell"
"6788","Florian Wirtz_2021",2021,"Leverkusen","Bundesliga","Florian Wirtz","GER","MF","17",2003,24.7,35,18,8,22,5,11,37,29.7,26,27,1,26,9,44,8,0,"https://fbref.com/en/players/e7fcf289/Florian-Wirtz"
"6789","Benjamin André_2021",2021,"Lille","Ligue 1","Benjamin André","FRA","MF","29",1990,32.1,114,68,47,61,6,53,122,43.4,69,39,10,29,76,190,49,0,"https://fbref.com/en/players/ef9c1c95/Benjamin-Andre"
"6790","Luiz Araújo_2021",2021,"Lille","Ligue 1","Luiz Araújo","BRA","MF","24",1996,16.6,38,25,12,18,8,8,28,28.6,20,23,1,22,11,49,3,0,"https://fbref.com/en/players/fa18c72e/Luiz-Araujo"
"6791","Jonathan Bamba_2021",2021,"Lille","Ligue 1","Jonathan Bamba","CIV","MF","24",1996,33.2,45,23,15,19,11,24,84,28.6,60,24,2,22,24,69,15,0,"https://fbref.com/en/players/b2bd0f6c/Jonathan-Bamba"
"6792","Sven Botman_2021",2021,"Lille","Ligue 1","Sven Botman","NED","DF","20",2000,36.8,31,21,18,12,1,14,26,53.8,12,31,21,10,57,88,126,2,"https://fbref.com/en/players/ccce7025/Sven-Botman"
"6793","Domagoj Bradarić_2021",2021,"Lille","Ligue 1","Domagoj Bradarić","CRO","DF","20",1999,14,28,18,11,13,4,12,27,44.4,15,14,4,10,26,54,21,0,"https://fbref.com/en/players/8bbe2df5/Domagoj-Bradaric"
"6794","Zeki Çelik_2021",2021,"Lille","Ligue 1","Zeki Çelik","TUR","DF","23",1997,26.5,72,33,30,30,12,44,81,54.3,37,32,6,26,38,110,52,0,"https://fbref.com/en/players/31a62dc7/Zeki-Celik"
"6795","Jonathan David_2021",2021,"Lille","Ligue 1","Jonathan David","CAN","FW","20",2000,26.2,17,10,5,5,7,9,24,37.5,15,19,1,18,3,20,9,0,"https://fbref.com/en/players/ce50fd99/Jonathan-David"
"6796","Tiago Djaló_2021",2021,"Lille","Ligue 1","Tiago Djaló","POR","DF","20",2000,9.7,22,13,14,5,3,15,23,65.2,8,10,4,6,9,31,23,0,"https://fbref.com/en/players/b2336681/Tiago-Djalo"
"6797","José Fonte_2021",2021,"Lille","Ligue 1","José Fonte","POR","DF","36",1983,35.4,40,29,28,10,2,27,33,81.8,6,36,23,13,36,76,137,1,"https://fbref.com/en/players/90f87966/Jose-Fonte"
"6798","Jonathan Ikone_2021",2021,"Lille","Ligue 1","Jonathan Ikone","FRA","MF,FW","22",1998,24.2,18,12,3,8,7,9,22,40.9,13,16,1,15,7,25,9,0,"https://fbref.com/en/players/42eaa028/Jonathan-Ikone"
"6799","Isaac Lihadji_2021",2021,"Lille","Ligue 1","Isaac Lihadji","FRA","MF,FW","18",2002,2.2,11,4,2,6,3,4,5,80,1,5,1,4,1,12,0,1,"https://fbref.com/en/players/57a46f3f/Isaac-Lihadji"
"6800","Mike Maignan_2021",2021,"Lille","Ligue 1","Mike Maignan","FRA","GK","25",1995,38,0,0,0,0,0,0,0,NA,0,0,0,0,0,0,7,2,"https://fbref.com/en/players/fcb38f57/Mike-Maignan"
"6801","Reinildo Mandava_2021",2021,"Lille","Ligue 1","Reinildo Mandava","MOZ","DF","26",1994,24.2,79,43,39,32,8,35,58,60.3,23,26,3,23,45,124,53,0,"https://fbref.com/en/players/c20bdcd7/Reinildo-Mandava"
"6802","Jérémy Pied_2021",2021,"Lille","Ligue 1","Jérémy Pied","FRA","DF","31",1989,3.5,7,0,3,3,1,4,9,44.4,5,3,1,2,6,13,8,0,"https://fbref.com/en/players/a634b9d2/Jeremy-Pied"
"6803","Renato Sanches_2021",2021,"Lille","Ligue 1","Renato Sanches","POR","MF","22",1997,14.1,13,7,4,8,1,5,25,20,20,13,2,11,13,26,8,0,"https://fbref.com/en/players/032f894e/Renato-Sanches"
"6804","Adama Soumaoro_2021",2021,"Lille","Ligue 1","Adama Soumaoro","FRA","DF","28",1992,1.6,1,0,0,0,1,0,0,NA,0,1,1,0,2,3,2,0,"https://fbref.com/en/players/7b075c75/Adama-Soumaoro"
"6805","Boubakary Soumaré_2021",2021,"Lille","Ligue 1","Boubakary Soumaré","FRA","MF","21",1999,21.3,44,29,16,25,3,14,29,48.3,15,14,6,8,39,83,21,0,"https://fbref.com/en/players/ae59b359/Boubakary-Soumare"
"6806","Timothy Weah_2021",2021,"Lille","Ligue 1","Timothy Weah","USA","FW,MF","20",2000,9.8,15,7,3,9,3,7,14,50,7,7,0,7,4,19,5,0,"https://fbref.com/en/players/8eec784d/Timothy-Weah"
"6807","Xeka_2021",2021,"Lille","Ligue 1","Xeka","POR","MF","25",1994,13.3,33,17,14,15,4,16,43,37.2,27,14,2,12,20,53,18,0,"https://fbref.com/en/players/f3600c02/Xeka"
"6808","Yusuf Yazıcı_2021",2021,"Lille","Ligue 1","Yusuf Yazıcı","TUR","FW,MF","23",1997,12.1,12,5,6,2,4,1,24,4.2,23,5,1,4,2,14,2,0,"https://fbref.com/en/players/f5c8b425/Yusuf-Yazici"
"6809","Burak Yılmaz_2021",2021,"Lille","Ligue 1","Burak Yılmaz","TUR","FW","35",1985,22.8,13,6,3,7,3,4,30,13.3,26,7,0,7,5,18,22,0,"https://fbref.com/en/players/165a2e40/Burak-Yilmaz"
"6810","Adrián_2021",2021,"Liverpool","Premier League","Adrián","ESP","GK","33",1987,3,0,0,0,0,0,0,0,NA,0,0,0,0,0,0,3,1,"https://fbref.com/en/players/f76e6b4e/Adrian"
"6811","Thiago Alcántara_2021",2021,"Liverpool","Premier League","Thiago Alcántara","ESP","MF","29",1991,20.6,61,36,20,30,11,17,49,34.7,32,26,0,26,30,91,14,0,"https://fbref.com/en/players/77e84962/Thiago-Alcantara"
"6812","Trent Alexander-Arnold_2021",2021,"Liverpool","Premier League","Trent Alexander-Arnold","ENG","DF","21",1998,33.7,56,33,31,18,7,36,56,64.3,20,24,3,21,49,105,50,3,"https://fbref.com/en/players/cd1acf9d/Trent-Alexander-Arnold"
"6813","Alisson_2021",2021,"Liverpool","Premier League","Alisson","BRA","GK","27",1992,33,3,2,3,0,0,3,4,75,1,0,0,0,2,5,26,7,"https://fbref.com/en/players/7a2e46a8/Alisson"
"6814","Fabinho_2021",2021,"Liverpool","Premier League","Fabinho","BRA","DF,MF","26",1993,28.5,58,31,21,29,8,27,54,50,27,28,10,18,44,102,66,1,"https://fbref.com/en/players/7f3b388c/Fabinho"
"6815","Roberto Firmino_2021",2021,"Liverpool","Premier League","Roberto Firmino","BRA","FW","28",1991,31.5,33,15,3,17,13,6,32,18.8,26,42,5,37,11,44,12,0,"https://fbref.com/en/players/4c370d81/Roberto-Firmino"
"6816","Joe Gomez_2021",2021,"Liverpool","Premier League","Joe Gomez","ENG","DF","23",1997,6.6,3,2,1,1,1,0,4,0,4,3,2,1,4,7,29,0,"https://fbref.com/en/players/7a11550b/Joe-Gomez"
"6817","Jordan Henderson_2021",2021,"Liverpool","Premier League","Jordan Henderson","ENG","MF,DF","30",1990,18.9,24,15,12,9,3,10,26,38.5,16,12,1,11,34,58,30,0,"https://fbref.com/en/players/935e6b8f/Jordan-Henderson"
"6818","Curtis Jones_2021",2021,"Liverpool","Premier League","Curtis Jones","ENG","MF","19",2001,13.1,16,6,6,7,3,12,25,48,13,13,0,13,19,35,11,1,"https://fbref.com/en/players/4fb9c88f/Curtis-Jones"
"6819","Diogo Jota_2021",2021,"Liverpool","Premier League","Diogo Jota","POR","FW","23",1996,12.4,12,6,4,7,1,2,29,6.9,27,9,0,9,5,17,3,0,"https://fbref.com/en/players/178ae8f8/Diogo-Jota"
"6820","Ozan Kabak_2021",2021,"Liverpool","Premier League","Ozan Kabak","TUR","DF","20",2000,8.9,19,10,11,4,4,6,9,66.7,3,2,2,0,12,31,28,1,"https://fbref.com/en/players/2d61d13a/Ozan-Kabak"
"6821","Naby Keïta_2021",2021,"Liverpool","Premier League","Naby Keïta","GUI","MF","25",1995,5.8,11,5,1,8,2,7,17,41.2,10,10,0,10,9,20,6,0,"https://fbref.com/en/players/f25c8e3a/Naby-Keita"
"6822","Caoimhín Kelleher_2021",2021,"Liverpool","Premier League","Caoimhín Kelleher","IRL","GK","21",1998,2,0,0,0,0,0,0,0,NA,0,0,0,0,0,0,2,0,"https://fbref.com/en/players/62d7ef38/Caoimhin-Kelleher"
"6823","Sadio Mané_2021",2021,"Liverpool","Premier League","Sadio Mané","SEN","FW","28",1992,31.2,48,30,6,22,20,12,33,36.4,21,30,0,30,15,63,11,0,"https://fbref.com/en/players/c691bfe2/Sadio-Mane"
"6824","Joël Matip_2021",2021,"Liverpool","Premier League","Joël Matip","CMR","DF","28",1991,7.7,14,9,7,7,0,7,8,87.5,1,6,0,6,7,21,22,0,"https://fbref.com/en/players/b217ef29/Joel-Matip"
"6825","James Milner_2021",2021,"Liverpool","Premier League","James Milner","ENG","MF,DF","34",1986,11.9,26,19,9,14,3,11,33,33.3,22,30,3,27,14,40,16,1,"https://fbref.com/en/players/2f90f6b8/James-Milner"
"6826","Takumi Minamino_2021",2021,"Liverpool","Premier League","Takumi Minamino","JPN","MF,FW","25",1995,3.3,4,3,1,2,1,0,12,0,12,1,0,1,2,6,3,0,"https://fbref.com/en/players/f833a830/Takumi-Minamino"
"6827","Divock Origi_2021",2021,"Liverpool","Premier League","Divock Origi","BEL","FW","25",1995,2.1,3,2,0,2,1,1,3,33.3,2,5,1,4,1,4,2,0,"https://fbref.com/en/players/43a166b4/Divock-Origi"
"6828","Alex Oxlade-Chamberlain_2021",2021,"Liverpool","Premier League","Alex Oxlade-Chamberlain","ENG","MF,FW","26",1993,2.8,4,0,0,3,1,0,2,0,2,1,0,1,2,6,0,0,"https://fbref.com/en/players/38c7feef/Alex-Oxlade-Chamberlain"
"6829","Nathaniel Phillips_2021",2021,"Liverpool","Premier League","Nathaniel Phillips","ENG","DF","23",1997,16.2,22,14,15,7,0,11,24,45.8,13,17,14,3,20,42,81,0,"https://fbref.com/en/players/515ebe8d/Nathaniel-Phillips"
"6830","Andrew Robertson_2021",2021,"Liverpool","Premier League","Andrew Robertson","SCO","DF","26",1994,37.6,46,34,23,18,5,28,57,49.1,29,39,9,30,21,67,79,1,"https://fbref.com/en/players/2e4f5f03/Andrew-Robertson"
"6831","Mohamed Salah_2021",2021,"Liverpool","Premier League","Mohamed Salah","EGY","FW","28",1992,34.2,18,9,4,4,10,7,16,43.8,9,10,0,10,1,19,10,1,"https://fbref.com/en/players/e342ad68/Mohamed-Salah"
"6832","Xherdan Shaqiri_2021",2021,"Liverpool","Premier League","Xherdan Shaqiri","SUI","MF,FW","28",1991,6.2,7,4,3,1,3,2,7,28.6,5,4,0,4,2,9,0,0,"https://fbref.com/en/players/6421ec64/Xherdan-Shaqiri"
"6833","Kostas Tsimikas_2021",2021,"Liverpool","Premier League","Kostas Tsimikas","GRE","DF,FW","24",1996,0.1,0,0,0,0,0,0,0,NA,0,0,0,0,0,0,0,0,"https://fbref.com/en/players/f315ca93/Kostas-Tsimikas"
"6834","Virgil van Dijk_2021",2021,"Liverpool","Premier League","Virgil van Dijk","NED","DF","29",1991,4.1,3,2,1,2,0,0,0,NA,0,1,1,0,5,8,8,1,"https://fbref.com/en/players/e06683ca/Virgil-van-Dijk"
"6835","Georginio Wijnaldum_2021",2021,"Liverpool","Premier League","Georginio Wijnaldum","NED","MF","29",1990,32.7,23,7,6,14,3,7,31,22.6,24,18,3,15,26,49,18,1,"https://fbref.com/en/players/eb58eef0/Georginio-Wijnaldum"
"6836","Neco Williams_2021",2021,"Liverpool","Premier League","Neco Williams","WAL","DF","19",2001,2.8,6,5,4,2,0,5,9,55.6,4,3,1,2,6,12,6,0,"https://fbref.com/en/players/dd323728/Neco-Williams"
"6837","Rhys Williams_2021",2021,"Liverpool","Premier League","Rhys Williams","ENG","DF","19",2001,7.3,6,4,3,3,0,3,3,100,0,4,3,1,6,12,27,1,"https://fbref.com/en/players/012c975a/Rhys-Williams"
"6838","Laurent Abergel_2021",2021,"Lorient","Ligue 1","Laurent Abergel","FRA","MF","27",1993,32.9,145,84,64,69,12,54,162,33.3,108,64,6,58,46,191,12,0,"https://fbref.com/en/players/31626657/Laurent-Abergel"
"6839","Quentin Boisgard_2021",2021,"Lorient","Ligue 1","Quentin Boisgard","FRA","MF,FW","23",1997,14.6,24,17,3,15,6,11,24,45.8,13,17,2,15,15,39,1,0,"https://fbref.com/en/players/f6496133/Quentin-Boisgard"
"6840","Umut Bozok_2021",2021,"Lorient","Ligue 1","Umut Bozok","TUR","MF,FW","23",1996,0.7,0,0,0,0,0,0,2,0,2,0,0,0,0,0,0,0,"https://fbref.com/en/players/6e2c94ad/Umut-Bozok"
"6841","Trevoh Chalobah_2021",2021,"Lorient","Ligue 1","Trevoh Chalobah","ENG","DF,MF","21",1999,24.9,45,26,32,13,0,24,50,48,26,20,7,13,69,114,56,0,"https://fbref.com/en/players/5515376c/Trevoh-Chalobah"
"6842","Jonathan Delaplace_2021",2021,"Lorient","Ligue 1","Jonathan Delaplace","FRA","DF","34",1986,10.1,8,5,5,1,2,7,13,53.8,6,12,5,7,17,25,19,1,"https://fbref.com/en/players/79685569/Jonathan-Delaplace"
"6843","Stéphane Diarra_2021",2021,"Lorient","Ligue 1","Stéphane Diarra","FRA","MF,FW","21",1998,2.2,0,0,0,0,0,0,7,0,7,6,1,5,4,4,1,0,"https://fbref.com/en/players/29939a1d/Stephane-Diarra"
"6844","Matthieu Dreyer_2021",2021,"Lorient","Ligue 1","Matthieu Dreyer","FRA","GK","31",1989,15,0,0,0,0,0,0,0,NA,0,0,0,0,0,0,4,2,"https://fbref.com/en/players/fbf83734/Matthieu-Dreyer"
"6845","Yoann Etienne_2021",2021,"Lorient","Ligue 1","Yoann Etienne","FRA","DF","23",1997,1,2,0,1,1,0,1,1,100,0,1,0,1,1,3,2,0,"https://fbref.com/en/players/a59d55b1/Yoann-Etienne"
"6846","Thomas Fontaine_2021",2021,"Lorient","Ligue 1","Thomas Fontaine","MAD","DF","29",1991,3.6,5,2,5,0,0,2,2,100,0,3,2,1,5,10,14,0,"https://fbref.com/en/players/9f90c06b/Thomas-Fontaine"
"6847","Andrew Gravillon_2021",2021,"Lorient","Ligue 1","Andrew Gravillon","GLP","DF","22",1998,25.2,26,17,17,9,0,13,28,46.4,15,44,31,13,59,85,118,4,"https://fbref.com/en/players/49136c42/Andrew-Gravillon"
"6848","Adrian Grbić_2021",2021,"Lorient","Ligue 1","Adrian Grbić","AUT","FW","23",1996,10.7,6,4,2,2,2,1,7,14.3,6,6,0,6,5,11,7,0,"https://fbref.com/en/players/4a987ffa/Adrian-Grbic"
"6849","Pierre-Yves Hamel_2021",2021,"Lorient","Ligue 1","Pierre-Yves Hamel","FRA","FW","26",1994,9.4,15,8,3,9,3,1,6,16.7,5,12,1,11,10,25,6,0,"https://fbref.com/en/players/a99da9ec/Pierre-Yves-Hamel"
"6850","Jérôme Hergault_2021",2021,"Lorient","Ligue 1","Jérôme Hergault","FRA","DF,MF","34",1986,18.1,38,23,22,10,6,17,31,54.8,14,16,2,14,22,60,34,0,"https://fbref.com/en/players/a84f9a4b/Jerome-Hergault"
"6851","Julien Laporte_2021",2021,"Lorient","Ligue 1","Julien Laporte","FRA","DF","26",1993,29.5,65,39,48,16,1,42,74,56.8,32,34,23,11,65,130,125,0,"https://fbref.com/en/players/f066022d/Julien-Laporte"
"6852","Armand Lauriente_2021",2021,"Lorient","Ligue 1","Armand Lauriente","FRA","MF,FW","21",1998,18,30,10,10,19,1,7,26,26.9,19,21,0,21,15,45,4,0,"https://fbref.com/en/players/2d22cea7/Armand-Lauriente"
"6853","Enzo Le Fée_2021",2021,"Lorient","Ligue 1","Enzo Le Fée","FRA","MF","20",2000,20.2,51,28,23,23,5,27,73,37,46,30,6,24,25,76,10,0,"https://fbref.com/en/players/6f806d99/Enzo-Le-Fee"
"6854","Vincent Le Goff_2021",2021,"Lorient","Ligue 1","Vincent Le Goff","FRA","DF","30",1989,25.6,42,29,16,24,2,18,49,36.7,31,27,5,22,44,86,44,0,"https://fbref.com/en/players/2321ea6e/Vincent-Le-Goff"
"6855","Fabien Lemoine_2021",2021,"Lorient","Ligue 1","Fabien Lemoine","FRA","MF","33",1987,21.5,74,45,39,33,2,36,89,40.4,53,25,1,24,27,101,35,0,"https://fbref.com/en/players/54d51e22/Fabien-Lemoine"
"6856","Sylvain Marveaux_2021",2021,"Lorient","Ligue 1","Sylvain Marveaux","FRA","MF,FW","34",1986,2.2,6,3,1,4,1,3,3,100,0,2,0,2,1,7,2,0,"https://fbref.com/en/players/4ef705ab/Sylvain-Marveaux"
"6857","Houboulang Mendes_2021",2021,"Lorient","Ligue 1","Houboulang Mendes","FRA","DF","22",1998,14.4,28,19,19,5,4,16,28,57.1,12,14,2,12,14,42,35,0,"https://fbref.com/en/players/1545cf15/Houboulang-Mendes"
"6858","Terem Moffi_2021",2021,"Lorient","Ligue 1","Terem Moffi","NGA","FW","21",1999,23,13,8,0,8,5,4,19,21.1,15,5,2,3,4,17,8,0,"https://fbref.com/en/players/065dc209/Terem-Moffi"
"6859","Thomas Monconduit_2021",2021,"Lorient","Ligue 1","Thomas Monconduit","FRA","MF","29",1991,12.8,28,15,9,16,3,15,41,36.6,26,10,3,7,13,41,21,1,"https://fbref.com/en/players/84d94b91/Thomas-Monconduit"
"6860","Jérémy Morel_2021",2021,"Lorient","Ligue 1","Jérémy Morel","MAD","DF","36",1984,27.7,31,19,21,10,0,20,39,51.3,19,26,11,15,44,75,81,1,"https://fbref.com/en/players/e97150c0/Jeremy-Morel"
"6861","Loris Mouyokolo_2021",2021,"Lorient","Ligue 1","Loris Mouyokolo","CGO","DF","19",2001,0.2,1,1,1,0,0,1,1,100,0,1,1,0,0,1,1,0,"https://fbref.com/en/players/96726741/Loris-Mouyokolo"
"6862","Paul Nardi_2021",2021,"Lorient","Ligue 1","Paul Nardi","FRA","GK","26",1994,23,0,0,0,0,0,0,1,0,1,1,0,1,0,0,15,2,"https://fbref.com/en/players/2d70dbe5/Paul-Nardi"
"6863","Franklin Wadja_2021",2021,"Lorient","Ligue 1","Franklin Wadja","CMR","MF,FW","25",1995,0.4,4,2,0,2,2,2,2,100,0,0,0,0,2,6,1,0,"https://fbref.com/en/players/7cbf91b2/Franklin-Wadja"
"6864","Yoane Wissa_2021",2021,"Lorient","Ligue 1","Yoane Wissa","COD","MF,FW","23",1996,29.7,35,20,12,14,9,11,34,32.4,23,25,3,22,20,55,14,0,"https://fbref.com/en/players/2500cef9/Yoane-Wissa"
"6865","Joachim Andersen_2021",2021,"Lyon","Ligue 1","Joachim Andersen","DEN","DF","24",1996,2.1,2,1,1,1,0,2,2,100,0,1,1,0,2,4,6,0,"https://fbref.com/en/players/e34fc66d/Joachim-Andersen"
"6866","Houssem Aouar_2021",2021,"Lyon","Ligue 1","Houssem Aouar","ALG","MF,FW","22",1998,19.8,17,12,0,13,4,8,25,32,17,17,1,16,17,34,4,0,"https://fbref.com/en/players/a5db0bec/Houssem-Aouar"
"6867","Melvin Bard_2021",2021,"Lyon","Ligue 1","Melvin Bard","FRA","DF","19",2000,4.8,12,8,7,4,1,6,11,54.5,5,10,2,8,6,18,14,0,"https://fbref.com/en/players/1ddbc7ca/Melvin-Bard"
"6868","Djamel Benlamri_2021",2021,"Lyon","Ligue 1","Djamel Benlamri","ALG","DF","30",1989,1.7,5,3,5,0,0,3,6,50,3,3,2,1,6,11,11,0,"https://fbref.com/en/players/2ab14aaa/Djamel-Benlamri"
"6869","Maxence Caqueret_2021",2021,"Lyon","Ligue 1","Maxence Caqueret","FRA","MF","20",2000,19.6,72,45,17,39,16,35,106,33,71,35,3,32,23,95,5,2,"https://fbref.com/en/players/f81ef10d/Maxence-Caqueret"
"6870","Rayan Cherki_2021",2021,"Lyon","Ligue 1","Rayan Cherki","FRA","FW,MF","16",2003,7.8,5,3,0,3,2,1,11,9.1,10,3,0,3,4,9,0,0,"https://fbref.com/en/players/b34c63a5/Rayan-Cherki"
"6871","Maxwel Cornet_2021",2021,"Lyon","Ligue 1","Maxwel Cornet","CIV","DF,FW","23",1996,27.2,70,41,39,24,7,33,58,56.9,25,23,5,18,43,113,47,2,"https://fbref.com/en/players/beb391dd/Maxwel-Cornet"
"6872","Mattia De Sciglio_2021",2021,"Lyon","Ligue 1","Mattia De Sciglio","ITA","DF","27",1992,16.3,29,17,15,11,3,18,27,66.7,9,13,4,9,27,56,44,0,"https://fbref.com/en/players/ae4e2852/Mattia-De-Sciglio"
"6873","Moussa Dembélé_2021",2021,"Lyon","Ligue 1","Moussa Dembélé","FRA","FW","24",1996,7.5,2,2,0,1,1,0,4,0,4,4,2,2,5,7,9,0,"https://fbref.com/en/players/e7986081/Moussa-Dembele"
"6874","Jason Denayer_2021",2021,"Lyon","Ligue 1","Jason Denayer","BEL","DF","25",1995,29,25,16,16,9,0,6,13,46.2,7,36,25,11,27,52,91,1,"https://fbref.com/en/players/47af88b8/Jason-Denayer"
"6875","Sinaly Diomande_2021",2021,"Lyon","Ligue 1","Sinaly Diomande","CIV","DF","19",2001,12.6,10,7,8,1,1,5,14,35.7,9,19,15,4,33,43,53,1,"https://fbref.com/en/players/6de23ab0/Sinaly-Diomande"
"6876","Leo Dubois_2021",2021,"Lyon","Ligue 1","Leo Dubois","FRA","DF","25",1994,32.3,38,26,19,16,3,18,36,50,18,27,9,18,31,69,69,2,"https://fbref.com/en/players/ff0ab48c/Leo-Dubois"
"6877","Bruno Guimarães_2021",2021,"Lyon","Ligue 1","Bruno Guimarães","BRA","MF","22",1997,19.5,76,34,26,41,9,30,64,46.9,34,24,4,20,14,90,13,0,"https://fbref.com/en/players/82518f62/Bruno-Guimaraes"
"6878","Malo Gusto_2021",2021,"Lyon","Ligue 1","Malo Gusto","FRA","DF,MF","17",2003,0,0,0,0,0,0,0,0,NA,0,0,0,0,0,0,0,0,"https://fbref.com/en/players/d56b9520/Malo-Gusto"
"6879","Tino Kadewere_2021",2021,"Lyon","Ligue 1","Tino Kadewere","ZIM","FW","24",1996,22.3,35,22,12,16,7,17,49,34.7,32,16,3,13,21,56,31,0,"https://fbref.com/en/players/7d08063d/Tino-Kadewere"
"6880","Habib Keita_2021",2021,"Lyon","Ligue 1","Habib Keita","MLI","MF","18",2002,0.1,0,0,0,0,0,0,0,NA,0,0,0,0,0,0,0,0,"https://fbref.com/en/players/cc588cbe/Habib-Keita"
"6881","Anthony Lopes_2021",2021,"Lyon","Ligue 1","Anthony Lopes","POR","GK","29",1990,38,1,1,1,0,0,1,2,50,1,1,0,1,1,2,20,1,"https://fbref.com/en/players/f00de885/Anthony-Lopes"
"6882","Jean Lucas_2021",2021,"Lyon","Ligue 1","Jean Lucas","BRA","MF","22",1998,1.9,3,2,2,1,0,1,4,25,3,3,1,2,2,5,1,0,"https://fbref.com/en/players/a99138af/Jean-Lucas"
"6883","Fernando Marçal_2021",2021,"Lyon","Ligue 1","Fernando Marçal","BRA","DF","31",1989,0.9,1,0,0,1,0,0,0,NA,0,0,0,0,2,3,0,0,"https://fbref.com/en/players/9ae9eaea/Fernando-Marcal"
"6884","Marcelo_2021",2021,"Lyon","Ligue 1","Marcelo","BRA","DF","33",1987,32.3,44,29,30,12,2,26,37,70.3,11,35,25,10,49,93,122,2,"https://fbref.com/en/players/e3d0b0c4/Marcelo"
"6885","Memphis_2021",2021,"Lyon","Ligue 1","Memphis","NED","FW","26",1994,32.5,4,3,0,3,1,1,20,5,19,11,1,10,5,9,3,0,"https://fbref.com/en/players/8f696594/Memphis"
"6886","Thiago Mendes_2021",2021,"Lyon","Ligue 1","Thiago Mendes","BRA","MF","28",1992,24.9,37,22,13,20,4,18,38,47.4,20,33,7,26,39,76,21,2,"https://fbref.com/en/players/c6e5d20f/Thiago-Mendes"
"6887","Lucas Paquetá_2021",2021,"Lyon","Ligue 1","Lucas Paquetá","BRA","MF","22",1997,25.3,70,36,30,28,12,23,66,34.8,43,28,3,25,20,90,16,1,"https://fbref.com/en/players/9b6f7fd5/Lucas-Paqueta"
"6888","Jeff Reine-Adélaïde_2021",2021,"Lyon","Ligue 1","Jeff Reine-Adélaïde","FRA","FW","22",1998,0.3,0,0,0,0,0,0,0,NA,0,0,0,0,0,0,0,0,"https://fbref.com/en/players/d504b3e1/Jeff-Reine-Adelaide"
"6889","Florent da Silva_2021",2021,"Lyon","Ligue 1","Florent da Silva","FRA","FW","17",2003,0,0,0,0,0,0,0,0,NA,0,0,0,0,0,0,0,0,"https://fbref.com/en/players/8db95f95/Florent-da-Silva"
"6890","Islam Slimani_2021",2021,"Lyon","Ligue 1","Islam Slimani","ALG","FW","32",1988,6.4,7,5,3,1,3,3,12,25,9,4,1,3,1,8,6,0,"https://fbref.com/en/players/ffec9769/Islam-Slimani"
"6891","Yaya Soumaré_2021",2021,"Lyon","Ligue 1","Yaya Soumaré","FRA","MF","20",2000,0,NA,1,NA,NA,NA,NA,NA,NA,NA,NA,NA,NA,2,NA,NA,NA,"https://fbref.com/en/players/cb4e852b/Yaya-Soumare"
"6892","Kenny Tete_2021",2021,"Lyon","Ligue 1","Kenny Tete","NED","DF","24",1995,0.2,2,0,1,1,0,0,0,NA,0,0,0,0,2,4,0,0,"https://fbref.com/en/players/77d7c96f/Kenny-Tete"
"6893","Karl Toko Ekambi_2021",2021,"Lyon","Ligue 1","Karl Toko Ekambi","CMR","FW","27",1992,31.2,16,10,5,3,8,8,32,25,24,20,1,19,26,42,8,0,"https://fbref.com/en/players/5ceba7fc/Karl-Toko-Ekambi"
"6894","László Bénes_2021",2021,"M'Gladbach","Bundesliga","László Bénes","SVK","MF","22",1997,1.7,6,2,5,1,0,2,4,50,2,0,0,0,2,8,1,0,"https://fbref.com/en/players/fe888e39/Laszlo-Benes"
"6895","Ramy Bensebaini_2021",2021,"M'Gladbach","Bundesliga","Ramy Bensebaini","ALG","DF","25",1995,20.1,43,24,27,13,3,26,42,61.9,16,39,7,32,47,90,66,0,"https://fbref.com/en/players/378825c7/Ramy-Bensebaini"
"6896","Jordan Beyer_2021",2021,"M'Gladbach","Bundesliga","Jordan Beyer","GER","DF","20",2000,2.1,2,1,2,0,0,1,2,50,1,5,4,1,5,7,5,0,"https://fbref.com/en/players/9af1f9ff/Jordan-Beyer"
"6897","Nico Elvedi_2021",2021,"M'Gladbach","Bundesliga","Nico Elvedi","SUI","DF","23",1996,28.2,49,35,36,12,1,25,37,67.6,12,38,22,16,65,114,123,0,"https://fbref.com/en/players/48035304/Nico-Elvedi"
"6898","Breel Embolo_2021",2021,"M'Gladbach","Bundesliga","Breel Embolo","SUI","FW,MF","23",1997,16,15,10,1,13,1,0,6,0,6,16,1,15,8,23,8,0,"https://fbref.com/en/players/0b4f388a/Breel-Embolo"
"6899","Matthias Ginter_2021",2021,"M'Gladbach","Bundesliga","Matthias Ginter","GER","DF","26",1994,34,26,16,15,10,1,14,24,58.3,10,43,32,11,51,77,121,0,"https://fbref.com/en/players/f521b80a/Matthias-Ginter"
"6900","Patrick Herrmann_2021",2021,"M'Gladbach","Bundesliga","Patrick Herrmann","GER","FW,MF","29",1991,9.7,9,6,4,3,2,2,14,14.3,12,16,0,16,10,19,8,0,"https://fbref.com/en/players/dfb6490a/Patrick-Herrmann"
"6901","Jonas Hofmann_2021",2021,"M'Gladbach","Bundesliga","Jonas Hofmann","GER","FW,MF","28",1992,20.2,26,20,12,12,2,10,53,18.9,43,27,2,25,27,53,9,0,"https://fbref.com/en/players/2903a856/Jonas-Hofmann"
"6902","Tony Jantschke_2021",2021,"M'Gladbach","Bundesliga","Tony Jantschke","GER","DF","30",1990,3,2,2,1,1,0,1,3,33.3,2,6,4,2,4,6,7,0,"https://fbref.com/en/players/34b54da7/Tony-Jantschke"
"6903","Christoph Kramer_2021",2021,"M'Gladbach","Bundesliga","Christoph Kramer","GER","MF","29",1991,22.6,55,37,22,28,5,28,58,48.3,30,32,11,21,34,89,39,0,"https://fbref.com/en/players/496aeede/Christoph-Kramer"
"6904","Stefan Lainer_2021",2021,"M'Gladbach","Bundesliga","Stefan Lainer","AUT","DF","27",1992,30.8,62,37,30,22,10,27,60,45,33,34,5,29,35,97,85,1,"https://fbref.com/en/players/4aea5077/Stefan-Lainer"
"6905","Valentino Lazaro_2021",2021,"M'Gladbach","Bundesliga","Valentino Lazaro","AUT","DF,FW","24",1996,13.8,17,11,7,5,5,12,19,63.2,7,18,1,17,15,32,20,0,"https://fbref.com/en/players/016ff750/Valentino-Lazaro"
"6906","Florian Neuhaus_2021",2021,"M'Gladbach","Bundesliga","Florian Neuhaus","GER","MF","23",1997,29.1,48,28,19,26,3,19,63,30.2,44,35,7,28,50,98,20,1,"https://fbref.com/en/players/36a59ba4/Florian-Neuhaus"
"6907","Alassane Pléa_2021",2021,"M'Gladbach","Bundesliga","Alassane Pléa","FRA","FW","27",1993,20,19,9,4,10,5,5,20,25,15,1,0,1,5,24,7,0,"https://fbref.com/en/players/bc6bd723/Alassane-Plea"
"6908","Rocco Reitz_2021",2021,"M'Gladbach","Bundesliga","Rocco Reitz","GER","MF","18",2002,0.7,3,2,0,3,0,2,2,100,0,3,1,2,1,4,1,0,"https://fbref.com/en/players/cc971106/Rocco-Reitz"
"6909","Tobias Sippel_2021",2021,"M'Gladbach","Bundesliga","Tobias Sippel","GER","GK","32",1988,3.8,0,0,0,0,0,0,0,NA,0,0,0,0,1,1,4,0,"https://fbref.com/en/players/0d8a37c2/Tobias-Sippel"
"6910","Yann Sommer_2021",2021,"M'Gladbach","Bundesliga","Yann Sommer","SUI","GK","31",1988,30.1,1,1,1,0,0,1,1,100,0,0,0,0,2,3,9,2,"https://fbref.com/en/players/420c18a1/Yann-Sommer"
"6911","Lars Stindl_2021",2021,"M'Gladbach","Bundesliga","Lars Stindl","GER","MF,FW","31",1988,21.8,24,17,3,16,5,7,32,21.9,25,26,3,23,13,37,14,0,"https://fbref.com/en/players/7cd6badb/Lars-Stindl"
"6912","Marcus Thuram_2021",2021,"M'Gladbach","Bundesliga","Marcus Thuram","FRA","FW,MF","22",1997,19.2,24,14,9,10,5,10,23,43.5,13,27,4,23,15,39,13,1,"https://fbref.com/en/players/6f8cd6d0/Marcus-Thuram"
"6913","Ibrahima Traoré_2021",2021,"M'Gladbach","Bundesliga","Ibrahima Traoré","GUI","FW,DF","32",1988,1.1,4,1,1,2,1,0,0,NA,0,2,0,2,0,4,0,0,"https://fbref.com/en/players/096a77c4/Ibrahima-Traore"
"6914","Oscar Wendt_2021",2021,"M'Gladbach","Bundesliga","Oscar Wendt","SWE","DF","34",1985,13.9,12,6,2,9,1,4,12,33.3,8,18,4,14,14,26,23,0,"https://fbref.com/en/players/b69261a0/Oscar-Wendt"
"6915","Hannes Wolf_2021",2021,"M'Gladbach","Bundesliga","Hannes Wolf","AUT","MF,FW","21",1999,15.3,26,13,8,10,8,8,36,22.2,28,18,1,17,9,35,4,0,"https://fbref.com/en/players/be42a291/Hannes-Wolf"
"6916","Denis Zakaria_2021",2021,"M'Gladbach","Bundesliga","Denis Zakaria","SUI","MF,DF","23",1996,15.8,30,15,12,15,3,11,20,55,9,20,7,13,23,53,29,1,"https://fbref.com/en/players/384d58d9/Denis-Zakaria"
"6917","Issah Abbas_2021",2021,"Mainz 05","Bundesliga","Issah Abbas","GHA","DF,FW","21",1998,0.2,0,0,0,0,0,0,0,NA,0,0,0,0,0,0,0,0,"https://fbref.com/en/players/2590ddf7/Issah-Abbas"
"6918","Ridle Baku_2021",2021,"Mainz 05","Bundesliga","Ridle Baku","GER","DF","22",1998,2,4,2,3,1,0,2,6,33.3,4,3,1,2,3,7,6,0,"https://fbref.com/en/players/442b56fa/Ridle-Baku"
"6919","Leandro Barreiro Martins_2021",2021,"Mainz 05","Bundesliga","Leandro Barreiro Martins","LUX","MF","20",2000,25.6,58,32,19,26,13,20,50,40,30,34,9,25,57,115,55,0,"https://fbref.com/en/players/00242b75/Leandro-Barreiro-Martins"
"6920","Stefan Bell_2021",2021,"Mainz 05","Bundesliga","Stefan Bell","GER","DF","28",1991,14.1,24,18,15,9,0,14,23,60.9,9,19,11,8,27,51,76,1,"https://fbref.com/en/players/857a5abe/Stefan-Bell"
"6921","Jean-Paul Boëtius_2021",2021,"Mainz 05","Bundesliga","Jean-Paul Boëtius","NED","MF,FW","26",1994,22.9,42,28,13,15,14,17,47,36.2,30,37,3,34,33,75,14,0,"https://fbref.com/en/players/635f2732/Jean-Paul-Boetius"
"6922","Daniel Brosinski_2021",2021,"Mainz 05","Bundesliga","Daniel Brosinski","GER","DF,FW","32",1988,15.9,19,14,10,7,2,12,31,38.7,19,18,1,17,14,33,33,0,"https://fbref.com/en/players/a7813ac4/Daniel-Brosinski"
"6923","Jonathan Burkardt_2021",2021,"Mainz 05","Bundesliga","Jonathan Burkardt","GER","FW,MF","20",2000,15.3,27,13,15,10,2,11,19,57.9,8,20,3,17,8,35,15,0,"https://fbref.com/en/players/05f99a4a/Jonathan-Burkardt"
"6924","Danny da Costa_2021",2021,"Mainz 05","Bundesliga","Danny da Costa","GER","DF,FW","27",1993,13.4,22,16,6,9,7,13,27,48.1,14,17,2,15,17,39,27,0,"https://fbref.com/en/players/5ddb8f9f/Danny-da-Costa"
"6925","Finn Dahmen_2021",2021,"Mainz 05","Bundesliga","Finn Dahmen","GER","GK","22",1998,3,0,0,0,0,0,0,1,0,1,0,0,0,0,0,1,0,"https://fbref.com/en/players/dee3013b/Finn-Dahmen"
"6926","Ji Dong-won_2021",2021,"Mainz 05","Bundesliga","Ji Dong-won","KOR","FW","29",1991,0.7,1,1,1,0,0,0,0,NA,0,1,0,1,2,3,0,0,"https://fbref.com/en/players/7d841904/Ji-Dong-won"
"6927","Edimilson Fernandes_2021",2021,"Mainz 05","Bundesliga","Edimilson Fernandes","SUI","MF,FW","24",1996,9.3,8,4,4,4,0,4,7,57.1,3,12,4,8,29,37,25,0,"https://fbref.com/en/players/3bb625ac/Edimilson-Fernandes"
"6928","Robert Glatzel_2021",2021,"Mainz 05","Bundesliga","Robert Glatzel","GER","FW","26",1994,4,1,0,1,0,0,0,2,0,2,2,0,2,0,1,2,0,"https://fbref.com/en/players/18a9efe4/Robert-Glatzel"
"6929","Alexander Hack_2021",2021,"Mainz 05","Bundesliga","Alexander Hack","GER","DF","26",1993,15.2,32,21,23,8,1,18,31,58.1,13,26,17,9,41,73,91,2,"https://fbref.com/en/players/a5ec3ede/Alexander-Hack"
"6930","Luca Kilian_2021",2021,"Mainz 05","Bundesliga","Luca Kilian","GER","DF","20",1999,4.2,14,7,10,4,0,9,17,52.9,8,3,1,2,13,27,12,0,"https://fbref.com/en/players/610aa1e9/Luca-Kilian"
"6931","Dominik Kohr_2021",2021,"Mainz 05","Bundesliga","Dominik Kohr","GER","MF","26",1994,14.1,47,31,14,26,7,20,39,51.3,19,18,5,13,27,74,15,0,"https://fbref.com/en/players/0fbecd11/Dominik-Kohr"
"6932","Pierre Kunde_2021",2021,"Mainz 05","Bundesliga","Pierre Kunde","CMR","MF","25",1995,5.7,8,4,1,5,2,2,9,22.2,7,6,0,6,10,18,9,0,"https://fbref.com/en/players/9ceb7642/Pierre-Kunde"
"6933","Danny Latza_2021",2021,"Mainz 05","Bundesliga","Danny Latza","GER","MF","30",1989,20,43,26,12,19,12,23,70,32.9,47,39,3,36,27,70,23,0,"https://fbref.com/en/players/33b554b7/Danny-Latza"
"6934","Aarón Martín_2021",2021,"Mainz 05","Bundesliga","Aarón Martín","ESP","DF,FW","23",1997,2.9,3,2,2,1,0,2,4,50,2,1,0,1,2,5,2,0,"https://fbref.com/en/players/2f3e911a/Aaron-Martin"
"6935","Jean-Philippe Mateta_2021",2021,"Mainz 05","Bundesliga","Jean-Philippe Mateta","FRA","FW","23",1997,11.1,6,3,1,3,2,0,3,0,3,3,1,2,4,10,6,0,"https://fbref.com/en/players/50e6dc35/Jean-Philippe-Mateta"
"6936","Phillipp Mwene_2021",2021,"Mainz 05","Bundesliga","Phillipp Mwene","AUT","DF,MF","26",1994,18.6,36,23,21,11,4,19,38,50,19,26,3,23,24,60,33,0,"https://fbref.com/en/players/2ff76adc/Phillipp-Mwene"
"6937","Paul Nebel_2021",2021,"Mainz 05","Bundesliga","Paul Nebel","GER","MF,FW","17",2002,0.6,1,1,0,1,0,0,1,0,1,0,0,0,2,3,0,0,"https://fbref.com/en/players/1b6d8083/Paul-Nebel"
"6938","Moussa Niakhate_2021",2021,"Mainz 05","Bundesliga","Moussa Niakhate","SEN","DF","24",1996,31.8,42,22,28,13,1,14,29,48.3,15,31,15,16,49,91,79,0,"https://fbref.com/en/players/00242715/Moussa-Niakhate"
"6939","Karim Onisiwo_2021",2021,"Mainz 05","Bundesliga","Karim Onisiwo","AUT","FW,MF","28",1992,20.5,31,20,7,15,9,14,23,60.9,9,20,1,19,5,36,12,0,"https://fbref.com/en/players/f26834c7/Karim-Onisiwo"
"6940","Levin Öztunalı_2021",2021,"Mainz 05","Bundesliga","Levin Öztunalı","GER","DF,FW","24",1996,8.4,24,18,14,8,2,8,17,47.1,9,15,0,15,15,39,16,0,"https://fbref.com/en/players/66385c46/Levin-Oztunali"
"6941","Matondo-Merveille Papela_2021",2021,"Mainz 05","Bundesliga","Matondo-Merveille Papela","GER","DF","19",2001,0,0,0,0,0,0,0,1,0,1,0,0,0,0,0,0,0,"https://fbref.com/en/players/b4b08774/Matondo-Merveille-Papela"
"6942","Robin Quaison_2021",2021,"Mainz 05","Bundesliga","Robin Quaison","SWE","FW,MF","26",1993,16.4,14,6,3,6,5,7,14,50,7,10,0,10,13,27,10,0,"https://fbref.com/en/players/74c7c2db/Robin-Quaison"
"6943","Jerry St. Juste_2021",2021,"Mainz 05","Bundesliga","Jerry St. Juste","NED","DF","23",1996,32,65,38,37,26,2,20,36,55.6,16,46,27,19,64,129,82,1,"https://fbref.com/en/players/90339309/Jerry-St-Juste"
"6944","Kevin Stöger_2021",2021,"Mainz 05","Bundesliga","Kevin Stöger","AUT","MF,FW","26",1993,6,12,6,2,9,1,5,16,31.3,11,5,0,5,6,18,4,0,"https://fbref.com/en/players/e5649a78/Kevin-Stoger"
"6945","Ádám Szalai_2021",2021,"Mainz 05","Bundesliga","Ádám Szalai","HUN","FW","32",1987,8.1,7,6,3,2,2,2,8,25,6,4,1,3,2,9,4,0,"https://fbref.com/en/players/53e07d0b/Adam-Szalai"
"6946","Niklas Tauer_2021",2021,"Mainz 05","Bundesliga","Niklas Tauer","GER","MF,DF","19",2001,0.8,1,1,0,1,0,1,2,50,1,3,1,2,3,4,1,0,"https://fbref.com/en/players/27270af4/Niklas-Tauer"
"6947","Robin Zentner_2021",2021,"Mainz 05","Bundesliga","Robin Zentner","GER","GK","25",1994,31,1,1,1,0,0,1,3,33.3,2,0,0,0,3,4,9,2,"https://fbref.com/en/players/5c4bf6ba/Robin-Zentner"
"6948","Sergio Agüero_2021",2021,"Manchester City","Premier League","Sergio Agüero","ARG","FW","32",1988,6.2,4,1,0,2,2,2,11,18.2,9,2,0,2,2,6,0,0,"https://fbref.com/en/players/4d034881/Sergio-Aguero"
"6949","Nathan Aké_2021",2021,"Manchester City","Premier League","Nathan Aké","NED","DF","25",1995,8.9,10,5,3,6,1,3,4,75,1,2,1,1,9,19,23,0,"https://fbref.com/en/players/eaeca114/Nathan-Ake"
"6950","João Cancelo_2021",2021,"Manchester City","Premier League","João Cancelo","POR","DF,MF","26",1994,25.5,68,41,42,19,7,43,83,51.8,40,23,2,21,41,109,33,2,"https://fbref.com/en/players/bd6351cd/Joao-Cancelo"
"6951","Scott Carson_2021",2021,"Manchester City","Premier League","Scott Carson","ENG","GK","34",1985,1,0,0,0,0,0,0,0,NA,0,0,0,0,0,0,0,0,"https://fbref.com/en/players/3e1550ee/Scott-Carson"
"6952","Kevin De Bruyne_2021",2021,"Manchester City","Premier League","Kevin De Bruyne","BEL","MF","29",1991,22.2,34,21,6,18,10,13,48,27.1,35,26,1,25,9,43,10,0,"https://fbref.com/en/players/e46012d4/Kevin-De-Bruyne"
"6953","Liam Delap_2021",2021,"Manchester City","Premier League","Liam Delap","ENG","FW","17",2003,0.4,0,0,0,0,0,0,0,NA,0,0,0,0,0,0,0,0,"https://fbref.com/en/players/dd897ee7/Liam-Delap"
"6954","Rúben Dias_2021",2021,"Manchester City","Premier League","Rúben Dias","POR","DF","23",1997,31.6,24,13,13,8,3,4,16,25,12,31,23,8,35,59,92,0,"https://fbref.com/en/players/31c69ef1/Ruben-Dias"
"6955","Ederson_2021",2021,"Manchester City","Premier League","Ederson","BRA","GK","26",1993,36,3,1,3,0,0,3,4,75,1,0,0,0,0,3,11,4,"https://fbref.com/en/players/3bb7b8b4/Ederson"
"6956","Fernandinho_2021",2021,"Manchester City","Premier League","Fernandinho","BRA","MF","35",1985,13.2,31,17,8,14,9,20,43,46.5,23,11,2,9,23,54,17,0,"https://fbref.com/en/players/101da2b5/Fernandinho"
"6957","Phil Foden_2021",2021,"Manchester City","Premier League","Phil Foden","ENG","FW,MF","20",2000,18,22,11,12,8,2,9,23,39.1,14,9,0,9,11,33,11,0,"https://fbref.com/en/players/ed1e53f3/Phil-Foden"
"6958","Eric García_2021",2021,"Manchester City","Premier League","Eric García","ESP","DF","19",2001,4.3,8,7,5,3,0,5,7,71.4,2,4,1,3,4,12,10,0,"https://fbref.com/en/players/2bed3eab/Eric-Garcia"
"6959","İlkay Gündoğan_2021",2021,"Manchester City","Premier League","İlkay Gündoğan","GER","MF","29",1990,22.5,25,15,8,12,5,10,39,25.6,29,13,4,9,20,45,9,0,"https://fbref.com/en/players/819b3158/Ilkay-Gundogan"
"6960","Gabriel Jesus_2021",2021,"Manchester City","Premier League","Gabriel Jesus","BRA","FW","23",1997,22.9,17,6,5,5,7,11,28,39.3,17,16,0,16,15,32,5,0,"https://fbref.com/en/players/b66315ae/Gabriel-Jesus"
"6961","Aymeric Laporte_2021",2021,"Manchester City","Premier League","Aymeric Laporte","ESP","DF","26",1994,14.9,13,6,10,3,0,7,11,63.6,4,12,7,5,11,24,28,0,"https://fbref.com/en/players/119b9a8e/Aymeric-Laporte"
"6962","Riyad Mahrez_2021",2021,"Manchester City","Premier League","Riyad Mahrez","ALG","FW","29",1991,21.7,20,5,2,10,8,6,30,20,24,19,0,19,8,28,4,0,"https://fbref.com/en/players/892d5bb1/Riyad-Mahrez"
"6963","Benjamin Mendy_2021",2021,"Manchester City","Premier League","Benjamin Mendy","FRA","DF","26",1994,10.6,13,9,1,8,4,5,21,23.8,16,12,5,7,5,18,14,1,"https://fbref.com/en/players/5271c8f1/Benjamin-Mendy"
"6964","Rodri_2021",2021,"Manchester City","Premier League","Rodri","ESP","MF","24",1996,30.5,72,40,24,40,8,33,66,50,33,23,9,14,36,108,54,3,"https://fbref.com/en/players/6434f10d/Rodri"
"6965","Bernardo Silva_2021",2021,"Manchester City","Premier League","Bernardo Silva","POR","MF,FW","25",1994,22.9,26,14,7,12,7,11,52,21.2,41,17,1,16,17,43,8,0,"https://fbref.com/en/players/3eb22ec9/Bernardo-Silva"
"6966","Zack Steffen_2021",2021,"Manchester City","Premier League","Zack Steffen","USA","GK","25",1995,1,0,0,0,0,0,0,0,NA,0,0,0,0,0,0,0,0,"https://fbref.com/en/players/42130443/Zack-Steffen"
"6967","Raheem Sterling_2021",2021,"Manchester City","Premier League","Raheem Sterling","ENG","FW","25",1994,28.2,21,10,5,12,4,5,12,41.7,7,15,0,15,15,36,4,0,"https://fbref.com/en/players/b400bde0/Raheem-Sterling"
"6968","John Stones_2021",2021,"Manchester City","Premier League","John Stones","ENG","DF","26",1994,21.5,21,10,13,5,3,9,14,64.3,5,23,15,8,18,39,56,1,"https://fbref.com/en/players/5eecec3d/John-Stones"
"6969","Ferrán Torres_2021",2021,"Manchester City","Premier League","Ferrán Torres","ESP","FW,MF","20",2000,14.5,12,5,4,6,2,5,16,31.3,11,16,0,16,3,15,8,0,"https://fbref.com/en/players/9e1035f8/Ferran-Torres"
"6970","Kyle Walker_2021",2021,"Manchester City","Premier League","Kyle Walker","ENG","DF","30",1990,21.6,29,19,15,12,2,16,24,66.7,8,19,7,12,14,43,28,0,"https://fbref.com/en/players/86dd77d1/Kyle-Walker"
"6971","Oleksandr Zinchenko_2021",2021,"Manchester City","Premier League","Oleksandr Zinchenko","UKR","DF","23",1996,16.4,25,15,12,9,4,14,24,58.3,10,17,4,13,23,48,28,0,"https://fbref.com/en/players/51cf8561/Oleksandr-Zinchenko"
"6972","Eric Bailly_2021",2021,"Manchester Utd","Premier League","Eric Bailly","CIV","DF","26",1994,10.2,5,5,3,1,1,0,1,0,1,13,11,2,13,18,36,2,"https://fbref.com/en/players/a1232f4e/Eric-Bailly"
"6973","Donny van de Beek_2021",2021,"Manchester Utd","Premier League","Donny van de Beek","NED","MF,FW","23",1997,5.8,15,10,2,11,2,7,15,46.7,8,10,1,9,6,21,7,0,"https://fbref.com/en/players/50dc94ce/Donny-van-de-Beek"
"6974","Edinson Cavani_2021",2021,"Manchester Utd","Premier League","Edinson Cavani","URU","FW","33",1987,15.3,12,8,1,8,3,2,13,15.4,11,2,0,2,6,18,11,0,"https://fbref.com/en/players/527f063d/Edinson-Cavani"
"6975","Amad Diallo_2021",2021,"Manchester Utd","Premier League","Amad Diallo","CIV","FW","18",2002,1.8,3,3,1,2,0,0,0,NA,0,2,1,1,0,3,1,0,"https://fbref.com/en/players/9dc96f10/Amad-Diallo"
"6976","Anthony Elanga_2021",2021,"Manchester Utd","Premier League","Anthony Elanga","SWE","FW","18",2002,1.7,4,2,3,1,0,4,5,80,1,1,1,0,1,5,1,0,"https://fbref.com/en/players/2fba6108/Anthony-Elanga"
"6977","Bruno Fernandes_2021",2021,"Manchester Utd","Premier League","Bruno Fernandes","POR","MF","25",1994,34.4,57,30,16,29,12,26,100,26,74,38,0,38,26,83,29,0,"https://fbref.com/en/players/507c7bdf/Bruno-Fernandes"
"6978","Timothy Fosu-Mensah_2021",2021,"Manchester Utd","Premier League","Timothy Fosu-Mensah","NED","DF","22",1998,0.9,2,0,1,1,0,1,1,100,0,0,0,0,3,5,1,0,"https://fbref.com/en/players/a9142dc3/Timothy-Fosu-Mensah"
"6979","Fred_2021",2021,"Manchester Utd","Premier League","Fred","BRA","MF","27",1993,26.6,81,39,39,38,4,29,89,32.6,60,49,9,40,45,126,26,1,"https://fbref.com/en/players/b853e0ad/Fred"
"6980","David de Gea_2021",2021,"Manchester Utd","Premier League","David de Gea","ESP","GK","29",1990,25.5,0,0,0,0,0,0,0,NA,0,0,0,0,0,0,8,3,"https://fbref.com/en/players/7ba6d84e/David-de-Gea"
"6981","Mason Greenwood_2021",2021,"Manchester Utd","Premier League","Mason Greenwood","ENG","FW","18",2001,20.2,13,10,6,4,3,5,22,22.7,17,9,0,9,5,18,1,0,"https://fbref.com/en/players/58eee997/Mason-Greenwood"
"6982","Dean Henderson_2021",2021,"Manchester Utd","Premier League","Dean Henderson","ENG","GK","23",1997,12.5,1,1,1,0,0,1,2,50,1,0,0,0,0,1,3,2,"https://fbref.com/en/players/e5a76dfe/Dean-Henderson"
"6983","Odion Ighalo_2021",2021,"Manchester Utd","Premier League","Odion Ighalo","NGA","FW","31",1989,0.1,0,0,0,0,0,0,1,0,1,0,0,0,0,0,0,0,"https://fbref.com/en/players/03622183/Odion-Ighalo"
"6984","Daniel James_2021",2021,"Manchester Utd","Premier League","Daniel James","WAL","FW","22",1997,10.1,15,9,4,7,4,3,18,16.7,15,10,1,9,0,15,6,0,"https://fbref.com/en/players/c931d9f9/Daniel-James"
"6985","Victor Lindelöf_2021",2021,"Manchester Utd","Premier League","Victor Lindelöf","SWE","DF","26",1994,28.7,22,10,12,10,0,12,24,50,12,22,14,8,30,52,95,1,"https://fbref.com/en/players/f5deef4c/Victor-Lindelof"
"6986","Harry Maguire_2021",2021,"Manchester Utd","Premier League","Harry Maguire","ENG","DF","27",1993,33.9,29,17,19,10,0,18,29,62.1,11,28,23,5,60,89,122,4,"https://fbref.com/en/players/d8931174/Harry-Maguire"
"6987","Anthony Martial_2021",2021,"Manchester Utd","Premier League","Anthony Martial","FRA","FW","24",1995,16.4,2,1,1,1,0,0,10,0,10,17,3,14,1,3,8,0,"https://fbref.com/en/players/8b788c01/Anthony-Martial"
"6988","Juan Mata_2021",2021,"Manchester Utd","Premier League","Juan Mata","ESP","FW,MF","32",1988,5.7,1,0,1,0,0,0,7,0,7,3,0,3,3,4,3,0,"https://fbref.com/en/players/29733c72/Juan-Mata"
"6989","Nemanja Matić_2021",2021,"Manchester Utd","Premier League","Nemanja Matić","SRB","MF","31",1988,12.3,25,11,13,12,0,13,31,41.9,18,19,5,14,22,47,10,3,"https://fbref.com/en/players/eb7822d7/Nemanja-Matic"
"6990","Scott McTominay_2021",2021,"Manchester Utd","Premier League","Scott McTominay","SCO","MF","23",1996,23.7,51,24,23,25,3,23,36,63.9,13,35,10,25,29,80,46,0,"https://fbref.com/en/players/d93c2511/Scott-McTominay"
"6991","Hannibal Mejbri_2021",2021,"Manchester Utd","Premier League","Hannibal Mejbri","TUN","MF","17",2003,0.1,0,0,0,0,0,0,0,NA,0,0,0,0,0,0,0,0,"https://fbref.com/en/players/ca22ccb0/Hannibal-Mejbri"
"6992","Paul Pogba_2021",2021,"Manchester Utd","Premier League","Paul Pogba","FRA","MF,FW","27",1993,21.1,36,26,15,16,5,11,33,33.3,22,24,2,22,26,62,37,0,"https://fbref.com/en/players/867239d3/Paul-Pogba"
"6993","Marcus Rashford_2021",2021,"Manchester Utd","Premier League","Marcus Rashford","ENG","FW","22",1997,32.4,18,9,2,8,8,7,27,25.9,20,22,2,20,8,26,10,0,"https://fbref.com/en/players/a1d5bd30/Marcus-Rashford"
"6994","Luke Shaw_2021",2021,"Manchester Utd","Premier League","Luke Shaw","ENG","DF","25",1995,29.5,44,28,21,16,7,21,36,58.3,15,34,9,25,20,64,44,2,"https://fbref.com/en/players/9c94165b/Luke-Shaw"
"6995","Shola Shoretire_2021",2021,"Manchester Utd","Premier League","Shola Shoretire","ENG","FW","16",2004,0.1,0,0,0,0,0,0,0,NA,0,0,0,0,0,0,0,0,"https://fbref.com/en/players/00f0482f/Shola-Shoretire"
"6996","Alex Telles_2021",2021,"Manchester Utd","Premier League","Alex Telles","BRA","DF","27",1992,7.7,14,7,10,3,1,8,17,47.1,9,7,2,5,16,30,20,0,"https://fbref.com/en/players/e73c9bb2/Alex-Telles"
"6997","William Thomas Fish_2021",2021,"Manchester Utd","Premier League","William Thomas Fish","ENG","FW","17",2003,0,0,0,0,0,0,0,0,NA,0,0,0,0,0,0,0,0,"https://fbref.com/en/players/b2ee9d2c/William-Thomas-Fish"
"6998","Axel Tuanzebe_2021",2021,"Manchester Utd","Premier League","Axel Tuanzebe","ENG","DF","22",1997,4.5,13,7,5,7,1,8,9,88.9,1,7,5,2,3,16,18,0,"https://fbref.com/en/players/2baec6ce/Axel-Tuanzebe"
"6999","Aaron Wan-Bissaka_2021",2021,"Manchester Utd","Premier League","Aaron Wan-Bissaka","ENG","DF","22",1997,34,88,54,53,29,6,32,45,71.1,13,65,17,48,62,150,84,2,"https://fbref.com/en/players/9e525177/Aaron-Wan-Bissaka"
"7000","Brandon Williams_2021",2021,"Manchester Utd","Premier League","Brandon Williams","ENG","DF","19",2000,2.1,0,0,0,0,0,0,1,0,1,1,0,1,1,1,7,0,"https://fbref.com/en/players/5e74d6c8/Brandon-Williams"
"7001","Marley Aké_2021",2021,"Marseille","Ligue 1","Marley Aké","FRA","FW","19",2001,1.6,3,3,1,0,2,0,1,0,1,2,0,2,0,3,1,0,"https://fbref.com/en/players/414e1f69/Marley-Ake"
"7002","Jordan Amavi_2021",2021,"Marseille","Ligue 1","Jordan Amavi","FRA","DF","26",1994,9,11,9,9,1,1,9,12,75,3,12,2,10,27,38,33,1,"https://fbref.com/en/players/22721b88/Jordan-Amavi"
"7003","Leonardo Balerdi_2021",2021,"Marseille","Ligue 1","Leonardo Balerdi","ARG","DF","21",1999,18.2,29,18,19,7,3,14,31,45.2,17,17,9,8,28,57,65,3,"https://fbref.com/en/players/7c3ed041/Leonardo-Balerdi"
"7004","Darío Benedetto_2021",2021,"Marseille","Ligue 1","Darío Benedetto","ARG","FW","30",1990,17.5,6,4,1,4,1,5,13,38.5,8,9,2,7,3,9,17,0,"https://fbref.com/en/players/bef0a7ac/Dario-Benedetto"
"7005","Duje Ćaleta-Car_2021",2021,"Marseille","Ligue 1","Duje Ćaleta-Car","CRO","DF","23",1996,31.3,29,17,19,9,1,17,30,56.7,13,29,22,7,44,73,130,0,"https://fbref.com/en/players/94f8d10c/Duje-Caleta-Car"
"7006","Mickaël Cuisance_2021",2021,"Marseille","Ligue 1","Mickaël Cuisance","FRA","MF","20",1999,11.4,24,11,2,15,7,10,33,30.3,23,13,1,12,3,27,4,0,"https://fbref.com/en/players/5722eced/Mickael-Cuisance"
"7007","Bamba Dieng_2021",2021,"Marseille","Ligue 1","Bamba Dieng","SEN","FW,DF","20",2000,1.4,5,3,3,2,0,2,4,50,2,2,0,2,0,5,0,0,"https://fbref.com/en/players/40774c6b/Bamba-Dieng"
"7008","Valère Germain_2021",2021,"Marseille","Ligue 1","Valère Germain","FRA","FW,MF","30",1990,9.5,8,6,2,4,2,3,11,27.3,8,7,2,5,11,19,22,0,"https://fbref.com/en/players/ea0ff634/Valere-Germain"
"7009","Álvaro González_2021",2021,"Marseille","Ligue 1","Álvaro González","ESP","DF","30",1990,31.5,26,17,20,6,0,19,31,61.3,12,30,18,12,33,59,119,1,"https://fbref.com/en/players/42dcf26d/Alvaro-Gonzalez"
"7010","Pape Gueye_2021",2021,"Marseille","Ligue 1","Pape Gueye","SEN","MF","21",1999,22.9,49,21,25,19,5,15,45,33.3,30,25,6,19,47,96,34,0,"https://fbref.com/en/players/7155e3e1/Pape-Gueye"
"7011","Luis Henrique_2021",2021,"Marseille","Ligue 1","Luis Henrique","BRA","FW,DF","18",2001,7.5,5,4,3,1,1,4,9,44.4,5,5,1,4,7,12,4,0,"https://fbref.com/en/players/f36d5624/Luis-Henrique"
"7012","Boubacar Kamara_2021",2021,"Marseille","Ligue 1","Boubacar Kamara","FRA","MF","20",1999,32.2,88,51,31,49,8,40,74,54.1,34,36,13,23,34,122,51,0,"https://fbref.com/en/players/cc77354e/Boubacar-Kamara"
"7013","Saîf-Eddine Khaoui_2021",2021,"Marseille","Ligue 1","Saîf-Eddine Khaoui","TUN","FW,DF","25",1995,6.7,19,11,7,6,6,7,16,43.8,9,8,0,8,12,31,1,0,"https://fbref.com/en/players/796b1c41/Saif-Eddine-Khaoui"
"7014","Pol Lirola_2021",2021,"Marseille","Ligue 1","Pol Lirola","ESP","DF,FW","22",1997,17.3,28,16,11,15,2,16,28,57.1,12,18,5,13,25,53,26,0,"https://fbref.com/en/players/ff800ed8/Pol-Lirola"
"7015","Maxime Lopez_2021",2021,"Marseille","Ligue 1","Maxime Lopez","FRA","FW,MF","22",1997,1.5,1,1,1,0,0,0,2,0,2,0,0,0,2,3,2,0,"https://fbref.com/en/players/20094685/Maxime-Lopez"
"7016","Steve Mandanda_2021",2021,"Marseille","Ligue 1","Steve Mandanda","FRA","GK","35",1985,37,0,0,0,0,0,0,1,0,1,0,0,0,2,2,8,6,"https://fbref.com/en/players/1d2d5cc8/Steve-Mandanda"
"7017","Arkadiusz Milik_2021",2021,"Marseille","Ligue 1","Arkadiusz Milik","POL","FW","26",1994,13.6,14,9,0,7,7,2,12,16.7,10,5,1,4,2,16,9,0,"https://fbref.com/en/players/85613cf0/Arkadiusz-Milik"
"7018","Yuto Nagatomo_2021",2021,"Marseille","Ligue 1","Yuto Nagatomo","JPN","DF","33",1986,17.7,23,16,12,8,3,9,18,50,9,14,3,11,29,52,43,0,"https://fbref.com/en/players/4b6960d2/Yuto-Nagatomo"
"7019","Olivier Ntcham_2021",2021,"Marseille","Ligue 1","Olivier Ntcham","CMR","MF","24",1996,1.3,1,0,0,1,0,1,3,33.3,2,3,1,2,2,3,3,0,"https://fbref.com/en/players/6554bb97/Olivier-Ntcham"
"7020","Dimitri Payet_2021",2021,"Marseille","Ligue 1","Dimitri Payet","FRA","FW,MF","33",1987,26.9,27,17,4,16,7,17,40,42.5,23,19,2,17,8,35,10,0,"https://fbref.com/en/players/58ae47b2/Dimitri-Payet"
"7021","Yohann Pelé_2021",2021,"Marseille","Ligue 1","Yohann Pelé","FRA","GK","37",1982,1,0,0,0,0,0,0,0,NA,0,0,0,0,0,0,0,0,"https://fbref.com/en/players/76806215/Yohann-Pele"
"7022","Lucas Perrin_2021",2021,"Marseille","Ligue 1","Lucas Perrin","FRA","DF","21",1998,3.4,7,4,4,3,0,5,12,41.7,7,5,4,1,8,15,16,0,"https://fbref.com/en/players/49070d66/Lucas-Perrin"
"7023","Nemanja Radonjić_2021",2021,"Marseille","Ligue 1","Nemanja Radonjić","SRB","FW","24",1996,4.4,6,5,1,2,3,2,12,16.7,10,8,0,8,3,9,1,0,"https://fbref.com/en/players/0630eb63/Nemanja-Radonjic"
"7024","Christopher Rocchia_2021",2021,"Marseille","Ligue 1","Christopher Rocchia","FRA","DF,FW","22",1998,0.2,1,0,1,0,0,0,2,0,2,0,0,0,0,1,1,0,"https://fbref.com/en/players/aa21406e/Christopher-Rocchia"
"7025","Valentin Rongier_2021",2021,"Marseille","Ligue 1","Valentin Rongier","FRA","MF","25",1994,21,93,59,31,55,7,43,85,50.6,42,32,2,30,28,121,21,1,"https://fbref.com/en/players/ed45c4a5/Valentin-Rongier"
"7026","Hiroki Sakai_2021",2021,"Marseille","Ligue 1","Hiroki Sakai","JPN","DF","30",1990,26.5,81,48,34,35,12,39,51,76.5,12,21,5,16,54,135,65,0,"https://fbref.com/en/players/d63e2912/Hiroki-Sakai"
"7027","Morgan Sanson_2021",2021,"Marseille","Ligue 1","Morgan Sanson","FRA","MF","25",1994,9.2,21,12,6,12,3,9,28,32.1,19,12,0,12,9,30,5,0,"https://fbref.com/en/players/6e7f1353/Morgan-Sanson"
"7028","Bouna Sarr_2021",2021,"Marseille","Ligue 1","Bouna Sarr","SEN","DF","28",1992,0.8,1,1,0,0,1,1,1,100,0,1,1,0,1,2,1,0,"https://fbref.com/en/players/1a4b9094/Bouna-Sarr"
"7029","Cheick Souaré_2021",2021,"Marseille","Ligue 1","Cheick Souaré","FRA","MF","17",2002,0.1,0,0,0,0,0,0,0,NA,0,1,1,0,1,1,0,0,"https://fbref.com/en/players/39c0c75b/Cheick-Souare"
"7030","Kevin Strootman_2021",2021,"Marseille","Ligue 1","Kevin Strootman","NED","MF,FW","30",1990,2.6,9,6,5,4,0,4,8,50,4,5,2,3,5,14,7,0,"https://fbref.com/en/players/ef2e5e1a/Kevin-Strootman"
"7031","Florian Thauvin_2021",2021,"Marseille","Ligue 1","Florian Thauvin","FRA","FW,MF","27",1993,30.4,40,22,14,21,5,20,54,37,34,26,2,24,14,54,11,0,"https://fbref.com/en/players/2b9fdeea/Florian-Thauvin"
"7032","Thierry Ambrose_2021",2021,"Metz","Ligue 1","Thierry Ambrose","GLP","FW","23",1997,8.4,7,4,1,1,5,2,12,16.7,10,2,0,2,2,9,4,0,"https://fbref.com/en/players/2945f4b7/Thierry-Ambrose"
"7033","Victorien Angban_2021",2021,"Metz","Ligue 1","Victorien Angban","CIV","MF","23",1996,18.6,36,24,17,15,4,17,42,40.5,25,17,4,13,19,55,9,1,"https://fbref.com/en/players/d8992b84/Victorien-Angban"
"7034","Farid Boulaya_2021",2021,"Metz","Ligue 1","Farid Boulaya","ALG","MF,FW","27",1993,31.3,24,16,4,17,3,13,51,25.5,38,19,3,16,12,36,7,0,"https://fbref.com/en/players/a0791826/Farid-Boulaya"
"7035","John Boye_2021",2021,"Metz","Ligue 1","John Boye","GHA","DF","33",1987,33.8,58,34,43,13,2,31,54,57.4,23,36,20,16,80,138,146,1,"https://fbref.com/en/players/861227d2/John-Boye"
"7036","Dylan Bronn_2021",2021,"Metz","Ligue 1","Dylan Bronn","TUN","DF","25",1995,37.9,57,37,38,19,0,24,44,54.5,20,31,14,17,44,101,112,0,"https://fbref.com/en/players/edd81e2a/Dylan-Bronn"
"7037","Marc-Aurèle Caillard_2021",2021,"Metz","Ligue 1","Marc-Aurèle Caillard","FRA","GK","26",1994,4,0,0,0,0,0,0,0,NA,0,0,0,0,0,0,2,0,"https://fbref.com/en/players/5ee6e943/Marc-Aurele-Caillard"
"7038","Fabien Centonze_2021",2021,"Metz","Ligue 1","Fabien Centonze","FRA","DF","24",1996,35.8,104,68,64,30,10,43,73,58.9,30,62,17,45,112,216,119,1,"https://fbref.com/en/players/3c6bbbab/Fabien-Centonze"
"7039","Thomas Delaine_2021",2021,"Metz","Ligue 1","Thomas Delaine","FRA","DF,FW","28",1992,19.8,32,18,19,11,2,20,35,57.1,15,22,5,17,24,56,30,1,"https://fbref.com/en/players/8332db56/Thomas-Delaine"
"7040","Habib Diallo_2021",2021,"Metz","Ligue 1","Habib Diallo","SEN","FW,MF","25",1995,1.6,1,1,0,1,0,1,1,100,0,0,0,0,0,1,5,0,"https://fbref.com/en/players/6605d143/Habib-Diallo"
"7041","Mamadou Fofana_2021",2021,"Metz","Ligue 1","Mamadou Fofana","MLI","MF,DF","22",1998,11.9,25,11,17,8,0,7,31,22.6,24,14,2,12,18,43,36,0,"https://fbref.com/en/players/4c4ffacc/Mamadou-Fofana"
"7042","Vagner Gonçalves_2021",2021,"Metz","Ligue 1","Vagner Gonçalves","CPV","FW,MF","24",1996,10.7,16,9,5,5,6,2,15,13.3,13,6,0,6,4,20,1,1,"https://fbref.com/en/players/743fd71f/Vagner-Goncalves"
"7043","Lamine Gueye_2021",2021,"Metz","Ligue 1","Lamine Gueye","SEN","FW,MF","22",1998,16.2,18,9,4,11,3,7,24,29.2,17,7,2,5,21,39,5,0,"https://fbref.com/en/players/9d5dcc23/Lamine-Gueye"
"7044","Boubakar Kouyaté_2021",2021,"Metz","Ligue 1","Boubakar Kouyaté","MLI","DF","23",1997,21.8,60,35,45,15,0,32,58,55.2,26,44,27,17,60,120,132,1,"https://fbref.com/en/players/562a4799/Boubakar-Kouyate"
"7045","Aaron Leya Iseka_2021",2021,"Metz","Ligue 1","Aaron Leya Iseka","BEL","FW","22",1997,11.2,6,4,2,3,1,0,4,0,4,4,2,2,0,6,6,0,"https://fbref.com/en/players/29ef0f49/Aaron-Leya-Iseka"
"7046","Habib Maïga_2021",2021,"Metz","Ligue 1","Habib Maïga","CIV","MF","24",1996,29.9,81,52,36,40,5,42,85,49.4,43,37,6,31,49,130,36,0,"https://fbref.com/en/players/e768de1f/Habib-Maiga"
"7047","Pape Matar Sarr_2021",2021,"Metz","Ligue 1","Pape Matar Sarr","SEN","MF","17",2002,17.7,45,29,19,21,5,20,38,52.6,18,24,4,20,27,72,16,0,"https://fbref.com/en/players/feb5d972/Pape-Matar-Sarr"
"7048","Youssef Maziz_2021",2021,"Metz","Ligue 1","Youssef Maziz","FRA","MF,FW","22",1998,2.9,2,0,1,1,0,1,5,20,4,1,0,1,6,8,1,0,"https://fbref.com/en/players/514270e8/Youssef-Maziz"
"7049","Kévin N'Doram_2021",2021,"Metz","Ligue 1","Kévin N'Doram","FRA","MF","24",1996,3.4,3,2,0,3,0,1,3,33.3,2,0,0,0,6,9,2,0,"https://fbref.com/en/players/e50623a0/Kevin-NDoram"
"7050","Papa Ndiaga Yade_2021",2021,"Metz","Ligue 1","Papa Ndiaga Yade","SEN","FW,MF","20",2000,11.1,15,8,9,2,4,7,20,35,13,9,0,9,4,19,6,0,"https://fbref.com/en/players/87e9c7cd/Papa-Ndiaga-Yade"
"7051","Opa Nguette_2021",2021,"Metz","Ligue 1","Opa Nguette","SEN","FW,MF","26",1994,12.6,15,8,2,8,5,3,10,30,7,14,2,12,1,16,1,0,"https://fbref.com/en/players/75a63397/Opa-Nguette"
"7052","Ibrahima Niane_2021",2021,"Metz","Ligue 1","Ibrahima Niane","SEN","FW","21",1999,7.4,1,1,0,0,1,1,2,50,1,3,0,3,0,1,8,0,"https://fbref.com/en/players/46faabfa/Ibrahima-Niane"
"7053","Alexandre Oukidja_2021",2021,"Metz","Ligue 1","Alexandre Oukidja","ALG","GK","32",1988,34,0,0,0,0,0,0,1,0,1,1,0,1,0,0,17,3,"https://fbref.com/en/players/ae7d0ecd/Alexandre-Oukidja"
"7054","Vincent Pajot_2021",2021,"Metz","Ligue 1","Vincent Pajot","FRA","MF","29",1990,10.2,35,20,19,11,5,10,18,55.6,8,9,2,7,42,77,11,0,"https://fbref.com/en/players/f86ca403/Vincent-Pajot"
"7055","Warren Tchimbembé_2021",2021,"Metz","Ligue 1","Warren Tchimbembé","CGO","MF,FW","22",1998,5.5,7,4,4,3,0,3,9,33.3,6,6,1,5,2,9,3,0,"https://fbref.com/en/players/93b8f9f4/Warren-Tchimbembe"
"7056","Cheikh Tidiane Sabaly_2021",2021,"Metz","Ligue 1","Cheikh Tidiane Sabaly","SEN","FW","21",1999,0.1,0,0,0,0,0,0,0,NA,0,0,0,0,0,0,0,0,"https://fbref.com/en/players/9ddf7fae/Cheikh-Tidiane-Sabaly"
"7057","Boubacar Traoré_2021",2021,"Metz","Ligue 1","Boubacar Traoré","MLI","MF","18",2001,0.6,3,2,1,2,0,1,1,100,0,1,0,1,0,3,0,0,"https://fbref.com/en/players/999ceb5f/Boubacar-Traore"
"7058","Matthieu Udol_2021",2021,"Metz","Ligue 1","Matthieu Udol","FRA","DF","24",1996,19.2,34,21,18,12,4,17,39,43.6,22,25,5,20,39,73,30,0,"https://fbref.com/en/players/cc41f558/Matthieu-Udol"
"7059","Ismaël Bennacer_2021",2021,"Milan","Serie A","Ismaël Bennacer","ALG","MF","22",1997,14.7,39,18,17,21,1,15,32,46.9,17,10,1,9,20,59,12,0,"https://fbref.com/en/players/db092d3b/Ismael-Bennacer"
"7060","Davide Calabria_2021",2021,"Milan","Serie A","Davide Calabria","ITA","DF","23",1996,29.4,101,64,61,32,8,54,90,60,36,42,9,33,37,138,82,1,"https://fbref.com/en/players/2146785a/Davide-Calabria"
"7061","Hakan Çalhanoğlu_2021",2021,"Milan","Serie A","Hakan Çalhanoğlu","TUR","MF,FW","26",1994,29,26,7,3,17,6,7,28,25,21,21,6,15,15,41,24,1,"https://fbref.com/en/players/cd0fa27b/Hakan-Calhanoglu"
"7062","Samu Castillejo_2021",2021,"Milan","Serie A","Samu Castillejo","ESP","FW","25",1995,13.1,24,12,9,14,1,14,40,35,26,21,0,21,6,30,9,0,"https://fbref.com/en/players/130a7a3f/Samu-Castillejo"
"7063","Lorenzo Colombo_2021",2021,"Milan","Serie A","Lorenzo Colombo","ITA","FW","18",2002,1,2,1,1,1,0,0,3,0,3,0,0,0,0,2,3,0,"https://fbref.com/en/players/04df29a5/Lorenzo-Colombo"
"7064","Andrea Conti_2021",2021,"Milan","Serie A","Andrea Conti","ITA","DF","26",1994,0.3,1,1,1,0,0,0,1,0,1,0,0,0,1,2,0,0,"https://fbref.com/en/players/8fef5412/Andrea-Conti"
"7065","Diogo Dalot_2021",2021,"Milan","Serie A","Diogo Dalot","POR","DF","21",1999,12.1,32,17,23,6,3,17,34,50,17,18,5,13,25,57,42,0,"https://fbref.com/en/players/d9565625/Diogo-Dalot"
"7066","Brahim Díaz_2021",2021,"Milan","Serie A","Brahim Díaz","ESP","MF,FW","20",1999,13.6,18,10,7,7,4,10,23,43.5,13,10,0,10,2,20,2,0,"https://fbref.com/en/players/407feb71/Brahim-Diaz"
"7067","Gianluigi Donnarumma_2021",2021,"Milan","Serie A","Gianluigi Donnarumma","ITA","GK","21",1999,37,0,0,0,0,0,0,1,0,1,1,0,1,1,1,23,2,"https://fbref.com/en/players/08f5afaa/Gianluigi-Donnarumma"
"7068","Léo Duarte_2021",2021,"Milan","Serie A","Léo Duarte","BRA","DF","24",1996,0.2,1,1,0,1,0,0,0,NA,0,0,0,0,1,2,0,0,"https://fbref.com/en/players/73ddc40c/Leo-Duarte"
"7069","Matteo Gabbia_2021",2021,"Milan","Serie A","Matteo Gabbia","ITA","DF","20",1999,6.2,9,5,3,6,0,2,2,100,0,8,6,2,3,12,21,0,"https://fbref.com/en/players/c235e803/Matteo-Gabbia"
"7070","Theo Hernández_2021",2021,"Milan","Serie A","Theo Hernández","FRA","DF","22",1997,32.6,48,29,22,21,5,19,38,50,19,29,6,23,34,82,64,5,"https://fbref.com/en/players/d4c9725f/Theo-Hernandez"
"7071","Zlatan Ibrahimović_2021",2021,"Milan","Serie A","Zlatan Ibrahimović","SWE","FW","38",1981,16.6,5,4,0,4,1,3,6,50,3,5,3,2,6,11,27,1,"https://fbref.com/en/players/4cde5509/Zlatan-Ibrahimovic"
"7072","Pierre Kalulu_2021",2021,"Milan","Serie A","Pierre Kalulu","FRA","DF","20",2000,8.1,18,14,11,6,1,10,14,71.4,4,9,3,6,19,37,20,0,"https://fbref.com/en/players/85f7d1be/Pierre-Kalulu"
"7073","Franck Kessié_2021",2021,"Milan","Serie A","Franck Kessié","CIV","MF","23",1996,35.8,53,30,28,19,6,20,38,52.6,18,47,15,32,46,99,51,0,"https://fbref.com/en/players/05e19d6a/Franck-Kessie"
"7074","Simon Kjær_2021",2021,"Milan","Serie A","Simon Kjær","DEN","DF","31",1989,26.6,45,26,23,20,2,18,30,60,12,42,26,16,42,87,125,0,"https://fbref.com/en/players/8b8a56ce/Simon-Kjaer"
"7075","Rade Krunić_2021",2021,"Milan","Serie A","Rade Krunić","BIH","MF,FW","26",1993,8,15,12,6,6,3,7,17,41.2,10,12,2,10,10,25,9,0,"https://fbref.com/en/players/817c6964/Rade-Krunic"
"7076","Rafael Leão_2021",2021,"Milan","Serie A","Rafael Leão","POR","FW","21",1999,21.4,13,6,4,7,2,6,15,40,9,17,0,17,4,17,14,1,"https://fbref.com/en/players/20730eae/Rafael-Leao"
"7077","Daniel Maldini_2021",2021,"Milan","Serie A","Daniel Maldini","ITA","FW,DF","18",2001,0.3,1,0,0,1,0,0,2,0,2,0,0,0,0,1,0,0,"https://fbref.com/en/players/801831fe/Daniel-Maldini"
"7078","Mario Mandžukić_2021",2021,"Milan","Serie A","Mario Mandžukić","CRO","FW","34",1986,2.4,7,6,2,4,1,2,3,66.7,1,0,0,0,2,9,3,0,"https://fbref.com/en/players/afa0d4e0/Mario-Mandzukic"
"7079","Soualiho Meïté_2021",2021,"Milan","Serie A","Soualiho Meïté","FRA","MF","26",1994,6.5,18,10,10,6,2,8,17,47.1,9,9,2,7,8,26,16,0,"https://fbref.com/en/players/5cec2c74/Soualiho-Meite"
"7080","Mateo Musacchio_2021",2021,"Milan","Serie A","Mateo Musacchio","ARG","DF","29",1990,0.4,2,1,2,0,0,2,3,66.7,1,1,0,1,3,5,0,0,"https://fbref.com/en/players/91899ca8/Mateo-Musacchio"
"7081","Jens Petter Hauge_2021",2021,"Milan","Serie A","Jens Petter Hauge","NOR","FW","20",1999,5.9,7,4,3,3,1,6,10,60,4,4,0,4,1,8,3,0,"https://fbref.com/en/players/12c35abe/Jens-Petter-Hauge"
"7082","Ante Rebić_2021",2021,"Milan","Serie A","Ante Rebić","CRO","FW","26",1993,19.7,26,9,4,8,14,8,37,21.6,29,21,1,20,7,33,17,0,"https://fbref.com/en/players/536cebe5/Ante-Rebic"
"7083","Alessio Romagnoli_2021",2021,"Milan","Serie A","Alessio Romagnoli","ITA","DF","25",1995,21.2,17,7,8,7,2,8,19,42.1,11,29,22,7,24,41,80,0,"https://fbref.com/en/players/3ead85f9/Alessio-Romagnoli"
"7084","Alexis Saelemaekers_2021",2021,"Milan","Serie A","Alexis Saelemaekers","BEL","FW","21",1999,22.4,43,26,20,18,5,19,60,31.7,41,29,1,28,25,68,6,0,"https://fbref.com/en/players/ee251371/Alexis-Saelemaekers"
"7085","Ciprian Tătărușanu_2021",2021,"Milan","Serie A","Ciprian Tătărușanu","ROU","GK","34",1986,1,0,0,0,0,0,0,0,NA,0,0,0,0,0,0,0,1,"https://fbref.com/en/players/b056e3da/Ciprian-Tatarusanu"
"7086","Fikayo Tomori_2021",2021,"Milan","Serie A","Fikayo Tomori","ENG","DF","22",1997,16.3,28,18,17,9,2,8,14,57.1,6,32,20,12,18,46,61,1,"https://fbref.com/en/players/7edfbb8a/Fikayo-Tomori"
"7087","Sandro Tonali_2021",2021,"Milan","Serie A","Sandro Tonali","ITA","MF","20",2000,14.8,28,19,14,13,1,13,28,46.4,15,18,5,13,22,50,18,0,"https://fbref.com/en/players/0db169ae/Sandro-Tonali"
"7088","Ruben Aguilar_2021",2021,"Monaco","Ligue 1","Ruben Aguilar","FRA","DF,MF","27",1993,24.7,63,37,32,21,10,32,52,61.5,20,30,3,27,47,110,43,1,"https://fbref.com/en/players/3dd738a1/Ruben-Aguilar"
"7089","Jean-Eudes Aholou_2021",2021,"Monaco","Ligue 1","Jean-Eudes Aholou","CIV","MF","26",1994,0.4,1,0,0,1,0,1,3,33.3,2,0,0,0,1,2,1,0,"https://fbref.com/en/players/48b28bfd/Jean-Eudes-Aholou"
"7090","Benoît Badiashile_2021",2021,"Monaco","Ligue 1","Benoît Badiashile","FRA","DF","19",2001,31.9,24,17,15,9,0,13,28,46.4,15,21,12,9,58,82,102,4,"https://fbref.com/en/players/06df8256/Benoit-Badiashile"
"7091","Fodé Ballo-Touré_2021",2021,"Monaco","Ligue 1","Fodé Ballo-Touré","SEN","DF","23",1997,7.4,21,17,9,11,1,6,13,46.2,7,7,0,7,6,27,11,1,"https://fbref.com/en/players/f449640d/Fode-Ballo-Toure"
"7092","Wissam Ben Yedder_2021",2021,"Monaco","Ligue 1","Wissam Ben Yedder","FRA","FW","29",1990,29,18,9,2,10,6,3,13,23.1,10,16,0,16,13,31,3,0,"https://fbref.com/en/players/942b4f90/Wissam-Ben-Yedder"
"7093","Giulian Biancone_2021",2021,"Monaco","Ligue 1","Giulian Biancone","FRA","DF,MF","20",2000,1,3,3,1,1,1,2,3,66.7,1,1,0,1,1,4,4,0,"https://fbref.com/en/players/de40e38c/Giulian-Biancone"
"7094","Krépin Diatta_2021",2021,"Monaco","Ligue 1","Krépin Diatta","SEN","MF,DF","21",1999,4.3,4,3,1,1,2,1,3,33.3,2,5,1,4,4,8,1,0,"https://fbref.com/en/players/8104e41e/Krepin-Diatta"
"7095","Sofiane Diop_2021",2021,"Monaco","Ligue 1","Sofiane Diop","FRA","MF,FW","20",2000,22.5,49,34,17,25,7,18,53,34,35,25,1,24,31,80,15,0,"https://fbref.com/en/players/19053e31/Sofiane-Diop"
"7096","Axel Disasi_2021",2021,"Monaco","Ligue 1","Axel Disasi","FRA","DF","22",1998,22.3,29,20,17,12,0,20,35,57.1,15,18,11,7,26,55,66,1,"https://fbref.com/en/players/ad82197c/Axel-Disasi"
"7097","Cesc Fàbregas_2021",2021,"Monaco","Ligue 1","Cesc Fàbregas","ESP","MF,FW","33",1987,9.7,20,12,6,9,5,9,22,40.9,13,11,1,10,13,33,3,0,"https://fbref.com/en/players/33508c78/Cesc-Fabregas"
"7098","Youssouf Fofana_2021",2021,"Monaco","Ligue 1","Youssouf Fofana","FRA","MF","21",1999,31.9,90,51,31,51,8,42,82,51.2,40,43,7,36,34,124,14,2,"https://fbref.com/en/players/822d51d7/Youssouf-Fofana"
"7099","Willem Geubbels_2021",2021,"Monaco","Ligue 1","Willem Geubbels","FRA","MF,FW","18",2001,3.3,12,8,5,7,0,5,13,38.5,8,9,0,9,3,15,5,0,"https://fbref.com/en/players/9836e892/Willem-Geubbels"
"7100","Aleksandr Golovin_2021",2021,"Monaco","Ligue 1","Aleksandr Golovin","RUS","MF,FW","24",1996,11.9,28,16,6,18,4,8,39,20.5,31,21,0,21,11,39,3,0,"https://fbref.com/en/players/3708e9fa/Aleksandr-Golovin"
"7101","Stevan Jovetić_2021",2021,"Monaco","Ligue 1","Stevan Jovetić","MNE","FW,MF","30",1989,8.9,8,4,2,3,3,3,13,23.1,10,1,0,1,3,11,3,0,"https://fbref.com/en/players/f36c432f/Stevan-Jovetic"
"7102","Benjamin Lecomte_2021",2021,"Monaco","Ligue 1","Benjamin Lecomte","FRA","GK","29",1991,28,0,0,0,0,0,0,2,0,2,1,0,1,2,2,20,1,"https://fbref.com/en/players/2fa2a875/Benjamin-Lecomte"
"7103","Florentino Luís_2021",2021,"Monaco","Ligue 1","Florentino Luís","POR","MF","20",1999,2.7,7,2,4,2,1,6,10,60,4,1,0,1,6,13,2,1,"https://fbref.com/en/players/881cd6be/Florentino-Luis"
"7104","Radosław Majecki_2021",2021,"Monaco","Ligue 1","Radosław Majecki","POL","GK","20",1999,1,0,0,0,0,0,0,0,NA,0,0,0,0,0,0,1,0,"https://fbref.com/en/players/20de219a/Radoslaw-Majecki"
"7105","Vito Mannone_2021",2021,"Monaco","Ligue 1","Vito Mannone","ITA","GK","32",1988,9,0,0,0,0,0,0,0,NA,0,0,0,0,0,0,3,1,"https://fbref.com/en/players/c4173f1a/Vito-Mannone"
"7106","Guillermo Maripán_2021",2021,"Monaco","Ligue 1","Guillermo Maripán","CHI","DF","26",1994,23.2,26,11,17,9,0,15,27,55.6,12,18,11,7,27,53,66,1,"https://fbref.com/en/players/d9764034/Guillermo-Maripan"
"7107","Gelson Martins_2021",2021,"Monaco","Ligue 1","Gelson Martins","POR","MF,FW","25",1995,17.2,41,26,12,16,13,15,37,40.5,22,20,0,20,13,54,8,0,"https://fbref.com/en/players/3ef0fa48/Gelson-Martins"
"7108","Eliot Matazo_2021",2021,"Monaco","Ligue 1","Eliot Matazo","BEL","MF","18",2002,3.5,11,5,6,5,0,3,7,42.9,4,1,0,1,1,12,2,0,"https://fbref.com/en/players/15944afd/Eliot-Matazo"
"7109","Chrislain Matsima_2021",2021,"Monaco","Ligue 1","Chrislain Matsima","FRA","DF,FW","18",2002,3.9,5,4,3,2,0,4,7,57.1,3,3,0,3,4,9,12,0,"https://fbref.com/en/players/cf1ef7ec/Chrislain-Matsima"
"7110","Enzo Millot_2021",2021,"Monaco","Ligue 1","Enzo Millot","FRA","MF","18",2002,0.5,2,0,0,1,1,1,1,100,0,0,0,0,2,4,0,0,"https://fbref.com/en/players/f76022e7/Enzo-Millot"
"7111","Henry Onyekuru_2021",2021,"Monaco","Ligue 1","Henry Onyekuru","NGA","FW","23",1997,1.6,1,0,1,0,0,1,4,25,3,1,0,1,0,1,0,0,"https://fbref.com/en/players/e90dc1d5/Henry-Onyekuru"
"7112","Strahinja Pavlović_2021",2021,"Monaco","Ligue 1","Strahinja Pavlović","SRB","DF","19",2001,0,0,0,0,0,0,0,0,NA,0,0,0,0,0,0,0,0,"https://fbref.com/en/players/25146df0/Strahinja-Pavlovic"
"7113","Pietro Pellegri_2021",2021,"Monaco","Ligue 1","Pietro Pellegri","ITA","FW,MF","19",2001,2.6,2,1,0,2,0,0,0,NA,0,1,0,1,0,2,0,0,"https://fbref.com/en/players/a44d3a3c/Pietro-Pellegri"
"7114","Djibril Sidibé_2021",2021,"Monaco","Ligue 1","Djibril Sidibé","FRA","DF","28",1992,22,58,34,26,29,3,37,52,71.2,15,20,5,15,50,108,37,2,"https://fbref.com/en/players/4c5b714f/Djibril-Sidibe"
"7115","Caio Henrique Oliveira Silva_2021",2021,"Monaco","Ligue 1","Caio Henrique Oliveira Silva","BRA","DF","23",1997,26.3,50,34,25,20,5,31,51,60.8,20,20,3,17,16,66,37,0,"https://fbref.com/en/players/30af8b93/Caio-Henrique-Oliveira-Silva"
"7116","Aurélien Tchouaméni_2021",2021,"Monaco","Ligue 1","Aurélien Tchouaméni","FRA","MF","20",2000,34,127,68,47,62,18,48,92,52.2,44,39,11,28,60,187,47,0,"https://fbref.com/en/players/4f255115/Aurelien-Tchouameni"
"7117","Kevin Volland_2021",2021,"Monaco","Ligue 1","Kevin Volland","GER","FW,MF","28",1992,30.8,33,16,11,19,3,8,34,23.5,26,23,0,23,4,37,4,0,"https://fbref.com/en/players/64f69877/Kevin-Volland"
"7118","Samy Benchamma_2021",2021,"Montpellier","Ligue 1","Samy Benchamma","FRA","DF,MF","20",2000,0.5,1,1,1,0,0,0,0,NA,0,0,0,0,0,1,1,0,"https://fbref.com/en/players/90c99c5c/Samy-Benchamma"
"7119","Dimitry Bertaud_2021",2021,"Montpellier","Ligue 1","Dimitry Bertaud","FRA","GK","22",1998,8.3,0,0,0,0,0,0,0,NA,0,0,0,0,1,1,2,0,"https://fbref.com/en/players/380a15e2/Dimitry-Bertaud"
"7120","Joris Chotard_2021",2021,"Montpellier","Ligue 1","Joris Chotard","FRA","MF","18",2001,12.9,12,8,5,6,1,6,31,19.4,25,12,3,9,11,23,15,0,"https://fbref.com/en/players/7909ffa4/Joris-Chotard"
"7121","Daniel Congré_2021",2021,"Montpellier","Ligue 1","Daniel Congré","FRA","DF","35",1985,36.6,59,35,45,12,2,36,70,51.4,34,50,33,17,69,128,144,3,"https://fbref.com/en/players/3f5b4635/Daniel-Congre"
"7122","Nicolas Cozza_2021",2021,"Montpellier","Ligue 1","Nicolas Cozza","FRA","DF","21",1999,15.2,39,30,27,11,1,20,40,50,20,20,11,9,26,65,62,0,"https://fbref.com/en/players/8f325097/Nicolas-Cozza"
"7123","Sacha Delaye_2021",2021,"Montpellier","Ligue 1","Sacha Delaye","FRA","MF","18",2002,0.1,0,0,0,0,0,0,1,0,1,0,0,0,1,1,1,0,"https://fbref.com/en/players/e4448c8c/Sacha-Delaye"
"7124","Andy Delort_2021",2021,"Montpellier","Ligue 1","Andy Delort","ALG","FW","28",1991,27.6,12,7,1,9,2,8,18,44.4,10,11,1,10,4,16,34,0,"https://fbref.com/en/players/d33c706e/Andy-Delort"
"7125","Keagan Dolly_2021",2021,"Montpellier","Ligue 1","Keagan Dolly","RSA","MF","27",1993,5,7,2,6,0,1,4,8,50,4,3,0,3,5,12,2,0,"https://fbref.com/en/players/ccb1c3af/Keagan-Dolly"
"7126","Jordan Ferri_2021",2021,"Montpellier","Ligue 1","Jordan Ferri","FRA","MF","28",1992,28.6,58,40,34,22,2,31,103,30.1,72,30,5,25,8,66,18,1,"https://fbref.com/en/players/375622c5/Jordan-Ferri"
"7127","Vitorino Hilton_2021",2021,"Montpellier","Ligue 1","Vitorino Hilton","BRA","DF","42",1977,23.5,15,10,10,4,1,3,14,21.4,11,34,26,8,38,53,104,3,"https://fbref.com/en/players/c4bbea9f/Vitorino-Hilton"
"7128","Yun Il-lok_2021",2021,"Montpellier","Ligue 1","Yun Il-lok","KOR","MF,FW","28",1992,3.5,0,0,0,0,0,0,4,0,4,0,0,0,5,5,1,0,"https://fbref.com/en/players/23bf644d/Yun-Il-lok"
"7129","Gaëtan Laborde_2021",2021,"Montpellier","Ligue 1","Gaëtan Laborde","FRA","FW,MF","26",1994,36.2,43,22,21,17,5,16,60,26.7,44,29,3,26,16,59,25,1,"https://fbref.com/en/players/7cdda3bf/Gaetan-Laborde"
"7130","Damien Le Tallec_2021",2021,"Montpellier","Ligue 1","Damien Le Tallec","FRA","MF,DF","30",1990,13.6,16,10,10,4,2,10,30,33.3,20,15,8,7,25,41,21,2,"https://fbref.com/en/players/8f4d116f/Damien-Le-Tallec"
"7131","Stephy Mavididi_2021",2021,"Montpellier","Ligue 1","Stephy Mavididi","ENG","FW,MF","22",1998,22.6,18,5,7,10,1,8,23,34.8,15,12,0,12,14,32,6,0,"https://fbref.com/en/players/30144daa/Stephy-Mavididi"
"7132","Pedro Mendes_2021",2021,"Montpellier","Ligue 1","Pedro Mendes","POR","DF","29",1990,18.1,21,19,16,5,0,14,21,66.7,7,23,13,10,34,55,58,0,"https://fbref.com/en/players/6690ef25/Pedro-Mendes"
"7133","Florent Mollet_2021",2021,"Montpellier","Ligue 1","Florent Mollet","FRA","MF","28",1991,26.2,20,15,7,11,2,12,47,25.5,35,18,4,14,32,52,9,1,"https://fbref.com/en/players/7e82a78f/Florent-Mollet"
"7134","Jonas Omlin_2021",2021,"Montpellier","Ligue 1","Jonas Omlin","SUI","GK","26",1994,29.7,1,1,1,0,0,1,4,25,3,0,0,0,0,1,9,1,"https://fbref.com/en/players/c631f952/Jonas-Omlin"
"7135","Ambroise Oyongo_2021",2021,"Montpellier","Ligue 1","Ambroise Oyongo","CMR","DF","29",1991,6.2,13,6,10,3,0,9,15,60,6,3,2,1,8,21,26,1,"https://fbref.com/en/players/e3e05edf/Ambroise-Oyongo"
"7136","Mihailo Ristić_2021",2021,"Montpellier","Ligue 1","Mihailo Ristić","SRB","DF","24",1995,24.8,45,22,25,13,7,28,44,63.6,16,30,9,21,26,71,57,0,"https://fbref.com/en/players/ea0aa7e0/Mihailo-Ristic"
"7137","Junior Sambia_2021",2021,"Montpellier","Ligue 1","Junior Sambia","FRA","DF,MF","23",1996,27.2,41,29,20,14,7,26,38,68.4,12,27,14,13,39,80,46,0,"https://fbref.com/en/players/24eb7ed6/Junior-Sambia"
"7138","Téji Savanier_2021",2021,"Montpellier","Ligue 1","Téji Savanier","FRA","MF","28",1991,24.1,49,33,16,25,8,22,73,30.1,51,28,6,22,38,87,15,0,"https://fbref.com/en/players/6bde367b/Teji-Savanier"
"7139","Petar Škuletić_2021",2021,"Montpellier","Ligue 1","Petar Škuletić","SRB","FW,MF","30",1990,2.6,3,2,1,2,0,0,5,0,5,4,2,2,0,3,4,0,"https://fbref.com/en/players/d9a66c60/Petar-Skuletic"
"7140","Arnaud Souquet_2021",2021,"Montpellier","Ligue 1","Arnaud Souquet","FRA","DF","28",1992,13.6,50,33,35,13,2,27,48,56.3,21,15,6,9,17,67,34,0,"https://fbref.com/en/players/4e0afc5d/Arnaud-Souquet"
"7141","Clément Vidal_2021",2021,"Montpellier","Ligue 1","Clément Vidal","FRA","DF","20",2000,1,2,1,1,1,0,2,4,50,2,4,4,0,1,3,6,1,"https://fbref.com/en/players/b2791a55/Clement-Vidal"
"7142","Elye Wahi_2021",2021,"Montpellier","Ligue 1","Elye Wahi","FRA","FW","17",2003,6.2,4,3,2,1,1,1,6,16.7,5,4,0,4,2,6,5,0,"https://fbref.com/en/players/0d7b6576/Elye-Wahi"
"7143","Mehdi Abeid_2021",2021,"Nantes","Ligue 1","Mehdi Abeid","ALG","MF","27",1992,14.7,34,19,16,14,4,15,30,50,15,9,2,7,20,54,10,0,"https://fbref.com/en/players/a4c3f7af/Mehdi-Abeid"
"7144","Dennis Appiah_2021",2021,"Nantes","Ligue 1","Dennis Appiah","FRA","DF","28",1992,17.3,55,34,33,15,7,32,59,54.2,27,23,6,17,25,80,43,0,"https://fbref.com/en/players/feb5d3ab/Dennis-Appiah"
"7145","Jean-Kévin Augustin_2021",2021,"Nantes","Ligue 1","Jean-Kévin Augustin","FRA","FW","23",1997,0.4,2,0,0,2,0,2,2,100,0,0,0,0,0,2,0,0,"https://fbref.com/en/players/97bfa797/Jean-Kevin-Augustin"
"7146","Ludovic Blas_2021",2021,"Nantes","Ligue 1","Ludovic Blas","FRA","MF,FW","22",1997,31,58,30,18,37,3,23,54,42.6,31,33,4,29,21,79,19,0,"https://fbref.com/en/players/6191093d/Ludovic-Blas"
"7147","Jean-Charles Castelletto_2021",2021,"Nantes","Ligue 1","Jean-Charles Castelletto","CMR","DF","25",1995,21.6,32,18,20,11,1,18,31,58.1,13,25,19,6,42,74,79,0,"https://fbref.com/en/players/e0f3a1f6/Jean-Charles-Castelletto"
"7148","Pedro Chirivella_2021",2021,"Nantes","Ligue 1","Pedro Chirivella","ESP","MF","23",1997,25.3,26,8,7,13,6,14,49,28.6,35,23,4,19,41,67,19,0,"https://fbref.com/en/players/68a26d51/Pedro-Chirivella"
"7149","Marcus Coco_2021",2021,"Nantes","Ligue 1","Marcus Coco","FRA","MF,FW","24",1996,16.4,36,21,17,15,4,16,36,44.4,20,16,3,13,20,56,17,0,"https://fbref.com/en/players/3010aefb/Marcus-Coco"
"7150","Sébastien Corchia_2021",2021,"Nantes","Ligue 1","Sébastien Corchia","FRA","DF","29",1990,23,55,30,29,17,9,33,60,55,27,28,10,18,38,93,40,1,"https://fbref.com/en/players/0e7ccfc4/Sebastien-Corchia"
"7151","Kalifa Coulibaly_2021",2021,"Nantes","Ligue 1","Kalifa Coulibaly","MLI","FW","28",1991,10.9,3,1,0,1,2,2,8,25,6,3,1,2,2,5,12,0,"https://fbref.com/en/players/9980269a/Kalifa-Coulibaly"
"7152","Renaud Emond_2021",2021,"Nantes","Ligue 1","Renaud Emond","BEL","FW,MF","28",1991,3.9,0,0,0,0,0,0,1,0,1,2,0,2,0,0,1,0,"https://fbref.com/en/players/5c9ac7f0/Renaud-Emond"
"7153","Fábio_2021",2021,"Nantes","Ligue 1","Fábio","BRA","DF","30",1990,16.7,62,37,37,23,2,35,61,57.4,26,29,8,21,37,99,49,0,"https://fbref.com/en/players/bc7b4580/Fabio"
"7154","Andrei Girotto_2021",2021,"Nantes","Ligue 1","Andrei Girotto","BRA","DF,MF","28",1992,29.6,65,41,50,15,0,39,70,55.7,31,34,15,19,59,124,103,0,"https://fbref.com/en/players/3befc2b6/Andrei-Girotto"
"7155","Abdoul Kader Bamba_2021",2021,"Nantes","Ligue 1","Abdoul Kader Bamba","FRA","FW,MF","26",1994,10.2,18,3,7,8,3,11,18,61.1,7,10,0,10,7,25,4,1,"https://fbref.com/en/players/32f3d97e/Abdoul-Kader-Bamba"
"7156","Randal Kolo Muani_2021",2021,"Nantes","Ligue 1","Randal Kolo Muani","FRA","FW","21",1998,33.7,22,14,1,13,8,7,27,25.9,20,15,2,13,8,30,26,0,"https://fbref.com/en/players/c0b3669f/Randal-Kolo-Muani"
"7157","Alban Lafont_2021",2021,"Nantes","Ligue 1","Alban Lafont","FRA","GK","21",1999,38,1,0,1,0,0,1,1,100,0,1,0,1,0,1,14,0,"https://fbref.com/en/players/4e7db402/Alban-Lafont"
"7158","Imran Louza_2021",2021,"Nantes","Ligue 1","Imran Louza","MAR","MF","21",1999,26.4,55,28,25,26,4,21,69,30.4,48,20,4,16,33,88,15,2,"https://fbref.com/en/players/e1df6989/Imran-Louza"
"7159","Batista Mendy_2021",2021,"Nantes","Ligue 1","Batista Mendy","FRA","MF","20",2000,0.8,1,1,0,1,0,0,1,0,1,3,1,2,1,2,1,0,"https://fbref.com/en/players/e472a6f6/Batista-Mendy"
"7160","Samuel Moutoussamy_2021",2021,"Nantes","Ligue 1","Samuel Moutoussamy","COD","FW","23",1996,0.9,0,0,0,0,0,0,1,0,1,1,0,1,0,0,0,0,"https://fbref.com/en/players/af0c835b/Samuel-Moutoussamy"
"7161","Bridge Ndilu_2021",2021,"Nantes","Ligue 1","Bridge Ndilu","FRA","FW,MF","20",2000,0.5,0,0,0,0,0,0,2,0,2,2,0,2,0,0,0,0,"https://fbref.com/en/players/602fc7b5/Bridge-Ndilu"
"7162","Nicolas Pallois_2021",2021,"Nantes","Ligue 1","Nicolas Pallois","FRA","DF","32",1987,30.8,58,36,42,14,2,38,72,52.8,34,44,20,24,37,95,155,1,"https://fbref.com/en/players/779847d6/Nicolas-Pallois"
"7163","Roli Pereira de Sa_2021",2021,"Nantes","Ligue 1","Roli Pereira de Sa","FRA","FW,MF","23",1996,0.6,4,3,1,3,0,3,4,75,1,2,0,2,0,4,0,0,"https://fbref.com/en/players/60f58477/Roli-Pereira-de-Sa"
"7164","Moses Simon_2021",2021,"Nantes","Ligue 1","Moses Simon","NGA","FW,MF","25",1995,25.8,27,14,11,9,7,17,36,47.2,19,24,1,23,15,42,15,1,"https://fbref.com/en/players/5f3eaaf5/Moses-Simon"
"7165","Abdoulaye Sylla_2021",2021,"Nantes","Ligue 1","Abdoulaye Sylla","GUI","DF","20",2000,0.1,2,1,2,0,0,1,1,100,0,1,0,1,0,2,1,0,"https://fbref.com/en/players/2aeb43f1/Abdoulaye-Sylla"
"7166","Abdoulaye Touré_2021",2021,"Nantes","Ligue 1","Abdoulaye Touré","FRA","MF","26",1994,18.7,28,12,10,16,2,14,31,45.2,17,17,2,15,22,50,19,0,"https://fbref.com/en/players/ef7cd87a/Abdoulaye-Toure"
"7167","Charles Traore_2021",2021,"Nantes","Ligue 1","Charles Traore","MLI","DF","28",1992,18.9,53,34,30,17,6,27,54,50,27,26,5,21,36,89,65,0,"https://fbref.com/en/players/de488e56/Charles-Traore"
"7168","Tiemoué Bakayoko_2021",2021,"Napoli","Serie A","Tiemoué Bakayoko","FRA","MF","25",1994,21.8,69,41,21,41,7,23,40,57.5,17,24,2,22,36,105,13,2,"https://fbref.com/en/players/59bf127b/Tiemoue-Bakayoko"
"7169","Antonio Cioffi_2021",2021,"Napoli","Serie A","Antonio Cioffi","ITA","FW","17",2002,0.1,0,0,0,0,0,0,0,NA,0,1,0,1,1,1,0,0,"https://fbref.com/en/players/3f1107d5/Antonio-Cioffi"
"7170","Diego Demme_2021",2021,"Napoli","Serie A","Diego Demme","GER","MF","28",1991,17.7,56,32,26,22,8,23,63,36.5,40,14,1,13,11,67,15,1,"https://fbref.com/en/players/dc3fa3b5/Diego-Demme"
"7171","Giovanni Di Lorenzo_2021",2021,"Napoli","Serie A","Giovanni Di Lorenzo","ITA","DF","26",1993,36,79,50,54,21,4,43,75,57.3,32,37,13,24,35,114,64,1,"https://fbref.com/en/players/230a2fac/Giovanni-Di-Lorenzo"
"7172","Elif Elmas_2021",2021,"Napoli","Serie A","Elif Elmas","MKD","MF,FW","20",1999,8.2,15,4,3,6,6,7,12,58.3,5,11,1,10,2,17,10,0,"https://fbref.com/en/players/cf007308/Elif-Elmas"
"7173","Faouzi Ghoulam_2021",2021,"Napoli","Serie A","Faouzi Ghoulam","ALG","DF,FW","29",1991,3.2,6,5,3,2,1,0,1,0,1,4,2,2,3,9,1,0,"https://fbref.com/en/players/c5adc293/Faouzi-Ghoulam"
"7174","Elseid Hysaj_2021",2021,"Napoli","Serie A","Elseid Hysaj","ALB","DF","26",1994,19.6,29,17,16,11,2,17,33,51.5,16,18,4,14,30,59,52,0,"https://fbref.com/en/players/2f3452eb/Elseid-Hysaj"
"7175","Lorenzo Insigne_2021",2021,"Napoli","Serie A","Lorenzo Insigne","ITA","FW","29",1991,31.8,26,18,8,12,6,13,72,18.1,59,30,1,29,37,63,6,1,"https://fbref.com/en/players/2f557579/Lorenzo-Insigne"
"7176","Kalidou Koulibaly_2021",2021,"Napoli","Serie A","Kalidou Koulibaly","SEN","DF","29",1991,24.5,36,24,25,7,4,19,32,59.4,13,46,26,20,29,65,64,2,"https://fbref.com/en/players/da974c7b/Kalidou-Koulibaly"
"7177","Fernando Llorente_2021",2021,"Napoli","Serie A","Fernando Llorente","ESP","FW,MF","35",1985,0.6,0,0,0,0,0,0,0,NA,0,0,0,0,0,0,0,0,"https://fbref.com/en/players/82dbf623/Fernando-Llorente"
"7178","Stanislav Lobotka_2021",2021,"Napoli","Serie A","Stanislav Lobotka","SVK","MF","25",1994,1.7,1,1,0,1,0,0,1,0,1,1,1,0,0,1,1,1,"https://fbref.com/en/players/e1cbb531/Stanislav-Lobotka"
"7179","Hirving Lozano_2021",2021,"Napoli","Serie A","Hirving Lozano","MEX","FW","25",1995,21.8,29,18,10,13,6,10,36,27.8,26,37,1,36,18,47,14,0,"https://fbref.com/en/players/a69e4806/Hirving-Lozano"
"7180","Nikola Maksimović_2021",2021,"Napoli","Serie A","Nikola Maksimović","SRB","DF","28",1991,13.4,18,9,11,6,1,9,18,50,9,15,6,9,21,39,49,3,"https://fbref.com/en/players/16b9d5cf/Nikola-Maksimovic"
"7181","Kévin Malcuit_2021",2021,"Napoli","Serie A","Kévin Malcuit","MAR","FW,MF","29",1991,0.4,2,1,2,0,0,0,1,0,1,0,0,0,2,4,2,0,"https://fbref.com/en/players/d6a889ea/Kevin-Malcuit"
"7182","Kostas Manolas_2021",2021,"Napoli","Serie A","Kostas Manolas","GRE","DF","29",1991,25.5,31,18,24,7,0,17,24,70.8,7,22,13,9,23,54,82,2,"https://fbref.com/en/players/c707411f/Kostas-Manolas"
"7183","Alex Meret_2021",2021,"Napoli","Serie A","Alex Meret","ITA","GK","23",1997,22,0,0,0,0,0,0,1,0,1,0,0,0,0,0,5,0,"https://fbref.com/en/players/9413b19f/Alex-Meret"
"7184","Dries Mertens_2021",2021,"Napoli","Serie A","Dries Mertens","BEL","FW,MF","33",1987,16.2,16,14,4,7,5,5,25,20,20,7,1,6,9,25,3,1,"https://fbref.com/en/players/89b2c8a9/Dries-Mertens"
"7185","Victor Osimhen_2021",2021,"Napoli","Serie A","Victor Osimhen","NGA","FW","21",1998,17.5,22,15,2,6,14,3,15,20,12,6,0,6,7,29,10,0,"https://fbref.com/en/players/8c90fd7a/Victor-Osimhen"
"7186","David Ospina_2021",2021,"Napoli","Serie A","David Ospina","COL","GK","31",1988,16,0,0,0,0,0,0,0,NA,0,0,0,0,0,0,4,0,"https://fbref.com/en/players/82b1198a/David-Ospina"
"7187","Andrea Petagna_2021",2021,"Napoli","Serie A","Andrea Petagna","ITA","FW","25",1995,10.7,2,0,0,2,0,2,7,28.6,5,4,0,4,1,3,7,0,"https://fbref.com/en/players/03f946ed/Andrea-Petagna"
"7188","Matteo Politano_2021",2021,"Napoli","Serie A","Matteo Politano","ITA","FW,MF","26",1993,21.2,24,16,13,9,2,11,47,23.4,36,14,1,13,14,38,18,0,"https://fbref.com/en/players/5e861944/Matteo-Politano"
"7189","Amir Rrahmani_2021",2021,"Napoli","Serie A","Amir Rrahmani","KVX","DF","26",1994,12.2,13,8,7,6,0,6,9,66.7,3,17,14,3,8,21,39,1,"https://fbref.com/en/players/4b3e1a38/Amir-Rrahmani"
"7190","Mário Rui_2021",2021,"Napoli","Serie A","Mário Rui","POR","DF","29",1991,18.5,24,13,17,6,1,17,33,51.5,16,17,4,13,28,52,29,1,"https://fbref.com/en/players/0b5a292a/Mario-Rui"
"7191","Fabián Ruiz Peña_2021",2021,"Napoli","Serie A","Fabián Ruiz Peña","ESP","MF","24",1996,28.5,58,31,26,21,11,25,70,35.7,45,33,3,30,36,94,32,1,"https://fbref.com/en/players/c0c7ff58/Fabian-Ruiz-Pena"
"7192","Piotr Zieliński_2021",2021,"Napoli","Serie A","Piotr Zieliński","POL","MF","26",1994,28,18,10,8,7,3,7,20,35,13,23,4,19,18,36,12,0,"https://fbref.com/en/players/a5296e55/Piotr-Zielinski"
"7193","Miguel Almirón_2021",2021,"Newcastle Utd","Premier League","Miguel Almirón","PAR","MF,FW","26",1994,27,49,29,21,25,3,14,56,25,42,23,4,19,25,74,20,1,"https://fbref.com/en/players/862a1c15/Miguel-Almiron"
"7194","Elliot Anderson_2021",2021,"Newcastle Utd","Premier League","Elliot Anderson","SCO","MF","17",2002,0,0,0,0,0,0,0,0,NA,0,0,0,0,0,0,0,0,"https://fbref.com/en/players/de31038e/Elliot-Anderson"
"7195","Andy Carroll_2021",2021,"Newcastle Utd","Premier League","Andy Carroll","ENG","FW","31",1989,4.4,3,1,1,1,1,1,8,12.5,7,1,0,1,0,3,14,0,"https://fbref.com/en/players/b581987a/Andy-Carroll"
"7196","Ciaran Clark_2021",2021,"Newcastle Utd","Premier League","Ciaran Clark","IRL","DF","30",1989,21,24,14,15,6,3,6,13,46.2,7,27,20,7,29,53,104,1,"https://fbref.com/en/players/2b91cf8e/Ciaran-Clark"
"7197","Karl Darlow_2021",2021,"Newcastle Utd","Premier League","Karl Darlow","ENG","GK","29",1990,25,0,0,0,0,0,0,0,NA,0,0,0,0,0,0,17,0,"https://fbref.com/en/players/cde3309f/Karl-Darlow"
"7198","Martin Dúbravka_2021",2021,"Newcastle Utd","Premier League","Martin Dúbravka","SVK","GK","31",1989,13,0,0,0,0,0,0,0,NA,0,0,0,0,0,0,3,0,"https://fbref.com/en/players/3a949a25/Martin-Dubravka"
"7199","Paul Dummett_2021",2021,"Newcastle Utd","Premier League","Paul Dummett","WAL","DF","28",1991,13.9,16,7,11,5,0,13,21,61.9,8,12,7,5,16,32,74,0,"https://fbref.com/en/players/3fe6bd8c/Paul-Dummett"
"7200","Federico Fernández_2021",2021,"Newcastle Utd","Premier League","Federico Fernández","ARG","DF","31",1989,23.1,29,22,23,5,1,17,21,81,4,41,31,10,17,46,147,0,"https://fbref.com/en/players/f25b010f/Federico-Fernandez"
"7201","Ryan Fraser_2021",2021,"Newcastle Utd","Premier League","Ryan Fraser","SCO","FW,MF","26",1994,10.3,4,1,3,1,0,2,5,40,3,1,0,1,6,10,7,0,"https://fbref.com/en/players/d56543a0/Ryan-Fraser"
"7202","Dwight Gayle_2021",2021,"Newcastle Utd","Premier League","Dwight Gayle","ENG","FW,MF","29",1990,5.7,2,0,1,1,0,0,7,0,7,3,1,2,1,3,2,0,"https://fbref.com/en/players/e58a03c6/Dwight-Gayle"
"7203","Isaac Hayden_2021",2021,"Newcastle Utd","Premier League","Isaac Hayden","ENG","MF,DF","25",1995,21.6,52,29,23,22,7,14,35,40,21,32,9,23,43,95,47,0,"https://fbref.com/en/players/c951a6df/Isaac-Hayden"
"7204","Jeff Hendrick_2021",2021,"Newcastle Utd","Premier League","Jeff Hendrick","IRL","MF","28",1992,15.8,8,3,5,3,0,1,13,7.7,12,14,9,5,19,27,18,0,"https://fbref.com/en/players/989d5705/Jeff-Hendrick"
"7205","Joelinton_2021",2021,"Newcastle Utd","Premier League","Joelinton","BRA","FW,MF","23",1996,22,33,21,7,21,5,14,37,37.8,23,30,2,28,9,42,24,0,"https://fbref.com/en/players/c17bfb65/Joelinton"
"7206","Emil Krafth_2021",2021,"Newcastle Utd","Premier League","Emil Krafth","SWE","DF","25",1994,14.3,19,8,9,9,1,12,25,48,13,15,9,6,15,34,52,2,"https://fbref.com/en/players/77cf6852/Emil-Krafth"
"7207","Jamaal Lascelles_2021",2021,"Newcastle Utd","Premier League","Jamaal Lascelles","ENG","DF","26",1993,18.1,14,7,5,9,0,3,6,50,3,27,17,10,12,26,86,0,"https://fbref.com/en/players/450ab6fc/Jamaal-Lascelles"
"7208","Jamal Lewis_2021",2021,"Newcastle Utd","Premier League","Jamal Lewis","NIR","DF","22",1998,20.4,37,20,23,13,1,16,38,42.1,22,21,7,14,11,48,44,1,"https://fbref.com/en/players/efb9215a/Jamal-Lewis"
"7209","Matthew Longstaff_2021",2021,"Newcastle Utd","Premier League","Matthew Longstaff","ENG","MF","20",2000,4.2,3,2,2,1,0,2,8,25,6,7,0,7,7,10,2,0,"https://fbref.com/en/players/c0027d2d/Matthew-Longstaff"
"7210","Sean Longstaff_2021",2021,"Newcastle Utd","Premier League","Sean Longstaff","ENG","MF","22",1997,15.7,31,14,13,15,3,18,42,42.9,24,26,5,21,19,50,14,2,"https://fbref.com/en/players/a2b105e0/Sean-Longstaff"
"7211","Javier Manquillo_2021",2021,"Newcastle Utd","Premier League","Javier Manquillo","ESP","DF","26",1994,9.2,24,14,8,14,2,11,17,64.7,6,8,1,7,9,33,15,1,"https://fbref.com/en/players/758dd7f0/Javier-Manquillo"
"7212","Jacob Murphy_2021",2021,"Newcastle Utd","Premier League","Jacob Murphy","ENG","DF,MF","25",1995,18.1,39,24,25,12,2,24,49,49,25,27,3,24,14,53,29,0,"https://fbref.com/en/players/de112b84/Jacob-Murphy"
"7213","Matt Ritchie_2021",2021,"Newcastle Utd","Premier League","Matt Ritchie","SCO","DF,MF","30",1989,15,10,3,5,3,2,3,17,17.6,14,17,2,15,12,22,47,0,"https://fbref.com/en/players/71ef519e/Matt-Ritchie"
"7214","Allan Saint-Maximin_2021",2021,"Newcastle Utd","Premier League","Allan Saint-Maximin","FRA","FW,MF","23",1997,17.3,16,9,6,9,1,4,9,44.4,5,10,0,10,4,20,2,0,"https://fbref.com/en/players/2b16cb1a/Allan-Saint-Maximin"
"7215","Fabian Schär_2021",2021,"Newcastle Utd","Premier League","Fabian Schär","SUI","DF","28",1991,13.8,13,4,8,5,0,7,19,36.8,12,19,12,7,27,40,52,1,"https://fbref.com/en/players/c8aa95da/Fabian-Schar"
"7216","Jonjo Shelvey_2021",2021,"Newcastle Utd","Premier League","Jonjo Shelvey","ENG","MF","28",1992,29.1,39,14,18,19,2,10,37,27,27,26,14,12,36,75,42,0,"https://fbref.com/en/players/3727dd3c/Jonjo-Shelvey"
"7217","Joe Willock_2021",2021,"Newcastle Utd","Premier League","Joe Willock","ENG","MF","20",1999,10.9,26,13,16,7,3,9,42,21.4,33,21,3,18,17,43,15,1,"https://fbref.com/en/players/a3b03921/Joe-Willock"
"7218","Callum Wilson_2021",2021,"Newcastle Utd","Premier League","Callum Wilson","ENG","FW","28",1992,23.2,12,5,1,6,5,2,12,16.7,10,10,3,7,7,19,14,0,"https://fbref.com/en/players/c596fcb0/Callum-Wilson"
"7219","DeAndre Yedlin_2021",2021,"Newcastle Utd","Premier League","DeAndre Yedlin","USA","DF","27",1993,4.8,9,4,8,1,0,4,10,40,6,5,1,4,7,16,17,0,"https://fbref.com/en/players/ae0a7ddf/DeAndre-Yedlin"
"7220","Youcef Atal_2021",2021,"Nice","Ligue 1","Youcef Atal","ALG","DF,FW","24",1996,10.6,25,12,11,14,0,13,26,50,13,10,2,8,26,51,12,0,"https://fbref.com/en/players/6a827d8e/Youcef-Atal"
"7221","Robson Bambu_2021",2021,"Nice","Ligue 1","Robson Bambu","BRA","DF","22",1997,11.6,16,11,14,2,0,11,14,78.6,3,8,7,1,10,26,57,0,"https://fbref.com/en/players/d4fa7d01/Robson-Bambu"
"7222","Danilo Barbosa_2021",2021,"Nice","Ligue 1","Danilo Barbosa","BRA","DF","24",1996,2.8,6,3,5,1,0,4,6,66.7,2,2,1,1,2,8,11,2,"https://fbref.com/en/players/0557ff4f/Danilo-Barbosa"
"7223","Salim Ben Seghir_2021",2021,"Nice","Ligue 1","Salim Ben Seghir","FRA","DF","17",2003,0.1,0,0,0,0,0,0,0,NA,0,0,0,0,0,0,0,0,"https://fbref.com/en/players/1f6298f2/Salim-Ben-Seghir"
"7224","Walter Benítez_2021",2021,"Nice","Ligue 1","Walter Benítez","ARG","GK","27",1993,38,1,1,1,0,0,1,3,33.3,2,1,0,1,1,2,7,2,"https://fbref.com/en/players/8a2248b4/Walter-Benitez"
"7225","Hicham Boudaoui_2021",2021,"Nice","Ligue 1","Hicham Boudaoui","ALG","MF","20",1999,19.3,52,35,20,24,8,26,68,38.2,42,14,4,10,23,75,26,1,"https://fbref.com/en/players/f9d5908e/Hicham-Boudaoui"
"7226","Patrick Burner_2021",2021,"Nice","Ligue 1","Patrick Burner","MTQ","DF","24",1996,0,0,0,0,0,0,0,0,NA,0,0,0,0,0,0,0,0,"https://fbref.com/en/players/8746d5d0/Patrick-Burner"
"7227","Alexis Claude-Maurice_2021",2021,"Nice","Ligue 1","Alexis Claude-Maurice","FRA","MF,FW","22",1998,21.2,40,19,17,14,9,14,48,29.2,34,16,2,14,14,54,3,0,"https://fbref.com/en/players/741418c3/Alexis-Claude-Maurice"
"7228","Racine Coly_2021",2021,"Nice","Ligue 1","Racine Coly","SEN","MF","24",1995,0.2,0,0,0,0,0,0,0,NA,0,0,0,0,0,0,0,0,"https://fbref.com/en/players/166a981d/Racine-Coly"
"7229","Flavius Daniliuc_2021",2021,"Nice","Ligue 1","Flavius Daniliuc","AUT","DF","19",2001,16.4,23,15,15,5,3,10,21,47.6,11,17,6,11,14,37,32,0,"https://fbref.com/en/players/7ef972c3/Flavius-Daniliuc"
"7230","Dante_2021",2021,"Nice","Ligue 1","Dante","BRA","DF","36",1983,8.6,10,5,6,4,0,3,7,42.9,4,6,4,2,10,20,20,0,"https://fbref.com/en/players/fd2bc67d/Dante"
"7231","Kasper Dolberg_2021",2021,"Nice","Ligue 1","Kasper Dolberg","DEN","FW","22",1997,21.4,6,2,1,3,2,2,11,18.2,9,11,2,9,6,12,19,1,"https://fbref.com/en/players/cc83b74d/Kasper-Dolberg"
"7232","Amine Gouiri_2021",2021,"Nice","Ligue 1","Amine Gouiri","FRA","FW,MF","20",2000,30.5,31,18,7,16,8,10,41,24.4,31,22,6,16,17,48,23,0,"https://fbref.com/en/players/aad56ca3/Amine-Gouiri"
"7233","Evann Guessand_2021",2021,"Nice","Ligue 1","Evann Guessand","FRA","FW","19",2001,0.3,0,0,0,0,0,0,1,0,1,1,1,0,1,1,1,0,"https://fbref.com/en/players/b73f17f8/Evann-Guessand"
"7234","Hassane Kamara_2021",2021,"Nice","Ligue 1","Hassane Kamara","CIV","DF,FW","26",1994,32.9,65,39,40,16,9,27,49,55.1,22,39,12,27,55,120,61,1,"https://fbref.com/en/players/19a12bed/Hassane-Kamara"
"7235","Pierre Lees-Melou_2021",2021,"Nice","Ligue 1","Pierre Lees-Melou","FRA","MF","27",1993,22.9,67,39,33,31,3,25,83,30.1,58,50,14,36,29,96,31,1,"https://fbref.com/en/players/f5044e54/Pierre-Lees-Melou"
"7236","Rony Lopes_2021",2021,"Nice","Ligue 1","Rony Lopes","POR","FW,MF","24",1995,19.8,20,14,4,13,3,6,27,22.2,21,14,3,11,8,28,6,0,"https://fbref.com/en/players/7c2965bb/Rony-Lopes"
"7237","Jordan Lotomba_2021",2021,"Nice","Ligue 1","Jordan Lotomba","SUI","DF,MF","21",1998,23.6,35,25,19,11,5,20,34,58.8,14,19,7,12,33,68,52,1,"https://fbref.com/en/players/fc4cf6a7/Jordan-Lotomba"
"7238","Hicham Mahou_2021",2021,"Nice","Ligue 1","Hicham Mahou","FRA","FW","21",1999,0.4,1,1,1,0,0,1,2,50,1,2,0,2,1,2,0,0,"https://fbref.com/en/players/f329ec76/Hicham-Mahou"
"7239","Myziane Maolida_2021",2021,"Nice","Ligue 1","Myziane Maolida","FRA","FW,MF","21",1999,12,13,8,4,4,5,4,11,36.4,7,6,1,5,6,19,4,0,"https://fbref.com/en/players/706a60e1/Myziane-Maolida"
"7240","Stanley N'Soki_2021",2021,"Nice","Ligue 1","Stanley N'Soki","FRA","DF","21",1999,13.8,27,19,15,9,3,13,22,59.1,9,17,4,13,26,53,38,2,"https://fbref.com/en/players/61590953/Stanley-NSoki"
"7241","Dan Ndoye_2021",2021,"Nice","Ligue 1","Dan Ndoye","SUI","FW,MF","19",2000,6.1,7,6,3,4,0,1,8,12.5,7,4,0,4,7,14,4,0,"https://fbref.com/en/players/8e697a8f/Dan-Ndoye"
"7242","Andy Pelmard_2021",2021,"Nice","Ligue 1","Andy Pelmard","FRA","DF","20",2000,13.4,18,12,12,5,1,9,12,75,3,11,3,8,20,38,35,0,"https://fbref.com/en/players/f18d7ab2/Andy-Pelmard"
"7243","Jeff Reine-Adélaïde_2021",2021,"Nice","Ligue 1","Jeff Reine-Adélaïde","FRA","MF,FW","22",1998,11.8,7,4,1,4,2,2,9,22.2,7,10,1,9,4,11,6,0,"https://fbref.com/en/players/d504b3e1/Jeff-Reine-Adelaide"
"7244","William Saliba_2021",2021,"Nice","Ligue 1","William Saliba","FRA","DF","19",2001,20,15,9,8,5,2,5,6,83.3,1,17,16,1,26,41,80,2,"https://fbref.com/en/players/972aeb2a/William-Saliba"
"7245","Morgan Schneiderlin_2021",2021,"Nice","Ligue 1","Morgan Schneiderlin","FRA","MF","30",1989,24.4,51,31,21,24,6,20,54,37,34,21,11,10,53,104,46,0,"https://fbref.com/en/players/51b41c5c/Morgan-Schneiderlin"
"7246","Malik Sellouki_2021",2021,"Nice","Ligue 1","Malik Sellouki","FRA","FW,MF","20",2000,0.7,0,0,0,0,0,0,1,0,1,2,0,2,2,2,0,0,"https://fbref.com/en/players/c0f706f3/Malik-Sellouki"
"7247","Eddy Sylvestre_2021",2021,"Nice","Ligue 1","Eddy Sylvestre","FRA","FW,MF","20",1999,1.1,1,1,1,0,0,0,1,0,1,1,0,1,1,2,0,0,"https://fbref.com/en/players/ff3a6a60/Eddy-Sylvestre"
"7248","Khéphren Thuram_2021",2021,"Nice","Ligue 1","Khéphren Thuram","FRA","MF","19",2001,16.6,32,16,5,21,6,9,27,33.3,18,21,9,12,18,50,22,1,"https://fbref.com/en/players/7d9397f8/Khephren-Thuram"
"7249","Jean-Clair Todibo_2021",2021,"Nice","Ligue 1","Jean-Clair Todibo","FRA","DF","20",1999,14.8,25,15,16,9,0,16,31,51.6,15,13,7,6,19,44,48,1,"https://fbref.com/en/players/88f130ed/Jean-Clair-Todibo"
"7250","Alexis Trouillet_2021",2021,"Nice","Ligue 1","Alexis Trouillet","FRA","MF,FW","19",2000,1.2,5,4,1,4,0,4,5,80,1,0,0,0,3,8,0,0,"https://fbref.com/en/players/0a8d6b91/Alexis-Trouillet"
"7251","Matteo Ahlinvi_2021",2021,"Nîmes","Ligue 1","Matteo Ahlinvi","BEN","MF","21",1999,10,26,20,10,14,2,11,39,28.2,28,6,0,6,2,28,8,0,"https://fbref.com/en/players/5ea9ebd4/Matteo-Ahlinvi"
"7252","Sofiane Alakouch_2021",2021,"Nîmes","Ligue 1","Sofiane Alakouch","MAR","DF","22",1998,16.7,53,33,30,16,7,29,45,64.4,16,17,2,15,21,74,38,0,"https://fbref.com/en/players/5314e067/Sofiane-Alakouch"
"7253","Karim Aribi_2021",2021,"Nîmes","Ligue 1","Karim Aribi","ALG","FW","26",1994,3.3,2,2,0,1,1,0,5,0,5,1,0,1,0,2,3,0,"https://fbref.com/en/players/08534272/Karim-Aribi"
"7254","Sami Ben Amar_2021",2021,"Nîmes","Ligue 1","Sami Ben Amar","MAR","MF","22",1998,0.1,0,0,0,0,0,0,0,NA,0,1,0,1,0,0,0,0,"https://fbref.com/en/players/c05d65d1/Sami-Ben-Amar"
"7255","Yassine Benrahou_2021",2021,"Nîmes","Ligue 1","Yassine Benrahou","FRA","MF","21",1999,13.8,16,9,8,6,2,7,25,28,18,9,0,9,4,20,5,1,"https://fbref.com/en/players/fbf76716/Yassine-Benrahou"
"7256","Anthony Briançon_2021",2021,"Nîmes","Ligue 1","Anthony Briançon","FRA","DF","25",1994,13.6,12,7,9,3,0,9,19,47.4,10,19,12,7,33,45,57,2,"https://fbref.com/en/players/16324e1d/Anthony-Briancon"
"7257","Lucas Buadés_2021",2021,"Nîmes","Ligue 1","Lucas Buadés","FRA","MF","22",1997,0.2,1,0,0,1,0,0,0,NA,0,0,0,0,0,1,0,0,"https://fbref.com/en/players/f9921b7f/Lucas-Buades"
"7258","Patrick Burner_2021",2021,"Nîmes","Ligue 1","Patrick Burner","MTQ","DF","24",1996,14.6,25,11,14,10,1,13,26,50,13,10,3,7,24,49,41,1,"https://fbref.com/en/players/8746d5d0/Patrick-Burner"
"7259","Nassim Chadli_2021",2021,"Nîmes","Ligue 1","Nassim Chadli","FRA","FW,MF","19",2001,0.3,2,1,2,0,0,0,1,0,1,1,0,1,0,2,0,0,"https://fbref.com/en/players/5c61496e/Nassim-Chadli"
"7260","Andrés Cubas_2021",2021,"Nîmes","Ligue 1","Andrés Cubas","PAR","MF","24",1996,24.9,80,47,30,44,6,33,74,44.6,41,37,10,27,50,130,29,3,"https://fbref.com/en/players/9b40a6ea/Andres-Cubas"
"7261","Lucas Deaux_2021",2021,"Nîmes","Ligue 1","Lucas Deaux","FRA","MF,DF","31",1988,19.5,47,32,20,22,5,16,49,32.7,33,20,3,17,20,67,30,4,"https://fbref.com/en/players/44f8c299/Lucas-Deaux"
"7262","Kevin Denkey_2021",2021,"Nîmes","Ligue 1","Kevin Denkey","TOG","FW","19",2000,5.8,4,2,0,3,1,0,3,0,3,2,0,2,1,5,2,0,"https://fbref.com/en/players/0d3585b5/Kevin-Denkey"
"7263","Clément Depres_2021",2021,"Nîmes","Ligue 1","Clément Depres","FRA","FW","25",1994,0.2,0,0,0,0,0,0,0,NA,0,0,0,0,0,0,0,0,"https://fbref.com/en/players/e53ab10b/Clement-Depres"
"7264","Mahamadou Doucouré_2021",2021,"Nîmes","Ligue 1","Mahamadou Doucouré","MLI","FW,MF","20",2000,0.5,1,1,1,0,0,1,1,100,0,0,0,0,0,1,0,0,"https://fbref.com/en/players/9826ea33/Mahamadou-Doucoure"
"7265","Haris Duljević_2021",2021,"Nîmes","Ligue 1","Haris Duljević","BIH","MF,FW","26",1993,8.6,15,9,4,7,4,6,22,27.3,16,3,0,3,8,23,1,0,"https://fbref.com/en/players/9b6556d2/Haris-Duljevic"
"7266","Niclas Eliasson_2021",2021,"Nîmes","Ligue 1","Niclas Eliasson","SWE","MF,FW","24",1995,20,28,14,9,12,7,11,24,45.8,13,20,1,19,23,51,16,0,"https://fbref.com/en/players/0033fb1b/Niclas-Eliasson"
"7267","Zinedine Ferhat_2021",2021,"Nîmes","Ligue 1","Zinedine Ferhat","ALG","FW,MF","27",1993,32.9,36,21,18,9,9,18,39,46.2,21,22,0,22,32,68,38,0,"https://fbref.com/en/players/005c0807/Zinedine-Ferhat"
"7268","Lamine Fomba_2021",2021,"Nîmes","Ligue 1","Lamine Fomba","FRA","MF","22",1998,24.2,66,36,30,25,11,30,65,46.2,35,48,19,29,59,125,39,2,"https://fbref.com/en/players/2145368f/Lamine-Fomba"
"7269","Kelyan Guessoum_2021",2021,"Nîmes","Ligue 1","Kelyan Guessoum","FRA","DF","21",1999,12.5,13,7,11,1,1,11,16,68.8,5,8,6,2,24,37,51,0,"https://fbref.com/en/players/fe296c72/Kelyan-Guessoum"
"7270","Moussa Koné_2021",2021,"Nîmes","Ligue 1","Moussa Koné","SEN","FW","23",1996,19.5,13,6,1,8,4,2,9,22.2,7,7,1,6,2,15,7,0,"https://fbref.com/en/players/3ef68782/Moussa-Kone"
"7271","Loïck Landre_2021",2021,"Nîmes","Ligue 1","Loïck Landre","FRA","DF","28",1992,18.1,14,7,9,5,0,13,28,46.4,15,22,19,3,31,45,52,0,"https://fbref.com/en/players/08082af0/Loick-Landre"
"7272","Marco Majouga_2021",2021,"Nîmes","Ligue 1","Marco Majouga","CTA","FW,MF","19",2001,1.4,1,1,1,0,0,1,3,33.3,2,0,0,0,0,1,0,0,"https://fbref.com/en/players/a27ecdc2/Marco-Majouga"
"7273","Pablo Martinez_2021",2021,"Nîmes","Ligue 1","Pablo Martinez","FRA","DF","31",1989,6,10,7,7,3,0,7,7,100,0,6,4,2,11,21,28,0,"https://fbref.com/en/players/1ad8cb67/Pablo-Martinez"
"7274","Birger Meling_2021",2021,"Nîmes","Ligue 1","Birger Meling","NOR","DF","25",1994,25.9,49,31,27,15,7,33,50,66,17,43,9,34,36,85,70,0,"https://fbref.com/en/players/70c52749/Birger-Meling"
"7275","Florian Miguel_2021",2021,"Nîmes","Ligue 1","Florian Miguel","FRA","DF","23",1996,17.1,14,13,12,2,0,9,17,52.9,8,21,13,8,45,59,66,1,"https://fbref.com/en/players/b66d1d8a/Florian-Miguel"
"7276","Gaëtan Paquiez_2021",2021,"Nîmes","Ligue 1","Gaëtan Paquiez","FRA","DF","26",1994,11.6,21,12,12,7,2,12,29,41.4,17,10,3,7,16,37,28,0,"https://fbref.com/en/players/475583ff/Gaetan-Paquiez"
"7277","Romain Philippoteaux_2021",2021,"Nîmes","Ligue 1","Romain Philippoteaux","FRA","FW,MF","32",1988,2.4,1,1,1,0,0,1,5,20,4,2,0,2,2,3,1,0,"https://fbref.com/en/players/f98b15f0/Romain-Philippoteaux"
"7278","Baptiste Reynet_2021",2021,"Nîmes","Ligue 1","Baptiste Reynet","FRA","GK","29",1990,38,2,1,2,0,0,2,4,50,2,1,0,1,1,3,9,2,"https://fbref.com/en/players/bcf1b2e9/Baptiste-Reynet"
"7279","Renaud Ripart_2021",2021,"Nîmes","Ligue 1","Renaud Ripart","FRA","MF,FW","27",1993,33.9,52,30,25,19,8,26,84,31,58,58,12,46,36,88,53,0,"https://fbref.com/en/players/beae3a73/Renaud-Ripart"
"7280","Nolan Roux_2021",2021,"Nîmes","Ligue 1","Nolan Roux","FRA","FW","32",1988,7.2,7,3,1,4,2,3,8,37.5,5,6,0,6,5,12,4,0,"https://fbref.com/en/players/3071a619/Nolan-Roux"
"7281","Sidy Sarr_2021",2021,"Nîmes","Ligue 1","Sidy Sarr","SEN","MF","24",1996,5.1,10,6,4,6,0,2,5,40,3,1,1,0,7,17,4,0,"https://fbref.com/en/players/a0b65401/Sidy-Sarr"
"7282","Naomichi Ueda_2021",2021,"Nîmes","Ligue 1","Naomichi Ueda","JPN","DF","25",1994,7.9,4,2,3,1,0,4,6,66.7,2,5,4,1,6,10,30,1,"https://fbref.com/en/players/539b4f25/Naomichi-Ueda"
"7283","Antoine Valerio_2021",2021,"Nîmes","Ligue 1","Antoine Valerio","FRA","MF","20",1999,0.8,0,0,0,0,0,0,1,0,1,1,0,1,2,2,0,0,"https://fbref.com/en/players/95981861/Antoine-Valerio"
"7284","Ezequiel Ávila_2021",2021,"Osasuna","La Liga","Ezequiel Ávila","ARG","FW,MF","26",1994,2.2,6,2,3,1,2,2,4,50,2,1,0,1,1,7,0,0,"https://fbref.com/en/players/253a06b9/Ezequiel-Avila"
"7285","Kike Barja_2021",2021,"Osasuna","La Liga","Kike Barja","ESP","MF,FW","23",1997,15.9,10,5,6,1,3,5,24,20.8,19,10,1,9,16,26,8,0,"https://fbref.com/en/players/aad53e64/Kike-Barja"
"7286","Darko Brašanac_2021",2021,"Osasuna","La Liga","Darko Brašanac","SRB","MF","28",1992,10.1,10,6,6,4,0,5,16,31.3,11,8,1,7,7,17,10,0,"https://fbref.com/en/players/4accb7e0/Darko-Brasanac"
"7287","Ante Budimir_2021",2021,"Osasuna","La Liga","Ante Budimir","CRO","FW","29",1991,18.1,20,12,2,11,7,4,15,26.7,11,17,4,13,2,22,17,1,"https://fbref.com/en/players/8f3565b3/Ante-Budimir"
"7288","Jonathan Calleri_2021",2021,"Osasuna","La Liga","Jonathan Calleri","ARG","FW","26",1993,17.2,15,6,2,4,9,3,17,17.6,14,18,2,16,1,16,10,1,"https://fbref.com/en/players/6922f806/Jonathan-Calleri"
"7289","Marc Cardona_2021",2021,"Osasuna","La Liga","Marc Cardona","ESP","FW,DF","25",1995,0.6,1,0,1,0,0,1,1,100,0,0,0,0,0,1,0,0,"https://fbref.com/en/players/b92b456a/Marc-Cardona"
"7290","Juan Cruz Armada_2021",2021,"Osasuna","La Liga","Juan Cruz Armada","ESP","DF","28",1992,21.8,36,22,17,16,3,19,35,54.3,16,19,5,14,15,51,50,0,"https://fbref.com/en/players/a56da3ba/Juan-Cruz-Armada"
"7291","Enric Gallego_2021",2021,"Osasuna","La Liga","Enric Gallego","ESP","FW","33",1986,9,6,3,2,2,2,2,14,14.3,12,5,1,4,1,7,9,0,"https://fbref.com/en/players/82e9b89d/Enric-Gallego"
"7292","David García_2021",2021,"Osasuna","La Liga","David García","ESP","DF","26",1994,35,26,17,13,13,0,13,24,54.2,11,36,19,17,59,85,171,0,"https://fbref.com/en/players/3e42f707/David-Garcia"
"7293","Rubén García_2021",2021,"Osasuna","La Liga","Rubén García","ESP","MF,FW","27",1993,30.2,50,29,21,22,7,14,45,31.1,31,28,2,26,29,79,20,0,"https://fbref.com/en/players/5c96b017/Ruben-Garcia"
"7294","Unai García_2021",2021,"Osasuna","La Liga","Unai García","ESP","DF","28",1992,13.8,19,9,14,4,1,9,15,60,6,16,8,8,14,33,40,0,"https://fbref.com/en/players/4a633cfe/Unai-Garcia"
"7295","Aridane Hernández_2021",2021,"Osasuna","La Liga","Aridane Hernández","ESP","DF","31",1989,22.5,20,11,13,6,1,7,12,58.3,5,22,19,3,34,54,127,1,"https://fbref.com/en/players/132ac341/Aridane-Hernandez"
"7296","Sergio Herrera_2021",2021,"Osasuna","La Liga","Sergio Herrera","ESP","GK","27",1993,32.9,0,0,0,0,0,0,2,0,2,0,0,0,3,3,29,3,"https://fbref.com/en/players/a4995f48/Sergio-Herrera"
"7297","Jony_2021",2021,"Osasuna","La Liga","Jony","ESP","MF,FW","29",1991,9.7,7,3,1,2,4,5,20,25,15,5,0,5,14,21,3,0,"https://fbref.com/en/players/244f57b9/Jony"
"7298","Adrián López_2021",2021,"Osasuna","La Liga","Adrián López","ESP","FW,MF","32",1988,5.3,3,3,0,1,2,1,5,20,4,3,0,3,0,3,3,0,"https://fbref.com/en/players/88a359d4/Adrian-Lopez"
"7299","Javi Martínez_2021",2021,"Osasuna","La Liga","Javi Martínez","ESP","MF,FW","20",1999,5.1,9,4,1,6,2,5,12,41.7,7,9,0,9,5,14,4,0,"https://fbref.com/en/players/3672b352/Javi-Martinez"
"7300","Jon Moncayola_2021",2021,"Osasuna","La Liga","Jon Moncayola","ESP","MF","22",1998,29.6,61,36,27,23,11,24,67,35.8,43,27,9,18,23,84,38,0,"https://fbref.com/en/players/9939e168/Jon-Moncayola"
"7301","Raúl Navas_2021",2021,"Osasuna","La Liga","Raúl Navas","ESP","DF","32",1988,1.9,6,3,5,1,0,4,6,66.7,2,0,0,0,3,9,13,0,"https://fbref.com/en/players/ad178594/Raul-Navas"
"7302","Iñigo Pérez_2021",2021,"Osasuna","La Liga","Iñigo Pérez","ESP","MF,DF","32",1988,15,20,10,9,6,5,10,16,62.5,6,12,0,12,15,35,8,1,"https://fbref.com/en/players/bc61cc65/Inigo-Perez"
"7303","Juan Pérez_2021",2021,"Osasuna","La Liga","Juan Pérez","ESP","GK","24",1996,3,0,0,0,0,0,0,0,NA,0,0,0,0,0,0,1,0,"https://fbref.com/en/players/8f29e08b/Juan-Perez"
"7304","Jonás Ramalho_2021",2021,"Osasuna","La Liga","Jonás Ramalho","ESP","DF","27",1993,3.4,5,4,4,0,1,1,3,33.3,2,3,0,3,2,7,7,0,"https://fbref.com/en/players/be3a0121/Jonas-Ramalho"
"7305","Facundo Roncaglia_2021",2021,"Osasuna","La Liga","Facundo Roncaglia","ARG","DF","33",1987,13.7,25,14,14,11,0,11,20,55,9,11,6,5,25,50,26,0,"https://fbref.com/en/players/51e3954c/Facundo-Roncaglia"
"7306","Rubén_2021",2021,"Osasuna","La Liga","Rubén","ESP","GK","36",1984,2.1,0,0,0,0,0,0,0,NA,0,0,0,0,0,0,1,0,"https://fbref.com/en/players/24279b8b/Ruben"
"7307","Manu Sánchez_2021",2021,"Osasuna","La Liga","Manu Sánchez","ESP","DF","19",2000,10.8,27,15,10,10,7,11,25,44,14,8,0,8,8,35,14,0,"https://fbref.com/en/players/ffacd3d5/Manu-Sanchez"
"7308","Oier Sanjurjo_2021",2021,"Osasuna","La Liga","Oier Sanjurjo","ESP","MF","34",1986,23.2,39,16,8,27,4,17,60,28.3,43,24,6,18,29,68,41,0,"https://fbref.com/en/players/466824fb/Oier-Sanjurjo"
"7309","Roberto Torres_2021",2021,"Osasuna","La Liga","Roberto Torres","ESP","MF,FW","31",1989,21,15,8,6,5,4,8,29,27.6,21,12,0,12,16,31,13,0,"https://fbref.com/en/players/d733aa38/Roberto-Torres"
"7310","Lucas Torró_2021",2021,"Osasuna","La Liga","Lucas Torró","ESP","MF","26",1994,17.2,32,15,11,19,2,21,34,61.8,13,16,7,9,27,59,43,0,"https://fbref.com/en/players/0e4fef6e/Lucas-Torro"
"7311","Nacho Vidal_2021",2021,"Osasuna","La Liga","Nacho Vidal","ESP","DF","25",1995,26.1,56,28,27,22,7,22,31,71,9,39,10,29,43,99,68,0,"https://fbref.com/en/players/3a9c4b7b/Nacho-Vidal"
"7312","Mitchel Bakker_2021",2021,"Paris S-G","Ligue 1","Mitchel Bakker","NED","DF","20",2000,18.8,38,30,15,14,9,17,26,65.4,9,22,2,20,22,60,20,0,"https://fbref.com/en/players/a8567629/Mitchel-Bakker"
"7313","Juan Bernat_2021",2021,"Paris S-G","Ligue 1","Juan Bernat","ESP","DF","27",1993,2.2,5,3,0,4,1,3,5,60,2,4,0,4,1,6,6,0,"https://fbref.com/en/players/433dc9a2/Juan-Bernat"
"7314","Marcin Bułka_2021",2021,"Paris S-G","Ligue 1","Marcin Bułka","POL","GK","20",1999,1,0,0,0,0,0,0,0,NA,0,0,0,0,0,0,0,1,"https://fbref.com/en/players/db87a2c4/Marcin-Bulka"
"7315","Colin Dagba_2021",2021,"Paris S-G","Ligue 1","Colin Dagba","FRA","DF","21",1998,15.1,23,11,4,17,2,14,19,73.7,5,18,5,13,16,39,18,1,"https://fbref.com/en/players/29c02c9f/Colin-Dagba"
"7316","Ángel Di María_2021",2021,"Paris S-G","Ligue 1","Ángel Di María","ARG","FW,MF","32",1988,20.6,26,17,6,8,12,11,45,24.4,34,14,1,13,6,32,7,0,"https://fbref.com/en/players/19cda00b/Angel-Di-Maria"
"7317","Abdou Diallo_2021",2021,"Paris S-G","Ligue 1","Abdou Diallo","SEN","DF","24",1996,16.6,16,11,9,5,2,8,13,61.5,5,15,8,7,25,41,36,0,"https://fbref.com/en/players/fc62f087/Abdou-Diallo"
"7318","Julian Draxler_2021",2021,"Paris S-G","Ligue 1","Julian Draxler","GER","MF,FW","26",1993,11.8,13,6,5,6,2,5,20,25,15,4,0,4,14,27,0,0,"https://fbref.com/en/players/1a992676/Julian-Draxler"
"7319","Bandiougou Fadiga_2021",2021,"Paris S-G","Ligue 1","Bandiougou Fadiga","FRA","FW,MF","19",2001,0.7,1,0,1,0,0,0,0,NA,0,0,0,0,0,1,0,0,"https://fbref.com/en/players/45bb4303/Bandiougou-Fadiga"
"7320","Alessandro Florenzi_2021",2021,"Paris S-G","Ligue 1","Alessandro Florenzi","ITA","DF","29",1991,17.1,24,16,9,9,6,12,29,41.4,17,7,1,6,17,41,25,0,"https://fbref.com/en/players/e288d4b3/Alessandro-Florenzi"
"7321","Idrissa Gana Gueye_2021",2021,"Paris S-G","Ligue 1","Idrissa Gana Gueye","SEN","MF","30",1989,17.6,63,35,20,34,9,26,50,52,24,26,7,19,20,83,9,3,"https://fbref.com/en/players/72c812f3/Idrissa-Gana-Gueye"
"7322","Ander Herrera_2021",2021,"Paris S-G","Ligue 1","Ander Herrera","ESP","MF","30",1989,20.6,53,35,17,26,10,30,77,39,47,31,5,26,31,84,22,1,"https://fbref.com/en/players/436a9dd0/Ander-Herrera"
"7323","Mauro Icardi_2021",2021,"Paris S-G","Ligue 1","Mauro Icardi","ARG","FW","27",1993,12,6,2,1,2,3,4,13,30.8,9,3,1,2,3,9,7,0,"https://fbref.com/en/players/43b78598/Mauro-Icardi"
"7324","Jesé_2021",2021,"Paris S-G","Ligue 1","Jesé","ESP","FW","27",1993,0.3,0,0,0,0,0,0,1,0,1,0,0,0,0,0,0,0,"https://fbref.com/en/players/4a537185/Jese"
"7325","Arnaud Kalimuendo_2021",2021,"Paris S-G","Ligue 1","Arnaud Kalimuendo","FRA","FW","18",2002,0.8,0,0,0,0,0,0,0,NA,0,0,0,0,0,0,0,0,"https://fbref.com/en/players/bf4c41f9/Arnaud-Kalimuendo"
"7326","Moise Kean_2021",2021,"Paris S-G","Ligue 1","Moise Kean","ITA","FW","20",2000,18.9,11,8,2,6,3,3,12,25,9,7,1,6,8,19,10,0,"https://fbref.com/en/players/3d50bcdb/Moise-Kean"
"7327","Thilo Kehrer_2021",2021,"Paris S-G","Ligue 1","Thilo Kehrer","GER","DF","23",1996,18,31,26,17,11,3,10,26,38.5,16,16,4,12,15,46,37,1,"https://fbref.com/en/players/51dbeea9/Thilo-Kehrer"
"7328","Presnel Kimpembe_2021",2021,"Paris S-G","Ligue 1","Presnel Kimpembe","FRA","DF","24",1995,25.6,46,28,23,19,4,24,34,70.6,10,19,11,8,30,76,61,4,"https://fbref.com/en/players/aef6e670/Presnel-Kimpembe"
"7329","Layvin Kurzawa_2021",2021,"Paris S-G","Ligue 1","Layvin Kurzawa","FRA","DF","27",1992,14.2,26,19,10,10,6,9,28,32.1,19,20,5,15,28,54,26,1,"https://fbref.com/en/players/41e7ef1c/Layvin-Kurzawa"
"7330","Marquinhos_2021",2021,"Paris S-G","Ligue 1","Marquinhos","BRA","DF","26",1994,23.6,27,21,14,10,3,15,26,57.7,11,21,9,12,27,54,75,2,"https://fbref.com/en/players/d5f2f82b/Marquinhos"
"7331","Kylian Mbappé_2021",2021,"Paris S-G","Ligue 1","Kylian Mbappé","FRA","FW","21",1998,26.4,4,2,0,1,3,2,9,22.2,7,7,1,6,3,7,4,1,"https://fbref.com/en/players/42fd9c7f/Kylian-Mbappe"
"7332","Edouard Michut_2021",2021,"Paris S-G","Ligue 1","Edouard Michut","FRA","MF","17",2003,0,0,0,0,0,0,0,0,NA,0,0,0,0,0,0,0,0,"https://fbref.com/en/players/fe6c1add/Edouard-Michut"
"7333","Kenny Nagera_2021",2021,"Paris S-G","Ligue 1","Kenny Nagera","FRA","FW","18",2002,0,0,0,0,0,0,0,0,NA,0,0,0,0,0,0,0,0,"https://fbref.com/en/players/833ce5f0/Kenny-Nagera"
"7334","Keylor Navas_2021",2021,"Paris S-G","Ligue 1","Keylor Navas","CRC","GK","33",1986,28,0,0,0,0,0,0,0,NA,0,0,0,0,0,0,10,0,"https://fbref.com/en/players/ecada4fc/Keylor-Navas"
"7335","Neymar_2021",2021,"Paris S-G","Ligue 1","Neymar","BRA","MF,FW","28",1992,15.7,14,11,1,6,7,8,37,21.6,29,8,0,8,9,23,0,0,"https://fbref.com/en/players/69384e5d/Neymar"
"7336","Leandro Paredes_2021",2021,"Paris S-G","Ligue 1","Leandro Paredes","ARG","MF","26",1994,14.5,30,18,12,15,3,19,39,48.7,20,17,5,12,17,47,13,1,"https://fbref.com/en/players/dff153a4/Leandro-Paredes"
"7337","Timothee Pembele_2021",2021,"Paris S-G","Ligue 1","Timothee Pembele","FRA","DF","17",2002,4.3,8,7,4,4,0,5,14,35.7,9,4,0,4,5,13,8,1,"https://fbref.com/en/players/f8ce97ca/Timothee-Pembele"
"7338","Danilo Pereira_2021",2021,"Paris S-G","Ligue 1","Danilo Pereira","POR","MF,DF","28",1991,15.9,21,11,6,11,4,6,14,42.9,8,14,6,8,29,50,33,4,"https://fbref.com/en/players/8fd9996f/Danilo-Pereira"
"7339","Rafinha_2021",2021,"Paris S-G","Ligue 1","Rafinha","BRA","MF,FW","27",1993,15.1,54,26,18,28,8,28,49,57.1,21,18,3,15,13,67,6,0,"https://fbref.com/en/players/0c2ac3cb/Rafinha"
"7340","Sergio Rico_2021",2021,"Paris S-G","Ligue 1","Sergio Rico","ESP","GK","26",1993,9,0,0,0,0,0,0,0,NA,0,0,0,0,0,0,1,0,"https://fbref.com/en/players/5f0241b2/Sergio-Rico"
"7341","Kays Ruiz_2021",2021,"Paris S-G","Ligue 1","Kays Ruiz","MAR","FW,MF","17",2002,2.1,1,1,0,1,0,0,4,0,4,1,0,1,3,4,2,0,"https://fbref.com/en/players/90a9cc01/Kays-Ruiz"
"7342","Pablo Sarabia_2021",2021,"Paris S-G","Ligue 1","Pablo Sarabia","ESP","FW,MF","28",1992,14.7,15,11,6,6,3,10,38,26.3,28,9,1,8,5,20,8,0,"https://fbref.com/en/players/9744ff80/Pablo-Sarabia"
"7343","Xavi Simons_2021",2021,"Paris S-G","Ligue 1","Xavi Simons","NED","MF","17",2003,0,0,0,0,0,0,0,0,NA,0,0,0,0,0,0,0,0,"https://fbref.com/en/players/da4d670f/Xavi-Simons"
"7344","Marco Verratti_2021",2021,"Paris S-G","Ligue 1","Marco Verratti","ITA","MF","27",1992,16.6,53,30,17,25,11,24,72,33.3,48,22,5,17,26,79,4,1,"https://fbref.com/en/players/1467af0d/Marco-Verratti"
"7345","Andrea Adorante_2021",2021,"Parma","Serie A","Andrea Adorante","ITA","FW","20",2000,0.1,0,0,0,0,0,0,0,NA,0,0,0,0,0,0,0,0,"https://fbref.com/en/players/7005ac66/Andrea-Adorante"
"7346","Bruno Alves_2021",2021,"Parma","Serie A","Bruno Alves","POR","DF","38",1981,18.1,13,10,10,3,0,7,9,77.8,2,17,12,5,26,39,81,0,"https://fbref.com/en/players/585a73a8/Bruno-Alves"
"7347","Botond Balogh_2021",2021,"Parma","Serie A","Botond Balogh","HUN","DF","18",2002,1.8,9,7,9,0,0,2,5,40,3,4,3,1,2,11,8,0,"https://fbref.com/en/players/348bafd4/Botond-Balogh"
"7348","Mattia Bani_2021",2021,"Parma","Serie A","Mattia Bani","ITA","DF","26",1993,12.7,20,11,15,4,1,4,8,50,4,10,6,4,33,53,50,0,"https://fbref.com/en/players/0821331c/Mattia-Bani"
"7349","Gastón Brugman_2021",2021,"Parma","Serie A","Gastón Brugman","URU","MF","27",1992,18,35,19,18,15,2,11,44,25,33,33,4,29,45,80,34,0,"https://fbref.com/en/players/e947ee4a/Gaston-Brugman"
"7350","Juan Brunetta_2021",2021,"Parma","Serie A","Juan Brunetta","ARG","FW,MF","23",1997,5.3,2,2,0,2,0,1,6,16.7,5,5,0,5,1,3,2,0,"https://fbref.com/en/players/d60099bc/Juan-Brunetta"
"7351","Maxime Busi_2021",2021,"Parma","Serie A","Maxime Busi","BEL","DF","20",1999,13.3,23,13,19,3,1,11,28,39.3,17,14,1,13,16,39,32,0,"https://fbref.com/en/players/7b082ec2/Maxime-Busi"
"7352","Drissa Camara_2021",2021,"Parma","Serie A","Drissa Camara","CIV","MF","18",2002,0.2,0,0,0,0,0,0,0,NA,0,0,0,0,0,0,0,0,"https://fbref.com/en/players/543d9d2b/Drissa-Camara"
"7353","Simone Colombi_2021",2021,"Parma","Serie A","Simone Colombi","ITA","GK","29",1991,2,0,0,0,0,0,0,0,NA,0,0,0,0,0,0,2,0,"https://fbref.com/en/players/72be9309/Simone-Colombi"
"7354","Andrea Conti_2021",2021,"Parma","Serie A","Andrea Conti","ITA","DF","26",1994,9,21,10,16,4,1,13,26,50,13,13,4,9,16,37,23,0,"https://fbref.com/en/players/8fef5412/Andrea-Conti"
"7355","Andreas Cornelius_2021",2021,"Parma","Serie A","Andreas Cornelius","DEN","FW","27",1993,21.1,11,4,1,5,5,2,12,16.7,10,9,2,7,1,12,25,1,"https://fbref.com/en/players/c693347d/Andreas-Cornelius"
"7356","Wylan Cyprien_2021",2021,"Parma","Serie A","Wylan Cyprien","FRA","MF","25",1995,4.6,9,4,5,3,1,2,4,50,2,13,8,5,5,14,6,1,"https://fbref.com/en/players/3e092724/Wylan-Cyprien"
"7357","Matteo Darmian_2021",2021,"Parma","Serie A","Matteo Darmian","ITA","DF","30",1989,2.3,6,5,3,3,0,4,7,57.1,3,2,0,2,6,12,7,0,"https://fbref.com/en/players/96e0490d/Matteo-Darmian"
"7358","Kastriot Dermaku_2021",2021,"Parma","Serie A","Kastriot Dermaku","ALB","DF,MF","28",1992,1.1,1,1,1,0,0,0,0,NA,0,2,1,1,2,3,8,0,"https://fbref.com/en/players/2990c466/Kastriot-Dermaku"
"7359","Jacopo Dezi_2021",2021,"Parma","Serie A","Jacopo Dezi","ITA","FW,MF","28",1992,0.9,4,3,0,2,2,3,6,50,3,2,0,2,0,4,0,0,"https://fbref.com/en/players/e921b9db/Jacopo-Dezi"
"7360","Daan Dierckx_2021",2021,"Parma","Serie A","Daan Dierckx","BEL","DF","17",2003,5.2,5,4,5,0,0,3,5,60,2,10,6,4,13,18,21,0,"https://fbref.com/en/players/3a35db3d/Daan-Dierckx"
"7361","Riccardo Gagliolo_2021",2021,"Parma","Serie A","Riccardo Gagliolo","SWE","DF","30",1990,21.7,45,18,35,8,2,28,45,62.2,17,34,7,27,36,81,64,1,"https://fbref.com/en/players/173061c0/Riccardo-Gagliolo"
"7362","Gervinho_2021",2021,"Parma","Serie A","Gervinho","CIV","FW","33",1987,22.5,5,1,2,2,1,1,14,7.1,13,11,1,10,10,15,3,0,"https://fbref.com/en/players/e468c053/Gervinho"
"7363","Alberto Grassi_2021",2021,"Parma","Serie A","Alberto Grassi","ITA","MF,DF","25",1995,13.1,30,11,14,13,3,8,29,27.6,21,22,9,13,26,56,32,0,"https://fbref.com/en/players/6cc97b6a/Alberto-Grassi"
"7364","Hernani_2021",2021,"Parma","Serie A","Hernani","BRA","MF","26",1994,24.3,51,25,21,27,3,29,66,43.9,37,35,4,31,31,82,40,1,"https://fbref.com/en/players/6f5ead86/Hernani"
"7365","Simone Iacoponi_2021",2021,"Parma","Serie A","Simone Iacoponi","ITA","DF","33",1987,13.3,22,12,16,5,1,13,26,50,13,9,4,5,11,33,42,1,"https://fbref.com/en/players/63071a3f/Simone-Iacoponi"
"7366","Roberto Inglese_2021",2021,"Parma","Serie A","Roberto Inglese","ITA","FW","28",1991,6.4,5,2,1,2,2,2,11,18.2,9,10,0,10,0,5,3,0,"https://fbref.com/en/players/6c1f7328/Roberto-Inglese"
"7367","Yann Karamoh_2021",2021,"Parma","Serie A","Yann Karamoh","FRA","FW,MF","22",1998,14.4,27,17,8,12,7,11,31,35.5,20,6,0,6,4,31,11,0,"https://fbref.com/en/players/8b66d9cc/Yann-Karamoh"
"7368","Márk Kosznovszky_2021",2021,"Parma","Serie A","Márk Kosznovszky","HUN","MF","18",2002,1,2,2,1,1,0,1,4,25,3,2,0,2,1,3,1,0,"https://fbref.com/en/players/185bf610/Mark-Kosznovszky"
"7369","Juraj Kucka_2021",2021,"Parma","Serie A","Juraj Kucka","SVK","MF,FW","33",1987,25.9,67,36,21,37,9,26,74,35.1,48,25,3,22,28,95,25,0,"https://fbref.com/en/players/5aaef9ef/Juraj-Kucka"
"7370","Jasmin Kurtić_2021",2021,"Parma","Serie A","Jasmin Kurtić","SVN","MF","31",1989,30.4,46,28,22,21,3,21,70,30,49,22,2,20,33,79,57,1,"https://fbref.com/en/players/144607cc/Jasmin-Kurtic"
"7371","Vincent Laurini_2021",2021,"Parma","Serie A","Vincent Laurini","FRA","DF","31",1989,9.7,16,11,8,6,2,7,9,77.8,2,8,4,4,17,33,22,1,"https://fbref.com/en/players/3535098b/Vincent-Laurini"
"7372","Dennis Man_2021",2021,"Parma","Serie A","Dennis Man","ROU","FW,MF","21",1998,7.8,12,6,6,4,2,6,21,28.6,15,5,0,5,2,14,6,0,"https://fbref.com/en/players/2079b3cc/Dennis-Man"
"7373","Valentin Mihaila_2021",2021,"Parma","Serie A","Valentin Mihaila","ROU","FW,MF","20",2000,7.8,2,1,1,1,0,0,10,0,10,8,1,7,5,7,8,0,"https://fbref.com/en/players/81a4c239/Valentin-Mihaila"
"7374","Yordan Osorio_2021",2021,"Parma","Serie A","Yordan Osorio","VEN","DF","26",1994,20.1,22,14,13,9,0,9,24,37.5,15,30,18,12,53,75,77,1,"https://fbref.com/en/players/4d17df3e/Yordan-Osorio"
"7375","Graziano Pellè_2021",2021,"Parma","Serie A","Graziano Pellè","ITA","FW","35",1985,6.8,2,2,0,1,1,1,8,12.5,7,3,0,3,2,4,8,0,"https://fbref.com/en/players/9654d8de/Graziano-Pelle"
"7376","Giuseppe Pezzella_2021",2021,"Parma","Serie A","Giuseppe Pezzella","ITA","DF","22",1997,20.3,34,19,23,9,2,22,41,53.7,19,22,9,13,12,46,52,3,"https://fbref.com/en/players/149c5f5d/Giuseppe-Pezzella"
"7377","Giacomo Ricci_2021",2021,"Parma","Serie A","Giacomo Ricci","ITA","DF","23",1996,0.7,3,1,1,2,0,0,0,NA,0,2,2,0,1,4,4,0,"https://fbref.com/en/players/cfb38237/Giacomo-Ricci"
"7378","Matteo Scozzarella_2021",2021,"Parma","Serie A","Matteo Scozzarella","ITA","MF","32",1988,1.7,4,0,3,1,0,2,3,66.7,1,3,1,2,6,10,0,0,"https://fbref.com/en/players/ea164f99/Matteo-Scozzarella"
"7379","Luigi Sepe_2021",2021,"Parma","Serie A","Luigi Sepe","ITA","GK","29",1991,36,0,0,0,0,0,0,2,0,2,0,0,0,2,2,13,2,"https://fbref.com/en/players/343f753a/Luigi-Sepe"
"7380","Luca Siligardi_2021",2021,"Parma","Serie A","Luca Siligardi","ITA","FW,MF","32",1988,0.4,0,0,0,0,0,0,2,0,2,0,0,0,0,0,0,0,"https://fbref.com/en/players/1cac99dc/Luca-Siligardi"
"7381","Simon Sohm_2021",2021,"Parma","Serie A","Simon Sohm","SUI","MF","19",2001,10,18,12,11,6,1,11,26,42.3,15,8,0,8,5,23,7,0,"https://fbref.com/en/players/a5f458d9/Simon-Sohm"
"7382","Mattia Sprocati_2021",2021,"Parma","Serie A","Mattia Sprocati","ITA","MF,FW","27",1993,0.2,1,0,0,1,0,1,1,100,0,0,0,0,1,2,0,0,"https://fbref.com/en/players/bdd0692f/Mattia-Sprocati"
"7383","Chaka Traorè_2021",2021,"Parma","Serie A","Chaka Traorè","CIV","FW,DF","15",2004,0.2,0,0,0,0,0,0,0,NA,0,0,0,0,0,0,1,1,"https://fbref.com/en/players/ee6e2b92/Chaka-Traore"
"7384","Lautaro Valenti_2021",2021,"Parma","Serie A","Lautaro Valenti","ARG","DF","21",1999,5.5,10,4,7,2,1,6,15,40,9,11,3,8,11,21,30,0,"https://fbref.com/en/players/55db5c36/Lautaro-Valenti"
"7385","Vasilios Zagaritis_2021",2021,"Parma","Serie A","Vasilios Zagaritis","GRE","DF","19",2001,0.7,0,0,0,0,0,0,0,NA,0,1,0,1,0,0,0,0,"https://fbref.com/en/players/b4a3d61a/Vasilios-Zagaritis"
"7386","Joshua Zirkzee_2021",2021,"Parma","Serie A","Joshua Zirkzee","NED","FW,MF","19",2001,1.3,2,2,1,1,0,1,3,33.3,2,1,1,0,0,2,1,0,"https://fbref.com/en/players/028e70b9/Joshua-Zirkzee"
"7387","Tyler Adams_2021",2021,"RB Leipzig","Bundesliga","Tyler Adams","USA","MF,DF","21",1999,20.6,35,24,12,15,8,17,31,54.8,14,22,5,17,29,64,30,0,"https://fbref.com/en/players/2b09d998/Tyler-Adams"
"7388","Angeliño_2021",2021,"RB Leipzig","Bundesliga","Angeliño","ESP","DF,FW","23",1997,24,31,19,10,18,3,13,24,54.2,11,22,1,21,30,61,40,0,"https://fbref.com/en/players/30941e96/Angelino"
"7389","Dennis Borkowski_2021",2021,"RB Leipzig","Bundesliga","Dennis Borkowski","GER","MF,FW","18",2002,0.1,0,0,0,0,0,0,0,NA,0,1,0,1,0,0,0,0,"https://fbref.com/en/players/78b9e99c/Dennis-Borkowski"
"7390","Emil Forsberg_2021",2021,"RB Leipzig","Bundesliga","Emil Forsberg","SWE","FW,MF","28",1991,17.1,11,6,1,6,4,5,27,18.5,22,10,1,9,11,22,4,0,"https://fbref.com/en/players/9a2e0ccc/Emil-Forsberg"
"7391","Péter Gulácsi_2021",2021,"RB Leipzig","Bundesliga","Péter Gulácsi","HUN","GK","30",1990,33,1,0,1,0,0,1,2,50,1,0,0,0,2,3,7,0,"https://fbref.com/en/players/bcb2ccd8/Peter-Gulacsi"
"7392","Amadou Haidara_2021",2021,"RB Leipzig","Bundesliga","Amadou Haidara","MLI","MF,FW","22",1998,21.2,50,28,20,21,9,11,36,30.6,25,33,1,32,30,80,24,0,"https://fbref.com/en/players/92432bc6/Amadou-Haidara"
"7393","Marcel Halstenberg_2021",2021,"RB Leipzig","Bundesliga","Marcel Halstenberg","GER","DF","28",1991,18.3,29,18,20,8,1,19,41,46.3,22,15,3,12,16,45,35,0,"https://fbref.com/en/players/8ff2354e/Marcel-Halstenberg"
"7394","Hwang Hee-chan_2021",2021,"RB Leipzig","Bundesliga","Hwang Hee-chan","KOR","FW,MF","24",1996,5.1,3,2,1,0,2,1,7,14.3,6,4,0,4,1,4,1,0,"https://fbref.com/en/players/169fd162/Hwang-Hee-chan"
"7395","Benjamin Henrichs_2021",2021,"RB Leipzig","Bundesliga","Benjamin Henrichs","GER","DF,MF","23",1997,6,12,7,4,5,3,2,9,22.2,7,9,1,8,8,20,8,0,"https://fbref.com/en/players/0a89e877/Benjamin-Henrichs"
"7396","Kevin Kampl_2021",2021,"RB Leipzig","Bundesliga","Kevin Kampl","SVN","MF","29",1990,21.5,38,26,9,24,5,18,35,51.4,17,20,2,18,29,67,14,0,"https://fbref.com/en/players/b825a650/Kevin-Kampl"
"7397","Lukas Klostermann_2021",2021,"RB Leipzig","Bundesliga","Lukas Klostermann","GER","DF","24",1996,16.1,23,19,8,12,3,11,18,61.1,7,16,6,10,18,41,44,1,"https://fbref.com/en/players/ca8033cb/Lukas-Klostermann"
"7398","Justin Kluivert_2021",2021,"RB Leipzig","Bundesliga","Justin Kluivert","NED","FW,MF","21",1999,9,2,1,1,1,0,0,2,0,2,4,0,4,5,7,3,0,"https://fbref.com/en/players/4c3a6744/Justin-Kluivert"
"7399","Ibrahima Konaté_2021",2021,"RB Leipzig","Bundesliga","Ibrahima Konaté","FRA","DF","21",1999,7.7,6,4,2,3,1,2,8,25,6,6,3,3,8,14,24,0,"https://fbref.com/en/players/5ed9b537/Ibrahima-Konate"
"7400","Konrad Laimer_2021",2021,"RB Leipzig","Bundesliga","Konrad Laimer","AUT","DF,MF","23",1997,0.9,2,0,0,1,1,0,4,0,4,2,0,2,1,3,0,0,"https://fbref.com/en/players/c1b7847c/Konrad-Laimer"
"7401","Josep Martinez_2021",2021,"RB Leipzig","Bundesliga","Josep Martinez","ESP","GK","22",1998,1,0,0,0,0,0,0,0,NA,0,0,0,0,0,0,0,0,"https://fbref.com/en/players/11d8aff0/Josep-Martinez"
"7402","Nordi Mukiele_2021",2021,"RB Leipzig","Bundesliga","Nordi Mukiele","FRA","DF","22",1997,18.6,44,30,14,28,2,21,37,56.8,16,33,1,32,23,67,33,2,"https://fbref.com/en/players/ac73ec79/Nordi-Mukiele"
"7403","Christopher Nkunku_2021",2021,"RB Leipzig","Bundesliga","Christopher Nkunku","FRA","FW,MF","22",1997,21,16,11,3,7,6,8,18,44.4,10,27,1,26,9,25,14,0,"https://fbref.com/en/players/7c56da38/Christopher-Nkunku"
"7404","Dani Olmo_2021",2021,"RB Leipzig","Bundesliga","Dani Olmo","ESP","MF","22",1998,24.4,23,14,6,13,4,4,23,17.4,19,15,0,15,13,36,21,0,"https://fbref.com/en/players/ae44e8e2/Dani-Olmo"
"7405","Willi Orban_2021",2021,"RB Leipzig","Bundesliga","Willi Orban","HUN","DF","27",1992,26.3,40,26,19,15,6,23,37,62.2,14,29,20,9,40,80,74,0,"https://fbref.com/en/players/20030c06/Willi-Orban"
"7406","Yussuf Poulsen_2021",2021,"RB Leipzig","Bundesliga","Yussuf Poulsen","DEN","FW","26",1994,15,10,6,1,6,3,1,17,5.9,16,16,0,16,6,16,13,0,"https://fbref.com/en/players/d2416c2e/Yussuf-Poulsen"
"7407","Marcel Sabitzer_2021",2021,"RB Leipzig","Bundesliga","Marcel Sabitzer","AUT","MF","26",1994,22.5,29,21,12,16,1,12,37,32.4,25,7,2,5,35,64,27,0,"https://fbref.com/en/players/e280527c/Marcel-Sabitzer"
"7408","Lazar Samardzic_2021",2021,"RB Leipzig","Bundesliga","Lazar Samardzic","SRB","MF","18",2002,2.2,10,7,4,6,0,5,13,38.5,8,6,0,6,2,12,1,0,"https://fbref.com/en/players/217c93a1/Lazar-Samardzic"
"7409","Alexander Sørloth_2021",2021,"RB Leipzig","Bundesliga","Alexander Sørloth","NOR","FW","24",1995,16,7,5,0,5,2,2,14,14.3,12,13,2,11,3,10,13,0,"https://fbref.com/en/players/e92cd3f7/Alexander-Sorloth"
"7410","Dayot Upamecano_2021",2021,"RB Leipzig","Bundesliga","Dayot Upamecano","FRA","DF","21",1998,25.9,37,30,18,19,0,14,20,70,6,25,14,11,33,70,74,2,"https://fbref.com/en/players/d248cd8f/Dayot-Upamecano"
"7411","Joscha Wosz_2021",2021,"RB Leipzig","Bundesliga","Joscha Wosz","GER","DF","18",2002,0.4,1,1,1,0,0,0,0,NA,0,1,0,1,1,2,0,0,"https://fbref.com/en/players/80c9e555/Joscha-Wosz"
"7412","Sergio Arribas_2021",2021,"Real Madrid","La Liga","Sergio Arribas","ESP","MF,FW","18",2001,1.5,3,1,2,1,0,1,3,33.3,2,2,0,2,4,7,2,0,"https://fbref.com/en/players/1e465e70/Sergio-Arribas"
"7413","Marco Asensio_2021",2021,"Real Madrid","La Liga","Marco Asensio","ESP","FW,MF","24",1996,20.8,12,6,7,4,1,3,24,12.5,21,15,0,15,11,23,10,0,"https://fbref.com/en/players/45af8a54/Marco-Asensio"
"7414","Karim Benzema_2021",2021,"Real Madrid","La Liga","Karim Benzema","FRA","FW","32",1987,32.2,8,6,4,2,2,5,15,33.3,10,9,2,7,8,16,24,0,"https://fbref.com/en/players/70d74ece/Karim-Benzema"
"7415","Blanco_2021",2021,"Real Madrid","La Liga","Blanco","ESP","MF,FW","20",2000,2.4,7,2,4,2,1,3,7,42.9,4,6,2,4,3,10,5,0,"https://fbref.com/en/players/506daeac/Blanco"
"7416","Dani Carvajal_2021",2021,"Real Madrid","La Liga","Dani Carvajal","ESP","DF","28",1992,10.6,27,20,12,10,5,11,20,55,9,19,1,18,13,40,27,0,"https://fbref.com/en/players/4958bfb2/Dani-Carvajal"
"7417","Casemiro_2021",2021,"Real Madrid","La Liga","Casemiro","BRA","MF","28",1992,32.2,84,49,50,30,4,33,73,45.2,40,50,17,33,70,154,62,0,"https://fbref.com/en/players/4d224fe8/Casemiro"
"7418","Víctor Chust_2021",2021,"Real Madrid","La Liga","Víctor Chust","ESP","DF","20",2000,1.1,1,1,0,1,0,0,2,0,2,2,2,0,1,2,5,0,"https://fbref.com/en/players/ec1a731e/Victor-Chust"
"7419","Thibaut Courtois_2021",2021,"Real Madrid","La Liga","Thibaut Courtois","BEL","GK","28",1992,38,0,0,0,0,0,0,1,0,1,1,0,1,1,1,17,2,"https://fbref.com/en/players/1840e36d/Thibaut-Courtois"
"7420","Hugo Duro_2021",2021,"Real Madrid","La Liga","Hugo Duro","ESP","FW","20",1999,0.6,0,0,0,0,0,0,0,NA,0,1,0,1,0,0,0,0,"https://fbref.com/en/players/37e103f8/Hugo-Duro"
"7421","Miguel Gutiérrez_2021",2021,"Real Madrid","La Liga","Miguel Gutiérrez","ESP","DF","19",2001,3.5,4,0,0,3,1,1,7,14.3,6,3,0,3,5,9,5,0,"https://fbref.com/en/players/7e98cff1/Miguel-Gutierrez"
"7422","Eden Hazard_2021",2021,"Real Madrid","La Liga","Eden Hazard","BEL","FW,MF","29",1991,5.9,3,2,1,2,0,0,3,0,3,3,0,3,3,6,0,0,"https://fbref.com/en/players/a39bb753/Eden-Hazard"
"7423","Isco_2021",2021,"Real Madrid","La Liga","Isco","ESP","MF","28",1992,10.1,13,9,5,5,3,2,14,14.3,12,7,1,6,2,15,2,0,"https://fbref.com/en/players/a0b4bb3e/Isco"
"7424","Luka Jović_2021",2021,"Real Madrid","La Liga","Luka Jović","SRB","FW","22",1997,1.7,0,0,0,0,0,0,0,NA,0,0,0,0,0,0,0,0,"https://fbref.com/en/players/4d8cd038/Luka-Jovic"
"7425","Vinicius Júnior_2021",2021,"Real Madrid","La Liga","Vinicius Júnior","BRA","FW","20",2000,21.9,32,22,14,10,8,11,43,25.6,32,28,0,28,7,39,4,0,"https://fbref.com/en/players/7111d552/Vinicius-Junior"
"7426","Toni Kroos_2021",2021,"Real Madrid","La Liga","Toni Kroos","GER","MF","30",1990,23.5,42,22,15,15,12,11,44,25,33,26,6,20,15,57,10,3,"https://fbref.com/en/players/6ce1f46f/Toni-Kroos"
"7427","Marcelo_2021",2021,"Real Madrid","La Liga","Marcelo","BRA","DF,MF","32",1988,11.7,25,21,11,6,8,11,24,45.8,13,13,1,12,10,35,15,0,"https://fbref.com/en/players/603116a7/Marcelo"
"7428","Mariano_2021",2021,"Real Madrid","La Liga","Mariano","DOM","FW","26",1993,5.7,4,2,2,1,1,0,9,0,9,3,1,2,0,4,3,0,"https://fbref.com/en/players/5c4dc0ff/Mariano"
"7429","Marvin_2021",2021,"Real Madrid","La Liga","Marvin","ESP","DF,MF","20",2000,1.5,3,2,0,3,0,1,2,50,1,1,0,1,2,5,3,0,"https://fbref.com/en/players/efaefda0/Marvin"
"7430","Borja Mayoral_2021",2021,"Real Madrid","La Liga","Borja Mayoral","ESP","FW","23",1997,0.3,0,0,0,0,0,0,1,0,1,0,0,0,0,0,0,0,"https://fbref.com/en/players/64e8ed6d/Borja-Mayoral"
"7431","Ferland Mendy_2021",2021,"Real Madrid","La Liga","Ferland Mendy","FRA","DF","25",1995,24.5,26,16,17,6,3,12,24,50,12,16,4,12,26,52,32,1,"https://fbref.com/en/players/3cefcaef/Ferland-Mendy"
"7432","Éder Militão_2021",2021,"Real Madrid","La Liga","Éder Militão","BRA","DF","22",1998,12.6,20,8,13,6,1,8,14,57.1,6,19,6,13,19,39,42,0,"https://fbref.com/en/players/2784f898/Eder-Militao"
"7433","Luka Modrić_2021",2021,"Real Madrid","La Liga","Luka Modrić","CRO","MF","34",1985,30.4,37,23,18,16,3,13,36,36.1,23,14,2,12,48,85,14,1,"https://fbref.com/en/players/6025fab1/Luka-Modric"
"7434","Nacho_2021",2021,"Real Madrid","La Liga","Nacho","ESP","DF","30",1990,22.2,27,14,13,11,3,12,35,34.3,23,19,9,10,40,67,58,0,"https://fbref.com/en/players/2946f9a1/Nacho"
"7435","Álvaro Odriozola_2021",2021,"Real Madrid","La Liga","Álvaro Odriozola","ESP","DF","24",1995,9.2,14,7,5,8,1,3,5,60,2,6,3,3,6,20,12,1,"https://fbref.com/en/players/1d1691ad/Alvaro-Odriozola"
"7436","Sergio Ramos_2021",2021,"Real Madrid","La Liga","Sergio Ramos","ESP","DF","34",1986,14.2,15,12,8,6,1,6,10,60,4,9,5,4,19,34,39,1,"https://fbref.com/en/players/08511d65/Sergio-Ramos"
"7437","Rodrygo_2021",2021,"Real Madrid","La Liga","Rodrygo","BRA","FW","19",2001,10.9,15,6,10,4,1,2,17,11.8,15,15,0,15,7,22,4,0,"https://fbref.com/en/players/8f5e92a6/Rodrygo"
"7438","Federico Valverde_2021",2021,"Real Madrid","La Liga","Federico Valverde","URU","MF","22",1998,14.8,25,16,9,8,8,10,26,38.5,16,16,2,14,22,47,4,0,"https://fbref.com/en/players/0959c2a2/Federico-Valverde"
"7439","Raphaël Varane_2021",2021,"Real Madrid","La Liga","Raphaël Varane","FRA","DF","27",1993,30.2,22,14,16,5,1,10,19,52.6,9,26,18,8,36,58,114,2,"https://fbref.com/en/players/9f8e9423/Raphael-Varane"
"7440","Lucas Vázquez_2021",2021,"Real Madrid","La Liga","Lucas Vázquez","ESP","DF,FW","29",1991,20.5,61,37,30,22,9,22,52,42.3,30,14,1,13,19,80,31,1,"https://fbref.com/en/players/fd51b456/Lucas-Vazquez"
"7441","Martin Ødegaard_2021",2021,"Real Madrid","La Liga","Martin Ødegaard","NOR","MF","21",1998,2.6,1,0,0,1,0,1,2,50,1,1,0,1,1,2,0,0,"https://fbref.com/en/players/79300479/Martin-Odegaard"
"7442","Aritz Arambarri_2021",2021,"Real Sociedad","La Liga","Aritz Arambarri","ESP","DF","22",1998,0.3,1,1,0,1,0,1,2,50,1,0,0,0,0,1,0,0,"https://fbref.com/en/players/f28876e5/Aritz-Arambarri"
"7443","Ander Barrenetxea_2021",2021,"Real Sociedad","La Liga","Ander Barrenetxea","ESP","MF,FW","18",2001,14.5,29,19,5,18,6,9,24,37.5,15,20,0,20,6,35,8,0,"https://fbref.com/en/players/200e89e1/Ander-Barrenetxea"
"7444","Jon Bautista_2021",2021,"Real Sociedad","La Liga","Jon Bautista","ESP","FW","25",1995,4.1,5,3,0,2,3,0,3,0,3,3,1,2,2,7,4,0,"https://fbref.com/en/players/debc6b55/Jon-Bautista"
"7445","Aritz Elustondo_2021",2021,"Real Sociedad","La Liga","Aritz Elustondo","ESP","DF","26",1994,20.9,30,16,21,7,2,18,22,81.8,4,12,5,7,15,45,63,0,"https://fbref.com/en/players/f7dc2ae5/Aritz-Elustondo"
"7446","Carlos Fernández_2021",2021,"Real Sociedad","La Liga","Carlos Fernández","ESP","FW,MF","24",1996,4.3,3,2,0,2,1,1,8,12.5,7,6,1,5,0,3,6,0,"https://fbref.com/en/players/e08647d6/Carlos-Fernandez"
"7447","Urko González_2021",2021,"Real Sociedad","La Liga","Urko González","ESP","MF","19",2001,0.5,0,0,0,0,0,0,1,0,1,1,1,0,0,0,1,0,"https://fbref.com/en/players/c4f5eb61/Urko-Gonzalez"
"7448","Andoni Gorosabel_2021",2021,"Real Sociedad","La Liga","Andoni Gorosabel","ESP","DF","23",1996,26.5,76,43,45,20,11,27,64,42.2,37,25,4,21,23,99,42,0,"https://fbref.com/en/players/6f5f82c0/Andoni-Gorosabel"
"7449","Ander Guevara_2021",2021,"Real Sociedad","La Liga","Ander Guevara","ESP","MF","23",1997,23.1,35,23,15,16,4,15,30,50,15,19,5,14,25,60,35,1,"https://fbref.com/en/players/8e48dc61/Ander-Guevara"
"7450","Jon Guridi_2021",2021,"Real Sociedad","La Liga","Jon Guridi","ESP","MF","25",1995,9.2,19,9,10,6,3,8,22,36.4,14,8,1,7,10,29,9,0,"https://fbref.com/en/players/4c0a6a48/Jon-Guridi"
"7451","Asier Illarramendi_2021",2021,"Real Sociedad","La Liga","Asier Illarramendi","ESP","MF","30",1990,3.7,5,2,1,4,0,1,5,20,4,2,0,2,5,10,7,0,"https://fbref.com/en/players/5ce0b5ba/Asier-Illarramendi"
"7452","Alexander Isak_2021",2021,"Real Sociedad","La Liga","Alexander Isak","SWE","FW","20",1999,26,9,5,0,3,6,3,8,37.5,5,17,1,16,3,12,7,0,"https://fbref.com/en/players/8e92be30/Alexander-Isak"
"7453","Adnan Januzaj_2021",2021,"Real Sociedad","La Liga","Adnan Januzaj","BEL","FW,MF","25",1995,11.3,9,8,0,6,3,3,8,37.5,5,7,2,5,3,12,4,0,"https://fbref.com/en/players/4737cebe/Adnan-Januzaj"
"7454","Willian José_2021",2021,"Real Sociedad","La Liga","Willian José","BRA","FW","28",1991,7.7,3,1,0,3,0,1,3,33.3,2,3,1,2,0,3,8,0,"https://fbref.com/en/players/d87e2cae/Willian-Jose"
"7455","Robin Le Normand_2021",2021,"Real Sociedad","La Liga","Robin Le Normand","ESP","DF","23",1996,30.5,34,20,25,8,1,9,19,47.4,10,35,24,11,36,70,87,1,"https://fbref.com/en/players/9a64e67e/Robin-Le-Normand"
"7456","Diego Llorente_2021",2021,"Real Sociedad","La Liga","Diego Llorente","ESP","DF","26",1993,1,1,0,1,0,0,1,2,50,1,1,1,0,2,3,5,0,"https://fbref.com/en/players/bba30585/Diego-Llorente"
"7457","Roberto López_2021",2021,"Real Sociedad","La Liga","Roberto López","ESP","MF,FW","20",2000,5.6,5,1,1,2,2,2,5,40,3,2,0,2,4,9,6,0,"https://fbref.com/en/players/2a8c9f98/Roberto-Lopez"
"7458","Mikel Merino_2021",2021,"Real Sociedad","La Liga","Mikel Merino","ESP","MF","24",1996,23.9,61,36,14,36,11,18,45,40,27,36,8,28,32,93,26,0,"https://fbref.com/en/players/d080ed5e/Mikel-Merino"
"7459","Martín Merquelanz_2021",2021,"Real Sociedad","La Liga","Martín Merquelanz","ESP","MF,FW","25",1995,6.1,9,3,3,2,4,2,7,28.6,5,7,1,6,3,12,4,0,"https://fbref.com/en/players/ddd5348b/Martin-Merquelanz"
"7460","Nacho Monreal_2021",2021,"Real Sociedad","La Liga","Nacho Monreal","ESP","DF","34",1986,23.1,31,19,17,11,3,7,20,35,13,14,3,11,31,62,43,0,"https://fbref.com/en/players/d4cb83cc/Nacho-Monreal"
"7461","Aihen Muñoz_2021",2021,"Real Sociedad","La Liga","Aihen Muñoz","ESP","DF","22",1997,13.4,23,16,15,5,3,11,19,57.9,8,12,2,10,10,33,31,0,"https://fbref.com/en/players/228b0d9d/Aihen-Munoz"
"7462","Roberto Navarro_2021",2021,"Real Sociedad","La Liga","Roberto Navarro","ESP","MF","18",2002,0.4,1,1,1,0,0,0,2,0,2,0,0,0,1,2,0,0,"https://fbref.com/en/players/c997b942/Roberto-Navarro"
"7463","Mikel Oyarzabal_2021",2021,"Real Sociedad","La Liga","Mikel Oyarzabal","ESP","FW,MF","23",1997,26.8,30,17,14,12,4,10,31,32.3,21,30,5,25,15,45,17,0,"https://fbref.com/en/players/8c3c640c/Mikel-Oyarzabal"
"7464","Jon Pacheco_2021",2021,"Real Sociedad","La Liga","Jon Pacheco","ESP","DF","19",2001,0.4,0,0,0,0,0,0,0,NA,0,0,0,0,1,1,0,0,"https://fbref.com/en/players/44150beb/Jon-Pacheco"
"7465","Portu_2021",2021,"Real Sociedad","La Liga","Portu","ESP","FW,MF","28",1992,24.3,18,8,4,10,4,7,36,19.4,29,24,2,22,8,26,5,0,"https://fbref.com/en/players/1bda5842/Portu"
"7466","Álex Remiro_2021",2021,"Real Sociedad","La Liga","Álex Remiro","ESP","GK","25",1995,38,0,0,0,0,0,0,1,0,1,0,0,0,3,3,14,0,"https://fbref.com/en/players/374ee424/Alex-Remiro"
"7467","Modibo Sagnan_2021",2021,"Real Sociedad","La Liga","Modibo Sagnan","FRA","DF","21",1999,6.9,12,7,6,6,0,4,6,66.7,2,7,2,5,6,18,25,1,"https://fbref.com/en/players/76d679c7/Modibo-Sagnan"
"7468","David Silva_2021",2021,"Real Sociedad","La Liga","David Silva","ESP","MF","34",1986,15.5,19,12,2,14,3,8,21,38.1,13,14,1,13,13,32,8,2,"https://fbref.com/en/players/e2716bd0/David-Silva"
"7469","Joseba Zaldúa_2021",2021,"Real Sociedad","La Liga","Joseba Zaldúa","ESP","DF","28",1992,7.1,15,12,7,5,3,6,18,33.3,12,6,2,4,6,21,13,0,"https://fbref.com/en/players/5ca20b7a/Joseba-Zaldua"
"7470","Igor Zubeldia_2021",2021,"Real Sociedad","La Liga","Igor Zubeldia","ESP","DF","23",1997,21.8,23,16,15,8,0,8,14,57.1,6,20,13,7,12,35,46,0,"https://fbref.com/en/players/5c7845f6/Igor-Zubeldia"
"7471","Martín Zubimendi_2021",2021,"Real Sociedad","La Liga","Martín Zubimendi","ESP","MF","21",1999,20.9,41,22,18,20,3,20,34,58.8,14,22,10,12,40,81,39,0,"https://fbref.com/en/players/3ee0dd59/Martin-Zubimendi"
"7472","Yunis Abdelhamid_2021",2021,"Reims","Ligue 1","Yunis Abdelhamid","MAR","DF","32",1987,32.1,59,37,36,23,0,26,42,61.9,16,34,15,19,61,120,132,0,"https://fbref.com/en/players/32c2d95f/Yunis-Abdelhamid"
"7473","Valon Berisha_2021",2021,"Reims","Ligue 1","Valon Berisha","KVX","MF","27",1993,18.3,40,23,19,17,4,11,47,23.4,36,14,2,12,25,65,21,1,"https://fbref.com/en/players/d5575935/Valon-Berisha"
"7474","El Bilal Touré_2021",2021,"Reims","Ligue 1","El Bilal Touré","MLI","FW","18",2001,13.8,22,12,3,16,3,8,18,44.4,10,8,3,5,6,28,10,1,"https://fbref.com/en/players/47c609d5/El-Bilal-Toure"
"7475","Mathieu Cafaro_2021",2021,"Reims","Ligue 1","Mathieu Cafaro","FRA","MF,FW","23",1997,23,40,17,15,19,6,13,43,30.2,30,11,0,11,17,57,12,0,"https://fbref.com/en/players/2a657da0/Mathieu-Cafaro"
"7476","Moreto Cassamã_2021",2021,"Reims","Ligue 1","Moreto Cassamã","GNB","MF","22",1998,22.6,49,36,24,23,2,27,49,55.1,22,19,6,13,36,85,33,4,"https://fbref.com/en/players/f54d2149/Moreto-Cassama"
"7477","Xavier Chavalerin_2021",2021,"Reims","Ligue 1","Xavier Chavalerin","FRA","MF","29",1991,28.3,92,50,47,38,7,26,74,35.1,48,43,9,34,43,135,29,1,"https://fbref.com/en/players/279ddf6a/Xavier-Chavalerin"
"7478","Thibault De Smet_2021",2021,"Reims","Ligue 1","Thibault De Smet","BEL","DF","22",1998,5.5,11,6,8,3,0,6,15,40,9,8,1,7,6,17,16,0,"https://fbref.com/en/players/5fdcb075/Thibault-De-Smet"
"7479","Boulaye Dia_2021",2021,"Reims","Ligue 1","Boulaye Dia","SEN","FW,MF","23",1996,32.6,23,12,3,11,9,4,22,18.2,18,19,5,14,12,35,37,1,"https://fbref.com/en/players/244bc2c8/Boulaye-Dia"
"7480","Tristan Dingomé_2021",2021,"Reims","Ligue 1","Tristan Dingomé","CMR","MF","29",1991,0.2,0,0,0,0,0,0,1,0,1,0,0,0,0,0,0,0,"https://fbref.com/en/players/92b56413/Tristan-Dingome"
"7481","Yehvann Diouf_2021",2021,"Reims","Ligue 1","Yehvann Diouf","FRA","GK","20",1999,1.5,0,0,0,0,0,0,0,NA,0,0,0,0,0,0,0,0,"https://fbref.com/en/players/eedea60b/Yehvann-Diouf"
"7482","Anastasios Donis_2021",2021,"Reims","Ligue 1","Anastasios Donis","GRE","MF","23",1996,1.1,4,1,2,0,2,1,1,100,0,0,0,0,0,4,0,0,"https://fbref.com/en/players/0f26fd24/Anastasios-Donis"
"7483","Fodé Doucouré_2021",2021,"Reims","Ligue 1","Fodé Doucouré","MLI","DF","19",2001,3.7,11,8,7,4,0,4,9,44.4,5,2,0,2,4,15,11,0,"https://fbref.com/en/players/1bfe34dc/Fode-Doucoure"
"7484","Moussa Doumbia_2021",2021,"Reims","Ligue 1","Moussa Doumbia","MLI","MF,FW","25",1994,10,10,6,4,4,2,4,22,18.2,18,5,1,4,10,20,4,0,"https://fbref.com/en/players/6481421d/Moussa-Doumbia"
"7485","Mouhamadou Drammeh_2021",2021,"Reims","Ligue 1","Mouhamadou Drammeh","FRA","MF","21",1999,1.9,0,0,0,0,0,0,2,0,2,0,0,0,2,2,7,0,"https://fbref.com/en/players/309937e7/Mouhamadou-Drammeh"
"7486","Hugo Ekitike_2021",2021,"Reims","Ligue 1","Hugo Ekitike","FRA","FW,MF","18",2002,1,1,1,0,0,1,0,1,0,1,0,0,0,0,1,0,0,"https://fbref.com/en/players/5b92d896/Hugo-Ekitike"
"7487","Wout Faes_2021",2021,"Reims","Ligue 1","Wout Faes","BEL","DF","22",1998,32.2,35,22,26,9,0,20,39,51.3,19,40,31,9,68,103,144,1,"https://fbref.com/en/players/9c221d14/Wout-Faes"
"7488","Alexis Flips_2021",2021,"Reims","Ligue 1","Alexis Flips","FRA","MF,FW","20",2000,0.5,0,0,0,0,0,0,2,0,2,0,0,0,0,0,1,0,"https://fbref.com/en/players/caef7840/Alexis-Flips"
"7489","Thomas Foket_2021",2021,"Reims","Ligue 1","Thomas Foket","BEL","DF","25",1994,36.9,77,43,50,20,7,40,69,58,29,28,7,21,69,146,92,2,"https://fbref.com/en/players/90eb507d/Thomas-Foket"
"7490","Fraser Hornby_2021",2021,"Reims","Ligue 1","Fraser Hornby","SCO","FW,MF","20",1999,0.4,0,0,0,0,0,0,0,NA,0,0,0,0,1,1,0,0,"https://fbref.com/en/players/29aee77c/Fraser-Hornby"
"7491","Ghislain Konan_2021",2021,"Reims","Ligue 1","Ghislain Konan","CIV","DF","24",1995,29,57,32,35,17,5,32,56,57.1,24,25,11,14,30,87,67,0,"https://fbref.com/en/players/6b2c894b/Ghislain-Konan"
"7492","Dereck Kutesa_2021",2021,"Reims","Ligue 1","Dereck Kutesa","SUI","MF,FW","22",1997,7.6,15,7,7,3,5,5,14,35.7,9,7,1,6,7,22,3,0,"https://fbref.com/en/players/1b6862e8/Dereck-Kutesa"
"7493","Dion Lopy_2021",2021,"Reims","Ligue 1","Dion Lopy","SEN","MF","18",2002,2.8,1,1,0,1,0,0,0,NA,0,0,0,0,2,3,1,0,"https://fbref.com/en/players/64c14d49/Dion-Lopy"
"7494","Dario Maresic_2021",2021,"Reims","Ligue 1","Dario Maresic","AUT","DF","20",1999,5.7,12,7,8,4,0,8,14,57.1,6,7,2,5,10,22,17,1,"https://fbref.com/en/players/5d93ccee/Dario-Maresic"
"7495","Nathanael Mbuku_2021",2021,"Reims","Ligue 1","Nathanael Mbuku","FRA","MF,FW","18",2002,24.6,33,19,9,13,11,8,28,28.6,20,17,0,17,14,47,10,0,"https://fbref.com/en/players/46750e9c/Nathanael-Mbuku"
"7496","Marshall Munetsi_2021",2021,"Reims","Ligue 1","Marshall Munetsi","ZIM","MF,DF","24",1996,21.4,35,19,19,14,2,21,41,51.2,20,33,25,8,57,92,85,3,"https://fbref.com/en/players/2acf0cd7/Marshall-Munetsi"
"7497","Predrag Rajković_2021",2021,"Reims","Ligue 1","Predrag Rajković","SRB","GK","24",1995,36.5,2,1,2,0,0,2,5,40,3,1,0,1,2,4,17,3,"https://fbref.com/en/players/58ad9383/Predrag-Rajkovic"
"7498","Moïse Sakava_2021",2021,"Reims","Ligue 1","Moïse Sakava","CMR","MF","19",2000,0.1,0,0,0,0,0,0,0,NA,0,0,0,0,0,0,0,0,"https://fbref.com/en/players/329e7a13/Moise-Sakava"
"7499","Kaj Sierhuis_2021",2021,"Reims","Ligue 1","Kaj Sierhuis","NED","FW,MF","22",1998,7.2,7,2,1,2,4,2,9,22.2,7,2,1,1,2,9,5,0,"https://fbref.com/en/players/9c2b1f11/Kaj-Sierhuis"
"7500","Arber Zeneli_2021",2021,"Reims","Ligue 1","Arber Zeneli","KVX","MF,FW","25",1995,14.3,20,10,11,1,8,8,22,36.4,14,12,1,11,3,23,8,0,"https://fbref.com/en/players/095e4199/Arber-Zeneli"
"7501","Matthis Abline_2021",2021,"Rennes","Ligue 1","Matthis Abline","FRA","FW","17",2003,0,0,0,0,0,0,0,0,NA,0,0,0,0,0,0,0,0,"https://fbref.com/en/players/0e46fa2f/Matthis-Abline"
"7502","Nayef Aguerd_2021",2021,"Rennes","Ligue 1","Nayef Aguerd","MAR","DF","24",1996,35,37,30,28,9,0,21,33,63.6,12,34,22,12,47,84,102,0,"https://fbref.com/en/players/288e1e13/Nayef-Aguerd"
"7503","Sacha Boey_2021",2021,"Rennes","Ligue 1","Sacha Boey","FRA","DF","19",2000,1.4,3,3,2,1,0,3,4,75,1,0,0,0,2,5,2,0,"https://fbref.com/en/players/6c8ddd52/Sacha-Boey"
"7504","Benjamin Bourigeaud_2021",2021,"Rennes","Ligue 1","Benjamin Bourigeaud","FRA","MF,FW","26",1994,28.4,40,23,17,16,7,21,71,29.6,50,37,1,36,19,59,25,0,"https://fbref.com/en/players/20e73fac/Benjamin-Bourigeaud"
"7505","Eduardo Camavinga_2021",2021,"Rennes","Ligue 1","Eduardo Camavinga","FRA","MF","17",2002,26.7,98,58,39,48,11,38,77,49.4,39,36,2,34,23,121,15,1,"https://fbref.com/en/players/7b9c2d84/Eduardo-Camavinga"
"7506","Damien Da Silva_2021",2021,"Rennes","Ligue 1","Damien Da Silva","FRA","DF","32",1988,29.6,22,13,13,8,1,12,18,66.7,6,17,13,4,44,66,99,1,"https://fbref.com/en/players/1ec7e1c5/Damien-Da-Silva"
"7507","Romain Del Castillo_2021",2021,"Rennes","Ligue 1","Romain Del Castillo","FRA","MF,FW","24",1996,7.2,30,11,5,14,11,5,25,20,20,6,0,6,3,33,4,1,"https://fbref.com/en/players/0be95d34/Romain-Del-Castillo"
"7508","Andy Diouf_2021",2021,"Rennes","Ligue 1","Andy Diouf","FRA","FW","17",2003,0.1,0,0,0,0,0,0,0,NA,0,0,0,0,0,0,0,0,"https://fbref.com/en/players/9b5237b1/Andy-Diouf"
"7509","Jeremy Doku_2021",2021,"Rennes","Ligue 1","Jeremy Doku","BEL","MF,FW","18",2002,25.7,44,25,9,24,11,11,26,42.3,15,18,1,17,11,55,1,0,"https://fbref.com/en/players/fffea3e5/Jeremy-Doku"
"7510","Yann Gboho_2021",2021,"Rennes","Ligue 1","Yann Gboho","FRA","MF,FW","19",2001,3.4,6,3,3,1,2,3,8,37.5,5,1,0,1,1,7,3,1,"https://fbref.com/en/players/6be41a31/Yann-Gboho"
"7511","Alfred Gomis_2021",2021,"Rennes","Ligue 1","Alfred Gomis","SEN","GK","26",1993,22,1,1,1,0,0,1,1,100,0,0,0,0,3,4,10,1,"https://fbref.com/en/players/cecbce23/Alfred-Gomis"
"7512","Clément Grenier_2021",2021,"Rennes","Ligue 1","Clément Grenier","FRA","MF,FW","29",1991,12,20,8,9,8,3,7,31,22.6,24,7,0,7,5,25,3,0,"https://fbref.com/en/players/8b298f56/Clement-Grenier"
"7513","Sehrou Guirassy_2021",2021,"Rennes","Ligue 1","Sehrou Guirassy","GUI","FW","24",1996,19.6,4,1,1,3,0,1,3,33.3,2,10,1,9,5,9,17,0,"https://fbref.com/en/players/923f4dda/Sehrou-Guirassy"
"7514","Dalbert Henrique_2021",2021,"Rennes","Ligue 1","Dalbert Henrique","BRA","DF","26",1993,4.1,7,6,4,2,1,6,8,75,2,8,2,6,5,12,8,0,"https://fbref.com/en/players/f45f9427/Dalbert-Henrique"
"7515","Adrien Hunou_2021",2021,"Rennes","Ligue 1","Adrien Hunou","FRA","FW,MF","26",1994,6.5,6,3,2,2,2,2,8,25,6,7,0,7,1,7,2,0,"https://fbref.com/en/players/d14229f3/Adrien-Hunou"
"7516","James Lea Siliki_2021",2021,"Rennes","Ligue 1","James Lea Siliki","CMR","MF","24",1996,2.8,5,2,1,3,1,2,2,100,0,3,0,3,1,6,1,1,"https://fbref.com/en/players/7cf431a5/James-Lea-Siliki"
"7517","Faitout Maouassa_2021",2021,"Rennes","Ligue 1","Faitout Maouassa","FRA","DF","22",1998,13,20,11,10,8,2,11,19,57.9,8,9,1,8,17,37,36,0,"https://fbref.com/en/players/e54a9890/Faitout-Maouassa"
"7518","Jonas Martin_2021",2021,"Rennes","Ligue 1","Jonas Martin","FRA","MF","30",1990,5.4,11,9,5,4,2,5,14,35.7,9,11,2,9,13,24,2,1,"https://fbref.com/en/players/468fdbad/Jonas-Martin"
"7519","Edouard Mendy_2021",2021,"Rennes","Ligue 1","Edouard Mendy","SEN","GK","28",1992,1,0,0,0,0,0,0,0,NA,0,0,0,0,0,0,0,0,"https://fbref.com/en/players/33887998/Edouard-Mendy"
"7520","M'Baye Niang_2021",2021,"Rennes","Ligue 1","M'Baye Niang","SEN","FW","25",1994,4.7,3,2,2,1,0,0,0,NA,0,2,0,2,1,4,2,0,"https://fbref.com/en/players/2054d037/MBaye-Niang"
"7521","Gerzino Nyamsi_2021",2021,"Rennes","Ligue 1","Gerzino Nyamsi","FRA","DF","23",1997,9.7,12,10,2,8,2,4,6,66.7,2,8,5,3,10,22,32,1,"https://fbref.com/en/players/6043997c/Gerzino-Nyamsi"
"7522","Steven Nzonzi_2021",2021,"Rennes","Ligue 1","Steven Nzonzi","FRA","MF","31",1988,32.3,34,16,15,16,3,12,31,38.7,19,24,10,14,16,50,26,0,"https://fbref.com/en/players/c7526c18/Steven-Nzonzi"
"7523","Raphinha_2021",2021,"Rennes","Ligue 1","Raphinha","BRA","FW,MF","23",1996,4.5,5,2,1,3,1,1,4,25,3,5,0,5,3,8,4,0,"https://fbref.com/en/players/3423f250/Raphinha"
"7524","Daniele Rugani_2021",2021,"Rennes","Ligue 1","Daniele Rugani","ITA","DF","26",1994,1,0,0,0,0,0,0,1,0,1,1,1,0,1,1,1,0,"https://fbref.com/en/players/14b8fcdf/Daniele-Rugani"
"7525","Georginio Rutter_2021",2021,"Rennes","Ligue 1","Georginio Rutter","FRA","FW,MF","18",2002,0.5,2,2,0,1,1,1,3,33.3,2,2,0,2,0,2,0,0,"https://fbref.com/en/players/c64c01fc/Georginio-Rutter"
"7526","Romain Salin_2021",2021,"Rennes","Ligue 1","Romain Salin","FRA","GK","36",1984,15,0,0,0,0,0,0,1,0,1,0,0,0,1,1,6,3,"https://fbref.com/en/players/74733221/Romain-Salin"
"7527","Brandon Soppy_2021",2021,"Rennes","Ligue 1","Brandon Soppy","FRA","DF","18",2002,6.2,21,15,16,5,0,10,16,62.5,6,3,0,3,6,27,12,0,"https://fbref.com/en/players/28f66c2e/Brandon-Soppy"
"7528","Flavien Tait_2021",2021,"Rennes","Ligue 1","Flavien Tait","FRA","MF,FW","27",1993,15.2,26,11,11,12,3,10,32,31.3,22,17,3,14,13,39,2,0,"https://fbref.com/en/players/a0f9b535/Flavien-Tait"
"7529","Martin Terrier_2021",2021,"Rennes","Ligue 1","Martin Terrier","FRA","FW,MF","23",1997,27.1,33,15,5,15,13,10,36,27.8,26,23,0,23,16,49,7,0,"https://fbref.com/en/players/5148dcc5/Martin-Terrier"
"7530","Hamari Traoré_2021",2021,"Rennes","Ligue 1","Hamari Traoré","MLI","DF","28",1992,33.3,56,38,23,27,6,22,59,37.3,37,31,5,26,76,132,50,0,"https://fbref.com/en/players/a4b1028a/Hamari-Traore"
"7531","Adrien Truffert_2021",2021,"Rennes","Ligue 1","Adrien Truffert","FRA","DF,MF","18",2001,21.7,38,18,18,12,8,13,24,54.2,11,26,5,21,18,56,38,1,"https://fbref.com/en/players/5d0e0a1f/Adrien-Truffert"
"7532","Chimuanya Ugochukwu_2021",2021,"Rennes","Ligue 1","Chimuanya Ugochukwu","FRA","MF","16",2004,0.7,3,1,0,3,0,2,3,66.7,1,1,0,1,0,3,0,0,"https://fbref.com/en/players/1df4a109/Chimuanya-Ugochukwu"
"7533","Edoardo Bove_2021",2021,"Roma","Serie A","Edoardo Bove","ITA","MF","18",2002,0.1,0,0,0,0,0,0,1,0,1,0,0,0,0,0,0,0,"https://fbref.com/en/players/ae94a6c5/Edoardo-Bove"
"7534","Riccardo Calafiori_2021",2021,"Roma","Serie A","Riccardo Calafiori","ITA","DF","18",2002,0.7,1,0,1,0,0,1,4,25,3,1,0,1,0,1,0,0,"https://fbref.com/en/players/aded8e6f/Riccardo-Calafiori"
"7535","Bryan Cristante_2021",2021,"Roma","Serie A","Bryan Cristante","ITA","DF,MF","25",1995,23.9,27,20,10,14,3,10,28,35.7,18,21,7,14,40,67,61,1,"https://fbref.com/en/players/16657b95/Bryan-Cristante"
"7536","Ebrima Darboe_2021",2021,"Roma","Serie A","Ebrima Darboe","GAM","MF","19",2001,3.6,5,2,3,1,1,3,10,30,7,3,0,3,8,13,0,1,"https://fbref.com/en/players/cf043a33/Ebrima-Darboe"
"7537","Amadou Diawara_2021",2021,"Roma","Serie A","Amadou Diawara","GUI","MF","23",1997,7.3,10,8,4,6,0,2,8,25,6,11,2,9,12,22,4,0,"https://fbref.com/en/players/bf309d24/Amadou-Diawara"
"7538","Edin Džeko_2021",2021,"Roma","Serie A","Edin Džeko","BIH","FW","34",1986,20.3,8,6,2,3,3,3,9,33.3,6,9,4,5,1,9,11,0,"https://fbref.com/en/players/3bb7f478/Edin-Dzeko"
"7539","Federico Fazio_2021",2021,"Roma","Serie A","Federico Fazio","ARG","DF","33",1987,4.5,3,2,3,0,0,3,4,75,1,3,3,0,7,10,18,1,"https://fbref.com/en/players/4e358a2d/Federico-Fazio"
"7540","Daniel Fuzato_2021",2021,"Roma","Serie A","Daniel Fuzato","BRA","GK","23",1997,5,0,0,0,0,0,0,0,NA,0,1,0,1,0,0,1,1,"https://fbref.com/en/players/82328faf/Daniel-Fuzato"
"7541","Roger Ibanez_2021",2021,"Roma","Serie A","Roger Ibanez","BRA","DF","21",1998,26.6,59,37,28,25,6,25,45,55.6,20,38,17,21,68,127,78,3,"https://fbref.com/en/players/82efe6fa/Roger-Ibanez"
"7542","Juan Jesus_2021",2021,"Roma","Serie A","Juan Jesus","BRA","DF","29",1991,1.7,3,1,2,1,0,2,4,50,2,1,0,1,2,5,5,0,"https://fbref.com/en/players/79083382/Juan-Jesus"
"7543","Rick Karsdorp_2021",2021,"Roma","Serie A","Rick Karsdorp","NED","DF","25",1995,28.3,36,23,19,12,5,21,48,43.8,27,18,1,17,30,66,32,0,"https://fbref.com/en/players/9f84febe/Rick-Karsdorp"
"7544","Justin Kluivert_2021",2021,"Roma","Serie A","Justin Kluivert","NED","MF","21",1999,0.2,0,0,0,0,0,0,0,NA,0,0,0,0,0,0,0,0,"https://fbref.com/en/players/4c3a6744/Justin-Kluivert"
"7545","Marash Kumbulla_2021",2021,"Roma","Serie A","Marash Kumbulla","ALB","DF","20",2000,15.1,16,11,8,7,1,5,17,29.4,12,12,5,7,24,40,38,1,"https://fbref.com/en/players/a40819d9/Marash-Kumbulla"
"7546","Pau López_2021",2021,"Roma","Serie A","Pau López","ESP","GK","25",1994,20.2,2,0,2,0,0,2,2,100,0,1,0,1,0,2,7,4,"https://fbref.com/en/players/20b9f052/Pau-Lopez"
"7547","Gianluca Mancini_2021",2021,"Roma","Serie A","Gianluca Mancini","ITA","DF","24",1996,31.7,50,29,29,19,2,18,31,58.1,13,38,18,20,72,122,77,3,"https://fbref.com/en/players/5aa53281/Gianluca-Mancini"
"7548","Borja Mayoral_2021",2021,"Roma","Serie A","Borja Mayoral","ESP","FW","23",1997,17.2,3,2,0,0,3,1,10,10,9,5,0,5,0,3,5,2,"https://fbref.com/en/players/64e8ed6d/Borja-Mayoral"
"7549","Antonio Mirante_2021",2021,"Roma","Serie A","Antonio Mirante","ITA","GK","37",1983,12.8,0,0,0,0,0,0,1,0,1,1,0,1,0,0,7,2,"https://fbref.com/en/players/30223b33/Antonio-Mirante"
"7550","Henrikh Mkhitaryan_2021",2021,"Roma","Serie A","Henrikh Mkhitaryan","ARM","MF,FW","31",1989,30.5,58,24,13,27,18,13,62,21,49,34,0,34,39,97,10,0,"https://fbref.com/en/players/dd0daf32/Henrikh-Mkhitaryan"
"7551","Javier Pastore_2021",2021,"Roma","Serie A","Javier Pastore","ARG","MF,FW","31",1989,0.9,2,2,2,0,0,2,2,100,0,0,0,0,0,2,0,0,"https://fbref.com/en/players/881ef58c/Javier-Pastore"
"7552","Pedro_2021",2021,"Roma","Serie A","Pedro","ESP","MF,FW","33",1987,17.7,22,14,6,11,5,7,35,20,28,10,0,10,9,31,2,1,"https://fbref.com/en/players/3ca7254a/Pedro"
"7553","Lorenzo Pellegrini_2021",2021,"Roma","Serie A","Lorenzo Pellegrini","ITA","MF","24",1996,28.9,40,24,13,20,7,21,60,35,39,37,2,35,42,82,23,1,"https://fbref.com/en/players/4a5a45c7/Lorenzo-Pellegrini"
"7554","Bruno Peres_2021",2021,"Roma","Serie A","Bruno Peres","BRA","DF","30",1990,15.9,21,11,11,7,3,13,24,54.2,11,18,4,14,27,48,11,0,"https://fbref.com/en/players/852351df/Bruno-Peres"
"7555","Carles Pérez_2021",2021,"Roma","Serie A","Carles Pérez","ESP","MF,FW","22",1998,8.6,9,4,3,6,0,6,31,19.4,25,9,0,9,6,15,1,0,"https://fbref.com/en/players/a8f21b9f/Carles-Perez"
"7556","Bryan Reynolds_2021",2021,"Roma","Serie A","Bryan Reynolds","USA","DF","19",2001,3.1,4,2,1,1,2,1,5,20,4,4,0,4,6,10,4,0,"https://fbref.com/en/players/2306bf5c/Bryan-Reynolds"
"7557","Davide Santon_2021",2021,"Roma","Serie A","Davide Santon","ITA","DF","29",1991,6.5,4,3,2,2,0,3,7,42.9,4,10,1,9,4,8,12,0,"https://fbref.com/en/players/88c89891/Davide-Santon"
"7558","Stephan El Shaarawy_2021",2021,"Roma","Serie A","Stephan El Shaarawy","ITA","MF,FW","27",1992,6.4,4,3,0,3,1,2,9,22.2,7,3,1,2,3,7,2,0,"https://fbref.com/en/players/d3aaad90/Stephan-El-Shaarawy"
"7559","Chris Smalling_2021",2021,"Roma","Serie A","Chris Smalling","ENG","DF","30",1989,12.3,14,8,5,7,2,6,10,60,4,17,11,6,28,42,46,1,"https://fbref.com/en/players/b6964eb6/Chris-Smalling"
"7560","Leonardo Spinazzola_2021",2021,"Roma","Serie A","Leonardo Spinazzola","ITA","DF","27",1993,23.6,12,6,3,9,0,8,20,40,12,16,1,15,25,37,31,0,"https://fbref.com/en/players/3626daea/Leonardo-Spinazzola"
"7561","Jordan Veretout_2021",2021,"Roma","Serie A","Jordan Veretout","FRA","MF","27",1993,22.8,20,12,8,12,0,9,33,27.3,24,14,3,11,14,34,21,3,"https://fbref.com/en/players/4a56052c/Jordan-Veretout"
"7562","Gonzalo Villar_2021",2021,"Roma","Serie A","Gonzalo Villar","ESP","MF","22",1998,20.7,44,18,14,24,6,18,61,29.5,43,25,3,22,22,66,14,1,"https://fbref.com/en/players/bdc74a8f/Gonzalo-Villar"
"7563","Nicola Zalewski_2021",2021,"Roma","Serie A","Nicola Zalewski","POL","MF","18",2002,0.1,1,1,0,1,0,1,1,100,0,0,0,0,0,1,0,0,"https://fbref.com/en/players/45191c29/Nicola-Zalewski"
"7564","Charles Abi_2021",2021,"Saint-Étienne","Ligue 1","Charles Abi","FRA","FW,MF","20",2000,10.1,8,2,5,0,3,3,12,25,9,6,2,4,4,12,5,0,"https://fbref.com/en/players/469d3d84/Charles-Abi"
"7565","Pape Abou Cissé_2021",2021,"Saint-Étienne","Ligue 1","Pape Abou Cissé","SEN","DF","24",1995,14,15,13,10,5,0,6,10,60,4,7,4,3,27,42,87,0,"https://fbref.com/en/players/8bc373ea/Pape-Abou-Cisse"
"7566","Adil Aouchiche_2021",2021,"Saint-Étienne","Ligue 1","Adil Aouchiche","FRA","MF,FW","18",2002,19.2,38,20,12,17,9,13,49,26.5,36,15,1,14,10,48,6,0,"https://fbref.com/en/players/b94b8be1/Adil-Aouchiche"
"7567","Stefan Bajic_2021",2021,"Saint-Étienne","Ligue 1","Stefan Bajic","FRA","GK","18",2001,1,0,0,0,0,0,0,0,NA,0,0,0,0,0,0,1,0,"https://fbref.com/en/players/be13e5a8/Stefan-Bajic"
"7568","Bilal Benkhedim_2021",2021,"Saint-Étienne","Ligue 1","Bilal Benkhedim","FRA","FW","19",2001,0.8,0,0,0,0,0,0,1,0,1,1,0,1,0,0,0,0,"https://fbref.com/en/players/b6047994/Bilal-Benkhedim"
"7569","Denis Bouanga_2021",2021,"Saint-Étienne","Ligue 1","Denis Bouanga","GAB","MF,FW","25",1994,30.2,52,28,22,24,6,16,58,27.6,42,32,3,29,20,72,36,0,"https://fbref.com/en/players/0b0cbe5b/Denis-Bouanga"
"7570","Ryad Boudebouz_2021",2021,"Saint-Étienne","Ligue 1","Ryad Boudebouz","ALG","MF,FW","30",1990,7.2,9,4,1,7,1,4,8,50,4,3,0,3,5,14,5,0,"https://fbref.com/en/players/1001ae82/Ryad-Boudebouz"
"7571","Mahdi Camara_2021",2021,"Saint-Étienne","Ligue 1","Mahdi Camara","FRA","MF,DF","22",1998,36.6,99,67,43,46,10,33,60,55,27,50,12,38,78,177,51,0,"https://fbref.com/en/players/8577e60a/Mahdi-Camara"
"7572","Mathieu Debuchy_2021",2021,"Saint-Étienne","Ligue 1","Mathieu Debuchy","FRA","DF","35",1985,23.4,58,33,37,17,4,40,62,64.5,22,27,9,18,45,103,61,0,"https://fbref.com/en/players/92232aad/Mathieu-Debuchy"
"7573","Assane Dioussé_2021",2021,"Saint-Étienne","Ligue 1","Assane Dioussé","SEN","DF","22",1997,0,0,0,0,0,0,0,0,NA,0,0,0,0,0,0,0,0,"https://fbref.com/en/players/7f622eef/Assane-Diousse"
"7574","Wesley Fofana_2021",2021,"Saint-Étienne","Ligue 1","Wesley Fofana","FRA","DF","19",2000,3.5,6,4,6,0,0,3,4,75,1,3,3,0,8,14,14,1,"https://fbref.com/en/players/132a82f1/Wesley-Fofana"
"7575","Baptiste Gabard_2021",2021,"Saint-Étienne","Ligue 1","Baptiste Gabard","FRA","MF","20",2000,1.5,4,3,1,3,0,1,5,20,4,4,0,4,1,5,0,0,"https://fbref.com/en/players/bc224243/Baptiste-Gabard"
"7576","Lucas Gourna-Douath_2021",2021,"Saint-Étienne","Ligue 1","Lucas Gourna-Douath","FRA","MF","16",2003,14.7,32,22,18,11,3,15,28,53.6,13,10,0,10,24,56,18,0,"https://fbref.com/en/players/3cd7820a/Lucas-Gourna-Douath"
"7577","Etienne Green_2021",2021,"Saint-Étienne","Ligue 1","Etienne Green","ENG","GK","20",2000,8,0,0,0,0,0,0,0,NA,0,0,0,0,0,0,3,0,"https://fbref.com/en/players/667b65da/Etienne-Green"
"7578","Romain Hamouma_2021",2021,"Saint-Étienne","Ligue 1","Romain Hamouma","FRA","FW,MF","33",1987,19.7,12,7,5,6,1,4,24,16.7,20,17,1,16,7,19,11,0,"https://fbref.com/en/players/0b4d8274/Romain-Hamouma"
"7579","Wahbi Khazri_2021",2021,"Saint-Étienne","Ligue 1","Wahbi Khazri","TUN","FW","29",1991,13.1,24,15,12,7,5,12,24,50,12,10,1,9,4,28,11,0,"https://fbref.com/en/players/2677a1de/Wahbi-Khazri"
"7580","Timothée Kolodziejczak_2021",2021,"Saint-Étienne","Ligue 1","Timothée Kolodziejczak","FRA","DF","28",1991,22.6,28,15,23,5,0,19,27,70.4,8,24,15,9,36,64,80,1,"https://fbref.com/en/players/ab096c6f/Timothee-Kolodziejczak"
"7581","Jean-Philippe Krasso_2021",2021,"Saint-Étienne","Ligue 1","Jean-Philippe Krasso","CIV","FW","23",1997,2.5,5,3,1,4,0,2,4,50,2,5,0,5,1,6,3,0,"https://fbref.com/en/players/037f2523/Jean-Philippe-Krasso"
"7582","Yanis Lhery_2021",2021,"Saint-Étienne","Ligue 1","Yanis Lhery","FRA","MF","17",2003,0.3,0,0,0,0,0,0,0,NA,0,0,0,0,0,0,0,0,"https://fbref.com/en/players/cc972842/Yanis-Lhery"
"7583","Yann M'Vila_2021",2021,"Saint-Étienne","Ligue 1","Yann M'Vila","FRA","MF","30",1990,0.2,0,0,0,0,0,0,2,0,2,0,0,0,1,1,0,0,"https://fbref.com/en/players/d4133fa1/Yann-MVila"
"7584","Yvann Macon_2021",2021,"Saint-Étienne","Ligue 1","Yvann Macon","FRA","DF","21",1998,6,30,20,20,8,2,7,19,36.8,12,6,2,4,9,39,13,0,"https://fbref.com/en/players/0bb6e193/Yvann-Macon"
"7585","Anthony Modeste_2021",2021,"Saint-Étienne","Ligue 1","Anthony Modeste","FRA","FW,MF","32",1988,3.3,2,1,0,2,0,1,4,25,3,3,1,2,0,2,3,0,"https://fbref.com/en/players/34e4343c/Anthony-Modeste"
"7586","Kévin Monnet-Paquet_2021",2021,"Saint-Étienne","Ligue 1","Kévin Monnet-Paquet","FRA","MF,FW","31",1988,6.3,11,7,7,2,2,5,10,50,5,5,0,5,6,17,7,0,"https://fbref.com/en/players/4a57580c/Kevin-Monnet-Paquet"
"7587","Aimen Moueffek_2021",2021,"Saint-Étienne","Ligue 1","Aimen Moueffek","FRA","DF,MF","19",2001,8.3,25,15,16,6,3,13,32,40.6,19,17,2,15,9,34,18,0,"https://fbref.com/en/players/2591b066/Aimen-Moueffek"
"7588","Harold Moukoudi_2021",2021,"Saint-Étienne","Ligue 1","Harold Moukoudi","CMR","DF","22",1997,25.3,46,27,37,8,1,28,38,73.7,10,24,10,14,42,88,78,1,"https://fbref.com/en/players/5f26e0c5/Harold-Moukoudi"
"7589","Jessy Moulin_2021",2021,"Saint-Étienne","Ligue 1","Jessy Moulin","FRA","GK","34",1986,29,2,1,2,0,0,2,3,66.7,1,0,0,0,2,4,9,2,"https://fbref.com/en/players/28a65a2c/Jessy-Moulin"
"7590","Yvan Neyou_2021",2021,"Saint-Étienne","Ligue 1","Yvan Neyou","CMR","MF","23",1997,27.1,58,31,24,33,1,25,60,41.7,35,34,5,29,31,89,13,1,"https://fbref.com/en/players/0ad37003/Yvan-Neyou"
"7591","Arnaud Nordin_2021",2021,"Saint-Étienne","Ligue 1","Arnaud Nordin","FRA","MF,FW","22",1998,19.7,14,8,5,5,4,6,21,28.6,15,13,2,11,9,23,10,0,"https://fbref.com/en/players/7b9a9e25/Arnaud-Nordin"
"7592","Panagiotis Retsos_2021",2021,"Saint-Étienne","Ligue 1","Panagiotis Retsos","GRE","DF","21",1998,3,5,3,5,0,0,3,7,42.9,4,1,1,0,3,8,12,0,"https://fbref.com/en/players/4bd00a50/Panagiotis-Retsos"
"7593","Maxence Rivera_2021",2021,"Saint-Étienne","Ligue 1","Maxence Rivera","FRA","MF,FW","18",2002,2.7,12,10,6,4,2,4,10,40,6,5,0,5,1,13,0,0,"https://fbref.com/en/players/46a7b605/Maxence-Rivera"
"7594","Mathys Saban_2021",2021,"Saint-Étienne","Ligue 1","Mathys Saban","FRA","FW","18",2002,0.1,0,0,0,0,0,0,0,NA,0,0,0,0,0,0,0,0,"https://fbref.com/en/players/7d9f3d69/Mathys-Saban"
"7595","Abdoulaye Sidibé_2021",2021,"Saint-Étienne","Ligue 1","Abdoulaye Sidibé","FRA","MF","18",2002,0.1,1,1,1,0,0,1,2,50,1,0,0,0,0,1,0,0,"https://fbref.com/en/players/a13028f6/Abdoulaye-Sidibe"
"7596","Gabriel Silva_2021",2021,"Saint-Étienne","Ligue 1","Gabriel Silva","BRA","DF","29",1991,3.9,7,6,7,0,0,1,2,50,1,4,1,3,6,13,8,0,"https://fbref.com/en/players/4914ed4a/Gabriel-Silva"
"7597","Nelson Sissoko_2021",2021,"Saint-Étienne","Ligue 1","Nelson Sissoko","FRA","DF","23",1997,5.3,12,6,6,3,3,7,12,58.3,5,2,1,1,12,24,16,1,"https://fbref.com/en/players/12bd0579/Nelson-Sissoko"
"7598","Rayan Souici_2021",2021,"Saint-Étienne","Ligue 1","Rayan Souici","FRA","DF","22",1998,0.1,0,0,0,0,0,0,0,NA,0,0,0,0,0,0,0,0,"https://fbref.com/en/players/e3ad3368/Rayan-Souici"
"7599","Saidou Sow_2021",2021,"Saint-Étienne","Ligue 1","Saidou Sow","GUI","DF","18",2002,11.1,23,12,17,6,0,13,19,68.4,6,12,8,4,14,37,39,1,"https://fbref.com/en/players/f6b94e8d/Saidou-Sow"
"7600","Tyron Tormin_2021",2021,"Saint-Étienne","Ligue 1","Tyron Tormin","FRA","FW,MF","19",2001,0.2,0,0,0,0,0,0,0,NA,0,0,0,0,0,0,0,0,"https://fbref.com/en/players/0d99c6e1/Tyron-Tormin"
"7601","Miguel Trauco_2021",2021,"Saint-Étienne","Ligue 1","Miguel Trauco","PER","DF","27",1992,22.6,47,29,25,14,8,23,43,53.5,20,19,4,15,30,77,34,1,"https://fbref.com/en/players/e4b72e34/Miguel-Trauco"
"7602","Marvin Tshibuabua_2021",2021,"Saint-Étienne","Ligue 1","Marvin Tshibuabua","FRA","DF","18",2002,0.5,1,0,1,0,0,0,0,NA,0,0,0,0,1,2,1,0,"https://fbref.com/en/players/7a0b1e96/Marvin-Tshibuabua"
"7603","Zaydou Youssouf_2021",2021,"Saint-Étienne","Ligue 1","Zaydou Youssouf","FRA","MF","21",1999,13.7,30,15,19,10,1,16,40,40,24,15,0,15,25,55,12,1,"https://fbref.com/en/players/e2f9bb5f/Zaydou-Youssouf"
"7604","Kristoffer Askildsen_2021",2021,"Sampdoria","Serie A","Kristoffer Askildsen","NOR","MF","19",2001,1.1,0,0,0,0,0,0,0,NA,0,2,0,2,3,3,3,0,"https://fbref.com/en/players/a69cc629/Kristoffer-Askildsen"
"7605","Emil Audero_2021",2021,"Sampdoria","Serie A","Emil Audero","ITA","GK","23",1997,37,1,1,1,0,0,1,2,50,1,0,0,0,1,2,16,0,"https://fbref.com/en/players/649b01d8/Emil-Audero"
"7606","Tommaso Augello_2021",2021,"Sampdoria","Serie A","Tommaso Augello","ITA","DF","25",1994,35.7,42,30,27,10,5,23,39,59,16,22,2,20,32,74,76,1,"https://fbref.com/en/players/3cd3b384/Tommaso-Augello"
"7607","Keita Baldé_2021",2021,"Sampdoria","Serie A","Keita Baldé","SEN","FW","25",1995,13.3,9,6,2,6,1,4,10,40,6,10,1,9,0,9,3,0,"https://fbref.com/en/players/509a4ccb/Keita-Balde"
"7608","Bartosz Bereszyński_2021",2021,"Sampdoria","Serie A","Bartosz Bereszyński","POL","DF","28",1992,29,66,44,37,22,7,41,73,56.2,32,40,20,20,42,108,88,0,"https://fbref.com/en/players/61b3978f/Bartosz-Bereszynski"
"7609","Federico Bonazzoli_2021",2021,"Sampdoria","Serie A","Federico Bonazzoli","ITA","FW","23",1997,1.5,0,0,0,0,0,0,0,NA,0,1,0,1,0,0,0,0,"https://fbref.com/en/players/bf57eaab/Federico-Bonazzoli"
"7610","Antonio Candreva_2021",2021,"Sampdoria","Serie A","Antonio Candreva","ITA","MF","33",1987,27.8,28,19,17,9,2,21,53,39.6,32,24,3,21,9,37,27,1,"https://fbref.com/en/players/356c9002/Antonio-Candreva"
"7611","Omar Colley_2021",2021,"Sampdoria","Serie A","Omar Colley","GAM","DF","27",1992,28.8,28,16,19,8,1,13,23,56.5,10,43,29,14,68,96,133,1,"https://fbref.com/en/players/8b95acda/Omar-Colley"
"7612","Mikkel Damsgaard_2021",2021,"Sampdoria","Serie A","Mikkel Damsgaard","DEN","MF,FW","20",2000,19.7,42,21,14,20,8,22,70,31.4,48,40,4,36,24,66,17,0,"https://fbref.com/en/players/215f3907/Mikkel-Damsgaard"
"7613","Fabio Depaoli_2021",2021,"Sampdoria","Serie A","Fabio Depaoli","ITA","MF","23",1997,0.9,1,0,0,1,0,0,2,0,2,0,0,0,1,2,1,0,"https://fbref.com/en/players/d97f2e8d/Fabio-Depaoli"
"7614","Albin Ekdal_2021",2021,"Sampdoria","Serie A","Albin Ekdal","SWE","MF","31",1989,25.5,56,29,21,32,3,23,65,35.4,42,31,12,19,49,105,35,0,"https://fbref.com/en/players/f503ea63/Albin-Ekdal"
"7615","Alex Ferrari_2021",2021,"Sampdoria","Serie A","Alex Ferrari","ITA","DF","26",1994,9.8,27,15,16,9,2,15,24,62.5,9,18,6,12,23,50,26,0,"https://fbref.com/en/players/d0dbca9f/Alex-Ferrari"
"7616","Manolo Gabbiadini_2021",2021,"Sampdoria","Serie A","Manolo Gabbiadini","ITA","FW","28",1991,9.7,2,2,0,2,0,0,1,0,1,3,1,2,3,5,5,0,"https://fbref.com/en/players/8f866fe8/Manolo-Gabbiadini"
"7617","Jakub Jankto_2021",2021,"Sampdoria","Serie A","Jakub Jankto","CZE","MF","24",1996,26.8,28,17,14,7,7,11,35,31.4,24,16,1,15,24,52,34,0,"https://fbref.com/en/players/1ea5f91c/Jakub-Jankto"
"7618","Antonino La Gumina_2021",2021,"Sampdoria","Serie A","Antonino La Gumina","ITA","FW","24",1996,3.8,3,2,0,1,2,0,3,0,3,5,1,4,3,6,5,0,"https://fbref.com/en/players/822a7761/Antonino-La-Gumina"
"7619","Mehdi Léris_2021",2021,"Sampdoria","Serie A","Mehdi Léris","ALG","DF,MF","22",1998,4.3,11,5,6,4,1,6,16,37.5,10,12,2,10,12,23,15,0,"https://fbref.com/en/players/7d3cbc67/Mehdi-Leris"
"7620","Karlo Letica_2021",2021,"Sampdoria","Serie A","Karlo Letica","CRO","GK","23",1997,1,0,0,0,0,0,0,0,NA,0,0,0,0,0,0,2,0,"https://fbref.com/en/players/4a6914ff/Karlo-Letica"
"7621","Antonio Palumbo_2021",2021,"Sampdoria","Serie A","Antonio Palumbo","ITA","MF","23",1996,0.1,0,0,0,0,0,0,1,0,1,0,0,0,0,0,0,0,"https://fbref.com/en/players/33e98344/Antonio-Palumbo"
"7622","Fabio Quagliarella_2021",2021,"Sampdoria","Serie A","Fabio Quagliarella","ITA","FW","37",1983,24.5,12,8,4,4,4,2,19,10.5,17,14,1,13,7,19,10,0,"https://fbref.com/en/players/ee4f2f3b/Fabio-Quagliarella"
"7623","Gastón Ramírez_2021",2021,"Sampdoria","Serie A","Gastón Ramírez","URU","FW,MF","29",1990,10.8,31,15,10,17,4,8,27,29.6,19,19,3,16,4,35,13,0,"https://fbref.com/en/players/2c851997/Gaston-Ramirez"
"7624","Vasco Regini_2021",2021,"Sampdoria","Serie A","Vasco Regini","ITA","DF","29",1990,1,2,2,2,0,0,2,2,100,0,1,1,0,1,3,5,0,"https://fbref.com/en/players/339c6ed4/Vasco-Regini"
"7625","Adrien Silva_2021",2021,"Sampdoria","Serie A","Adrien Silva","POR","MF","31",1989,17.8,49,22,21,22,6,18,54,33.3,36,34,1,33,30,79,10,1,"https://fbref.com/en/players/d6f88a1d/Adrien-Silva"
"7626","Morten Thorsby_2021",2021,"Sampdoria","Serie A","Morten Thorsby","NOR","MF","24",1996,29.4,76,42,32,36,8,20,60,33.3,40,51,16,35,25,101,30,0,"https://fbref.com/en/players/d1b49282/Morten-Thorsby"
"7627","Lorenzo Tonelli_2021",2021,"Sampdoria","Serie A","Lorenzo Tonelli","ITA","DF","30",1990,19.8,33,18,20,11,2,10,21,47.6,11,21,14,7,25,58,94,1,"https://fbref.com/en/players/8cc29864/Lorenzo-Tonelli"
"7628","Ernesto Torregrossa_2021",2021,"Sampdoria","Serie A","Ernesto Torregrossa","VEN","FW","28",1992,1.9,1,1,0,0,1,0,2,0,2,4,0,4,1,2,1,0,"https://fbref.com/en/players/bf39bdec/Ernesto-Torregrossa"
"7629","Valerio Verre_2021",2021,"Sampdoria","Serie A","Valerio Verre","ITA","FW,MF","26",1994,11.1,11,7,2,7,2,4,19,21.1,15,14,2,12,9,20,3,0,"https://fbref.com/en/players/33ecf462/Valerio-Verre"
"7630","Maya Yoshida_2021",2021,"Sampdoria","Serie A","Maya Yoshida","JPN","DF","31",1988,25.3,17,4,10,7,0,7,13,53.8,6,45,34,11,57,74,93,1,"https://fbref.com/en/players/caffaf5a/Maya-Yoshida"
"7631","Kaan Ayhan_2021",2021,"Sassuolo","Serie A","Kaan Ayhan","TUR","DF","25",1994,8.8,15,9,8,5,2,8,13,61.5,5,9,5,4,16,31,33,0,"https://fbref.com/en/players/2200181e/Kaan-Ayhan"
"7632","Domenico Berardi_2021",2021,"Sassuolo","Serie A","Domenico Berardi","ITA","FW","25",1994,27.5,42,22,17,11,14,21,62,33.9,41,23,1,22,26,68,34,0,"https://fbref.com/en/players/53a0e358/Domenico-Berardi"
"7633","Jeremie Boga_2021",2021,"Sassuolo","Serie A","Jeremie Boga","CIV","FW,MF","23",1997,19.8,11,9,5,0,6,3,11,27.3,8,10,0,10,8,19,7,0,"https://fbref.com/en/players/fe012aca/Jeremie-Boga"
"7634","Mehdi Bourabia_2021",2021,"Sassuolo","Serie A","Mehdi Bourabia","MAR","MF","28",1991,5.9,6,5,1,4,1,2,7,28.6,5,14,6,8,12,18,8,0,"https://fbref.com/en/players/0d077b88/Mehdi-Bourabia"
"7635","Francesco Caputo_2021",2021,"Sassuolo","Serie A","Francesco Caputo","ITA","FW","32",1987,18.9,0,0,0,0,0,0,2,0,2,4,0,4,1,1,3,0,"https://fbref.com/en/players/5bd72174/Francesco-Caputo"
"7636","Vlad Chiricheș_2021",2021,"Sassuolo","Serie A","Vlad Chiricheș","ROU","DF","30",1989,20.4,38,23,34,3,1,21,35,60,14,31,21,10,50,88,59,2,"https://fbref.com/en/players/c316607a/Vlad-Chiriches"
"7637","Andrea Consigli_2021",2021,"Sassuolo","Serie A","Andrea Consigli","ITA","GK","33",1987,37,2,2,2,0,0,2,2,100,0,0,0,0,0,2,14,4,"https://fbref.com/en/players/8cabdc1e/Andrea-Consigli"
"7638","Grégoire Defrel_2021",2021,"Sassuolo","Serie A","Grégoire Defrel","MTQ","MF,FW","29",1991,14.8,13,8,5,5,3,5,13,38.5,8,9,0,9,7,20,5,0,"https://fbref.com/en/players/854ee61a/Gregoire-Defrel"
"7639","Lukáš Haraslín_2021",2021,"Sassuolo","Serie A","Lukáš Haraslín","SVK","FW,MF","24",1996,3.7,8,4,2,5,1,2,5,40,3,1,0,1,0,8,2,0,"https://fbref.com/en/players/5c397195/Lukas-Haraslin"
"7640","Hamed Junior Traorè_2021",2021,"Sassuolo","Serie A","Hamed Junior Traorè","CIV","MF,FW","20",2000,19.9,29,17,10,10,9,14,35,40,21,27,3,24,18,47,9,0,"https://fbref.com/en/players/570bb4b9/Hamed-Junior-Traore"
"7641","Isaac Karamoko_2021",2021,"Sassuolo","Serie A","Isaac Karamoko","FRA","DF","18",2002,0,1,0,0,0,1,1,1,100,0,0,0,0,0,1,0,0,"https://fbref.com/en/players/4c7919df/Isaac-Karamoko"
"7642","Giorgos Kyriakopoulos_2021",2021,"Sassuolo","Serie A","Giorgos Kyriakopoulos","GRE","DF","24",1996,16.2,35,18,17,12,6,8,28,28.6,20,16,5,11,15,50,42,0,"https://fbref.com/en/players/0a483542/Giorgos-Kyriakopoulos"
"7643","Manuel Locatelli_2021",2021,"Sassuolo","Serie A","Manuel Locatelli","ITA","MF","22",1998,32,81,47,43,28,10,29,56,51.8,27,35,15,20,51,132,65,1,"https://fbref.com/en/players/a8a874f1/Manuel-Locatelli"
"7644","Maxime Lopez_2021",2021,"Sassuolo","Serie A","Maxime Lopez","FRA","MF","22",1997,20.7,24,13,15,6,3,14,41,34.1,27,9,0,9,16,40,10,1,"https://fbref.com/en/players/20094685/Maxime-Lopez"
"7645","Francesco Magnanelli_2021",2021,"Sassuolo","Serie A","Francesco Magnanelli","ITA","MF","35",1984,4.9,7,5,2,5,0,3,10,30,7,6,2,4,13,20,10,0,"https://fbref.com/en/players/07767f42/Francesco-Magnanelli"
"7646","Gian Marco Ferrari_2021",2021,"Sassuolo","Serie A","Gian Marco Ferrari","ITA","DF","28",1992,33.5,32,20,15,14,3,10,23,43.5,13,46,37,9,50,82,100,1,"https://fbref.com/en/players/8650af85/Gian-Marco-Ferrari"
"7647","Marlon_2021",2021,"Sassuolo","Serie A","Marlon","BRA","DF","24",1995,19.4,19,13,13,6,0,13,18,72.2,5,23,17,6,27,46,44,2,"https://fbref.com/en/players/cdf65d12/Marlon"
"7648","Mert Müldür_2021",2021,"Sassuolo","Serie A","Mert Müldür","TUR","DF","21",1999,18.6,43,20,26,9,8,27,53,50.9,26,17,1,16,36,79,41,0,"https://fbref.com/en/players/1295552e/Mert-Muldur"
"7649","Pedro Obiang_2021",2021,"Sassuolo","Serie A","Pedro Obiang","EQG","MF","28",1992,16.3,35,22,17,15,3,12,35,34.3,23,26,7,19,22,57,27,0,"https://fbref.com/en/players/ba1e04b3/Pedro-Obiang"
"7650","Brian Oddei_2021",2021,"Sassuolo","Serie A","Brian Oddei","ITA","FW,MF","17",2002,0.5,2,1,1,1,0,2,3,66.7,1,1,0,1,0,2,1,0,"https://fbref.com/en/players/97e8ea97/Brian-Oddei"
"7651","Gianluca Pegolo_2021",2021,"Sassuolo","Serie A","Gianluca Pegolo","ITA","GK","39",1981,1,0,0,0,0,0,0,0,NA,0,0,0,0,0,0,1,0,"https://fbref.com/en/players/f058ed1f/Gianluca-Pegolo"
"7652","Federico Peluso_2021",2021,"Sassuolo","Serie A","Federico Peluso","ITA","DF","36",1984,2.3,1,1,1,0,0,1,2,50,1,2,2,0,3,4,12,0,"https://fbref.com/en/players/4f2908e5/Federico-Peluso"
"7653","Giacomo Raspadori_2021",2021,"Sassuolo","Serie A","Giacomo Raspadori","ITA","FW,MF","20",2000,13.7,5,3,1,1,3,0,4,0,4,13,5,8,2,7,9,0,"https://fbref.com/en/players/6e058f06/Giacomo-Raspadori"
"7654","Federico Ricci_2021",2021,"Sassuolo","Serie A","Federico Ricci","ITA","FW","26",1994,0,0,0,0,0,0,0,0,NA,0,0,0,0,0,0,0,0,"https://fbref.com/en/players/524eb8c5/Federico-Ricci"
"7655","Rogério_2021",2021,"Sassuolo","Serie A","Rogério","BRA","DF","22",1998,20.9,26,13,19,5,2,19,27,70.4,8,26,5,21,31,57,53,0,"https://fbref.com/en/players/10e7f486/Rogerio"
"7656","Nicolás Schiappacasse_2021",2021,"Sassuolo","Serie A","Nicolás Schiappacasse","URU","MF","21",1999,0.2,0,0,0,0,0,0,0,NA,0,0,0,0,0,0,0,0,"https://fbref.com/en/players/afe31d55/Nicolas-Schiappacasse"
"7657","Jeremy Toljan_2021",2021,"Sassuolo","Serie A","Jeremy Toljan","GER","DF","25",1994,16.6,21,12,16,3,2,12,27,44.4,15,15,7,8,13,34,28,0,"https://fbref.com/en/players/a96e5dc0/Jeremy-Toljan"
"7658","Filip Đuričić_2021",2021,"Sassuolo","Serie A","Filip Đuričić","SRB","MF,FW","28",1992,23.1,32,23,6,16,10,12,30,40,18,20,2,18,9,41,12,0,"https://fbref.com/en/players/eccbe56a/Filip-Djuricic"
"7659","Mehmet Aydin_2021",2021,"Schalke 04","Bundesliga","Mehmet Aydin","GER","DF","18",2002,5.6,15,7,9,6,0,4,10,40,6,6,1,5,6,21,16,0,"https://fbref.com/en/players/fe46e261/Mehmet-Aydin"
"7660","Timo Becker_2021",2021,"Schalke 04","Bundesliga","Timo Becker","GER","DF","23",1997,18.2,34,23,28,6,0,16,25,64,9,18,4,14,22,56,58,0,"https://fbref.com/en/players/543ddcaf/Timo-Becker"
"7661","Nabil Bentaleb_2021",2021,"Schalke 04","Bundesliga","Nabil Bentaleb","ALG","MF","25",1994,6.1,14,8,7,6,1,4,15,26.7,11,5,2,3,6,20,8,0,"https://fbref.com/en/players/3189f61a/Nabil-Bentaleb"
"7662","Nassim Boujellab_2021",2021,"Schalke 04","Bundesliga","Nassim Boujellab","MAR","MF,FW","21",1999,6.7,13,9,2,10,1,2,12,16.7,10,10,3,7,7,20,9,0,"https://fbref.com/en/players/541127d5/Nassim-Boujellab"
"7663","Can Bozdogan_2021",2021,"Schalke 04","Bundesliga","Can Bozdogan","GER","MF,FW","19",2001,7.2,13,5,6,6,1,4,15,26.7,11,10,2,8,7,20,5,0,"https://fbref.com/en/players/b797f558/Can-Bozdogan"
"7664","Kerim Calhanoglu_2021",2021,"Schalke 04","Bundesliga","Kerim Calhanoglu","GER","DF","17",2002,3.3,3,3,1,1,1,0,3,0,3,4,0,4,7,10,6,0,"https://fbref.com/en/players/d1db4b83/Kerim-Calhanoglu"
"7665","Ralf Fährmann_2021",2021,"Schalke 04","Bundesliga","Ralf Fährmann","GER","GK","31",1988,20.8,2,1,2,0,0,1,2,50,1,0,0,0,1,3,9,3,"https://fbref.com/en/players/1e43fad8/Ralf-Fahrmann"
"7666","Florian Flick_2021",2021,"Schalke 04","Bundesliga","Florian Flick","GER","MF","20",2000,4,10,7,4,6,0,7,16,43.8,9,4,3,1,7,17,5,1,"https://fbref.com/en/players/9642c929/Florian-Flick"
"7667","Amine Harit_2021",2021,"Schalke 04","Bundesliga","Amine Harit","MAR","MF,FW","23",1997,23.3,22,13,8,11,3,10,23,43.5,13,9,1,8,17,39,7,1,"https://fbref.com/en/players/e7d59f4f/Amine-Harit"
"7668","Matthew Hoppe_2021",2021,"Schalke 04","Bundesliga","Matthew Hoppe","USA","FW","19",2001,14.5,6,6,1,3,2,2,12,16.7,10,8,2,6,4,10,15,0,"https://fbref.com/en/players/1bc432b7/Matthew-Hoppe"
"7669","Klaas-Jan Huntelaar_2021",2021,"Schalke 04","Bundesliga","Klaas-Jan Huntelaar","NED","FW","36",1983,6.5,4,2,0,2,2,0,2,0,2,3,1,2,2,6,3,0,"https://fbref.com/en/players/5042e5c2/Klaas-Jan-Huntelaar"
"7670","Vedad Ibišević_2021",2021,"Schalke 04","Bundesliga","Vedad Ibišević","BIH","FW","35",1984,1.7,0,0,0,0,0,0,0,NA,0,1,0,1,1,1,1,0,"https://fbref.com/en/players/c3fd9887/Vedad-Ibisevic"
"7671","Blendi Idrizi_2021",2021,"Schalke 04","Bundesliga","Blendi Idrizi","KVX","MF","22",1998,2.6,8,4,1,6,1,1,1,100,0,6,2,4,3,11,1,0,"https://fbref.com/en/players/58450270/Blendi-Idrizi"
"7672","Ozan Kabak_2021",2021,"Schalke 04","Bundesliga","Ozan Kabak","TUR","DF","20",2000,13.8,17,9,11,5,1,6,13,46.2,7,20,11,9,13,30,57,0,"https://fbref.com/en/players/2d61d13a/Ozan-Kabak"
"7673","Jimmy Kaparos_2021",2021,"Schalke 04","Bundesliga","Jimmy Kaparos","GER","MF","18",2001,0.2,0,0,0,0,0,0,1,0,1,0,0,0,0,0,0,0,"https://fbref.com/en/players/11bc43f4/Jimmy-Kaparos"
"7674","Sead Kolašinac_2021",2021,"Schalke 04","Bundesliga","Sead Kolašinac","BIH","DF,MF","27",1993,15.8,20,17,10,7,3,8,18,44.4,10,17,5,12,20,40,17,0,"https://fbref.com/en/players/3935e52e/Sead-Kolasinac"
"7675","Ahmed Kutucu_2021",2021,"Schalke 04","Bundesliga","Ahmed Kutucu","TUR","FW,MF","20",2000,1.2,1,0,0,0,1,1,2,50,1,1,0,1,0,1,0,0,"https://fbref.com/en/players/beda9675/Ahmed-Kutucu"
"7676","Michael Langer_2021",2021,"Schalke 04","Bundesliga","Michael Langer","AUT","GK","35",1985,2.7,0,0,0,0,0,0,0,NA,0,0,0,0,0,0,3,0,"https://fbref.com/en/players/d20f088b/Michael-Langer"
"7677","Jan Luca Schuler_2021",2021,"Schalke 04","Bundesliga","Jan Luca Schuler","GER","FW","21",1999,0.4,2,2,1,1,0,0,1,0,1,1,0,1,0,2,0,0,"https://fbref.com/en/players/6ca598d5/Jan-Luca-Schuler"
"7678","Kilian Ludewig_2021",2021,"Schalke 04","Bundesliga","Kilian Ludewig","GER","DF,FW","20",2000,5.8,16,6,10,5,1,8,25,32,17,7,0,7,3,19,14,0,"https://fbref.com/en/players/9b1b7d78/Kilian-Ludewig"
"7679","Mikail Maden_2021",2021,"Schalke 04","Bundesliga","Mikail Maden","NOR","FW","18",2002,0.1,0,0,0,0,0,0,0,NA,0,0,0,0,0,0,0,0,"https://fbref.com/en/players/fc0f3ef3/Mikail-Maden"
"7680","Omar Mascarell_2021",2021,"Schalke 04","Bundesliga","Omar Mascarell","ESP","MF","27",1993,19.6,41,24,15,19,7,21,54,38.9,33,40,14,26,37,78,32,1,"https://fbref.com/en/players/11fd2b75/Omar-Mascarell"
"7681","Rabbi Matondo_2021",2021,"Schalke 04","Bundesliga","Rabbi Matondo","WAL","FW,MF","19",2000,2.4,3,2,0,3,0,2,3,66.7,1,1,0,1,1,4,1,0,"https://fbref.com/en/players/33144cc5/Rabbi-Matondo"
"7682","Henning Matriciani_2021",2021,"Schalke 04","Bundesliga","Henning Matriciani","GER","DF","20",2000,0.3,1,1,1,0,0,1,1,100,0,1,0,1,0,1,1,0,"https://fbref.com/en/players/ab3f1bdf/Henning-Matriciani"
"7683","Hamza Mendyl_2021",2021,"Schalke 04","Bundesliga","Hamza Mendyl","MAR","FW,DF","22",1997,1.1,2,2,2,0,0,0,2,0,2,2,0,2,0,2,2,0,"https://fbref.com/en/players/f99fe221/Hamza-Mendyl"
"7684","Levent Mercan_2021",2021,"Schalke 04","Bundesliga","Levent Mercan","GER","FW","19",2000,0.1,0,0,0,0,0,0,0,NA,0,0,0,0,0,0,0,0,"https://fbref.com/en/players/33340bd6/Levent-Mercan"
"7685","Shkodran Mustafi_2021",2021,"Schalke 04","Bundesliga","Shkodran Mustafi","GER","DF","28",1992,11.5,16,5,15,1,0,3,12,25,9,20,15,5,32,48,76,1,"https://fbref.com/en/players/3f2d59fe/Shkodran-Mustafi"
"7686","Matija Nastasić_2021",2021,"Schalke 04","Bundesliga","Matija Nastasić","SRB","DF","27",1993,13.6,11,7,9,2,0,9,16,56.3,7,22,18,4,26,37,51,1,"https://fbref.com/en/players/f35430a4/Matija-Nastasic"
"7687","Bastian Oczipka_2021",2021,"Schalke 04","Bundesliga","Bastian Oczipka","GER","DF,FW","31",1989,21.4,33,20,22,10,1,7,21,33.3,14,22,4,18,24,57,41,0,"https://fbref.com/en/players/d1661819/Bastian-Oczipka"
"7688","Gonçalo Paciência_2021",2021,"Schalke 04","Bundesliga","Gonçalo Paciência","POR","FW","25",1994,8.3,8,3,4,1,3,4,16,25,12,4,1,3,1,9,3,0,"https://fbref.com/en/players/962e54cb/Goncalo-Paciencia"
"7689","Vasileios Pavlidis_2021",2021,"Schalke 04","Bundesliga","Vasileios Pavlidis","GRE","FW","17",2002,0,0,0,0,0,0,0,0,NA,0,0,0,0,0,0,0,0,"https://fbref.com/en/players/75422cbf/Vasileios-Pavlidis"
"7690","Benito Raman_2021",2021,"Schalke 04","Bundesliga","Benito Raman","BEL","FW,MF","25",1994,13.8,19,13,11,6,2,6,29,20.7,23,11,0,11,5,24,5,0,"https://fbref.com/en/players/867501bf/Benito-Raman"
"7691","Sebastian Rudy_2021",2021,"Schalke 04","Bundesliga","Sebastian Rudy","GER","DF","30",1990,2,4,2,2,0,2,4,7,57.1,3,6,4,2,1,5,4,0,"https://fbref.com/en/players/80f36c88/Sebastian-Rudy"
"7692","Frederik Rønnow_2021",2021,"Schalke 04","Bundesliga","Frederik Rønnow","DEN","GK","27",1992,10.5,0,0,0,0,0,0,0,NA,0,0,0,0,1,1,9,1,"https://fbref.com/en/players/a70b8345/Frederik-Ronnow"
"7693","Salif Sané_2021",2021,"Schalke 04","Bundesliga","Salif Sané","SEN","DF","29",1990,11.9,17,9,9,7,1,13,23,56.5,10,25,13,12,25,42,66,0,"https://fbref.com/en/players/791abba1/Salif-Sane"
"7694","Alessandro Schöpf_2021",2021,"Schalke 04","Bundesliga","Alessandro Schöpf","AUT","FW,MF","26",1994,10.5,11,9,3,7,1,1,6,16.7,5,15,1,14,6,17,6,0,"https://fbref.com/en/players/106bca06/Alessandro-Schopf"
"7695","Suat Serdar_2021",2021,"Schalke 04","Bundesliga","Suat Serdar","GER","MF","23",1997,21.7,55,35,18,33,4,17,52,32.7,35,29,4,25,23,78,21,0,"https://fbref.com/en/players/b3325a30/Suat-Serdar"
"7696","Steven Skrzybski_2021",2021,"Schalke 04","Bundesliga","Steven Skrzybski","GER","FW,DF","27",1992,4.7,5,4,0,5,0,1,7,14.3,6,13,1,12,5,10,1,1,"https://fbref.com/en/players/58ce23e5/Steven-Skrzybski"
"7697","Benjamin Stambouli_2021",2021,"Schalke 04","Bundesliga","Benjamin Stambouli","FRA","DF,MF","29",1990,21.7,45,29,24,18,3,15,37,40.5,22,42,14,28,49,94,45,1,"https://fbref.com/en/players/5939baa2/Benjamin-Stambouli"
"7698","Malick Thiaw_2021",2021,"Schalke 04","Bundesliga","Malick Thiaw","GER","DF","18",2001,16.1,42,27,24,17,1,15,26,57.7,11,17,12,5,33,75,70,0,"https://fbref.com/en/players/ff5ea0bf/Malick-Thiaw"
"7699","Mark Uth_2021",2021,"Schalke 04","Bundesliga","Mark Uth","GER","FW,MF","28",1991,16.6,25,13,13,10,2,5,23,21.7,18,21,0,21,5,30,10,0,"https://fbref.com/en/players/a3ddb1b9/Mark-Uth"
"7700","William_2021",2021,"Schalke 04","Bundesliga","William","BRA","DF,FW","25",1995,5.3,14,10,10,4,0,5,15,33.3,10,16,5,11,11,25,15,1,"https://fbref.com/en/players/d4d0a9ad/William"
"7701","Marcos Acuña_2021",2021,"Sevilla","La Liga","Marcos Acuña","ARG","DF","28",1991,25.9,62,42,34,20,8,23,41,56.1,18,23,2,21,23,85,30,1,"https://fbref.com/en/players/81442ecb/Marcos-Acuna"
"7702","Yassine Bounou_2021",2021,"Sevilla","La Liga","Yassine Bounou","MAR","GK","29",1991,33,1,1,1,0,0,0,2,0,2,0,0,0,0,1,12,2,"https://fbref.com/en/players/f6798fc3/Yassine-Bounou"
"7703","Diego Carlos_2021",2021,"Sevilla","La Liga","Diego Carlos","BRA","DF","27",1993,31,22,13,17,4,1,8,16,50,8,35,27,8,31,53,114,1,"https://fbref.com/en/players/b4a014b1/Diego-Carlos"
"7704","Youssef En-Nesyri_2021",2021,"Sevilla","La Liga","Youssef En-Nesyri","MAR","FW","23",1997,25.7,17,11,2,9,6,4,21,19,17,15,0,15,8,25,23,0,"https://fbref.com/en/players/04e17fd5/Youssef-En-Nesyri"
"7705","Sergio Escudero_2021",2021,"Sevilla","La Liga","Sergio Escudero","ESP","DF","30",1989,6.3,12,8,6,5,1,6,12,50,6,5,2,3,9,21,7,0,"https://fbref.com/en/players/b0616e3d/Sergio-Escudero"
"7706","Carlos Fernández_2021",2021,"Sevilla","La Liga","Carlos Fernández","ESP","FW","24",1996,1.6,1,0,1,0,0,0,2,0,2,3,1,2,1,2,0,0,"https://fbref.com/en/players/e08647d6/Carlos-Fernandez"
"7707","Fernando_2021",2021,"Sevilla","La Liga","Fernando","BRA","MF","33",1987,28.3,54,28,24,25,5,23,43,53.5,20,25,11,14,41,95,70,0,"https://fbref.com/en/players/41f32541/Fernando"
"7708","Bryan Gil_2021",2021,"Sevilla","La Liga","Bryan Gil","ESP","FW","19",2001,0.1,1,1,0,1,0,0,0,NA,0,0,0,0,0,1,0,0,"https://fbref.com/en/players/7b5ab7f2/Bryan-Gil"
"7709","Papu Gómez_2021",2021,"Sevilla","La Liga","Papu Gómez","ARG","MF,FW","32",1988,10.2,9,6,2,4,3,2,12,16.7,10,13,2,11,7,16,6,0,"https://fbref.com/en/players/6e4df551/Papu-Gomez"
"7710","Sergi Gómez_2021",2021,"Sevilla","La Liga","Sergi Gómez","ESP","DF","28",1992,8,4,3,2,2,0,1,1,100,0,5,4,1,6,10,34,0,"https://fbref.com/en/players/bc6f5f06/Sergi-Gomez"
"7711","Nemanja Gudelj_2021",2021,"Sevilla","La Liga","Nemanja Gudelj","SRB","MF,DF","28",1991,11.6,23,12,16,5,2,4,10,40,6,10,6,4,24,47,24,2,"https://fbref.com/en/players/0076ab7f/Nemanja-Gudelj"
"7712","Munir El Haddadi_2021",2021,"Sevilla","La Liga","Munir El Haddadi","MAR","FW","24",1995,9.4,12,8,5,5,2,2,12,16.7,10,6,0,6,5,17,6,0,"https://fbref.com/en/players/8696bc90/Munir-El-Haddadi"
"7713","Oussama Idrissi_2021",2021,"Sevilla","La Liga","Oussama Idrissi","MAR","FW,MF","24",1996,0.3,1,1,0,1,0,1,2,50,1,2,0,2,1,2,0,0,"https://fbref.com/en/players/34caa4b3/Oussama-Idrissi"
"7714","Luuk de Jong_2021",2021,"Sevilla","La Liga","Luuk de Jong","NED","FW","29",1990,14.1,9,5,3,2,4,1,7,14.3,6,11,3,8,5,14,15,0,"https://fbref.com/en/players/abb3bb95/Luuk-de-Jong"
"7715","Joan Jordán_2021",2021,"Sevilla","La Liga","Joan Jordán","ESP","MF","26",1994,26.7,52,28,17,29,6,17,76,22.4,59,22,3,19,27,79,25,0,"https://fbref.com/en/players/2a0c8ba4/Joan-Jordan"
"7716","Jules Koundé_2021",2021,"Sevilla","La Liga","Jules Koundé","FRA","DF","21",1998,33.1,27,15,14,11,2,10,24,41.7,14,24,16,8,40,67,104,0,"https://fbref.com/en/players/4d1666ff/Jules-Kounde"
"7717","Jesús Navas_2021",2021,"Sevilla","La Liga","Jesús Navas","ESP","DF","34",1985,31.4,27,21,15,11,1,15,22,68.2,7,10,3,7,37,64,62,1,"https://fbref.com/en/players/3f10bd22/Jesus-Navas"
"7718","Lucas Ocampos_2021",2021,"Sevilla","La Liga","Lucas Ocampos","ARG","FW","26",1994,29.2,36,24,12,16,8,13,37,35.1,24,33,1,32,19,55,30,1,"https://fbref.com/en/players/a08b974a/Lucas-Ocampos"
"7719","Ivan Rakitić_2021",2021,"Sevilla","La Liga","Ivan Rakitić","CRO","MF","32",1988,24.8,32,18,18,10,4,12,41,29.3,29,19,4,15,26,58,29,1,"https://fbref.com/en/players/89f951b5/Ivan-Rakitic"
"7720","Karim Rekik_2021",2021,"Sevilla","La Liga","Karim Rekik","NED","DF","25",1994,7.3,7,5,2,5,0,1,4,25,3,8,3,5,6,13,17,0,"https://fbref.com/en/players/3376a776/Karim-Rekik"
"7721","Óscar Rodríguez Arnaiz_2021",2021,"Sevilla","La Liga","Óscar Rodríguez Arnaiz","ESP","MF,FW","22",1998,5.7,15,9,3,8,4,6,13,46.2,7,2,0,2,10,25,1,0,"https://fbref.com/en/players/19709006/Oscar-Rodriguez-Arnaiz"
"7722","Suso_2021",2021,"Sevilla","La Liga","Suso","ESP","FW","26",1993,24.6,20,10,8,6,6,10,41,24.4,31,12,0,12,8,28,8,0,"https://fbref.com/en/players/4e219ad2/Suso"
"7723","Óliver Torres_2021",2021,"Sevilla","La Liga","Óliver Torres","ESP","MF,FW","25",1994,15.6,34,22,13,15,6,19,53,35.8,34,15,0,15,15,49,9,0,"https://fbref.com/en/players/58a9a4d9/Oliver-Torres"
"7724","Tomáš Vaclík_2021",2021,"Sevilla","La Liga","Tomáš Vaclík","CZE","GK","31",1989,5,0,0,0,0,0,0,1,0,1,0,0,0,0,0,0,1,"https://fbref.com/en/players/7b456af7/Tomas-Vaclik"
"7725","Franco Vázquez_2021",2021,"Sevilla","La Liga","Franco Vázquez","ARG","FW,MF","31",1989,1.8,5,1,0,3,2,1,5,20,4,2,1,1,1,6,1,0,"https://fbref.com/en/players/467bae22/Franco-Vazquez"
"7726","Aleix Vidal_2021",2021,"Sevilla","La Liga","Aleix Vidal","ESP","DF","30",1989,6.6,9,5,5,3,1,5,12,41.7,7,10,1,9,12,21,9,0,"https://fbref.com/en/players/04965583/Aleix-Vidal"
"7727","Ethan Ampadu_2021",2021,"Sheffield Utd","Premier League","Ethan Ampadu","WAL","DF,MF","19",2000,23.2,57,36,31,24,2,20,46,43.5,26,40,19,21,49,106,87,3,"https://fbref.com/en/players/10b9fa99/Ethan-Ampadu"
"7728","George Baldock_2021",2021,"Sheffield Utd","Premier League","George Baldock","GRE","DF","27",1993,31,47,34,28,14,5,21,50,42,29,26,7,19,25,72,70,1,"https://fbref.com/en/players/394854c4/George-Baldock"
"7729","Chris Basham_2021",2021,"Sheffield Utd","Premier League","Chris Basham","ENG","DF,MF","32",1988,28.6,69,42,41,23,5,41,67,61.2,26,36,15,21,49,118,105,1,"https://fbref.com/en/players/1aa84968/Chris-Basham"
"7730","Sander Berge_2021",2021,"Sheffield Utd","Premier League","Sander Berge","NOR","MF","22",1998,12.4,16,7,8,5,3,7,15,46.7,8,11,2,9,4,20,18,0,"https://fbref.com/en/players/d0b6129f/Sander-Berge"
"7731","Jayden Bogle_2021",2021,"Sheffield Utd","Premier League","Jayden Bogle","ENG","DF,MF","20",2000,12.3,33,23,21,10,2,20,39,51.3,19,14,4,10,14,47,22,0,"https://fbref.com/en/players/ae5019e6/Jayden-Bogle"
"7732","Rhian Brewster_2021",2021,"Sheffield Utd","Premier League","Rhian Brewster","ENG","FW,MF","20",2000,12.5,8,5,1,4,3,1,13,7.7,12,15,2,13,5,13,5,0,"https://fbref.com/en/players/30e81a88/Rhian-Brewster"
"7733","Kean Bryan_2021",2021,"Sheffield Utd","Premier League","Kean Bryan","ENG","DF","23",1996,11.2,20,10,9,11,0,9,19,47.4,10,16,10,6,13,33,39,1,"https://fbref.com/en/players/c684d3c9/Kean-Bryan"
"7734","Oliver Burke_2021",2021,"Sheffield Utd","Premier League","Oliver Burke","SCO","FW","23",1997,14.1,16,8,6,9,1,5,24,20.8,19,24,0,24,2,18,6,0,"https://fbref.com/en/players/f631c17f/Oliver-Burke"
"7735","John Egan_2021",2021,"Sheffield Utd","Premier League","John Egan","IRL","DF","27",1992,29.2,41,21,29,12,0,22,39,56.4,17,43,31,12,41,82,131,0,"https://fbref.com/en/players/debe38a0/John-Egan"
"7736","John Fleck_2021",2021,"Sheffield Utd","Premier League","John Fleck","SCO","MF","28",1991,28.6,51,33,28,18,5,26,83,31.3,57,26,4,22,28,79,12,1,"https://fbref.com/en/players/b63e789d/John-Fleck"
"7737","Antwoine Hackford_2021",2021,"Sheffield Utd","Premier League","Antwoine Hackford","ENG","DF","16",2004,0.1,0,0,0,0,0,0,0,NA,0,0,0,0,0,0,0,0,"https://fbref.com/en/players/a7588cdc/Antwoine-Hackford"
"7738","Phil Jagielka_2021",2021,"Sheffield Utd","Premier League","Phil Jagielka","ENG","DF","37",1982,5.8,5,4,4,0,1,2,7,28.6,5,11,5,6,10,15,26,2,"https://fbref.com/en/players/3233eefd/Phil-Jagielka"
"7739","Daniel Jebbison_2021",2021,"Sheffield Utd","Premier League","Daniel Jebbison","ENG","FW","16",2003,3.2,6,2,1,3,2,3,7,42.9,4,6,1,5,1,7,0,0,"https://fbref.com/en/players/03edb878/Daniel-Jebbison"
"7740","Max Lowe_2021",2021,"Sheffield Utd","Premier League","Max Lowe","ENG","DF","23",1997,6.1,26,11,18,6,2,9,21,42.9,12,12,4,8,5,31,11,0,"https://fbref.com/en/players/7af88b33/Max-Lowe"
"7741","John Lundstram_2021",2021,"Sheffield Utd","Premier League","John Lundstram","ENG","MF","26",1994,22.6,25,16,12,11,2,13,47,27.7,34,26,8,18,14,39,29,1,"https://fbref.com/en/players/0df2b165/John-Lundstram"
"7742","Oliver McBurnie_2021",2021,"Sheffield Utd","Premier League","Oliver McBurnie","SCO","FW","24",1996,14.7,15,7,7,7,1,5,17,29.4,12,10,3,7,6,21,30,0,"https://fbref.com/en/players/78b8ac63/Oliver-McBurnie"
"7743","David McGoldrick_2021",2021,"Sheffield Utd","Premier League","David McGoldrick","IRL","FW,MF","32",1987,26.6,33,21,8,15,10,13,31,41.9,18,19,3,16,2,35,25,0,"https://fbref.com/en/players/dbe56a33/David-McGoldrick"
"7744","Lys Mousset_2021",2021,"Sheffield Utd","Premier League","Lys Mousset","FRA","FW,MF","24",1996,3.3,1,0,0,0,1,0,2,0,2,1,0,1,0,1,1,1,"https://fbref.com/en/players/d9cfca3d/Lys-Mousset"
"7745","Iliman Ndiaye_2021",2021,"Sheffield Utd","Premier League","Iliman Ndiaye","SEN","MF","20",2000,0.1,1,1,0,1,0,1,1,100,0,0,0,0,0,1,0,0,"https://fbref.com/en/players/5ed97752/Iliman-Ndiaye"
"7746","Oliver Norwood_2021",2021,"Sheffield Utd","Premier League","Oliver Norwood","NIR","MF","29",1991,24.7,49,22,16,28,5,21,72,29.2,51,29,12,17,36,85,51,1,"https://fbref.com/en/players/43439614/Oliver-Norwood"
"7747","Jack O'Connell_2021",2021,"Sheffield Utd","Premier League","Jack O'Connell","ENG","DF","26",1994,2,3,1,1,1,1,0,1,0,1,4,3,1,2,5,7,0,"https://fbref.com/en/players/312626c1/Jack-OConnell"
"7748","Ben Osborn_2021",2021,"Sheffield Utd","Premier League","Ben Osborn","ENG","MF,DF","25",1994,17.8,33,18,15,10,8,13,40,32.5,27,20,3,17,12,45,17,0,"https://fbref.com/en/players/79bc4c45/Ben-Osborn"
"7749","Aaron Ramsdale_2021",2021,"Sheffield Utd","Premier League","Aaron Ramsdale","ENG","GK","22",1998,38,1,1,1,0,0,1,1,100,0,0,0,0,2,3,22,6,"https://fbref.com/en/players/466fb2c5/Aaron-Ramsdale"
"7750","Jack Robinson_2021",2021,"Sheffield Utd","Premier League","Jack Robinson","ENG","DF","26",1993,9.7,14,6,8,5,1,6,11,54.5,5,10,4,6,9,23,42,0,"https://fbref.com/en/players/7399c7a8/Jack-Robinson"
"7751","Femi Seriki_2021",2021,"Sheffield Utd","Premier League","Femi Seriki","ENG","MF","18",2002,0,0,0,0,0,0,0,0,NA,0,0,0,0,0,0,0,0,"https://fbref.com/en/players/e4e0deaa/Femi-Seriki"
"7752","Billy Sharp_2021",2021,"Sheffield Utd","Premier League","Billy Sharp","ENG","FW","34",1986,8.2,5,1,0,3,2,2,9,22.2,7,2,0,2,0,5,2,0,"https://fbref.com/en/players/e8c9f4e9/Billy-Sharp"
"7753","Enda Stevens_2021",2021,"Sheffield Utd","Premier League","Enda Stevens","IRL","DF","30",1990,30,59,26,32,19,8,33,58,56.9,25,41,12,29,22,81,81,1,"https://fbref.com/en/players/17d4507a/Enda-Stevens"
"7754","Che Adams_2021",2021,"Southampton","Premier League","Che Adams","SCO","FW","24",1996,29.6,25,16,4,15,6,6,17,35.3,11,20,2,18,4,29,19,1,"https://fbref.com/en/players/f2bf1b0f/Che-Adams"
"7755","Stuart Armstrong_2021",2021,"Southampton","Premier League","Stuart Armstrong","SCO","MF","28",1992,30.7,60,41,19,32,9,27,75,36,48,26,1,25,24,84,19,0,"https://fbref.com/en/players/97333cf5/Stuart-Armstrong"
"7756","Jan Bednarek_2021",2021,"Southampton","Premier League","Jan Bednarek","POL","DF","24",1996,34.4,37,19,25,11,1,25,49,51,24,44,27,17,84,121,132,0,"https://fbref.com/en/players/4115ce4e/Jan-Bednarek"
"7757","Ryan Bertrand_2021",2021,"Southampton","Premier League","Ryan Bertrand","ENG","DF","30",1989,28.9,60,32,26,27,7,30,48,62.5,18,19,1,18,30,90,41,1,"https://fbref.com/en/players/01226327/Ryan-Bertrand"
"7758","Ibrahima Diallo_2021",2021,"Southampton","Premier League","Ibrahima Diallo","FRA","MF","21",1999,11.3,29,16,11,17,1,9,16,56.3,7,10,1,9,10,39,12,2,"https://fbref.com/en/players/11ff3d56/Ibrahima-Diallo"
"7759","Moussa Djenepo_2021",2021,"Southampton","Premier League","Moussa Djenepo","MLI","MF","22",1998,13.8,52,27,27,17,8,28,63,44.4,35,24,2,22,10,62,14,0,"https://fbref.com/en/players/254147d4/Moussa-Djenepo"
"7760","Fraser Forster_2021",2021,"Southampton","Premier League","Fraser Forster","ENG","GK","32",1988,8,1,0,1,0,0,1,2,50,1,0,0,0,0,1,9,0,"https://fbref.com/en/players/c3e39f12/Fraser-Forster"
"7761","Danny Ings_2021",2021,"Southampton","Premier League","Danny Ings","ENG","FW","28",1992,24.1,22,13,3,16,3,12,28,42.9,16,39,2,37,3,25,27,1,"https://fbref.com/en/players/07802f7f/Danny-Ings"
"7762","Alexandre Jankewitz_2021",2021,"Southampton","Premier League","Alexandre Jankewitz","SUI","MF","18",2001,0,2,1,2,0,0,1,1,100,0,0,0,0,0,2,0,0,"https://fbref.com/en/players/7c39363f/Alexandre-Jankewitz"
"7763","Shane Long_2021",2021,"Southampton","Premier League","Shane Long","IRL","FW","33",1987,2.3,2,1,0,0,2,2,3,66.7,1,0,0,0,3,5,1,0,"https://fbref.com/en/players/9f472354/Shane-Long"
"7764","Alex McCarthy_2021",2021,"Southampton","Premier League","Alex McCarthy","ENG","GK","30",1989,30,1,0,1,0,0,1,4,25,3,0,0,0,0,1,11,1,"https://fbref.com/en/players/36c2ca73/Alex-McCarthy"
"7765","Takumi Minamino_2021",2021,"Southampton","Premier League","Takumi Minamino","JPN","MF","25",1995,7.9,7,3,2,5,0,2,19,10.5,17,13,1,12,4,11,9,0,"https://fbref.com/en/players/f833a830/Takumi-Minamino"
"7766","Dan Nlundulu_2021",2021,"Southampton","Premier League","Dan Nlundulu","ENG","FW,MF","21",1999,1.2,0,0,0,0,0,0,1,0,1,2,0,2,0,0,2,0,"https://fbref.com/en/players/30040f5d/Dan-Nlundulu"
"7767","Michael Obafemi_2021",2021,"Southampton","Premier League","Michael Obafemi","IRL","FW","20",2000,0.7,1,0,0,1,0,0,1,0,1,1,0,1,0,1,0,0,"https://fbref.com/en/players/caa1a7f0/Michael-Obafemi"
"7768","Kayne Ramsey_2021",2021,"Southampton","Premier League","Kayne Ramsey","ENG","DF","19",2000,1,5,2,4,1,0,3,3,100,0,0,0,0,0,5,3,0,"https://fbref.com/en/players/dc31b84c/Kayne-Ramsey"
"7769","Nathan Redmond_2021",2021,"Southampton","Premier League","Nathan Redmond","ENG","MF,FW","26",1994,19.3,30,17,14,12,4,8,24,33.3,16,24,2,22,11,41,9,0,"https://fbref.com/en/players/ab651565/Nathan-Redmond"
"7770","Oriol Romeu_2021",2021,"Southampton","Premier League","Oriol Romeu","ESP","MF","28",1991,19.6,69,35,25,39,5,26,68,38.2,42,28,7,21,30,99,18,0,"https://fbref.com/en/players/4b511457/Oriol-Romeu"
"7771","Mohammed Salisu_2021",2021,"Southampton","Premier League","Mohammed Salisu","GHA","DF","21",1999,9.4,38,21,20,16,2,25,34,73.5,9,22,5,17,17,55,30,0,"https://fbref.com/en/players/0b33f6ad/Mohammed-Salisu"
"7772","William Smallbone_2021",2021,"Southampton","Premier League","William Smallbone","IRL","MF","20",2000,1.9,6,3,2,4,0,1,3,33.3,2,5,0,5,2,8,1,0,"https://fbref.com/en/players/5e105217/William-Smallbone"
"7773","Jack Stephens_2021",2021,"Southampton","Premier League","Jack Stephens","ENG","DF","26",1994,17.1,34,19,19,15,0,17,38,44.7,21,25,14,11,28,62,64,2,"https://fbref.com/en/players/6adbc307/Jack-Stephens"
"7774","Allan Tchaptchet_2021",2021,"Southampton","Premier League","Allan Tchaptchet","FRA","DF","18",2001,0.1,0,0,0,0,0,0,0,NA,0,0,0,0,0,0,0,0,"https://fbref.com/en/players/ab7d7882/Allan-Tchaptchet"
"7775","Nathan Tella_2021",2021,"Southampton","Premier League","Nathan Tella","ENG","FW,MF","21",1999,8.3,8,5,1,4,3,6,15,40,9,13,0,13,3,11,2,0,"https://fbref.com/en/players/f1e94cd6/Nathan-Tella"
"7776","Yan Valery_2021",2021,"Southampton","Premier League","Yan Valery","TUN","DF,MF","21",1999,1.1,5,3,2,3,0,1,5,20,4,2,0,2,2,7,5,0,"https://fbref.com/en/players/531a4aa8/Yan-Valery"
"7777","Jannik Vestergaard_2021",2021,"Southampton","Premier League","Jannik Vestergaard","DEN","DF","27",1992,28.6,50,31,31,15,4,35,52,67.3,17,29,16,13,42,92,122,0,"https://fbref.com/en/players/1900032e/Jannik-Vestergaard"
"7778","Jake Vokins_2021",2021,"Southampton","Premier League","Jake Vokins","ENG","DF","20",2000,0.7,0,0,0,0,0,0,1,0,1,0,0,0,0,0,0,0,"https://fbref.com/en/players/d484c261/Jake-Vokins"
"7779","Theo Walcott_2021",2021,"Southampton","Premier League","Theo Walcott","ENG","MF,FW","31",1989,18,23,11,8,9,6,11,32,34.4,21,16,0,16,14,37,5,0,"https://fbref.com/en/players/1ecb65be/Theo-Walcott"
"7780","Kyle Walker-Peters_2021",2021,"Southampton","Premier League","Kyle Walker-Peters","ENG","DF","23",1997,29.4,83,53,56,25,2,34,57,59.6,23,41,10,31,38,121,66,2,"https://fbref.com/en/players/984a5a64/Kyle-Walker-Peters"
"7781","James Ward-Prowse_2021",2021,"Southampton","Premier League","James Ward-Prowse","ENG","MF","25",1994,38,75,49,30,41,4,29,70,41.4,41,36,4,32,42,117,60,0,"https://fbref.com/en/players/3515d404/James-Ward-Prowse"
"7782","Caleb Watts_2021",2021,"Southampton","Premier League","Caleb Watts","AUS","MF","18",2002,0.4,2,1,2,0,0,1,2,50,1,0,0,0,0,2,0,0,"https://fbref.com/en/players/c7170b46/Caleb-Watts"
"7783","Gennaro Acampora_2021",2021,"Spezia","Serie A","Gennaro Acampora","ITA","MF,FW","26",1994,4.9,6,4,1,4,1,2,7,28.6,5,4,1,3,4,10,4,0,"https://fbref.com/en/players/01040647/Gennaro-Acampora"
"7784","Lucien Agoume_2021",2021,"Spezia","Serie A","Lucien Agoume","FRA","MF","18",2002,8.9,18,10,11,7,0,6,19,31.6,13,10,5,5,15,33,10,0,"https://fbref.com/en/players/8bc8829a/Lucien-Agoume"
"7785","Kevin Agudelo_2021",2021,"Spezia","Serie A","Kevin Agudelo","COL","FW","21",1998,15.1,39,28,9,15,15,12,34,35.3,22,30,0,30,10,49,2,0,"https://fbref.com/en/players/46fa7204/Kevin-Agudelo"
"7786","Paolo Bartolomei_2021",2021,"Spezia","Serie A","Paolo Bartolomei","ITA","MF","30",1989,3.6,6,2,3,1,2,4,7,57.1,3,1,0,1,1,7,2,0,"https://fbref.com/en/players/6029a945/Paolo-Bartolomei"
"7787","Simone Bastoni_2021",2021,"Spezia","Serie A","Simone Bastoni","ITA","DF","23",1996,16.9,50,29,26,22,2,27,52,51.9,25,19,1,18,16,66,31,0,"https://fbref.com/en/players/1ac232b8/Simone-Bastoni"
"7788","Elio Capradossi_2021",2021,"Spezia","Serie A","Elio Capradossi","ITA","DF","24",1996,1,2,1,2,0,0,2,2,100,0,0,0,0,1,3,5,0,"https://fbref.com/en/players/174944a3/Elio-Capradossi"
"7789","Julian Chabot_2021",2021,"Spezia","Serie A","Julian Chabot","GER","DF","22",1998,18.4,48,34,28,16,4,23,37,62.2,14,25,13,12,37,85,43,1,"https://fbref.com/en/players/ae7058f9/Julian-Chabot"
"7790","Alessandro Deiola_2021",2021,"Spezia","Serie A","Alessandro Deiola","ITA","MF","24",1995,4,6,3,2,3,1,5,13,38.5,8,3,1,2,3,9,1,0,"https://fbref.com/en/players/7f267d66/Alessandro-Deiola"
"7791","Cristian Dell'Orco_2021",2021,"Spezia","Serie A","Cristian Dell'Orco","ITA","DF","26",1994,2.9,1,0,1,0,0,1,3,33.3,2,8,5,3,7,8,9,1,"https://fbref.com/en/players/b0243215/Cristian-DellOrco"
"7792","Martin Erlic_2021",2021,"Spezia","Serie A","Martin Erlic","CRO","DF","22",1998,20,23,14,16,6,1,11,20,55,9,22,16,6,41,64,71,2,"https://fbref.com/en/players/0fee6bda/Martin-Erlic"
"7793","Nahuel Estévez_2021",2021,"Spezia","Serie A","Nahuel Estévez","ARG","MF","24",1995,19.6,13,5,4,6,3,5,32,15.6,27,23,5,18,20,33,22,1,"https://fbref.com/en/players/cec60a2f/Nahuel-Estevez"
"7794","Diego Farias_2021",2021,"Spezia","Serie A","Diego Farias","BRA","FW","30",1990,16.8,9,5,4,1,4,4,21,19,17,12,0,12,13,22,3,0,"https://fbref.com/en/players/157d29b6/Diego-Farias"
"7795","Salvador Ferrer_2021",2021,"Spezia","Serie A","Salvador Ferrer","ESP","DF","22",1998,13.2,20,10,10,8,2,8,22,36.4,14,13,4,9,24,44,37,1,"https://fbref.com/en/players/eb76987d/Salvador-Ferrer"
"7796","Andrey Galabinov_2021",2021,"Spezia","Serie A","Andrey Galabinov","BUL","FW","31",1988,4.8,2,1,1,1,0,1,3,33.3,2,2,0,2,0,2,5,0,"https://fbref.com/en/players/0a1efd3c/Andrey-Galabinov"
"7797","Emmanuel Gyasi_2021",2021,"Spezia","Serie A","Emmanuel Gyasi","GHA","FW","26",1994,31.7,30,16,16,10,4,9,31,29,22,13,2,11,14,44,8,0,"https://fbref.com/en/players/f9758dae/Emmanuel-Gyasi"
"7798","Ardian Ismajli_2021",2021,"Spezia","Serie A","Ardian Ismajli","ALB","DF","23",1996,14.4,19,9,10,8,1,8,13,61.5,5,10,7,3,23,42,52,1,"https://fbref.com/en/players/6b635f5c/Ardian-Ismajli"
"7799","Giulio Maggiore_2021",2021,"Spezia","Serie A","Giulio Maggiore","ITA","MF","22",1998,24.6,61,36,26,28,7,21,53,39.6,32,33,6,27,19,80,25,1,"https://fbref.com/en/players/957e4c87/Giulio-Maggiore"
"7800","Juan Manuel Ramos_2021",2021,"Spezia","Serie A","Juan Manuel Ramos","URU","DF","23",1996,3.3,5,0,3,0,2,4,7,57.1,3,1,0,1,2,7,6,0,"https://fbref.com/en/players/36d7971a/Juan-Manuel-Ramos"
"7801","Riccardo Marchizza_2021",2021,"Spezia","Serie A","Riccardo Marchizza","ITA","DF","22",1998,17.3,20,11,12,5,3,12,21,57.1,9,13,4,9,11,31,27,0,"https://fbref.com/en/players/91d0fabf/Riccardo-Marchizza"
"7802","Giuseppe Mastinu_2021",2021,"Spezia","Serie A","Giuseppe Mastinu","ITA","FW","28",1991,0.4,1,1,0,0,1,1,1,100,0,1,0,1,0,1,0,0,"https://fbref.com/en/players/26cd1bff/Giuseppe-Mastinu"
"7803","Federico Mattiello_2021",2021,"Spezia","Serie A","Federico Mattiello","ITA","DF","25",1995,0.4,0,0,0,0,0,0,0,NA,0,0,0,0,0,0,0,0,"https://fbref.com/en/players/fba81826/Federico-Mattiello"
"7804","Luca Mora_2021",2021,"Spezia","Serie A","Luca Mora","ITA","MF","32",1988,1.3,3,1,1,2,0,2,4,50,2,2,1,1,0,3,2,0,"https://fbref.com/en/players/42fff925/Luca-Mora"
"7805","M'Bala Nzola_2021",2021,"Spezia","Serie A","M'Bala Nzola","ANG","FW","23",1996,21.1,12,5,2,6,4,4,7,57.1,3,15,1,14,3,15,20,0,"https://fbref.com/en/players/a4948e67/MBala-Nzola"
"7806","Roberto Piccoli_2021",2021,"Spezia","Serie A","Roberto Piccoli","ITA","FW","19",2001,7.8,7,3,0,4,3,2,4,50,2,4,0,4,2,9,5,0,"https://fbref.com/en/players/1cadaf34/Roberto-Piccoli"
"7807","Tommaso Pobega_2021",2021,"Spezia","Serie A","Tommaso Pobega","ITA","MF","21",1999,13.7,24,13,7,13,4,11,31,35.5,20,10,2,8,9,33,22,0,"https://fbref.com/en/players/55a1cac2/Tommaso-Pobega"
"7808","Ivan Provedel_2021",2021,"Spezia","Serie A","Ivan Provedel","ITA","GK","26",1994,29,2,0,2,0,0,2,6,33.3,4,0,0,0,2,4,20,1,"https://fbref.com/en/players/277da414/Ivan-Provedel"
"7809","Rafael_2021",2021,"Spezia","Serie A","Rafael","BRA","GK","38",1982,2.3,0,0,0,0,0,0,0,NA,0,0,0,0,0,0,0,0,"https://fbref.com/en/players/dd06d56c/Rafael"
"7810","Matteo Ricci_2021",2021,"Spezia","Serie A","Matteo Ricci","ITA","MF","26",1994,24.8,40,23,14,24,2,27,52,51.9,25,24,4,20,34,74,13,0,"https://fbref.com/en/players/3cf7dc7e/Matteo-Ricci"
"7811","Jacopo Sala_2021",2021,"Spezia","Serie A","Jacopo Sala","ITA","DF","28",1991,4.2,17,9,14,1,2,8,22,36.4,14,5,2,3,5,22,6,0,"https://fbref.com/en/players/da5a981b/Jacopo-Sala"
"7812","Riccardo Saponara_2021",2021,"Spezia","Serie A","Riccardo Saponara","ITA","FW,MF","28",1991,4.3,4,1,1,0,3,1,3,33.3,2,1,0,1,1,5,4,0,"https://fbref.com/en/players/3bb7af3b/Riccardo-Saponara"
"7813","Léo Sena_2021",2021,"Spezia","Serie A","Léo Sena","BRA","MF","24",1995,9.8,22,12,7,10,5,12,26,46.2,14,19,4,15,11,33,5,0,"https://fbref.com/en/players/1de40dae/Leo-Sena"
"7814","Claudio Terzi_2021",2021,"Spezia","Serie A","Claudio Terzi","ITA","DF","36",1984,20.8,34,21,19,14,1,19,28,67.9,9,23,12,11,35,69,55,1,"https://fbref.com/en/players/5570e6fb/Claudio-Terzi"
"7815","Daniele Verde_2021",2021,"Spezia","Serie A","Daniele Verde","ITA","FW","24",1996,10.9,5,4,2,2,1,4,10,40,6,5,0,5,9,14,7,0,"https://fbref.com/en/players/d3298c99/Daniele-Verde"
"7816","Luca Vignali_2021",2021,"Spezia","Serie A","Luca Vignali","ITA","DF","24",1996,17.7,19,9,10,6,3,7,25,28,18,13,5,8,22,41,25,0,"https://fbref.com/en/players/c1e8e74e/Luca-Vignali"
"7817","Jeroen Zoet_2021",2021,"Spezia","Serie A","Jeroen Zoet","NED","GK","29",1991,6.7,0,0,0,0,0,0,1,0,1,0,0,0,0,0,4,2,"https://fbref.com/en/players/cc1a0c57/Jeroen-Zoet"
"7818","Ismael Aaneba_2021",2021,"Strasbourg","Ligue 1","Ismael Aaneba","FRA","DF","21",1999,0.1,0,0,0,0,0,0,0,NA,0,0,0,0,1,1,1,0,"https://fbref.com/en/players/a7e4760c/Ismael-Aaneba"
"7819","Jean-Eudes Aholou_2021",2021,"Strasbourg","Ligue 1","Jean-Eudes Aholou","CIV","MF","26",1994,23.8,46,25,18,25,3,19,48,39.6,29,17,5,12,53,99,32,0,"https://fbref.com/en/players/48b28bfd/Jean-Eudes-Aholou"
"7820","Ludovic Ajorque_2021",2021,"Strasbourg","Ligue 1","Ludovic Ajorque","FRA","FW","26",1994,33,30,18,6,18,6,7,31,22.6,24,14,5,9,11,41,54,0,"https://fbref.com/en/players/462475ed/Ludovic-Ajorque"
"7821","Jean-Ricner Bellegarde_2021",2021,"Strasbourg","Ligue 1","Jean-Ricner Bellegarde","FRA","MF,FW","22",1998,23.2,56,39,22,25,9,14,23,60.9,9,20,2,18,19,75,16,0,"https://fbref.com/en/players/10f0fdd3/Jean-Ricner-Bellegarde"
"7822","Anthony Caci_2021",2021,"Strasbourg","Ligue 1","Anthony Caci","FRA","DF","23",1997,31.1,80,46,47,27,6,35,69,50.7,34,30,4,26,55,135,65,1,"https://fbref.com/en/players/0118c54c/Anthony-Caci"
"7823","Lionel Carole_2021",2021,"Strasbourg","Ligue 1","Lionel Carole","FRA","DF","29",1991,14.9,37,25,18,14,5,16,29,55.2,13,3,1,2,38,75,28,0,"https://fbref.com/en/players/5b5724d2/Lionel-Carole"
"7824","Mehdi Chahiri_2021",2021,"Strasbourg","Ligue 1","Mehdi Chahiri","MAR","FW,MF","24",1996,8.9,18,8,7,5,6,8,20,40,12,9,0,9,6,24,5,0,"https://fbref.com/en/players/1787195f/Mehdi-Chahiri"
"7825","Habib Diallo_2021",2021,"Strasbourg","Ligue 1","Habib Diallo","SEN","FW","25",1995,25.8,11,6,3,6,2,7,18,38.9,11,12,2,10,13,24,12,0,"https://fbref.com/en/players/6605d143/Habib-Diallo"
"7826","Alexander Djiku_2021",2021,"Strasbourg","Ligue 1","Alexander Djiku","GHA","DF,MF","25",1994,28.4,60,41,45,13,2,32,52,61.5,20,28,10,18,91,151,104,0,"https://fbref.com/en/players/43e7a164/Alexander-Djiku"
"7827","Frederic Guilbert_2021",2021,"Strasbourg","Ligue 1","Frederic Guilbert","FRA","DF","25",1994,12.4,37,19,23,11,3,21,34,61.8,13,14,1,13,33,70,32,0,"https://fbref.com/en/players/5d8d7454/Frederic-Guilbert"
"7828","Bingourou Kamara_2021",2021,"Strasbourg","Ligue 1","Bingourou Kamara","SEN","GK","23",1996,8,1,1,1,0,0,1,3,33.3,2,0,0,0,1,2,2,1,"https://fbref.com/en/players/3814120d/Bingourou-Kamara"
"7829","Eiji Kawashima_2021",2021,"Strasbourg","Ligue 1","Eiji Kawashima","JPN","GK","37",1983,24,1,0,1,0,0,1,1,100,0,0,0,0,0,1,4,2,"https://fbref.com/en/players/a4527d33/Eiji-Kawashima"
"7830","Lamine Koné_2021",2021,"Strasbourg","Ligue 1","Lamine Koné","CIV","DF","31",1989,11.6,9,6,5,4,0,5,8,62.5,3,4,3,1,15,24,36,0,"https://fbref.com/en/players/a46472d0/Lamine-Kone"
"7831","Kenny Lala_2021",2021,"Strasbourg","Ligue 1","Kenny Lala","FRA","DF","28",1991,20.4,22,13,13,8,1,11,22,50,11,12,6,6,23,45,33,1,"https://fbref.com/en/players/770d7eb8/Kenny-Lala"
"7832","Dimitri Liénard_2021",2021,"Strasbourg","Ligue 1","Dimitri Liénard","FRA","MF","32",1988,20.3,39,27,17,19,3,24,55,43.6,31,23,1,22,18,57,10,0,"https://fbref.com/en/players/f7691f63/Dimitri-Lienard"
"7833","Abdul Majeed Waris_2021",2021,"Strasbourg","Ligue 1","Abdul Majeed Waris","GHA","FW,MF","28",1991,6.1,1,1,1,0,0,1,6,16.7,5,0,0,0,2,3,2,0,"https://fbref.com/en/players/46907171/Abdul-Majeed-Waris"
"7834","Stefan Mitrović_2021",2021,"Strasbourg","Ligue 1","Stefan Mitrović","SRB","DF","30",1990,30.9,36,27,29,7,0,24,37,64.9,13,23,13,10,31,67,108,5,"https://fbref.com/en/players/e6777e6b/Stefan-Mitrovic"
"7835","Dion Moise Sahi_2021",2021,"Strasbourg","Ligue 1","Dion Moise Sahi","CIV","FW,MF","18",2001,1,1,0,0,1,0,1,1,100,0,1,0,1,0,1,0,0,"https://fbref.com/en/players/cdc4458b/Dion-Moise-Sahi"
"7836","Sanjin Prcić_2021",2021,"Strasbourg","Ligue 1","Sanjin Prcić","BIH","MF","26",1993,3.9,3,2,0,3,0,2,5,40,3,4,3,1,4,7,2,1,"https://fbref.com/en/players/51c30111/Sanjin-Prcic"
"7837","Idriss Saadi_2021",2021,"Strasbourg","Ligue 1","Idriss Saadi","ALG","MF,FW","28",1992,1.4,0,0,0,0,0,0,2,0,2,0,0,0,0,0,0,0,"https://fbref.com/en/players/17f29fb0/Idriss-Saadi"
"7838","Matz Sels_2021",2021,"Strasbourg","Ligue 1","Matz Sels","BEL","GK","28",1992,6,0,0,0,0,0,0,0,NA,0,0,0,0,0,0,4,0,"https://fbref.com/en/players/834b5c4c/Matz-Sels"
"7839","Mahame Siby_2021",2021,"Strasbourg","Ligue 1","Mahame Siby","MLI","MF","24",1996,0.2,0,0,0,0,0,0,1,0,1,0,0,0,0,0,1,0,"https://fbref.com/en/players/6d075c67/Mahame-Siby"
"7840","Mohamed Simakan_2021",2021,"Strasbourg","Ligue 1","Mohamed Simakan","FRA","DF","20",2000,17.9,32,22,21,6,5,9,18,50,9,17,11,6,31,63,41,0,"https://fbref.com/en/players/fcb27134/Mohamed-Simakan"
"7841","Ibrahima Sissoko_2021",2021,"Strasbourg","Ligue 1","Ibrahima Sissoko","FRA","MF","22",1997,28.7,68,48,25,35,8,28,68,41.2,40,22,5,17,48,116,44,0,"https://fbref.com/en/players/0f8418aa/Ibrahima-Sissoko"
"7842","Adrien Thomasson_2021",2021,"Strasbourg","Ligue 1","Adrien Thomasson","FRA","MF,FW","26",1993,29.2,36,17,8,16,12,12,58,20.7,46,44,5,39,22,58,2,0,"https://fbref.com/en/players/c76b7567/Adrien-Thomasson"
"7843","Kévin Zohi_2021",2021,"Strasbourg","Ligue 1","Kévin Zohi","MLI","FW,MF","23",1996,4.8,9,5,3,4,2,2,6,33.3,4,6,0,6,6,15,3,0,"https://fbref.com/en/players/775185ae/Kevin-Zohi"
"7844","Naouirou Ahamada_2021",2021,"Stuttgart","Bundesliga","Naouirou Ahamada","FRA","MF","18",2002,2.8,4,1,3,1,0,1,1,100,0,2,0,2,1,5,1,0,"https://fbref.com/en/players/a6c58494/Naouirou-Ahamada"
"7845","Waldemar Anton_2021",2021,"Stuttgart","Bundesliga","Waldemar Anton","GER","DF","24",1996,30.1,31,20,17,14,0,12,31,38.7,19,28,18,10,47,78,114,0,"https://fbref.com/en/players/5e66fa06/Waldemar-Anton"
"7846","Fabian Bredlow_2021",2021,"Stuttgart","Bundesliga","Fabian Bredlow","GER","GK","25",1995,1,0,0,0,0,0,0,0,NA,0,0,0,0,0,0,0,0,"https://fbref.com/en/players/d28339cb/Fabian-Bredlow"
"7847","Gonzalo Castro_2021",2021,"Stuttgart","Bundesliga","Gonzalo Castro","GER","MF","33",1987,19.2,21,7,6,9,6,8,23,34.8,15,16,3,13,8,29,12,0,"https://fbref.com/en/players/68829001/Gonzalo-Castro"
"7848","Darko Churlinov_2021",2021,"Stuttgart","Bundesliga","Darko Churlinov","MKD","DF,MF","20",2000,2.4,2,2,2,0,0,1,3,33.3,2,5,1,4,0,2,2,0,"https://fbref.com/en/players/c6608135/Darko-Churlinov"
"7849","Tanguy Coulibaly_2021",2021,"Stuttgart","Bundesliga","Tanguy Coulibaly","FRA","DF,FW","19",2001,16.7,26,15,10,7,9,11,23,47.8,12,20,0,20,10,36,11,0,"https://fbref.com/en/players/05ba9d7c/Tanguy-Coulibaly"
"7850","Daniel Didavi_2021",2021,"Stuttgart","Bundesliga","Daniel Didavi","GER","MF,FW","30",1990,10.8,16,6,2,9,5,7,12,58.3,5,10,0,10,3,19,8,0,"https://fbref.com/en/players/d3096421/Daniel-Didavi"
"7851","Lilian Egloff_2021",2021,"Stuttgart","Bundesliga","Lilian Egloff","GER","MF","17",2002,0.2,0,0,0,0,0,0,0,NA,0,0,0,0,0,0,0,0,"https://fbref.com/en/players/2f7fec15/Lilian-Egloff"
"7852","Wataru Endo_2021",2021,"Stuttgart","Bundesliga","Wataru Endo","JPN","MF","27",1993,32.8,65,44,25,34,6,29,71,40.8,42,53,14,39,51,116,59,0,"https://fbref.com/en/players/c149016b/Wataru-Endo"
"7853","Philipp Förster_2021",2021,"Stuttgart","Bundesliga","Philipp Förster","GER","MF","25",1995,16.8,22,13,7,12,3,6,25,24,19,18,1,17,15,37,2,0,"https://fbref.com/en/players/76fa965f/Philipp-Forster"
"7854","Hamadi Al Ghaddioui_2021",2021,"Stuttgart","Bundesliga","Hamadi Al Ghaddioui","MAR","FW","29",1990,0.5,0,0,0,0,0,0,1,0,1,0,0,0,0,0,0,0,"https://fbref.com/en/players/5723931e/Hamadi-Al-Ghaddioui"
"7855","Nicolás González_2021",2021,"Stuttgart","Bundesliga","Nicolás González","ARG","FW,MF","22",1998,10.4,5,5,1,2,2,0,6,0,6,10,3,7,4,9,6,0,"https://fbref.com/en/players/2374aaca/Nicolas-Gonzalez"
"7856","Sasa Kalajdzic_2021",2021,"Stuttgart","Bundesliga","Sasa Kalajdzic","AUT","FW","23",1997,23.7,16,12,4,5,7,2,17,11.8,15,10,1,9,9,25,21,0,"https://fbref.com/en/players/15f24fe7/Sasa-Kalajdzic"
"7857","Marcin Kamiński_2021",2021,"Stuttgart","Bundesliga","Marcin Kamiński","POL","DF","28",1992,2.4,1,1,0,0,1,0,0,NA,0,2,1,1,1,2,10,0,"https://fbref.com/en/players/463503e2/Marcin-Kaminski"
"7858","Atakan Karazor_2021",2021,"Stuttgart","Bundesliga","Atakan Karazor","GER","DF,MF","23",1996,11.5,20,12,12,7,1,13,22,59.1,9,18,8,10,21,41,50,2,"https://fbref.com/en/players/5762be5c/Atakan-Karazor"
"7859","Silas Katompa_2021",2021,"Stuttgart","Bundesliga","Silas Katompa","COD","DF,FW","21",1998,21.3,48,29,19,19,10,21,44,47.7,23,29,1,28,22,70,11,2,"https://fbref.com/en/players/de4cac2d/Silas-Katompa"
"7860","Marc-Oliver Kempf_2021",2021,"Stuttgart","Bundesliga","Marc-Oliver Kempf","GER","DF","25",1995,30.3,49,26,28,18,3,29,49,59.2,20,40,25,15,68,117,103,1,"https://fbref.com/en/players/815c314f/Marc-Oliver-Kempf"
"7861","Philipp Klement_2021",2021,"Stuttgart","Bundesliga","Philipp Klement","GER","MF,FW","27",1992,4.7,7,3,6,0,1,3,7,42.9,4,9,2,7,6,13,7,0,"https://fbref.com/en/players/0cddeaa7/Philipp-Klement"
"7862","Mateo Klimowicz_2021",2021,"Stuttgart","Bundesliga","Mateo Klimowicz","GER","MF,FW","20",2000,13.3,20,15,6,10,4,5,18,27.8,13,5,1,4,2,22,2,0,"https://fbref.com/en/players/2b7c56b4/Mateo-Klimowicz"
"7863","Gregor Kobel_2021",2021,"Stuttgart","Bundesliga","Gregor Kobel","SUI","GK","22",1997,33,2,2,2,0,0,2,2,100,0,0,0,0,2,4,8,1,"https://fbref.com/en/players/cd59b9df/Gregor-Kobel"
"7864","Luca Mack_2021",2021,"Stuttgart","Bundesliga","Luca Mack","GER","MF","20",2000,0.1,0,0,0,0,0,0,0,NA,0,0,0,0,0,0,1,0,"https://fbref.com/en/players/81868f73/Luca-Mack"
"7865","Orel Mangala_2021",2021,"Stuttgart","Bundesliga","Orel Mangala","BEL","MF","22",1998,23.4,27,15,13,11,3,17,28,60.7,11,27,10,17,26,53,30,0,"https://fbref.com/en/players/a572e291/Orel-Mangala"
"7866","Roberto Massimo_2021",2021,"Stuttgart","Bundesliga","Roberto Massimo","GER","DF,FW","19",2000,8.4,21,11,13,5,3,11,24,45.8,13,5,1,4,11,32,13,0,"https://fbref.com/en/players/fc62fdf4/Roberto-Massimo"
"7867","Konstantinos Mavropanos_2021",2021,"Stuttgart","Bundesliga","Konstantinos Mavropanos","GRE","DF","22",1997,16.3,42,29,29,12,1,27,46,58.7,19,25,10,15,59,101,66,1,"https://fbref.com/en/players/00963611/Konstantinos-Mavropanos"
"7868","Alkhaly Momo Cissé_2021",2021,"Stuttgart","Bundesliga","Alkhaly Momo Cissé","GUI","FW,DF","17",2002,0.4,1,1,1,0,0,0,0,NA,0,1,0,1,0,1,0,0,"https://fbref.com/en/players/c51e68be/Alkhaly-Momo-Cisse"
"7869","Mohamed Sankoh_2021",2021,"Stuttgart","Bundesliga","Mohamed Sankoh","NED","MF","16",2003,0.2,0,0,0,0,0,0,0,NA,0,1,0,1,0,0,0,0,"https://fbref.com/en/players/be625686/Mohamed-Sankoh"
"7870","Borna Sosa_2021",2021,"Stuttgart","Bundesliga","Borna Sosa","CRO","DF,FW","22",1998,22.7,14,10,6,6,2,8,25,32,17,23,4,19,31,45,74,0,"https://fbref.com/en/players/af0d79a9/Borna-Sosa"
"7871","Pascal Stenzel_2021",2021,"Stuttgart","Bundesliga","Pascal Stenzel","GER","DF","24",1996,14.2,33,14,15,17,1,22,50,44,28,19,4,15,26,59,39,1,"https://fbref.com/en/players/99f7e9aa/Pascal-Stenzel"
"7872","Erik Thommy_2021",2021,"Stuttgart","Bundesliga","Erik Thommy","GER","MF,DF","25",1994,3.5,3,1,0,3,0,0,3,0,3,3,0,3,3,6,4,0,"https://fbref.com/en/players/df8e7b62/Erik-Thommy"
"7873","Cristian Ansaldi_2021",2021,"Torino","Serie A","Cristian Ansaldi","ARG","DF,FW","33",1986,21.6,48,33,25,14,9,24,38,63.2,14,21,7,14,16,64,38,0,"https://fbref.com/en/players/bbafc0c4/Cristian-Ansaldi"
"7874","Daniele Baselli_2021",2021,"Torino","Serie A","Daniele Baselli","ITA","MF","28",1992,4.4,12,7,3,6,3,6,10,60,4,2,0,2,9,21,5,0,"https://fbref.com/en/players/ea06dd97/Daniele-Baselli"
"7875","Andrea Belotti_2021",2021,"Torino","Serie A","Andrea Belotti","ITA","FW","26",1993,32.1,30,18,4,16,10,11,35,31.4,24,27,4,23,12,42,21,0,"https://fbref.com/en/players/d705ba44/Andrea-Belotti"
"7876","Álex Berenguer_2021",2021,"Torino","Serie A","Álex Berenguer","ESP","MF","25",1995,1.5,2,0,0,0,2,2,5,40,3,2,0,2,0,2,1,0,"https://fbref.com/en/players/dc1c2fce/Alex-Berenguer"
"7877","Federico Bonazzoli_2021",2021,"Torino","Serie A","Federico Bonazzoli","ITA","FW","23",1997,6.3,6,4,0,4,2,2,13,15.4,11,3,0,3,2,8,3,0,"https://fbref.com/en/players/bf57eaab/Federico-Bonazzoli"
"7878","Gleison Bremer_2021",2021,"Torino","Serie A","Gleison Bremer","BRA","DF","23",1997,32.6,51,34,36,14,1,21,36,58.3,15,54,21,33,70,121,142,1,"https://fbref.com/en/players/5fd5ed86/Gleison-Bremer"
"7879","Alessandro Buongiorno_2021",2021,"Torino","Serie A","Alessandro Buongiorno","ITA","DF","21",1999,9.5,12,5,8,4,0,7,12,58.3,5,15,9,6,11,23,44,1,"https://fbref.com/en/players/4ae67f27/Alessandro-Buongiorno"
"7880","Simone Edera_2021",2021,"Torino","Serie A","Simone Edera","ITA","DF,MF","23",1997,0.6,3,1,2,1,0,3,4,75,1,0,0,0,1,4,1,0,"https://fbref.com/en/players/8697c095/Simone-Edera"
"7881","Amer Gojak_2021",2021,"Torino","Serie A","Amer Gojak","BIH","MF,FW","23",1997,5.3,1,0,1,0,0,1,7,14.3,6,5,0,5,3,4,1,0,"https://fbref.com/en/players/51ffa295/Amer-Gojak"
"7882","Armando Izzo_2021",2021,"Torino","Serie A","Armando Izzo","ITA","DF","28",1992,22.3,30,16,13,13,4,13,33,39.4,20,22,9,13,53,83,62,0,"https://fbref.com/en/players/89976232/Armando-Izzo"
"7883","Karol Linetty_2021",2021,"Torino","Serie A","Karol Linetty","POL","MF","25",1995,20.4,38,28,13,19,6,16,45,35.6,29,19,5,14,15,53,7,0,"https://fbref.com/en/players/d023d70f/Karol-Linetty"
"7884","Saša Lukić_2021",2021,"Torino","Serie A","Saša Lukić","SRB","MF","23",1996,23.4,32,13,11,18,3,15,50,30,35,23,5,18,17,49,17,0,"https://fbref.com/en/players/c6e8cf1f/Sasa-Lukic"
"7885","Lyanco_2021",2021,"Torino","Serie A","Lyanco","BRA","DF","23",1997,21.8,21,14,13,6,2,8,14,57.1,6,36,26,10,46,67,76,0,"https://fbref.com/en/players/b5bf1770/Lyanco"
"7886","Rolando Mandragora_2021",2021,"Torino","Serie A","Rolando Mandragora","ITA","MF","23",1997,16.9,19,4,4,9,6,7,30,23.3,23,19,6,13,20,39,19,0,"https://fbref.com/en/players/c7259b83/Rolando-Mandragora"
"7887","Soualiho Meïté_2021",2021,"Torino","Serie A","Soualiho Meïté","FRA","MF","26",1994,10.2,11,7,6,4,1,5,16,31.3,11,18,1,17,10,21,9,1,"https://fbref.com/en/players/5cec2c74/Soualiho-Meite"
"7888","Vanja Milinković-Savić_2021",2021,"Torino","Serie A","Vanja Milinković-Savić","SRB","GK","23",1997,5,1,1,1,0,0,1,1,100,0,0,0,0,0,1,1,3,"https://fbref.com/en/players/9fa26bc2/Vanja-Milinkovic-Savic"
"7889","Vincenzo Millico_2021",2021,"Torino","Serie A","Vincenzo Millico","ITA","FW,MF","19",2000,0.2,0,0,0,0,0,0,0,NA,0,0,0,0,0,0,0,0,"https://fbref.com/en/players/6817095b/Vincenzo-Millico"
"7890","Nicola Murru_2021",2021,"Torino","Serie A","Nicola Murru","ITA","DF","25",1994,6.3,9,6,1,5,3,3,5,60,2,11,1,10,12,21,24,0,"https://fbref.com/en/players/d183e9d6/Nicola-Murru"
"7891","Nicolas Nkoulou_2021",2021,"Torino","Serie A","Nicolas Nkoulou","CMR","DF","30",1990,15.1,14,9,11,3,0,7,12,58.3,5,28,14,14,33,47,71,1,"https://fbref.com/en/players/93cf32a8/Nicolas-Nkoulou"
"7892","Tomás Rincón_2021",2021,"Torino","Serie A","Tomás Rincón","VEN","MF","32",1988,31.6,68,38,27,33,8,36,71,50.7,35,32,7,25,31,99,44,0,"https://fbref.com/en/players/f1cfc209/Tomas-Rincon"
"7893","Ricardo Rodríguez_2021",2021,"Torino","Serie A","Ricardo Rodríguez","SUI","DF","27",1992,13.8,21,14,11,8,2,13,22,59.1,9,16,5,11,20,41,43,0,"https://fbref.com/en/players/7f78ad23/Ricardo-Rodriguez"
"7894","Antonio Sanabria_2021",2021,"Torino","Serie A","Antonio Sanabria","PAR","FW","24",1996,10.9,8,3,0,4,4,2,9,22.2,7,5,0,5,5,13,8,0,"https://fbref.com/en/players/0a447501/Antonio-Sanabria"
"7895","Jacopo Segre_2021",2021,"Torino","Serie A","Jacopo Segre","ITA","MF","23",1997,2.1,5,2,2,1,2,2,5,40,3,0,0,0,0,5,1,0,"https://fbref.com/en/players/3cb132e6/Jacopo-Segre"
"7896","Wilfried Singo_2021",2021,"Torino","Serie A","Wilfried Singo","CIV","DF","19",2000,20.6,29,14,16,6,7,17,33,51.5,16,13,3,10,29,58,40,0,"https://fbref.com/en/players/8b609c34/Wilfried-Singo"
"7897","Salvatore Sirigu_2021",2021,"Torino","Serie A","Salvatore Sirigu","ITA","GK","33",1987,32,1,0,1,0,0,1,2,50,1,0,0,0,0,1,6,2,"https://fbref.com/en/players/10dc46f0/Salvatore-Sirigu"
"7898","Samir Ujkani_2021",2021,"Torino","Serie A","Samir Ujkani","KVX","GK","32",1988,1,0,0,0,0,0,0,0,NA,0,0,0,0,0,0,1,0,"https://fbref.com/en/players/96640846/Samir-Ujkani"
"7899","Simone Verdi_2021",2021,"Torino","Serie A","Simone Verdi","ITA","MF,FW","28",1992,18,19,12,10,6,3,6,19,31.6,13,8,0,8,8,27,2,2,"https://fbref.com/en/players/0375723e/Simone-Verdi"
"7900","Mërgim Vojvoda_2021",2021,"Torino","Serie A","Mërgim Vojvoda","KVX","DF,FW","25",1995,15.1,24,14,18,5,1,12,22,54.5,10,19,4,15,18,42,35,1,"https://fbref.com/en/players/be2706c0/Mergim-Vojvoda"
"7901","Simone Zaza_2021",2021,"Torino","Serie A","Simone Zaza","ITA","FW","29",1991,16.6,15,9,4,6,5,6,20,30,14,14,0,14,3,18,5,1,"https://fbref.com/en/players/9592289a/Simone-Zaza"
"7902","Toby Alderweireld_2021",2021,"Tottenham","Premier League","Toby Alderweireld","BEL","DF","31",1989,24.9,35,22,22,11,2,18,30,60,12,40,28,12,10,45,121,0,"https://fbref.com/en/players/f7d50789/Toby-Alderweireld"
"7903","Dele Alli_2021",2021,"Tottenham","Premier League","Dele Alli","ENG","MF","24",1996,6.9,18,11,8,6,4,7,19,36.8,12,9,0,9,7,25,3,0,"https://fbref.com/en/players/cea4ee8f/Dele-Alli"
"7904","Serge Aurier_2021",2021,"Tottenham","Premier League","Serge Aurier","CIV","DF","27",1992,17.8,55,33,33,17,5,15,40,37.5,25,28,5,23,19,74,44,3,"https://fbref.com/en/players/5c2b4f07/Serge-Aurier"
"7905","Gareth Bale_2021",2021,"Tottenham","Premier League","Gareth Bale","WAL","FW","31",1989,10.2,17,10,4,9,4,7,14,50,7,13,2,11,8,25,16,0,"https://fbref.com/en/players/a58bb1e1/Gareth-Bale"
"7906","Steven Bergwijn_2021",2021,"Tottenham","Premier League","Steven Bergwijn","NED","FW,MF","22",1997,13.4,15,7,8,3,4,7,20,35,13,7,1,6,5,20,9,0,"https://fbref.com/en/players/a29b1131/Steven-Bergwijn"
"7907","Ben Davies_2021",2021,"Tottenham","Premier League","Ben Davies","WAL","DF","27",1993,15,27,17,10,11,6,13,30,43.3,17,10,5,5,18,45,49,2,"https://fbref.com/en/players/44781702/Ben-Davies"
"7908","Eric Dier_2021",2021,"Tottenham","Premier League","Eric Dier","ENG","DF","26",1994,28,23,14,13,10,0,11,18,61.1,7,37,31,6,23,46,123,3,"https://fbref.com/en/players/ac861941/Eric-Dier"
"7909","Matt Doherty_2021",2021,"Tottenham","Premier League","Matt Doherty","IRL","DF","28",1992,13.8,29,15,15,10,4,13,33,39.4,20,20,5,15,23,52,46,0,"https://fbref.com/en/players/d557d734/Matt-Doherty"
"7910","Son Heung-min_2021",2021,"Tottenham","Premier League","Son Heung-min","KOR","FW","28",1992,34.6,32,18,11,14,7,18,72,25,54,28,3,25,14,46,8,0,"https://fbref.com/en/players/92e7e919/Son-Heung-min"
"7911","Pierre Højbjerg_2021",2021,"Tottenham","Premier League","Pierre Højbjerg","DEN","MF","24",1995,38,98,51,45,42,11,54,129,41.9,75,51,9,42,48,146,66,0,"https://fbref.com/en/players/8b04d6c1/Pierre-Hojbjerg"
"7912","Harry Kane_2021",2021,"Tottenham","Premier League","Harry Kane","ENG","FW","27",1993,34.2,22,12,1,17,4,8,26,30.8,18,28,11,17,11,33,40,0,"https://fbref.com/en/players/21a66f6a/Harry-Kane"
"7913","Érik Lamela_2021",2021,"Tottenham","Premier League","Érik Lamela","ARG","FW,MF","28",1992,8,17,9,1,11,5,8,21,38.1,13,11,1,10,6,23,2,0,"https://fbref.com/en/players/abe66106/Erik-Lamela"
"7914","Hugo Lloris_2021",2021,"Tottenham","Premier League","Hugo Lloris","FRA","GK","33",1986,38,0,0,0,0,0,0,1,0,1,0,0,0,0,0,10,1,"https://fbref.com/en/players/8f62b6ee/Hugo-Lloris"
"7915","Giovani Lo Celso_2021",2021,"Tottenham","Premier League","Giovani Lo Celso","ARG","MF","24",1996,10.5,28,22,12,11,5,10,29,34.5,19,12,1,11,7,35,5,0,"https://fbref.com/en/players/d7553721/Giovani-Lo-Celso"
"7916","Lucas Moura_2021",2021,"Tottenham","Premier League","Lucas Moura","BRA","FW,MF","27",1992,15.7,32,16,12,16,4,8,29,27.6,21,12,0,12,18,50,10,0,"https://fbref.com/en/players/2b622f01/Lucas-Moura"
"7917","Tanguy Ndombele_2021",2021,"Tottenham","Premier League","Tanguy Ndombele","FRA","MF","23",1996,23.2,41,20,11,21,9,18,44,40.9,26,28,4,24,19,60,15,0,"https://fbref.com/en/players/5cdddffa/Tanguy-Ndombele"
"7918","Sergio Reguilón_2021",2021,"Tottenham","Premier League","Sergio Reguilón","ESP","DF","23",1996,24.9,47,25,30,13,4,23,48,47.9,25,39,7,32,32,79,50,1,"https://fbref.com/en/players/3353737a/Sergio-Reguilon"
"7919","Joe Rodon_2021",2021,"Tottenham","Premier League","Joe Rodon","WAL","DF","22",1997,8.1,14,9,11,2,1,3,4,75,1,10,8,2,21,35,36,2,"https://fbref.com/en/players/8d62d31a/Joe-Rodon"
"7920","Davinson Sánchez_2021",2021,"Tottenham","Premier League","Davinson Sánchez","COL","DF","24",1996,16.5,40,20,31,9,0,21,32,65.6,11,18,13,5,14,54,85,2,"https://fbref.com/en/players/da7b447d/Davinson-Sanchez"
"7921","Dane Scarlett_2021",2021,"Tottenham","Premier League","Dane Scarlett","ENG","FW","16",2004,0,0,0,0,0,0,0,0,NA,0,0,0,0,0,0,0,0,"https://fbref.com/en/players/21945a9e/Dane-Scarlett"
"7922","Moussa Sissoko_2021",2021,"Tottenham","Premier League","Moussa Sissoko","FRA","MF","30",1989,17.6,22,16,19,3,0,8,20,40,12,11,4,7,23,45,25,0,"https://fbref.com/en/players/2acd49b9/Moussa-Sissoko"
"7923","Japhet Tanganga_2021",2021,"Tottenham","Premier League","Japhet Tanganga","ENG","DF","21",1999,5.4,5,4,3,2,0,1,3,33.3,2,6,5,1,3,8,15,0,"https://fbref.com/en/players/e9971f2d/Japhet-Tanganga"
"7924","Carlos Vinícius_2021",2021,"Tottenham","Premier League","Carlos Vinícius","BRA","FW","25",1995,3.4,3,1,2,1,0,1,1,100,0,0,0,0,2,5,5,0,"https://fbref.com/en/players/8b529245/Carlos-Vinicius"
"7925","Harry Winks_2021",2021,"Tottenham","Premier League","Harry Winks","ENG","MF","24",1996,9.6,16,9,11,5,0,5,20,25,15,16,4,12,11,27,12,1,"https://fbref.com/en/players/2f7acede/Harry-Winks"
"7926","Nícolas Andrade_2021",2021,"Udinese","Serie A","Nícolas Andrade","BRA","GK","32",1988,2,0,0,0,0,0,0,0,NA,0,0,0,0,0,0,0,0,"https://fbref.com/en/players/326d09ef/Nicolas-Andrade"
"7927","Tolgay Arslan_2021",2021,"Udinese","Serie A","Tolgay Arslan","GER","MF","29",1990,20.2,52,32,24,24,4,25,54,46.3,29,22,2,20,22,74,15,1,"https://fbref.com/en/players/963a328b/Tolgay-Arslan"
"7928","Rodrigo Becão_2021",2021,"Udinese","Serie A","Rodrigo Becão","BRA","DF","24",1996,30.9,59,33,36,20,3,27,49,55.1,22,48,27,21,68,127,94,2,"https://fbref.com/en/players/19e4eab9/Rodrigo-Becao"
"7929","Kevin Bonifazi_2021",2021,"Udinese","Serie A","Kevin Bonifazi","ITA","DF","24",1996,27.4,32,21,24,6,2,8,23,34.8,15,33,20,13,50,82,85,1,"https://fbref.com/en/players/fb77bfef/Kevin-Bonifazi"
"7930","Jayden Braaf_2021",2021,"Udinese","Serie A","Jayden Braaf","NED","FW","17",2002,1.3,0,0,0,0,0,0,1,0,1,0,0,0,0,0,0,0,"https://fbref.com/en/players/c609e90e/Jayden-Braaf"
"7931","Mamadou Coulibaly_2021",2021,"Udinese","Serie A","Mamadou Coulibaly","SEN","MF","21",1999,2,10,8,5,5,0,0,0,NA,0,2,0,2,1,11,0,0,"https://fbref.com/en/players/c976160c/Mamadou-Coulibaly"
"7932","Sebastien De Maio_2021",2021,"Udinese","Serie A","Sebastien De Maio","FRA","DF","33",1987,9.5,15,10,6,9,0,4,5,80,1,16,9,7,18,33,41,0,"https://fbref.com/en/players/952a03fe/Sebastien-De-Maio"
"7933","Rodrigo De Paul_2021",2021,"Udinese","Serie A","Rodrigo De Paul","ARG","MF","26",1994,35.6,41,24,17,22,2,15,60,25,45,32,1,31,17,58,20,1,"https://fbref.com/en/players/162efffd/Rodrigo-De-Paul"
"7934","Gerard Deulofeu_2021",2021,"Udinese","Serie A","Gerard Deulofeu","ESP","FW,MF","26",1994,6.6,2,2,1,1,0,2,12,16.7,10,2,0,2,3,5,0,0,"https://fbref.com/en/players/39583cfd/Gerard-Deulofeu"
"7935","Fernando Forestieri_2021",2021,"Udinese","Serie A","Fernando Forestieri","ITA","FW,MF","30",1990,6.1,9,7,4,4,1,3,7,42.9,4,7,0,7,2,11,0,0,"https://fbref.com/en/players/d60c26fc/Fernando-Forestieri"
"7936","Manuel Gasparini_2021",2021,"Udinese","Serie A","Manuel Gasparini","ITA","GK","18",2002,0,0,0,0,0,0,0,0,NA,0,0,0,0,0,0,0,0,"https://fbref.com/en/players/7033ca08/Manuel-Gasparini"
"7937","Mato Jajalo_2021",2021,"Udinese","Serie A","Mato Jajalo","BIH","MF","32",1988,0.4,1,1,1,0,0,1,1,100,0,1,0,1,2,3,0,0,"https://fbref.com/en/players/8c65eb5f/Mato-Jajalo"
"7938","Kevin Lasagna_2021",2021,"Udinese","Serie A","Kevin Lasagna","ITA","FW","27",1992,12.3,6,1,2,3,1,3,14,21.4,11,11,0,11,6,12,7,0,"https://fbref.com/en/players/09538fdb/Kevin-Lasagna"
"7939","Fernando Llorente_2021",2021,"Udinese","Serie A","Fernando Llorente","ESP","FW","35",1985,7.9,4,1,2,2,0,2,5,40,3,3,0,3,2,6,17,0,"https://fbref.com/en/players/82dbf623/Fernando-Llorente"
"7940","Jean-Victor Makengo_2021",2021,"Udinese","Serie A","Jean-Victor Makengo","FRA","MF","22",1998,5.8,8,7,5,3,0,3,13,23.1,10,7,1,6,5,13,7,0,"https://fbref.com/en/players/22bfb57e/Jean-Victor-Makengo"
"7941","Rolando Mandragora_2021",2021,"Udinese","Serie A","Rolando Mandragora","ITA","MF","23",1997,4.4,8,5,3,4,1,3,10,30,7,10,3,7,6,14,5,0,"https://fbref.com/en/players/c7259b83/Rolando-Mandragora"
"7942","Ryder Matos_2021",2021,"Udinese","Serie A","Ryder Matos","BRA","MF","27",1993,0.1,0,0,0,0,0,0,0,NA,0,0,0,0,0,0,0,0,"https://fbref.com/en/players/7280b54f/Ryder-Matos"
"7943","Petar Mićin_2021",2021,"Udinese","Serie A","Petar Mićin","SRB","MF","21",1998,0.2,0,0,0,0,0,0,0,NA,0,0,0,0,0,0,0,0,"https://fbref.com/en/players/259deea9/Petar-Micin"
"7944","Nahuel Molina_2021",2021,"Udinese","Serie A","Nahuel Molina","ARG","DF","22",1998,20.3,27,18,13,10,4,16,42,38.1,26,26,4,22,21,48,49,1,"https://fbref.com/en/players/23610943/Nahuel-Molina"
"7945","Juan Musso_2021",2021,"Udinese","Serie A","Juan Musso","ARG","GK","26",1994,35,1,1,1,0,0,1,1,100,0,0,0,0,1,2,8,1,"https://fbref.com/en/players/a111cf41/Juan-Musso"
"7946","Ilija Nestorovski_2021",2021,"Udinese","Serie A","Ilija Nestorovski","MKD","FW,MF","30",1990,7.8,6,4,2,3,1,2,13,15.4,11,5,0,5,1,7,7,0,"https://fbref.com/en/players/b1236c63/Ilija-Nestorovski"
"7947","Bram Nuytinck_2021",2021,"Udinese","Serie A","Bram Nuytinck","NED","DF","30",1990,18.2,21,15,10,9,2,13,20,65,7,30,17,13,25,46,77,0,"https://fbref.com/en/players/e33f36d5/Bram-Nuytinck"
"7948","Stefano Okaka_2021",2021,"Udinese","Serie A","Stefano Okaka","ITA","FW","30",1989,16.5,10,7,2,5,3,2,10,20,8,7,1,6,2,12,19,0,"https://fbref.com/en/players/601ef102/Stefano-Okaka"
"7949","Thomas Ouwejan_2021",2021,"Udinese","Serie A","Thomas Ouwejan","NED","DF","23",1996,4.6,4,1,0,3,1,2,9,22.2,7,4,0,4,5,9,6,0,"https://fbref.com/en/players/36d9dabe/Thomas-Ouwejan"
"7950","Martin Palumbo_2021",2021,"Udinese","Serie A","Martin Palumbo","NOR","MF","18",2002,0.7,0,0,0,0,0,0,0,NA,0,5,0,5,1,1,0,0,"https://fbref.com/en/players/f8d41a8c/Martin-Palumbo"
"7951","Roberto Pereyra_2021",2021,"Udinese","Serie A","Roberto Pereyra","ARG","MF,FW","29",1991,32.5,18,11,7,8,3,7,23,30.4,16,24,5,19,27,45,24,0,"https://fbref.com/en/players/75f2c59f/Roberto-Pereyra"
"7952","Ignacio Pussetto_2021",2021,"Udinese","Serie A","Ignacio Pussetto","ARG","FW","24",1995,8.4,16,8,5,6,5,6,17,35.3,11,14,0,14,13,29,6,0,"https://fbref.com/en/players/62437b4f/Ignacio-Pussetto"
"7953","Samir Santos_2021",2021,"Udinese","Serie A","Samir Santos","BRA","DF","25",1994,24.6,40,23,26,12,2,13,29,44.8,16,33,17,16,58,98,60,1,"https://fbref.com/en/players/92b4758e/Samir-Santos"
"7954","Simone Scuffet_2021",2021,"Udinese","Serie A","Simone Scuffet","ITA","GK","24",1996,1,0,0,0,0,0,0,0,NA,0,0,0,0,0,0,0,0,"https://fbref.com/en/players/41bd99ea/Simone-Scuffet"
"7955","Jens Stryger Larsen_2021",2021,"Udinese","Serie A","Jens Stryger Larsen","DEN","DF","29",1991,29.3,17,11,14,3,0,8,25,32,17,26,11,15,24,41,65,0,"https://fbref.com/en/players/f91e81c9/Jens-Stryger-Larsen"
"7956","Hidde ter Avest_2021",2021,"Udinese","Serie A","Hidde ter Avest","NED","DF","23",1997,3.9,5,2,3,2,0,2,5,40,3,3,1,2,2,7,5,0,"https://fbref.com/en/players/18f9dbd0/Hidde-ter-Avest"
"7957","Walace_2021",2021,"Udinese","Serie A","Walace","BRA","MF","25",1995,22.8,50,23,28,19,3,21,60,35,39,36,3,33,34,84,23,0,"https://fbref.com/en/players/26db8853/Walace"
"7958","Marvin Zeegelaar_2021",2021,"Udinese","Serie A","Marvin Zeegelaar","NED","DF","29",1990,19.3,40,18,23,16,1,20,39,51.3,19,21,9,12,24,64,43,0,"https://fbref.com/en/players/8abd0c03/Marvin-Zeegelaar"
"7959","Robert Andrich_2021",2021,"Union Berlin","Bundesliga","Robert Andrich","GER","MF","25",1994,28.1,51,24,22,27,2,24,53,45.3,29,40,6,34,51,102,31,2,"https://fbref.com/en/players/e0b113a7/Robert-Andrich"
"7960","Taiwo Awoniyi_2021",2021,"Union Berlin","Bundesliga","Taiwo Awoniyi","NGA","FW","22",1997,15.1,5,3,2,3,0,1,14,7.1,13,9,0,9,3,8,4,0,"https://fbref.com/en/players/e5478b87/Taiwo-Awoniyi"
"7961","Sheraldo Becker_2021",2021,"Union Berlin","Bundesliga","Sheraldo Becker","SUR","FW,MF","25",1995,12.3,5,4,2,2,1,3,5,60,2,4,0,4,6,11,7,0,"https://fbref.com/en/players/8eb55dbb/Sheraldo-Becker"
"7962","Marius Bülter_2021",2021,"Union Berlin","Bundesliga","Marius Bülter","GER","FW,MF","27",1993,10.9,15,8,6,6,3,5,17,29.4,12,17,2,15,12,27,11,0,"https://fbref.com/en/players/ab5b7dc1/Marius-Bulter"
"7963","Leon Dajaku_2021",2021,"Union Berlin","Bundesliga","Leon Dajaku","GER","FW","19",2001,0.4,0,0,0,0,0,0,0,NA,0,0,0,0,0,0,0,0,"https://fbref.com/en/players/aeaf1bc1/Leon-Dajaku"
"7964","Keita Endo_2021",2021,"Union Berlin","Bundesliga","Keita Endo","JPN","MF,FW","22",1997,5.1,8,3,1,5,2,3,9,33.3,6,5,2,3,6,14,4,0,"https://fbref.com/en/players/1a83027b/Keita-Endo"
"7965","Marvin Friedrich_2021",2021,"Union Berlin","Bundesliga","Marvin Friedrich","GER","DF","24",1995,34,47,29,35,11,1,18,32,56.3,14,38,18,20,52,99,109,0,"https://fbref.com/en/players/b77f44a4/Marvin-Friedrich"
"7966","Christian Gentner_2021",2021,"Union Berlin","Bundesliga","Christian Gentner","GER","MF","34",1985,11.5,17,8,9,5,3,5,18,27.8,13,13,1,12,17,34,16,0,"https://fbref.com/en/players/a4f94a0d/Christian-Gentner"
"7967","Niko Gießelmann_2021",2021,"Union Berlin","Bundesliga","Niko Gießelmann","GER","DF","28",1991,4.8,12,9,7,4,1,5,8,62.5,3,9,3,6,8,20,13,1,"https://fbref.com/en/players/7242b495/Niko-Giesselmann"
"7968","Akaki Gogia_2021",2021,"Union Berlin","Bundesliga","Akaki Gogia","GER","FW,MF","28",1992,1.6,1,0,0,1,0,0,2,0,2,0,0,0,1,2,0,0,"https://fbref.com/en/players/deee6467/Akaki-Gogia"
"7969","Sebastian Griesbeck_2021",2021,"Union Berlin","Bundesliga","Sebastian Griesbeck","GER","MF","29",1990,9.9,20,9,8,11,1,8,19,42.1,11,13,3,10,5,25,8,0,"https://fbref.com/en/players/a8db7ebb/Sebastian-Griesbeck"
"7970","Florian Hübner_2021",2021,"Union Berlin","Bundesliga","Florian Hübner","GER","DF","29",1991,5.8,10,5,7,3,0,7,15,46.7,8,7,3,4,13,23,21,0,"https://fbref.com/en/players/e87ad81a/Florian-Hubner"
"7971","Marcus Ingvartsen_2021",2021,"Union Berlin","Bundesliga","Marcus Ingvartsen","DEN","MF,FW","24",1996,21.8,17,11,5,6,6,8,26,30.8,18,22,0,22,18,35,10,0,"https://fbref.com/en/players/271b8617/Marcus-Ingvartsen"
"7972","Loris Karius_2021",2021,"Union Berlin","Bundesliga","Loris Karius","GER","GK","27",1993,3.2,0,0,0,0,0,0,0,NA,0,0,0,0,0,0,2,0,"https://fbref.com/en/players/32e7ce92/Loris-Karius"
"7973","Robin Knoche_2021",2021,"Union Berlin","Bundesliga","Robin Knoche","GER","DF","28",1992,33.8,44,29,30,12,2,23,39,59,16,43,27,16,49,93,118,2,"https://fbref.com/en/players/6bd5cd5d/Robin-Knoche"
"7974","Max Kruse_2021",2021,"Union Berlin","Bundesliga","Max Kruse","GER","FW,MF","32",1988,18.1,7,3,1,5,1,2,9,22.2,7,11,0,11,3,10,3,0,"https://fbref.com/en/players/f9446dcd/Max-Kruse"
"7975","Christopher Lenz_2021",2021,"Union Berlin","Bundesliga","Christopher Lenz","GER","DF,FW","25",1994,25,74,41,39,30,5,35,71,49.3,36,34,5,29,35,109,50,0,"https://fbref.com/en/players/bbd86530/Christopher-Lenz"
"7976","Andreas Luthe_2021",2021,"Union Berlin","Bundesliga","Andreas Luthe","GER","GK","33",1987,30.8,1,1,1,0,0,1,3,33.3,2,1,0,1,0,1,8,3,"https://fbref.com/en/players/7fe12375/Andreas-Luthe"
"7977","Tim Maciejewski_2021",2021,"Union Berlin","Bundesliga","Tim Maciejewski","GER","FW","19",2001,0.1,0,0,0,0,0,0,0,NA,0,0,0,0,0,0,0,0,"https://fbref.com/en/players/bfd522a6/Tim-Maciejewski"
"7978","Joshua Mees_2021",2021,"Union Berlin","Bundesliga","Joshua Mees","GER","FW","24",1996,0.1,0,0,0,0,0,0,0,NA,0,0,0,0,0,0,0,0,"https://fbref.com/en/players/4b6dd263/Joshua-Mees"
"7979","Petar Musa_2021",2021,"Union Berlin","Bundesliga","Petar Musa","CRO","FW","22",1998,7.9,12,8,3,6,3,4,8,50,4,10,0,10,4,16,5,0,"https://fbref.com/en/players/4567a0b4/Petar-Musa"
"7980","Joel Pohjanpalo_2021",2021,"Union Berlin","Bundesliga","Joel Pohjanpalo","FIN","FW","25",1994,9.5,5,1,0,3,2,1,6,16.7,5,1,0,1,1,6,12,0,"https://fbref.com/en/players/ea003d07/Joel-Pohjanpalo"
"7981","Grischa Prömel_2021",2021,"Union Berlin","Bundesliga","Grischa Prömel","GER","MF","25",1995,20.2,39,23,14,23,2,18,34,52.9,16,20,2,18,24,63,22,0,"https://fbref.com/en/players/924f9191/Grischa-Promel"
"7982","Julian Ryerson_2021",2021,"Union Berlin","Bundesliga","Julian Ryerson","NOR","DF,MF","22",1997,11.9,22,15,4,14,4,12,15,80,3,13,0,13,11,33,17,0,"https://fbref.com/en/players/009a4f60/Julian-Ryerson"
"7983","Nico Schlotterbeck_2021",2021,"Union Berlin","Bundesliga","Nico Schlotterbeck","GER","DF","20",1999,14.3,34,19,14,19,1,18,28,64.3,10,13,6,7,31,65,29,1,"https://fbref.com/en/players/34e12499/Nico-Schlotterbeck"
"7984","Cedric Teuchert_2021",2021,"Union Berlin","Bundesliga","Cedric Teuchert","GER","FW,MF","23",1997,8.4,7,5,2,4,1,3,16,18.8,13,12,0,12,5,12,6,0,"https://fbref.com/en/players/f956479d/Cedric-Teuchert"
"7985","Christopher Trimmel_2021",2021,"Union Berlin","Bundesliga","Christopher Trimmel","AUT","DF,FW","33",1987,28.6,50,25,28,18,4,28,54,51.9,26,32,7,25,50,100,99,0,"https://fbref.com/en/players/056d2d95/Christopher-Trimmel"
"7986","Alejandro Blanco_2021",2021,"Valencia","La Liga","Alejandro Blanco","ESP","MF","21",1998,6.4,8,4,4,4,0,3,18,16.7,15,5,0,5,8,16,9,0,"https://fbref.com/en/players/c4dce677/Alejandro-Blanco"
"7987","Denis Cheryshev_2021",2021,"Valencia","La Liga","Denis Cheryshev","RUS","MF","29",1990,12.2,19,15,6,7,6,6,26,23.1,20,15,1,14,12,31,15,0,"https://fbref.com/en/players/0ac94a23/Denis-Cheryshev"
"7988","Jasper Cillessen_2021",2021,"Valencia","La Liga","Jasper Cillessen","NED","GK","31",1989,10,0,0,0,0,0,0,0,NA,0,0,0,0,0,0,0,0,"https://fbref.com/en/players/04ac8285/Jasper-Cillessen"
"7989","Thierry Correia_2021",2021,"Valencia","La Liga","Thierry Correia","POR","DF","21",1999,23.7,47,27,32,10,5,21,43,48.8,22,24,6,18,42,89,63,1,"https://fbref.com/en/players/c78b352d/Thierry-Correia"
"7990","Patrick Cutrone_2021",2021,"Valencia","La Liga","Patrick Cutrone","ITA","FW","22",1998,1.2,0,0,0,0,0,0,1,0,1,0,0,0,1,1,0,0,"https://fbref.com/en/players/a4fe8cda/Patrick-Cutrone"
"7991","Mouctar Diakhaby_2021",2021,"Valencia","La Liga","Mouctar Diakhaby","GUI","DF","23",1996,23.1,16,8,10,6,0,8,12,66.7,4,28,21,7,27,43,102,1,"https://fbref.com/en/players/d2110326/Mouctar-Diakhaby"
"7992","Jaume Doménech_2021",2021,"Valencia","La Liga","Jaume Doménech","ESP","GK","29",1990,28,1,1,1,0,0,1,2,50,1,1,0,1,0,1,16,2,"https://fbref.com/en/players/c9cb972b/Jaume-Domenech"
"7993","Vicente Esquerdo_2021",2021,"Valencia","La Liga","Vicente Esquerdo","ESP","MF","21",1999,2.6,7,4,5,2,0,4,6,66.7,2,4,2,2,8,15,1,0,"https://fbref.com/en/players/ced26057/Vicente-Esquerdo"
"7994","Kévin Gameiro_2021",2021,"Valencia","La Liga","Kévin Gameiro","FRA","FW","33",1987,12,7,4,3,2,2,3,11,27.3,8,10,0,10,0,7,3,0,"https://fbref.com/en/players/42276181/Kevin-Gameiro"
"7995","Maxi Gómez_2021",2021,"Valencia","La Liga","Maxi Gómez","URU","FW","23",1996,29.9,11,9,3,7,1,3,14,21.4,11,13,3,10,2,13,34,0,"https://fbref.com/en/players/4c2e9442/Maxi-Gomez"
"7996","Gonçalo Guedes_2021",2021,"Valencia","La Liga","Gonçalo Guedes","POR","MF,FW","23",1996,25.4,18,12,8,7,3,10,45,22.2,35,24,1,23,8,26,7,0,"https://fbref.com/en/players/e6bc67d7/Goncalo-Guedes"
"7997","Hugo Guillamón_2021",2021,"Valencia","La Liga","Hugo Guillamón","ESP","DF","20",2000,22.1,23,13,17,6,0,8,20,40,12,19,14,5,27,50,102,3,"https://fbref.com/en/players/f7c12fbf/Hugo-Guillamon"
"7998","Jason_2021",2021,"Valencia","La Liga","Jason","ESP","MF,DF","26",1994,4.9,9,3,5,2,2,4,16,25,12,6,1,5,10,19,4,0,"https://fbref.com/en/players/9038c2a1/Jason"
"7999","Lee Kangin_2021",2021,"Valencia","La Liga","Lee Kangin","KOR","FW,MF","19",2001,14,15,11,8,4,3,3,31,9.7,28,12,0,12,2,17,0,0,"https://fbref.com/en/players/8455ad90/Lee-Kangin"
"8000","Koba Koindredi_2021",2021,"Valencia","La Liga","Koba Koindredi","FRA","MF","18",2001,0.2,1,1,1,0,0,0,1,0,1,0,0,0,0,1,0,0,"https://fbref.com/en/players/3a58d075/Koba-Koindredi"
"8001","Geoffrey Kondogbia_2021",2021,"Valencia","La Liga","Geoffrey Kondogbia","CTA","MF","27",1993,4.9,16,9,9,4,3,7,19,36.8,12,6,1,5,8,24,8,0,"https://fbref.com/en/players/cce181df/Geoffrey-Kondogbia"
"8002","Toni Lato_2021",2021,"Valencia","La Liga","Toni Lato","ESP","DF","22",1997,8.1,13,6,7,3,3,6,13,46.2,7,12,1,11,10,23,21,0,"https://fbref.com/en/players/8e088e04/Toni-Lato"
"8003","José Luis Gayà_2021",2021,"Valencia","La Liga","José Luis Gayà","ESP","DF","25",1995,31.6,59,33,40,13,6,33,68,48.5,35,22,3,19,38,97,62,1,"https://fbref.com/en/players/b05e2dbd/Jose-Luis-Gaya"
"8004","Eliaquim Mangala_2021",2021,"Valencia","La Liga","Eliaquim Mangala","FRA","DF","29",1991,3.6,0,0,0,0,0,0,1,0,1,8,6,2,6,6,12,0,"https://fbref.com/en/players/f520049f/Eliaquim-Mangala"
"8005","Guillem Molina_2021",2021,"Valencia","La Liga","Guillem Molina","ESP","DF","20",2000,1.7,1,0,1,0,0,0,5,0,5,1,1,0,4,5,5,0,"https://fbref.com/en/players/0bbab654/Guillem-Molina"
"8006","Yunus Musah_2021",2021,"Valencia","La Liga","Yunus Musah","USA","MF","17",2002,17,21,18,12,3,6,8,24,33.3,16,20,0,20,15,36,12,1,"https://fbref.com/en/players/b51b1b9c/Yunus-Musah"
"8007","Christian Oliva_2021",2021,"Valencia","La Liga","Christian Oliva","URU","MF","24",1996,2.2,2,0,1,1,0,1,6,16.7,5,1,0,1,6,8,0,0,"https://fbref.com/en/players/d3b888e3/Christian-Oliva"
"8008","Gabriel Paulista_2021",2021,"Valencia","La Liga","Gabriel Paulista","BRA","DF","29",1990,30.2,17,11,9,5,3,6,17,35.3,11,32,27,5,59,76,132,3,"https://fbref.com/en/players/b7ca5c51/Gabriel-Paulista"
"8009","Cristiano Piccini_2021",2021,"Valencia","La Liga","Cristiano Piccini","ITA","DF","27",1992,0.7,1,1,1,0,0,1,2,50,1,0,0,0,0,1,3,0,"https://fbref.com/en/players/32c0491f/Cristiano-Piccini"
"8010","Uroš Račić_2021",2021,"Valencia","La Liga","Uroš Račić","SRB","MF","22",1998,24.3,38,22,16,16,6,16,54,29.6,38,33,11,22,26,64,54,0,"https://fbref.com/en/players/faed84db/Uros-Racic"
"8011","Francisco Reis Ferreira_2021",2021,"Valencia","La Liga","Francisco Reis Ferreira","POR","DF","23",1997,2,1,1,1,0,0,0,3,0,3,0,0,0,0,1,6,0,"https://fbref.com/en/players/4b3c863f/Francisco-Reis-Ferreira"
"8012","Rubén Sobrino_2021",2021,"Valencia","La Liga","Rubén Sobrino","ESP","MF,FW","28",1992,0.5,1,1,1,0,0,0,1,0,1,0,0,0,0,1,1,0,"https://fbref.com/en/players/19b776e9/Ruben-Sobrino"
"8013","Carlos Soler_2021",2021,"Valencia","La Liga","Carlos Soler","ESP","MF","23",1997,30.4,41,24,14,24,3,19,52,36.5,33,35,11,24,23,64,41,0,"https://fbref.com/en/players/fed17f5a/Carlos-Soler"
"8014","Manu Vallejo_2021",2021,"Valencia","La Liga","Manu Vallejo","ESP","FW,MF","23",1997,10.6,18,8,5,8,5,5,26,19.2,21,8,0,8,3,21,3,0,"https://fbref.com/en/players/0bc4e720/Manu-Vallejo"
"8015","Daniel Wass_2021",2021,"Valencia","La Liga","Daniel Wass","DEN","MF,DF","31",1989,33.1,52,31,21,29,2,22,55,40,33,33,13,20,47,99,69,0,"https://fbref.com/en/players/d83bbc54/Daniel-Wass"
"8016","Rubén Alcaraz_2021",2021,"Valladolid","La Liga","Rubén Alcaraz","ESP","MF","29",1991,24.1,54,29,32,21,1,30,80,37.5,50,35,8,27,31,85,28,0,"https://fbref.com/en/players/036bba5f/Ruben-Alcaraz"
"8017","Miguel Ángel Rubio_2021",2021,"Valladolid","La Liga","Miguel Ángel Rubio","ESP","DF","22",1998,1.5,0,0,0,0,0,0,0,NA,0,2,2,0,3,3,11,0,"https://fbref.com/en/players/56cafd0a/Miguel-Angel-Rubio"
"8018","Sergio Benito_2021",2021,"Valladolid","La Liga","Sergio Benito","ESP","FW","21",1999,0,0,0,0,0,0,0,0,NA,0,0,0,0,0,0,0,0,"https://fbref.com/en/players/608bcb88/Sergio-Benito"
"8019","Joaquín Fernández_2021",2021,"Valladolid","La Liga","Joaquín Fernández","ESP","DF","24",1996,23,30,16,21,8,1,12,21,57.1,9,24,15,9,43,73,113,0,"https://fbref.com/en/players/b86a64b2/Joaquin-Fernandez"
"8020","Raúl García_2021",2021,"Valladolid","La Liga","Raúl García","ESP","DF,MF","31",1989,5.6,10,8,5,5,0,6,20,30,14,5,1,4,9,19,10,0,"https://fbref.com/en/players/1a317a1b/Raul-Garcia"
"8021","Bruno González_2021",2021,"Valladolid","La Liga","Bruno González","ESP","DF","30",1990,25.1,26,17,18,8,0,17,31,54.8,14,22,14,8,37,63,112,1,"https://fbref.com/en/players/f11fe861/Bruno-Gonzalez"
"8022","Sergi Guardiola_2021",2021,"Valladolid","La Liga","Sergi Guardiola","ESP","FW","29",1991,19.9,11,5,1,5,5,2,27,7.4,25,12,1,11,7,18,16,3,"https://fbref.com/en/players/32974271/Sergi-Guardiola"
"8023","Pablo Hervías_2021",2021,"Valladolid","La Liga","Pablo Hervías","ESP","DF,MF","27",1993,13.4,19,12,7,9,3,9,26,34.6,17,6,0,6,11,30,8,0,"https://fbref.com/en/players/ba5a9545/Pablo-Hervias"
"8024","Saidy Janko_2021",2021,"Valladolid","La Liga","Saidy Janko","GAM","DF","24",1995,13.6,19,10,12,5,2,8,14,57.1,6,9,1,8,18,37,47,0,"https://fbref.com/en/players/689c9cf4/Saidy-Janko"
"8025","Jota_2021",2021,"Valladolid","La Liga","Jota","POR","MF,FW","21",1999,7.4,7,3,1,4,2,5,10,50,5,4,0,4,6,13,5,1,"https://fbref.com/en/players/2b65fe46/Jota"
"8026","Kenan Kodro_2021",2021,"Valladolid","La Liga","Kenan Kodro","BIH","FW,MF","26",1993,5.1,0,0,0,0,0,0,2,0,2,2,1,1,2,2,6,0,"https://fbref.com/en/players/e82d2807/Kenan-Kodro"
"8027","Kuki_2021",2021,"Valladolid","La Liga","Kuki","ESP","MF","22",1998,0.3,1,1,0,0,1,0,1,0,1,0,0,0,0,1,0,0,"https://fbref.com/en/players/2b6dc4d7/Kuki"
"8028","Maranhão_2021",2021,"Valladolid","La Liga","Maranhão","BRA","FW","23",1996,13.1,8,2,2,2,4,0,8,0,8,15,2,13,2,10,9,0,"https://fbref.com/en/players/ae86d473/Maranhao"
"8029","Jordi Masip_2021",2021,"Valladolid","La Liga","Jordi Masip","ESP","GK","31",1989,25,0,0,0,0,0,0,2,0,2,2,0,2,2,2,8,1,"https://fbref.com/en/players/8fae77ea/Jordi-Masip"
"8030","Roque Mesa_2021",2021,"Valladolid","La Liga","Roque Mesa","ESP","MF","31",1989,19.6,46,29,18,24,4,20,47,42.6,27,11,2,9,14,60,23,1,"https://fbref.com/en/players/7c4243d4/Roque-Mesa"
"8031","Míchel_2021",2021,"Valladolid","La Liga","Míchel","ESP","MF","32",1988,10.5,18,11,10,3,5,5,22,22.7,17,10,1,9,9,27,12,1,"https://fbref.com/en/players/418f8f61/Michel"
"8032","Javi Moyano_2021",2021,"Valladolid","La Liga","Javi Moyano","ESP","DF","34",1986,1.1,0,0,0,0,0,0,0,NA,0,2,0,2,0,0,2,0,"https://fbref.com/en/players/933e8c8a/Javi-Moyano"
"8033","Nacho_2021",2021,"Valladolid","La Liga","Nacho","ESP","DF","31",1989,20.1,43,21,29,10,4,24,52,46.2,28,21,1,20,29,72,47,0,"https://fbref.com/en/players/e29d1111/Nacho"
"8034","Lucas Olaza_2021",2021,"Valladolid","La Liga","Lucas Olaza","URU","DF","26",1994,14,20,9,11,7,2,9,17,52.9,8,15,7,8,15,35,38,0,"https://fbref.com/en/players/4cee5954/Lucas-Olaza"
"8035","Kiko Olivas_2021",2021,"Valladolid","La Liga","Kiko Olivas","ESP","DF","31",1988,2,3,2,2,1,0,3,5,60,2,2,2,0,7,10,3,0,"https://fbref.com/en/players/72b07a9c/Kiko-Olivas"
"8036","Fabián Orellana_2021",2021,"Valladolid","La Liga","Fabián Orellana","CHI","MF,FW","34",1986,23.8,33,19,12,14,7,12,55,21.8,43,18,0,18,15,48,9,0,"https://fbref.com/en/players/c90977db/Fabian-Orellana"
"8037","Kike Pérez_2021",2021,"Valladolid","La Liga","Kike Pérez","ESP","MF","23",1997,12.9,26,19,8,14,4,7,33,21.2,26,10,1,9,17,43,18,0,"https://fbref.com/en/players/237a3851/Kike-Perez"
"8038","Luis Pérez_2021",2021,"Valladolid","La Liga","Luis Pérez","ESP","DF","25",1995,14.4,33,17,16,17,0,18,30,60,12,26,8,18,14,47,54,1,"https://fbref.com/en/players/b7c04927/Luis-Perez"
"8039","Óscar Plano_2021",2021,"Valladolid","La Liga","Óscar Plano","ESP","MF,FW","29",1991,28,42,24,24,12,6,14,46,30.4,32,35,6,29,34,76,43,0,"https://fbref.com/en/players/7c388b20/Oscar-Plano"
"8040","Oriol Rey_2021",2021,"Valladolid","La Liga","Oriol Rey","ESP","MF","22",1998,0.2,0,0,0,0,0,0,0,NA,0,0,0,0,1,1,0,0,"https://fbref.com/en/players/e8a0d2f7/Oriol-Rey"
"8041","Roberto_2021",2021,"Valladolid","La Liga","Roberto","ESP","GK","34",1986,13,0,0,0,0,0,0,1,0,1,0,0,0,0,0,7,0,"https://fbref.com/en/players/ba3ca78f/Roberto"
"8042","Waldo Rubio_2021",2021,"Valladolid","La Liga","Waldo Rubio","ESP","FW,MF","24",1995,4.2,6,4,2,2,2,1,14,7.1,13,6,0,6,3,9,3,0,"https://fbref.com/en/players/ccaa5728/Waldo-Rubio"
"8043","Fede San Emeterio_2021",2021,"Valladolid","La Liga","Fede San Emeterio","ESP","MF","23",1997,16.2,25,14,15,7,3,11,31,35.5,20,23,8,15,28,53,33,0,"https://fbref.com/en/players/efecd633/Fede-San-Emeterio"
"8044","Javi Sánchez_2021",2021,"Valladolid","La Liga","Javi Sánchez","ESP","DF","23",1997,10.2,15,10,10,4,1,9,10,90,1,15,7,8,15,30,37,0,"https://fbref.com/en/players/60359288/Javi-Sanchez"
"8045","Toni Villa_2021",2021,"Valladolid","La Liga","Toni Villa","ESP","MF,FW","25",1995,10.8,31,16,11,14,6,15,42,35.7,27,15,1,14,5,36,3,0,"https://fbref.com/en/players/636eae97/Toni-Villa"
"8046","Shon Weissman_2021",2021,"Valladolid","La Liga","Shon Weissman","ISR","FW","24",1996,23.7,12,9,4,5,3,2,23,8.7,21,17,3,14,8,20,7,0,"https://fbref.com/en/players/379dc075/Shon-Weissman"
"8047","Jawad El Yamiq_2021",2021,"Valladolid","La Liga","Jawad El Yamiq","MAR","DF","28",1992,15.3,21,14,14,7,0,8,11,72.7,3,15,10,5,46,67,100,0,"https://fbref.com/en/players/f6f6b6e8/Jawad-El-Yamiq"
"8048","Raúl Albiol_2021",2021,"Villarreal","La Liga","Raúl Albiol","ESP","DF","34",1985,34.6,22,15,19,3,0,13,18,72.2,5,32,22,10,22,44,146,2,"https://fbref.com/en/players/4bd414c1/Raul-Albiol"
"8049","Paco Alcácer_2021",2021,"Villarreal","La Liga","Paco Alcácer","ESP","FW","26",1993,17.2,6,3,1,2,3,3,7,42.9,4,8,0,8,9,15,6,0,"https://fbref.com/en/players/a7a9d95a/Paco-Alcacer"
"8050","Sergio Asenjo_2021",2021,"Villarreal","La Liga","Sergio Asenjo","ESP","GK","31",1989,36,0,0,0,0,0,0,1,0,1,0,0,0,0,0,13,2,"https://fbref.com/en/players/9f0ea33f/Sergio-Asenjo"
"8051","Carlos Bacca_2021",2021,"Villarreal","La Liga","Carlos Bacca","COL","FW","33",1986,8.7,9,5,5,3,1,3,5,60,2,5,0,5,3,12,2,0,"https://fbref.com/en/players/09a9e921/Carlos-Bacca"
"8052","Alex Baena_2021",2021,"Villarreal","La Liga","Alex Baena","ESP","MF","19",2001,1.5,4,3,1,2,1,1,3,33.3,2,1,1,0,1,5,1,0,"https://fbref.com/en/players/518f2234/Alex-Baena"
"8053","Étienne Capoue_2021",2021,"Villarreal","La Liga","Étienne Capoue","FRA","MF","32",1988,13.2,20,10,14,6,0,8,18,44.4,10,7,1,6,20,40,23,0,"https://fbref.com/en/players/5acc4a10/Etienne-Capoue"
"8054","Sofian Chakla_2021",2021,"Villarreal","La Liga","Sofian Chakla","MAR","DF","26",1993,0.1,0,0,0,0,0,0,0,NA,0,0,0,0,0,0,0,0,"https://fbref.com/en/players/37f04799/Sofian-Chakla"
"8055","Samuel Chukwueze_2021",2021,"Villarreal","La Liga","Samuel Chukwueze","NGA","MF,FW","21",1999,15.2,12,7,4,4,4,3,17,17.6,14,8,0,8,10,22,3,0,"https://fbref.com/en/players/b8a642fc/Samuel-Chukwueze"
"8056","Francis Coquelin_2021",2021,"Villarreal","La Liga","Francis Coquelin","FRA","MF","29",1991,8.2,19,14,4,12,3,8,19,42.1,11,8,2,6,21,40,11,1,"https://fbref.com/en/players/a6951bf8/Francis-Coquelin"
"8057","Jaume Costa_2021",2021,"Villarreal","La Liga","Jaume Costa","ESP","DF,MF","32",1988,3.9,10,6,4,6,0,7,9,77.8,2,7,1,6,6,16,8,0,"https://fbref.com/en/players/808d48f3/Jaume-Costa"
"8058","Pervis Estupiñán_2021",2021,"Villarreal","La Liga","Pervis Estupiñán","ECU","DF","22",1998,13,37,17,23,12,2,14,23,60.9,9,10,2,8,35,72,14,2,"https://fbref.com/en/players/d38fdf53/Pervis-Estupinan"
"8059","Juan Foyth_2021",2021,"Villarreal","La Liga","Juan Foyth","ARG","DF,MF","22",1998,13,40,22,22,14,4,12,29,41.4,17,21,6,15,19,59,24,1,"https://fbref.com/en/players/6c7762c3/Juan-Foyth"
"8060","Ramiro Funes Mori_2021",2021,"Villarreal","La Liga","Ramiro Funes Mori","ARG","DF","29",1991,8.1,12,8,7,5,0,7,11,63.6,4,7,5,2,8,20,42,1,"https://fbref.com/en/players/89cbc961/Ramiro-Funes-Mori"
"8061","Mario Gaspar_2021",2021,"Villarreal","La Liga","Mario Gaspar","ESP","DF","29",1990,20.6,55,34,22,24,9,21,40,52.5,19,26,4,22,30,85,47,1,"https://fbref.com/en/players/fb5d47b3/Mario-Gaspar"
"8062","Moi Gómez_2021",2021,"Villarreal","La Liga","Moi Gómez","ESP","MF,FW","26",1994,28.5,21,12,6,8,7,14,35,40,21,20,3,17,11,32,16,0,"https://fbref.com/en/players/5a626448/Moi-Gomez"
"8063","Vicente Iborra_2021",2021,"Villarreal","La Liga","Vicente Iborra","ESP","MF","32",1988,10.3,18,8,8,7,3,8,24,33.3,16,14,7,7,14,32,25,1,"https://fbref.com/en/players/ad1ffcfd/Vicente-Iborra"
"8064","Takefusa Kubo_2021",2021,"Villarreal","La Liga","Takefusa Kubo","JPN","MF,FW","19",2001,3.3,1,1,0,0,1,1,5,20,4,2,0,2,1,2,2,0,"https://fbref.com/en/players/16aa3654/Takefusa-Kubo"
"8065","Álex Millán_2021",2021,"Villarreal","La Liga","Álex Millán","ESP","FW","20",1999,0,0,0,0,0,0,0,0,NA,0,0,0,0,0,0,0,0,"https://fbref.com/en/players/29ad0dd4/Alex-Millan"
"8066","Alberto Moreno_2021",2021,"Villarreal","La Liga","Alberto Moreno","ESP","DF","28",1992,2.1,7,4,7,0,0,2,5,40,3,2,1,1,3,10,2,0,"https://fbref.com/en/players/11b9265b/Alberto-Moreno"
"8067","Gerard Moreno_2021",2021,"Villarreal","La Liga","Gerard Moreno","ESP","FW","28",1992,29.7,24,15,8,10,6,7,34,20.6,27,17,4,13,15,39,26,0,"https://fbref.com/en/players/81f0781e/Gerard-Moreno"
"8068","Fernando Niño_2021",2021,"Villarreal","La Liga","Fernando Niño","ESP","FW","19",2000,6.6,8,3,0,4,4,2,9,22.2,7,1,0,1,2,10,2,0,"https://fbref.com/en/players/81d5c497/Fernando-Nino"
"8069","Daniel Parejo_2021",2021,"Villarreal","La Liga","Daniel Parejo","ESP","MF","31",1989,34.6,65,40,32,23,10,33,81,40.7,48,35,8,27,45,110,21,3,"https://fbref.com/en/players/7460ca0d/Daniel-Parejo"
"8070","Alfonso Pedraza_2021",2021,"Villarreal","La Liga","Alfonso Pedraza","ESP","DF","24",1996,23.3,35,19,16,11,8,11,31,35.5,20,21,5,16,34,69,47,1,"https://fbref.com/en/players/63f04c6c/Alfonso-Pedraza"
"8071","Rubén Peña_2021",2021,"Villarreal","La Liga","Rubén Peña","ESP","DF","29",1991,12.4,25,14,8,15,2,19,33,57.6,14,20,1,19,13,38,19,0,"https://fbref.com/en/players/1f079188/Ruben-Pena"
"8072","Yeremi Pino_2021",2021,"Villarreal","La Liga","Yeremi Pino","ESP","FW,MF","17",2002,8.9,19,11,10,7,2,8,28,28.6,20,20,1,19,9,28,8,0,"https://fbref.com/en/players/540ec57b/Yeremi-Pino"
"8073","Dani Raba_2021",2021,"Villarreal","La Liga","Dani Raba","ESP","MF,FW","24",1995,1.7,2,1,0,1,1,2,8,25,6,1,0,1,0,2,0,0,"https://fbref.com/en/players/ea6a7ab4/Dani-Raba"
"8074","Gerónimo Rulli_2021",2021,"Villarreal","La Liga","Gerónimo Rulli","ARG","GK","28",1992,2,0,0,0,0,0,0,0,NA,0,0,0,0,0,0,0,1,"https://fbref.com/en/players/625c144a/Geronimo-Rulli"
"8075","Pau Torres_2021",2021,"Villarreal","La Liga","Pau Torres","ESP","DF","23",1997,33,17,11,10,5,2,11,18,61.1,7,33,25,8,23,40,111,1,"https://fbref.com/en/players/532e1e4f/Pau-Torres"
"8076","Manu Trigueros_2021",2021,"Villarreal","La Liga","Manu Trigueros","ESP","MF","28",1991,28.1,51,30,25,21,5,21,77,27.3,56,32,2,30,17,68,19,0,"https://fbref.com/en/players/963829d0/Manu-Trigueros"
"8077","Felix Agu_2021",2021,"Werder Bremen","Bundesliga","Felix Agu","GER","DF","20",1999,7.8,20,9,10,9,1,10,18,55.6,8,14,3,11,12,32,18,0,"https://fbref.com/en/players/cb6d81b3/Felix-Agu"
"8078","Ludwig Augustinsson_2021",2021,"Werder Bremen","Bundesliga","Ludwig Augustinsson","SWE","DF,FW","26",1994,21.7,37,20,19,14,4,17,29,58.6,12,21,7,14,20,57,62,0,"https://fbref.com/en/players/9fec8860/Ludwig-Augustinsson"
"8079","Philipp Bargfrede_2021",2021,"Werder Bremen","Bundesliga","Philipp Bargfrede","GER","MF","31",1989,0.3,0,0,0,0,0,0,0,NA,0,0,0,0,0,0,3,0,"https://fbref.com/en/players/3f7cd8f1/Philipp-Bargfrede"
"8080","Leonardo Bittencourt_2021",2021,"Werder Bremen","Bundesliga","Leonardo Bittencourt","GER","MF,FW","26",1993,16.8,58,32,24,28,6,16,51,31.4,35,29,2,27,13,71,10,0,"https://fbref.com/en/players/dc62fbee/Leonardo-Bittencourt"
"8081","Tahith Chong_2021",2021,"Werder Bremen","Bundesliga","Tahith Chong","NED","MF,FW","20",1999,4.3,11,6,1,9,1,4,8,50,4,4,0,4,5,16,1,0,"https://fbref.com/en/players/2696b6a9/Tahith-Chong"
"8082","Eren Dinkçi_2021",2021,"Werder Bremen","Bundesliga","Eren Dinkçi","GER","MF,FW","18",2001,1.2,1,1,1,0,0,0,1,0,1,4,0,4,2,3,1,0,"https://fbref.com/en/players/4ccd8957/Eren-Dinkci"
"8083","Johannes Eggestein_2021",2021,"Werder Bremen","Bundesliga","Johannes Eggestein","GER","FW,MF","22",1998,0.4,0,0,0,0,0,0,1,0,1,0,0,0,1,1,2,0,"https://fbref.com/en/players/d571df78/Johannes-Eggestein"
"8084","Maximilian Eggestein_2021",2021,"Werder Bremen","Bundesliga","Maximilian Eggestein","GER","MF","23",1996,32.7,57,42,22,29,6,21,46,45.7,25,30,5,25,43,100,36,0,"https://fbref.com/en/players/beb882a8/Maximilian-Eggestein"
"8085","Patrick Erras_2021",2021,"Werder Bremen","Bundesliga","Patrick Erras","GER","FW,MF","25",1995,0.3,0,0,0,0,0,0,1,0,1,0,0,0,0,0,0,0,"https://fbref.com/en/players/e3f6253d/Patrick-Erras"
"8086","Marco Friedl_2021",2021,"Werder Bremen","Bundesliga","Marco Friedl","AUT","DF","22",1998,30.9,50,34,31,17,2,30,62,48.4,32,38,17,21,55,105,118,1,"https://fbref.com/en/players/f86ad3f5/Marco-Friedl"
"8087","Niclas Füllkrug_2021",2021,"Werder Bremen","Bundesliga","Niclas Füllkrug","GER","FW","27",1993,9.7,7,3,2,4,1,1,13,7.7,12,10,4,6,3,10,13,0,"https://fbref.com/en/players/4f16405e/Niclas-Fullkrug"
"8088","Theodor Gebre Selassie_2021",2021,"Werder Bremen","Bundesliga","Theodor Gebre Selassie","CZE","DF","33",1986,33.7,61,35,39,17,5,28,64,43.8,36,33,11,22,58,119,98,1,"https://fbref.com/en/players/3f65898c/Theodor-Gebre-Selassie"
"8089","Christian Groß_2021",2021,"Werder Bremen","Bundesliga","Christian Groß","GER","MF,DF","31",1989,16.3,44,28,17,25,2,15,37,40.5,22,12,2,10,24,68,37,0,"https://fbref.com/en/players/14a7af33/Christian-Gross"
"8090","Ilia Gruev_2021",2021,"Werder Bremen","Bundesliga","Ilia Gruev","BUL","FW","20",2000,0,0,0,0,0,0,0,0,NA,0,0,0,0,0,0,0,0,"https://fbref.com/en/players/1fc4f3d1/Ilia-Gruev"
"8091","Davy Klaassen_2021",2021,"Werder Bremen","Bundesliga","Davy Klaassen","NED","MF","27",1993,2.5,3,1,0,1,2,0,5,0,5,5,1,4,3,6,4,0,"https://fbref.com/en/players/15fd5593/Davy-Klaassen"
"8092","Jean-Manuel Mbom_2021",2021,"Werder Bremen","Bundesliga","Jean-Manuel Mbom","GER","MF,DF","20",2000,12.9,19,13,14,3,2,8,27,29.6,19,17,6,11,13,32,27,0,"https://fbref.com/en/players/1a5d7cb9/Jean-Manuel-Mbom"
"8093","Kevin Möhwald_2021",2021,"Werder Bremen","Bundesliga","Kevin Möhwald","GER","MF","27",1993,17.3,15,9,9,5,1,4,18,22.2,14,10,3,7,32,47,19,2,"https://fbref.com/en/players/a5ce09f2/Kevin-Mohwald"
"8094","Niklas Moisander_2021",2021,"Werder Bremen","Bundesliga","Niklas Moisander","FIN","DF","34",1985,13.6,14,11,11,3,0,8,14,57.1,6,15,8,7,22,36,61,0,"https://fbref.com/en/players/00844823/Niklas-Moisander"
"8095","Yuya Osako_2021",2021,"Werder Bremen","Bundesliga","Yuya Osako","JPN","MF,FW","30",1990,8.5,12,8,2,5,5,2,9,22.2,7,6,1,5,5,17,7,0,"https://fbref.com/en/players/f69fba57/Yuya-Osako"
"8096","Jiří Pavlenka_2021",2021,"Werder Bremen","Bundesliga","Jiří Pavlenka","CZE","GK","28",1992,34,2,0,2,0,0,2,2,100,0,0,0,0,1,3,17,4,"https://fbref.com/en/players/0a1cb833/Jiri-Pavlenka"
"8097","Milot Rashica_2021",2021,"Werder Bremen","Bundesliga","Milot Rashica","KVX","FW,MF","24",1996,16.2,24,12,11,11,2,12,23,52.2,11,7,0,7,4,28,6,0,"https://fbref.com/en/players/6c6a3300/Milot-Rashica"
"8098","Josh Sargent_2021",2021,"Werder Bremen","Bundesliga","Josh Sargent","USA","FW,MF","20",2000,27.8,32,19,13,13,6,13,27,48.1,14,39,4,35,17,49,36,0,"https://fbref.com/en/players/a8d4428b/Josh-Sargent"
"8099","Romano Schmid_2021",2021,"Werder Bremen","Bundesliga","Romano Schmid","AUT","MF,FW","20",2000,13.1,22,16,8,10,4,8,35,22.9,27,21,0,21,8,30,6,0,"https://fbref.com/en/players/220ace7e/Romano-Schmid"
"8100","Davie Selke_2021",2021,"Werder Bremen","Bundesliga","Davie Selke","GER","FW","25",1995,9,3,2,1,1,1,0,6,0,6,3,2,1,1,4,7,0,"https://fbref.com/en/players/1238a3f9/Davie-Selke"
"8101","Ömer Toprak_2021",2021,"Werder Bremen","Bundesliga","Ömer Toprak","TUR","DF","31",1989,21.6,23,16,15,6,2,12,24,50,12,27,16,11,36,59,115,1,"https://fbref.com/en/players/c5fd13e9/Omer-Toprak"
"8102","Miloš Veljković_2021",2021,"Werder Bremen","Bundesliga","Miloš Veljković","SRB","DF","24",1995,19.1,24,14,17,6,1,15,31,48.4,16,22,9,13,29,53,94,1,"https://fbref.com/en/players/a5ae8f8e/Milos-Veljkovic"
"8103","Nick Woltemade_2021",2021,"Werder Bremen","Bundesliga","Nick Woltemade","GER","MF,FW","18",2002,1.6,3,2,1,1,1,2,4,50,2,1,0,1,0,3,0,0,"https://fbref.com/en/players/7ca196eb/Nick-Woltemade"
"8104","Semi Ajayi_2021",2021,"West Brom","Premier League","Semi Ajayi","NGA","DF","26",1993,30.9,40,14,34,6,0,23,41,56.1,18,51,32,19,42,82,122,2,"https://fbref.com/en/players/d6192210/Semi-Ajayi"
"8105","Charlie Austin_2021",2021,"West Brom","Premier League","Charlie Austin","ENG","FW,MF","31",1989,1.5,4,2,1,2,1,1,3,33.3,2,0,0,0,3,7,4,0,"https://fbref.com/en/players/8d228291/Charlie-Austin"
"8106","Kyle Bartley_2021",2021,"West Brom","Premier League","Kyle Bartley","ENG","DF","29",1991,28.7,27,16,14,10,3,11,23,47.8,12,50,35,15,38,65,159,1,"https://fbref.com/en/players/18e96f64/Kyle-Bartley"
"8107","David Button_2021",2021,"West Brom","Premier League","David Button","ENG","GK","31",1989,1,0,0,0,0,0,0,0,NA,0,0,0,0,0,0,0,0,"https://fbref.com/en/players/e608ed4c/David-Button"
"8108","Mbaye Diagne_2021",2021,"West Brom","Premier League","Mbaye Diagne","SEN","FW","28",1991,13.2,4,3,3,0,1,1,4,25,3,2,1,1,1,5,16,0,"https://fbref.com/en/players/dda3969e/Mbaye-Diagne"
"8109","Grady Diangana_2021",2021,"West Brom","Premier League","Grady Diangana","ENG","MF,FW","22",1998,13.7,35,19,19,9,7,19,43,44.2,24,16,2,14,16,51,9,0,"https://fbref.com/en/players/f522d7ec/Grady-Diangana"
"8110","Kyle Edwards_2021",2021,"West Brom","Premier League","Kyle Edwards","ENG","MF,FW","22",1998,1.3,3,2,1,1,1,0,0,NA,0,2,0,2,1,4,0,0,"https://fbref.com/en/players/1566e437/Kyle-Edwards"
"8111","Sam Field_2021",2021,"West Brom","Premier League","Sam Field","ENG","MF","22",1998,0.7,5,5,3,2,0,0,0,NA,0,4,1,3,2,7,4,0,"https://fbref.com/en/players/bd8a7d05/Sam-Field"
"8112","Darnell Furlong_2021",2021,"West Brom","Premier League","Darnell Furlong","ENG","DF","24",1995,32.6,45,27,27,12,6,21,44,47.7,23,39,16,23,49,94,90,0,"https://fbref.com/en/players/3ec9195b/Darnell-Furlong"
"8113","Conor Gallagher_2021",2021,"West Brom","Premier League","Conor Gallagher","ENG","MF","20",2000,28.1,81,41,30,39,12,29,97,29.9,68,47,8,39,27,108,31,0,"https://fbref.com/en/players/c2731c10/Conor-Gallagher"
"8114","Kieran Gibbs_2021",2021,"West Brom","Premier League","Kieran Gibbs","ENG","DF","30",1989,9,15,11,11,3,1,8,10,80,2,8,6,2,16,31,30,1,"https://fbref.com/en/players/46ee5234/Kieran-Gibbs"
"8115","Karlan Grant_2021",2021,"West Brom","Premier League","Karlan Grant","ENG","FW,MF","22",1997,12.5,5,3,3,2,0,2,4,50,2,7,0,7,5,10,17,0,"https://fbref.com/en/players/87f7500e/Karlan-Grant"
"8116","Kamil Grosicki_2021",2021,"West Brom","Premier League","Kamil Grosicki","POL","MF,FW","32",1988,1.6,2,1,2,0,0,2,8,25,6,1,0,1,2,4,1,0,"https://fbref.com/en/players/81d8091f/Kamil-Grosicki"
"8117","Rekeem Harper_2021",2021,"West Brom","Premier League","Rekeem Harper","ENG","MF","20",2000,0.4,0,0,0,0,0,0,0,NA,0,2,0,2,1,1,0,0,"https://fbref.com/en/players/3c066877/Rekeem-Harper"
"8118","Ahmed Hegazi_2021",2021,"West Brom","Premier League","Ahmed Hegazi","EGY","DF","29",1991,1,0,0,0,0,0,0,0,NA,0,2,0,2,1,1,7,0,"https://fbref.com/en/players/5540c9dc/Ahmed-Hegazi"
"8119","Branislav Ivanović_2021",2021,"West Brom","Premier League","Branislav Ivanović","SRB","DF","36",1984,8.5,14,5,11,3,0,7,13,53.8,6,11,5,6,8,22,25,0,"https://fbref.com/en/players/85f8571a/Branislav-Ivanovic"
"8120","Sam Johnstone_2021",2021,"West Brom","Premier League","Sam Johnstone","ENG","GK","27",1993,37,0,0,0,0,0,0,0,NA,0,0,0,0,2,2,15,2,"https://fbref.com/en/players/9e5708be/Sam-Johnstone"
"8121","Filip Krovinović_2021",2021,"West Brom","Premier League","Filip Krovinović","CRO","MF","24",1995,6.1,13,10,6,5,2,6,18,33.3,12,2,0,2,4,17,2,0,"https://fbref.com/en/players/c2dfedeb/Filip-Krovinovic"
"8122","Jake Livermore_2021",2021,"West Brom","Premier League","Jake Livermore","ENG","MF","30",1989,13.8,33,18,14,16,3,14,31,45.2,17,21,6,15,16,49,26,0,"https://fbref.com/en/players/b98570d1/Jake-Livermore"
"8123","Ainsley Maitland-Niles_2021",2021,"West Brom","Premier League","Ainsley Maitland-Niles","ENG","MF","22",1997,13.7,22,10,7,8,7,9,28,32.1,19,12,1,11,17,39,24,0,"https://fbref.com/en/players/e3a5814e/Ainsley-Maitland-Niles"
"8124","Dara O'Shea_2021",2021,"West Brom","Premier League","Dara O'Shea","IRL","DF","21",1999,23.4,45,25,30,13,2,21,45,46.7,24,32,17,15,45,90,108,0,"https://fbref.com/en/players/1d042188/Dara-OShea"
"8125","Lee Peltier_2021",2021,"West Brom","Premier League","Lee Peltier","ENG","DF","33",1986,2.5,9,4,8,1,0,4,4,100,0,1,1,0,1,10,11,0,"https://fbref.com/en/players/af341b88/Lee-Peltier"
"8126","Matheus Pereira_2021",2021,"West Brom","Premier League","Matheus Pereira","POR","MF,FW","24",1996,28.6,26,15,14,10,2,12,54,22.2,42,18,0,18,29,55,16,0,"https://fbref.com/en/players/b04ee927/Matheus-Pereira"
"8127","Matt Phillips_2021",2021,"West Brom","Premier League","Matt Phillips","SCO","MF","29",1991,20.3,15,8,4,11,0,7,23,30.4,16,32,4,28,10,25,32,1,"https://fbref.com/en/players/7bb5f40e/Matt-Phillips"
"8128","Callum Robinson_2021",2021,"West Brom","Premier League","Callum Robinson","IRL","FW,MF","25",1995,17.3,7,5,5,1,1,3,19,15.8,16,9,0,9,7,14,8,0,"https://fbref.com/en/players/e75750a3/Callum-Robinson"
"8129","Hal Robson-Kanu_2021",2021,"West Brom","Premier League","Hal Robson-Kanu","WAL","FW","31",1989,6.2,2,1,1,0,1,0,1,0,1,2,0,2,2,4,7,0,"https://fbref.com/en/players/fb2dec57/Hal-Robson-Kanu"
"8130","Romaine Sawyers_2021",2021,"West Brom","Premier League","Romaine Sawyers","SKN","MF","28",1991,16.5,30,18,16,12,2,14,43,32.6,29,20,4,16,18,48,12,3,"https://fbref.com/en/players/77bb1522/Romaine-Sawyers"
"8131","Robert Snodgrass_2021",2021,"West Brom","Premier League","Robert Snodgrass","SCO","MF,FW","32",1987,5.8,17,12,12,4,1,10,16,62.5,6,11,2,9,1,18,12,0,"https://fbref.com/en/players/9f4647e9/Robert-Snodgrass"
"8132","Conor Townsend_2021",2021,"West Brom","Premier League","Conor Townsend","ENG","DF","27",1993,24.8,44,28,32,9,3,30,49,61.2,19,38,15,23,36,80,55,2,"https://fbref.com/en/players/4dc4f138/Conor-Townsend"
"8133","Okay Yokuşlu_2021",2021,"West Brom","Premier League","Okay Yokuşlu","TUR","MF","26",1994,14.6,38,25,21,13,4,17,35,48.6,18,15,3,12,35,73,33,1,"https://fbref.com/en/players/e49ce451/Okay-Yokuslu"
"8134","Felipe Anderson_2021",2021,"West Ham","Premier League","Felipe Anderson","BRA","FW,MF","27",1993,0,1,1,0,1,0,0,0,NA,0,0,0,0,0,1,0,0,"https://fbref.com/en/players/9f1893b9/Felipe-Anderson"
"8135","Michail Antonio_2021",2021,"West Ham","Premier League","Michail Antonio","JAM","FW","30",1990,21.9,7,4,1,5,1,1,7,14.3,6,20,3,17,7,14,7,0,"https://fbref.com/en/players/ac05f970/Michail-Antonio"
"8136","Fabián Balbuena_2021",2021,"West Ham","Premier League","Fabián Balbuena","PAR","DF","28",1991,13.3,24,12,23,1,0,14,23,60.9,9,23,6,17,25,49,63,0,"https://fbref.com/en/players/3626f7d9/Fabian-Balbuena"
"8137","Saïd Benrahma_2021",2021,"West Ham","Premier League","Saïd Benrahma","ALG","FW,MF","24",1995,15.5,24,15,8,11,5,8,28,28.6,20,10,0,10,8,32,8,0,"https://fbref.com/en/players/5a04fd92/Said-Benrahma"
"8138","Jarrod Bowen_2021",2021,"West Ham","Premier League","Jarrod Bowen","ENG","FW,MF","23",1996,28.5,26,15,12,7,7,10,29,34.5,19,19,1,18,22,48,10,0,"https://fbref.com/en/players/79c84d1c/Jarrod-Bowen"
"8139","Vladimír Coufal_2021",2021,"West Ham","Premier League","Vladimír Coufal","CZE","DF","27",1992,33.9,73,36,50,15,8,52,89,58.4,37,41,7,34,41,114,102,1,"https://fbref.com/en/players/fdf3cb77/Vladimir-Coufal"
"8140","Aaron Cresswell_2021",2021,"West Ham","Premier League","Aaron Cresswell","ENG","DF","30",1989,35.2,32,13,15,15,2,18,32,56.3,14,29,14,15,32,64,79,2,"https://fbref.com/en/players/4f974391/Aaron-Cresswell"
"8141","Craig Dawson_2021",2021,"West Ham","Premier League","Craig Dawson","ENG","DF","30",1990,21.4,11,8,7,4,0,5,12,41.7,7,26,22,4,32,43,88,3,"https://fbref.com/en/players/3e9e06cb/Craig-Dawson"
"8142","Issa Diop_2021",2021,"West Ham","Premier League","Issa Diop","FRA","DF","23",1997,15.3,20,14,12,8,0,7,18,38.9,11,32,22,10,22,42,59,0,"https://fbref.com/en/players/a712ca2b/Issa-Diop"
"8143","Łukasz Fabiański_2021",2021,"West Ham","Premier League","Łukasz Fabiański","POL","GK","35",1985,35,1,0,1,0,0,1,1,100,0,1,0,1,1,2,12,3,"https://fbref.com/en/players/9328b835/Lukasz-Fabianski"
"8144","Pablo Fornals_2021",2021,"West Ham","Premier League","Pablo Fornals","ESP","FW,MF","24",1996,28.6,44,26,14,24,6,11,73,15.1,62,43,1,42,36,80,9,0,"https://fbref.com/en/players/82927de4/Pablo-Fornals"
"8145","Ryan Fredericks_2021",2021,"West Ham","Premier League","Ryan Fredericks","ENG","DF,FW","27",1992,6.3,9,5,5,4,0,3,7,42.9,4,6,2,4,11,20,20,0,"https://fbref.com/en/players/c067631c/Ryan-Fredericks"
"8146","Sébastien Haller_2021",2021,"West Ham","Premier League","Sébastien Haller","CIV","FW","26",1994,10.4,14,9,1,6,7,4,20,20,16,7,1,6,5,19,7,0,"https://fbref.com/en/players/ba115a40/Sebastien-Haller"
"8147","Ben Johnson_2021",2021,"West Ham","Premier League","Ben Johnson","ENG","DF,FW","20",2000,5.8,11,5,5,3,3,7,9,77.8,2,5,1,4,11,22,9,0,"https://fbref.com/en/players/9319781b/Ben-Johnson"
"8148","Manuel Lanzini_2021",2021,"West Ham","Premier League","Manuel Lanzini","ARG","MF,FW","27",1993,6.3,9,2,3,4,2,3,10,30,7,9,0,9,7,16,5,0,"https://fbref.com/en/players/26f6dca8/Manuel-Lanzini"
"8149","Jesse Lingard_2021",2021,"West Ham","Premier League","Jesse Lingard","ENG","MF,FW","27",1992,15.8,12,6,4,8,0,5,14,35.7,9,7,1,6,4,16,0,0,"https://fbref.com/en/players/810e3c74/Jesse-Lingard"
"8150","Arthur Masuaku_2021",2021,"West Ham","Premier League","Arthur Masuaku","COD","DF,MF","26",1993,11.2,20,12,14,6,0,11,34,32.4,23,12,0,12,8,28,28,2,"https://fbref.com/en/players/57df7a11/Arthur-Masuaku"
"8151","Mark Noble_2021",2021,"West Ham","Premier League","Mark Noble","ENG","MF","33",1987,7.9,8,4,2,5,1,4,14,28.6,10,7,3,4,13,21,3,0,"https://fbref.com/en/players/ff527768/Mark-Noble"
"8152","Angelo Ogbonna_2021",2021,"West Ham","Premier League","Angelo Ogbonna","ITA","DF","32",1988,27.7,26,13,20,5,1,9,17,52.9,8,25,11,14,30,56,119,0,"https://fbref.com/en/players/74b2cd7e/Angelo-Ogbonna"
"8153","Darren Randolph_2021",2021,"West Ham","Premier League","Darren Randolph","IRL","GK","33",1987,3,0,0,0,0,0,0,0,NA,0,0,0,0,0,0,1,0,"https://fbref.com/en/players/6385ebfb/Darren-Randolph"
"8154","Declan Rice_2021",2021,"West Ham","Premier League","Declan Rice","ENG","MF","21",1999,32,59,35,33,25,1,21,51,41.2,30,39,11,28,59,118,41,0,"https://fbref.com/en/players/1c7012b8/Declan-Rice"
"8155","Robert Snodgrass_2021",2021,"West Ham","Premier League","Robert Snodgrass","SCO","FW,MF","32",1987,0.1,0,0,0,0,0,0,0,NA,0,0,0,0,0,0,0,0,"https://fbref.com/en/players/9f4647e9/Robert-Snodgrass"
"8156","Tomáš Souček_2021",2021,"West Ham","Premier League","Tomáš Souček","CZE","MF","25",1995,38,78,41,37,36,5,28,77,36.4,49,43,18,25,62,140,107,0,"https://fbref.com/en/players/6613c819/Tomas-Soucek"
"8157","Andriy Yarmolenko_2021",2021,"West Ham","Premier League","Andriy Yarmolenko","UKR","FW,MF","30",1989,4.2,5,4,2,2,1,2,8,25,6,1,0,1,1,6,2,0,"https://fbref.com/en/players/849c826a/Andriy-Yarmolenko"
"8158","Maximilian Arnold_2021",2021,"Wolfsburg","Bundesliga","Maximilian Arnold","GER","MF","26",1994,28.7,47,32,20,26,1,18,49,36.7,31,24,3,21,49,96,57,0,"https://fbref.com/en/players/86e119e0/Maximilian-Arnold"
"8159","Ridle Baku_2021",2021,"Wolfsburg","Bundesliga","Ridle Baku","GER","FW,DF","22",1998,29.8,50,31,20,20,10,22,53,41.5,31,54,4,50,40,90,33,1,"https://fbref.com/en/players/442b56fa/Ridle-Baku"
"8160","Bartosz Bialek_2021",2021,"Wolfsburg","Bundesliga","Bartosz Bialek","POL","FW,MF","18",2001,3,6,5,1,4,1,4,4,100,0,5,1,4,3,9,4,0,"https://fbref.com/en/players/763b8b37/Bartosz-Bialek"
"8161","Josip Brekalo_2021",2021,"Wolfsburg","Bundesliga","Josip Brekalo","CRO","FW","22",1998,20.2,22,10,10,7,5,8,29,27.6,21,18,0,18,17,39,3,1,"https://fbref.com/en/players/d4a2533d/Josip-Brekalo"
"8162","John Brooks_2021",2021,"Wolfsburg","Bundesliga","John Brooks","USA","DF","27",1993,30.8,47,29,33,14,0,30,54,55.6,24,35,10,25,55,102,134,0,"https://fbref.com/en/players/e27da244/John-Brooks"
"8163","Koen Casteels_2021",2021,"Wolfsburg","Bundesliga","Koen Casteels","BEL","GK","28",1992,32,0,0,0,0,0,0,1,0,1,1,0,1,2,2,9,2,"https://fbref.com/en/players/db401046/Koen-Casteels"
"8164","Yannick Gerhardt_2021",2021,"Wolfsburg","Bundesliga","Yannick Gerhardt","GER","MF,FW","26",1994,21.5,52,32,14,32,6,21,52,40.4,31,34,4,30,21,73,30,0,"https://fbref.com/en/players/62ab9184/Yannick-Gerhardt"
"8165","Daniel Ginczek_2021",2021,"Wolfsburg","Bundesliga","Daniel Ginczek","GER","FW,MF","29",1991,2.4,2,2,1,1,0,2,8,25,6,2,0,2,1,3,2,0,"https://fbref.com/en/players/e5f63987/Daniel-Ginczek"
"8166","Josuha Guilavogui_2021",2021,"Wolfsburg","Bundesliga","Josuha Guilavogui","FRA","MF,DF","29",1990,8.3,17,9,9,8,0,5,12,41.7,7,12,5,7,29,46,25,0,"https://fbref.com/en/players/e6c43eec/Josuha-Guilavogui"
"8167","Felix Klaus_2021",2021,"Wolfsburg","Bundesliga","Felix Klaus","GER","DF,MF","27",1992,1.5,7,4,3,4,0,4,5,80,1,4,0,4,2,9,4,0,"https://fbref.com/en/players/aeda1f69/Felix-Klaus"
"8168","Maxence Lacroix_2021",2021,"Wolfsburg","Bundesliga","Maxence Lacroix","FRA","DF","20",2000,28.8,49,29,37,12,0,24,45,53.3,21,51,21,30,65,114,140,1,"https://fbref.com/en/players/277c49ed/Maxence-Lacroix"
"8169","Yunus Mallı_2021",2021,"Wolfsburg","Bundesliga","Yunus Mallı","TUR","MF","28",1992,0.6,1,0,0,1,0,1,1,100,0,0,0,0,0,1,0,0,"https://fbref.com/en/players/f3722c97/Yunus-Malli"
"8170","Omar Marmoush_2021",2021,"Wolfsburg","Bundesliga","Omar Marmoush","EGY","FW","21",1999,0,0,0,0,0,0,0,0,NA,0,0,0,0,0,0,0,0,"https://fbref.com/en/players/0e0102eb/Omar-Marmoush"
"8171","Kevin Mbabu_2021",2021,"Wolfsburg","Bundesliga","Kevin Mbabu","SUI","DF","25",1995,18.2,51,33,27,17,7,24,35,68.6,11,28,7,21,22,73,59,1,"https://fbref.com/en/players/493924a7/Kevin-Mbabu"
"8172","Admir Mehmedi_2021",2021,"Wolfsburg","Bundesliga","Admir Mehmedi","SUI","MF,FW","29",1991,9.1,17,9,6,7,4,6,16,37.5,10,7,0,7,5,22,1,0,"https://fbref.com/en/players/b500b384/Admir-Mehmedi"
"8173","Paulo Otávio_2021",2021,"Wolfsburg","Bundesliga","Paulo Otávio","BRA","DF","25",1994,19.3,60,40,32,22,6,34,62,54.8,28,51,7,44,42,102,59,0,"https://fbref.com/en/players/1cbe4984/Paulo-Otavio"
"8174","Pavao Pervan_2021",2021,"Wolfsburg","Bundesliga","Pavao Pervan","AUT","GK","32",1987,2,0,0,0,0,0,0,0,NA,0,0,0,0,0,0,1,0,"https://fbref.com/en/players/c89e8aae/Pavao-Pervan"
"8175","Maximilian Philipp_2021",2021,"Wolfsburg","Bundesliga","Maximilian Philipp","GER","MF","26",1994,12.3,15,6,3,6,6,5,21,23.8,16,17,0,17,6,21,3,0,"https://fbref.com/en/players/061e8e23/Maximilian-Philipp"
"8176","Marin Pongračić_2021",2021,"Wolfsburg","Bundesliga","Marin Pongračić","CRO","DF","22",1997,6.4,13,9,9,3,1,6,8,75,2,12,5,7,11,24,27,0,"https://fbref.com/en/players/2a6cd437/Marin-Pongracic"
"8177","Jérôme Roussillon_2021",2021,"Wolfsburg","Bundesliga","Jérôme Roussillon","FRA","DF","27",1993,13.7,24,12,14,8,2,11,20,55,9,10,1,9,19,43,28,0,"https://fbref.com/en/players/13203c45/Jerome-Roussillon"
"8178","João Victor Santos Sá_2021",2021,"Wolfsburg","Bundesliga","João Victor Santos Sá","BRA","FW","26",1994,5.2,9,6,2,6,1,6,11,54.5,5,11,0,11,8,17,2,0,"https://fbref.com/en/players/1a1033a1/Joao-Victor-Santos-Sa"
"8179","Xaver Schlager_2021",2021,"Wolfsburg","Bundesliga","Xaver Schlager","AUT","MF","22",1997,29.2,66,40,20,38,8,22,68,32.4,46,50,6,44,54,120,38,0,"https://fbref.com/en/players/8f056768/Xaver-Schlager"
"8180","Tim Siersleben_2021",2021,"Wolfsburg","Bundesliga","Tim Siersleben","GER","DF","20",2000,0.4,2,2,2,0,0,1,1,100,0,1,0,1,0,2,0,0,"https://fbref.com/en/players/f761c901/Tim-Siersleben"
"8181","Renato Steffen_2021",2021,"Wolfsburg","Bundesliga","Renato Steffen","SUI","FW,MF","28",1991,17.4,24,15,6,12,6,13,24,54.2,11,21,2,19,22,46,15,0,"https://fbref.com/en/players/dd669209/Renato-Steffen"
"8182","Wout Weghorst_2021",2021,"Wolfsburg","Bundesliga","Wout Weghorst","NED","FW","27",1992,32.7,13,8,2,8,3,4,20,20,16,17,3,14,4,17,26,0,"https://fbref.com/en/players/c4e87b8b/Wout-Weghorst"
"8183","William_2021",2021,"Wolfsburg","Bundesliga","William","BRA","MF,FW","25",1995,0,0,0,0,0,0,0,0,NA,0,0,0,0,0,0,0,0,"https://fbref.com/en/players/d4d0a9ad/William"
"8184","Rayan Aït Nouri_2021",2021,"Wolves","Premier League","Rayan Aït Nouri","ALG","DF","19",2001,15.6,29,16,18,10,1,13,27,48.1,14,14,1,13,15,44,25,0,"https://fbref.com/en/players/9b398aea/Rayan-Ait-Nouri"
"8185","Willy Boly_2021",2021,"Wolves","Premier League","Willy Boly","CIV","DF","29",1991,20.9,33,20,26,7,0,13,24,54.2,11,18,12,6,32,65,84,1,"https://fbref.com/en/players/a4ac4b8f/Willy-Boly"
"8186","Oskar Buur_2021",2021,"Wolves","Premier League","Oskar Buur","DEN","DF","22",1998,0.2,0,0,0,0,0,0,2,0,2,0,0,0,0,0,0,0,"https://fbref.com/en/players/aa6f2f2c/Oskar-Buur"
"8187","Jonny Castro_2021",2021,"Wolves","Premier League","Jonny Castro","ESP","MF,DF","26",1994,5.5,11,5,6,4,1,6,13,46.2,7,9,3,6,9,20,7,0,"https://fbref.com/en/players/e28868f3/Jonny-Castro"
"8188","Conor Coady_2021",2021,"Wolves","Premier League","Conor Coady","ENG","DF","27",1993,36.7,35,23,25,10,0,19,35,54.3,16,40,32,8,27,62,134,2,"https://fbref.com/en/players/2928dca2/Conor-Coady"
"8189","Theo Corbeanu_2021",2021,"Wolves","Premier League","Theo Corbeanu","CAN","FW","18",2002,0.1,2,1,0,2,0,1,1,100,0,0,0,0,1,3,0,0,"https://fbref.com/en/players/25b82f9a/Theo-Corbeanu"
"8190","Patrick Cutrone_2021",2021,"Wolves","Premier League","Patrick Cutrone","ITA","FW","22",1998,0.3,0,0,0,0,0,0,0,NA,0,0,0,0,0,0,0,0,"https://fbref.com/en/players/a4fe8cda/Patrick-Cutrone"
"8191","Leander Dendoncker_2021",2021,"Wolves","Premier League","Leander Dendoncker","BEL","MF,DF","25",1995,27.8,54,29,29,22,3,31,60,51.7,29,38,15,23,27,81,52,2,"https://fbref.com/en/players/5a7301ae/Leander-Dendoncker"
"8192","Morgan Gibbs-White_2021",2021,"Wolves","Premier League","Morgan Gibbs-White","ENG","MF,FW","20",2000,4.6,9,7,3,4,2,5,12,41.7,7,6,0,6,3,12,1,0,"https://fbref.com/en/players/32f60ed8/Morgan-Gibbs-White"
"8193","Ki-Jana Hoever_2021",2021,"Wolves","Premier League","Ki-Jana Hoever","NED","DF,MF","18",2002,6.4,14,6,11,2,1,10,22,45.5,12,2,0,2,9,23,23,0,"https://fbref.com/en/players/9a71e978/Ki-Jana-Hoever"
"8194","Raúl Jiménez_2021",2021,"Wolves","Premier League","Raúl Jiménez","MEX","FW","29",1991,9.1,3,2,1,2,0,0,7,0,7,2,0,2,8,11,12,0,"https://fbref.com/en/players/b561db50/Raul-Jimenez"
"8195","Willian José_2021",2021,"Wolves","Premier League","Willian José","BRA","FW","28",1991,12.3,2,1,1,1,0,1,4,25,3,6,1,5,1,3,12,0,"https://fbref.com/en/players/d87e2cae/Willian-Jose"
"8196","Max Kilman_2021",2021,"Wolves","Premier League","Max Kilman","ENG","DF","23",1997,14.6,21,14,13,4,4,8,14,57.1,6,17,8,9,19,40,46,0,"https://fbref.com/en/players/d0f72bf1/Max-Kilman"
"8197","Fernando Marçal_2021",2021,"Wolves","Premier League","Fernando Marçal","BRA","DF,MF","31",1989,6.9,13,5,6,7,0,6,11,54.5,5,11,2,9,12,25,25,0,"https://fbref.com/en/players/9ae9eaea/Fernando-Marcal"
"8198","João Moutinho_2021",2021,"Wolves","Premier League","João Moutinho","POR","MF","33",1986,28.1,75,40,34,35,6,35,91,38.5,56,18,3,15,47,122,28,0,"https://fbref.com/en/players/f5a00fa4/Joao-Moutinho"
"8199","Pedro Neto_2021",2021,"Wolves","Premier League","Pedro Neto","POR","FW,MF","20",2000,28.3,16,9,4,6,6,6,28,21.4,22,18,2,16,31,47,8,0,"https://fbref.com/en/players/7ba2eaa9/Pedro-Neto"
"8200","Rúben Neves_2021",2021,"Wolves","Premier League","Rúben Neves","POR","MF","23",1997,29.7,86,46,42,38,6,36,88,40.9,52,55,11,44,65,151,46,2,"https://fbref.com/en/players/44bfb6c5/Ruben-Neves"
"8201","Owen Otasowie_2021",2021,"Wolves","Premier League","Owen Otasowie","USA","MF,FW","19",2001,2.1,5,5,3,2,0,1,2,50,1,1,1,0,3,8,4,0,"https://fbref.com/en/players/6956ff08/Owen-Otasowie"
"8202","Rui Patrício_2021",2021,"Wolves","Premier League","Rui Patrício","POR","GK","32",1988,37,0,0,0,0,0,0,1,0,1,0,0,0,1,1,3,3,"https://fbref.com/en/players/79b0d6a0/Rui-Patricio"
"8203","Daniel Podence_2021",2021,"Wolves","Premier League","Daniel Podence","POR","MF,FW","24",1995,18.5,12,6,5,5,2,2,19,10.5,17,5,1,4,13,25,2,0,"https://fbref.com/en/players/7fcc71d8/Daniel-Podence"
"8204","John Ruddy_2021",2021,"Wolves","Premier League","John Ruddy","ENG","GK","33",1986,1,0,0,0,0,0,0,0,NA,0,0,0,0,0,0,0,0,"https://fbref.com/en/players/da8b19e2/John-Ruddy"
"8205","Romain Saïss_2021",2021,"Wolves","Premier League","Romain Saïss","MAR","DF","30",1990,26.7,35,24,23,12,0,19,33,57.6,14,28,13,15,52,87,115,1,"https://fbref.com/en/players/9fbbcf39/Romain-Saiss"
"8206","Nélson Semedo_2021",2021,"Wolves","Premier League","Nélson Semedo","POR","DF,MF","26",1993,33.1,85,48,53,23,9,42,72,58.3,30,30,10,20,41,126,78,2,"https://fbref.com/en/players/d04b94db/Nelson-Semedo"
"8207","Fábio Silva_2021",2021,"Wolves","Premier League","Fábio Silva","POR","FW","18",2002,15.2,6,4,1,4,1,4,12,33.3,8,12,1,11,4,10,5,1,"https://fbref.com/en/players/e7aa9d7c/Fabio-Silva"
"8208","Adama Traoré_2021",2021,"Wolves","Premier League","Adama Traoré","ESP","FW,MF","24",1996,29.4,28,16,11,13,4,13,21,61.9,8,23,1,22,7,35,12,1,"https://fbref.com/en/players/9a28eba4/Adama-Traore"
"8209","Rúben Vinagre_2021",2021,"Wolves","Premier League","Rúben Vinagre","POR","MF,DF","21",1999,1.9,7,5,5,2,0,3,4,75,1,3,0,3,2,9,4,0,"https://fbref.com/en/players/b937e490/Ruben-Vinagre"
"8210","Vitinha_2021",2021,"Wolves","Premier League","Vitinha","POR","MF","20",2000,5.8,7,3,2,5,0,3,8,37.5,5,3,0,3,3,10,1,0,"https://fbref.com/en/players/3b029691/Vitinha"
"8211","Martin Agirregabiria_2022",2022,"Alavés","La Liga","Martin Agirregabiria","ESP","DF","25",1996,18,34,22,17,11,6,18,37,48.6,19,20,3,17,25,59,38,0,"https://fbref.com/en/players/355c883a/Martin-Agirregabiria"
"8212","Rubén Duarte_2022",2022,"Alavés","La Liga","Rubén Duarte","ESP","DF","25",1995,29.1,76,47,43,27,6,43,85,50.6,42,40,6,34,57,133,82,0,"https://fbref.com/en/players/1fe0492d/Ruben-Duarte"
"8213","Gonzalo Escalante_2022",2022,"Alavés","La Liga","Gonzalo Escalante","ARG","MF","28",1993,14.4,30,14,9,20,1,13,34,38.2,21,27,2,25,21,51,28,0,"https://fbref.com/en/players/3f79a1c8/Gonzalo-Escalante"
"8214","Manu García_2022",2022,"Alavés","La Liga","Manu García","ESP","MF","23",1998,12,18,9,6,9,3,9,27,33.3,18,8,2,6,13,31,4,0,"https://fbref.com/en/players/6ed1a2a2/Manu-Garcia"
"8215","Saúl García_2022",2022,"Alavés","La Liga","Saúl García","ESP","MF","26",1994,0,1,1,1,0,0,0,0,NA,0,0,0,0,0,1,0,0,"https://fbref.com/en/players/dafa5038/Saul-Garcia"
"8216","John Guidetti_2022",2022,"Alavés","La Liga","John Guidetti","SWE","FW,MF","29",1992,3.1,2,1,0,0,2,0,1,0,1,1,0,1,0,2,0,0,"https://fbref.com/en/players/99bebd12/John-Guidetti"
"8217","Jason_2022",2022,"Alavés","La Liga","Jason","ESP","MF,FW","27",1994,7.5,11,7,6,4,1,7,20,35,13,7,0,7,7,18,5,0,"https://fbref.com/en/players/9038c2a1/Jason"
"8218","Joselu_2022",2022,"Alavés","La Liga","Joselu","ESP","FW","31",1990,34.7,16,11,1,9,6,7,25,28,18,21,4,17,7,23,45,0,"https://fbref.com/en/players/6265208f/Joselu"
"8219","Víctor Laguardia_2022",2022,"Alavés","La Liga","Víctor Laguardia","ESP","DF","31",1989,33.8,29,16,21,8,0,19,30,63.3,11,36,24,12,27,56,151,1,"https://fbref.com/en/players/b7c99b9b/Victor-Laguardia"
"8220","Florian Lejeune_2022",2022,"Alavés","La Liga","Florian Lejeune","FRA","DF","30",1991,30,33,24,22,10,1,12,20,60,8,30,19,11,31,64,158,0,"https://fbref.com/en/players/6eaed4eb/Florian-Lejeune"
"8221","Javi López_2022",2022,"Alavés","La Liga","Javi López","ESP","DF","19",2002,5.1,8,6,6,2,0,4,6,66.7,2,7,1,6,4,12,15,0,"https://fbref.com/en/players/e9ada8cf/Javi-Lopez"
"8222","Mamadou Loum_2022",2022,"Alavés","La Liga","Mamadou Loum","SEN","MF","24",1996,25.7,49,22,26,22,1,17,45,37.8,28,30,11,19,37,86,68,1,"https://fbref.com/en/players/bcfc4473/Mamadou-Loum"
"8223","Iván Martín_2022",2022,"Alavés","La Liga","Iván Martín","ESP","MF,FW","22",1999,1.8,1,1,1,0,0,0,1,0,1,2,0,2,1,2,1,0,"https://fbref.com/en/players/ae48c5cb/Ivan-Martin"
"8224","Tomás Mendes_2022",2022,"Alavés","La Liga","Tomás Mendes","ESP","MF","16",2004,0.1,0,0,0,0,0,0,0,NA,0,0,0,0,0,0,1,0,"https://fbref.com/en/players/45f771db/Tomas-Mendes"
"8225","Édgar Méndez_2022",2022,"Alavés","La Liga","Édgar Méndez","ESP","FW,MF","31",1990,17.9,25,14,11,10,4,11,34,32.4,23,16,0,16,4,29,17,0,"https://fbref.com/en/players/aed746df/Edgar-Mendez"
"8226","Matt Miazga_2022",2022,"Alavés","La Liga","Matt Miazga","USA","DF","26",1995,9.3,7,7,3,4,0,2,7,28.6,5,14,12,2,11,18,55,1,"https://fbref.com/en/players/9fc0f253/Matt-Miazga"
"8227","Miguel_2022",2022,"Alavés","La Liga","Miguel","ESP","FW,MF","21",1999,9.2,7,3,1,5,1,2,15,13.3,13,6,0,6,1,8,7,0,"https://fbref.com/en/players/6763373d/Miguel"
"8228","Toni Moya_2022",2022,"Alavés","La Liga","Toni Moya","ESP","MF","23",1998,15.4,23,10,7,13,3,13,43,30.2,30,18,5,13,20,43,18,0,"https://fbref.com/en/players/9e098912/Toni-Moya"
"8229","Ximo Navarro_2022",2022,"Alavés","La Liga","Ximo Navarro","ESP","DF","31",1990,15,28,19,21,6,1,13,27,48.1,14,11,5,6,22,50,56,2,"https://fbref.com/en/players/8db394aa/Ximo-Navarro"
"8230","Jesús Owono_2022",2022,"Alavés","La Liga","Jesús Owono","EQG","GK","20",2001,1,0,0,0,0,0,0,0,NA,0,0,0,0,0,0,1,0,"https://fbref.com/en/players/d6e3d7fb/Jesus-Owono"
"8231","Fernando Pacheco_2022",2022,"Alavés","La Liga","Fernando Pacheco","ESP","GK","29",1992,33.9,2,1,2,0,0,2,2,100,0,0,0,0,0,2,18,1,"https://fbref.com/en/players/97852360/Fernando-Pacheco"
"8232","Facundo Pellistri_2022",2022,"Alavés","La Liga","Facundo Pellistri","URU","MF,FW","19",2001,7.5,9,5,4,3,2,1,10,10,9,13,2,11,6,15,7,0,"https://fbref.com/en/players/ac7e7b1c/Facundo-Pellistri"
"8233","Tomás Pina Isla_2022",2022,"Alavés","La Liga","Tomás Pina Isla","ESP","MF","33",1987,16,28,16,13,11,4,14,29,48.3,15,12,3,9,22,50,23,0,"https://fbref.com/en/players/e54bd0a2/Tomas-Pina-Isla"
"8234","Pere Pons_2022",2022,"Alavés","La Liga","Pere Pons","ESP","MF","28",1993,15.2,26,18,4,20,2,7,21,33.3,14,10,1,9,6,32,11,0,"https://fbref.com/en/players/29b61deb/Pere-Pons"
"8235","Luis Rioja_2022",2022,"Alavés","La Liga","Luis Rioja","ESP","MF,FW","27",1993,34.6,28,15,11,10,7,14,58,24.1,44,22,1,21,25,53,20,0,"https://fbref.com/en/players/eb3dd471/Luis-Rioja"
"8236","Unai Ropero_2022",2022,"Alavés","La Liga","Unai Ropero","ESP","MF","19",2001,0.1,0,0,0,0,0,0,0,NA,0,0,0,0,1,1,0,0,"https://fbref.com/en/players/7868c973/Unai-Ropero"
"8237","Antonio Sivera_2022",2022,"Alavés","La Liga","Antonio Sivera","ESP","GK","24",1996,3.1,0,0,0,0,0,0,1,0,1,0,0,0,0,0,0,0,"https://fbref.com/en/players/9970da54/Antonio-Sivera"
"8238","Mamadou Sylla_2022",2022,"Alavés","La Liga","Mamadou Sylla","SEN","FW,MF","27",1994,4.4,2,2,0,1,1,0,1,0,1,0,0,0,1,3,5,0,"https://fbref.com/en/players/e5ec95f8/Mamadou-Sylla"
"8239","Tachi_2022",2022,"Alavés","La Liga","Tachi","ESP","DF","23",1997,2.7,6,3,3,3,0,5,7,71.4,2,4,3,1,1,7,9,0,"https://fbref.com/en/players/8b625720/Tachi"
"8240","Nahuel Tenaglia_2022",2022,"Alavés","La Liga","Nahuel Tenaglia","ARG","DF","25",1996,11.9,42,27,30,9,3,24,37,64.9,13,10,2,8,26,68,42,0,"https://fbref.com/en/players/66654daa/Nahuel-Tenaglia"
"8241","Marc Tenas_2022",2022,"Alavés","La Liga","Marc Tenas","ESP","FW,MF","20",2001,0.6,1,1,1,0,0,1,1,100,0,1,0,1,0,1,0,1,"https://fbref.com/en/players/1c5d79e2/Marc-Tenas"
"8242","Mircea Ţîrlea_2022",2022,"Alavés","La Liga","Mircea Ţîrlea","ROU","DF","21",2000,0.2,0,0,0,0,0,0,0,NA,0,0,0,0,0,0,1,0,"https://fbref.com/en/players/683a1d81/Mircea-Tirlea"
"8243","Manu Vallejo_2022",2022,"Alavés","La Liga","Manu Vallejo","ESP","MF,FW","24",1997,4.1,8,2,1,4,3,4,13,30.8,9,7,0,7,0,8,4,0,"https://fbref.com/en/players/0bc4e720/Manu-Vallejo"
"8244","Mohamed Ali Cho_2022",2022,"Angers","Ligue 1","Mohamed Ali Cho","FRA","FW","17",2004,20.4,10,5,1,4,5,5,17,29.4,12,17,1,16,8,18,0,1,"https://fbref.com/en/players/f8405304/Mohamed-Ali-Cho"
"8245","Stéphane Bahoken_2022",2022,"Angers","Ligue 1","Stéphane Bahoken","CMR","FW","29",1992,12.2,13,8,2,7,4,1,9,11.1,8,15,0,15,3,16,3,0,"https://fbref.com/en/players/5046b7d4/Stephane-Bahoken"
"8246","Abdoulaye Bamba_2022",2022,"Angers","Ligue 1","Abdoulaye Bamba","CIV","DF,FW","31",1990,5.1,6,5,6,0,0,4,11,36.4,7,5,1,4,9,15,13,0,"https://fbref.com/en/players/7fecbcdb/Abdoulaye-Bamba"
"8247","Nabil Bentaleb_2022",2022,"Angers","Ligue 1","Nabil Bentaleb","ALG","MF","26",1994,16.8,42,24,15,20,7,16,29,55.2,13,24,9,15,28,70,13,0,"https://fbref.com/en/players/3189f61a/Nabil-Bentaleb"
"8248","Paul Bernardoni_2022",2022,"Angers","Ligue 1","Paul Bernardoni","FRA","GK","24",1997,13,3,2,3,0,0,3,4,75,1,0,0,0,0,3,8,1,"https://fbref.com/en/players/28dabd43/Paul-Bernardoni"
"8249","Antonin Bobichon_2022",2022,"Angers","Ligue 1","Antonin Bobichon","FRA","MF,FW","25",1995,0.4,1,0,0,1,0,0,0,NA,0,0,0,0,1,2,0,0,"https://fbref.com/en/players/7d937aa1/Antonin-Bobichon"
"8250","Sofiane Boufal_2022",2022,"Angers","Ligue 1","Sofiane Boufal","MAR","FW,MF","27",1993,25.9,44,29,19,16,9,18,38,47.4,20,19,2,17,7,51,1,0,"https://fbref.com/en/players/b0c71810/Sofiane-Boufal"
"8251","Bilal Brahimi_2022",2022,"Angers","Ligue 1","Bilal Brahimi","ALG","FW","21",2000,3.8,1,1,0,1,0,0,3,0,3,0,0,0,1,2,1,0,"https://fbref.com/en/players/02bcaf8e/Bilal-Brahimi"
"8252","Jimmy Cabot_2022",2022,"Angers","Ligue 1","Jimmy Cabot","FRA","DF","27",1994,22.3,81,44,59,15,7,47,83,56.6,36,29,0,29,32,113,30,0,"https://fbref.com/en/players/46359159/Jimmy-Cabot"
"8253","Pierrick Capelle_2022",2022,"Angers","Ligue 1","Pierrick Capelle","FRA","MF,DF","34",1987,13.3,36,24,16,17,3,18,52,34.6,34,12,1,11,16,52,20,0,"https://fbref.com/en/players/79b2399c/Pierrick-Capelle"
"8254","Souleyman Doumbia_2022",2022,"Angers","Ligue 1","Souleyman Doumbia","CIV","DF,FW","24",1996,24.7,30,20,16,9,5,13,27,48.1,14,25,4,21,39,69,51,0,"https://fbref.com/en/players/9daeac61/Souleyman-Doumbia"
"8255","Enzo Ebosse_2022",2022,"Angers","Ligue 1","Enzo Ebosse","CMR","DF","22",1999,21,25,14,19,6,0,11,19,57.9,8,19,9,10,15,40,42,0,"https://fbref.com/en/players/9ba7b4fa/Enzo-Ebosse"
"8256","Noah Fatar_2022",2022,"Angers","Ligue 1","Noah Fatar","FRA","DF,MF","19",2002,0.1,1,0,0,0,1,0,1,0,1,0,0,0,1,2,0,0,"https://fbref.com/en/players/2693f6bc/Noah-Fatar"
"8257","Angelo Fulgini_2022",2022,"Angers","Ligue 1","Angelo Fulgini","FRA","MF,FW","24",1996,32.5,35,25,8,18,9,14,44,31.8,30,21,5,16,22,57,5,1,"https://fbref.com/en/players/4b96c347/Angelo-Fulgini"
"8258","Noah Guede-Nadje_2022",2022,"Angers","Ligue 1","Noah Guede-Nadje","FRA","MF","17",2003,0,0,0,0,0,0,0,0,NA,0,0,0,0,0,0,0,0,"https://fbref.com/en/players/94b442c0/Noah-Guede-Nadje"
"8259","Marin Jakoliš_2022",2022,"Angers","Ligue 1","Marin Jakoliš","CRO","FW","24",1996,2.5,2,1,0,1,1,0,6,0,6,0,0,0,1,3,0,0,"https://fbref.com/en/players/96f4ebc0/Marin-Jakolis"
"8260","Vincent Manceau_2022",2022,"Angers","Ligue 1","Vincent Manceau","FRA","DF","32",1989,26.2,32,19,18,13,1,14,37,37.8,23,23,6,17,32,64,72,0,"https://fbref.com/en/players/c26a3918/Vincent-Manceau"
"8261","Anthony Mandrea_2022",2022,"Angers","Ligue 1","Anthony Mandrea","ALG","GK","24",1996,10,0,0,0,0,0,0,0,NA,0,0,0,0,0,0,9,0,"https://fbref.com/en/players/f7d3a773/Anthony-Mandrea"
"8262","Thomas Mangani_2022",2022,"Angers","Ligue 1","Thomas Mangani","FRA","MF","34",1987,24.4,58,30,23,34,1,31,68,45.6,37,38,11,27,36,94,29,0,"https://fbref.com/en/players/c801616a/Thomas-Mangani"
"8263","Jason Mbock_2022",2022,"Angers","Ligue 1","Jason Mbock","FRA","FW","21",1999,0.2,0,0,0,0,0,0,0,NA,0,0,0,0,0,0,0,0,"https://fbref.com/en/players/890bc029/Jason-Mbock"
"8264","Farid El Melali_2022",2022,"Angers","Ligue 1","Farid El Melali","ALG","FW","24",1997,0.2,0,0,0,0,0,0,1,0,1,1,0,1,0,0,1,0,"https://fbref.com/en/players/d21e361a/Farid-El-Melali"
"8265","Batista Mendy_2022",2022,"Angers","Ligue 1","Batista Mendy","FRA","MF,DF","21",2000,26.8,49,28,21,22,6,23,45,51.1,22,37,6,31,34,83,40,0,"https://fbref.com/en/players/e472a6f6/Batista-Mendy"
"8266","Casimir Ninga_2022",2022,"Angers","Ligue 1","Casimir Ninga","CHA","FW","28",1993,4.5,5,1,1,4,0,2,5,40,3,2,0,2,1,6,0,0,"https://fbref.com/en/players/91f2da4c/Casimir-Ninga"
"8267","Azzedine Ounahi_2022",2022,"Angers","Ligue 1","Azzedine Ounahi","MAR","MF","21",2000,18.1,39,22,16,22,1,11,40,27.5,29,19,1,18,26,65,13,0,"https://fbref.com/en/players/83299cc0/Azzedine-Ounahi"
"8268","Mathias Pereira Lage_2022",2022,"Angers","Ligue 1","Mathias Pereira Lage","POR","DF","24",1996,11.6,21,7,10,7,4,8,30,26.7,22,18,7,11,21,42,22,0,"https://fbref.com/en/players/8846a40f/Mathias-Pereira-Lage"
"8269","Danijel Petković_2022",2022,"Angers","Ligue 1","Danijel Petković","MNE","GK","28",1993,15,0,0,0,0,0,0,1,0,1,0,0,0,1,1,9,5,"https://fbref.com/en/players/b98cea65/Danijel-Petkovic"
"8270","Waniss Taibi_2022",2022,"Angers","Ligue 1","Waniss Taibi","FRA","MF,FW","19",2002,1.5,8,7,4,4,0,2,4,50,2,0,0,0,1,9,1,0,"https://fbref.com/en/players/95192fe4/Waniss-Taibi"
"8271","Sada Thioub_2022",2022,"Angers","Ligue 1","Sada Thioub","SEN","FW","26",1995,0,0,0,0,0,0,0,0,NA,0,0,0,0,0,0,0,0,"https://fbref.com/en/players/f4bc42b1/Sada-Thioub"
"8272","Romain Thomas_2022",2022,"Angers","Ligue 1","Romain Thomas","FRA","DF","33",1988,28.5,49,37,28,21,0,30,57,52.6,27,35,19,16,44,93,126,0,"https://fbref.com/en/players/275e2c51/Romain-Thomas"
"8273","Ismaël Traoré_2022",2022,"Angers","Ligue 1","Ismaël Traoré","CIV","DF","34",1986,35.7,28,17,16,11,1,13,28,46.4,15,25,17,8,44,72,122,1,"https://fbref.com/en/players/b666421b/Ismael-Traore"
"8274","Andrés Andrade Cedeño_2022",2022,"Arminia","Bundesliga","Andrés Andrade Cedeño","PAN","DF","22",1998,11.6,27,16,18,8,1,17,35,48.6,18,16,7,9,19,46,44,0,"https://fbref.com/en/players/6ea23758/Andres-Andrade-Cedeno"
"8275","Jacob Barrett Laursen_2022",2022,"Arminia","Bundesliga","Jacob Barrett Laursen","DEN","DF","26",1994,18.1,16,12,10,6,0,8,21,38.1,13,19,7,12,28,44,43,0,"https://fbref.com/en/players/c0d3bd23/Jacob-Barrett-Laursen"
"8276","George Bello_2022",2022,"Arminia","Bundesliga","George Bello","USA","DF","19",2002,4.8,7,7,7,0,0,4,4,100,0,5,4,1,6,13,11,0,"https://fbref.com/en/players/aca0a525/George-Bello"
"8277","Cédric Brunner_2022",2022,"Arminia","Bundesliga","Cédric Brunner","SUI","DF","27",1994,24.3,51,35,29,20,2,25,49,51,24,27,10,17,43,94,84,0,"https://fbref.com/en/players/f0a37d36/Cedric-Brunner"
"8278","Gonzalo Castro_2022",2022,"Arminia","Bundesliga","Gonzalo Castro","GER","MF,FW","34",1987,4.8,8,3,4,4,0,1,5,20,4,3,0,3,3,11,3,0,"https://fbref.com/en/players/68829001/Gonzalo-Castro"
"8279","Lennart-Marten Czyborra_2022",2022,"Arminia","Bundesliga","Lennart-Marten Czyborra","GER","DF","22",1999,1.5,0,0,0,0,0,0,2,0,2,0,0,0,3,3,3,1,"https://fbref.com/en/players/7ba1f1ef/Lennart-Marten-Czyborra"
"8280","Mike van der Hoorn_2022",2022,"Arminia","Bundesliga","Mike van der Hoorn","NED","DF","28",1992,0.2,1,0,1,0,0,0,0,NA,0,0,0,0,1,2,2,0,"https://fbref.com/en/players/25f50295/Mike-van-der-Hoorn"
"8281","Edimilson Fernandes_2022",2022,"Arminia","Bundesliga","Edimilson Fernandes","SUI","MF,FW","25",1996,3.1,2,0,1,1,0,1,4,25,3,2,2,0,2,4,6,0,"https://fbref.com/en/players/3bb625ac/Edimilson-Fernandes"
"8282","Robin Hack_2022",2022,"Arminia","Bundesliga","Robin Hack","GER","FW,MF","22",1998,15.2,14,8,6,5,3,3,21,14.3,18,18,1,17,5,19,4,0,"https://fbref.com/en/players/0174ba21/Robin-Hack"
"8283","Burak İnce_2022",2022,"Arminia","Bundesliga","Burak İnce","TUR","FW","17",2004,1.5,1,1,1,0,0,1,2,50,1,1,0,1,0,1,0,0,"https://fbref.com/en/players/683dec01/Burak-Ince"
"8284","Stefanos Kapino_2022",2022,"Arminia","Bundesliga","Stefanos Kapino","GRE","GK","27",1994,1,0,0,0,0,0,0,0,NA,0,0,0,0,0,0,0,0,"https://fbref.com/en/players/62ba5881/Stefanos-Kapino"
"8285","Fabian Klos_2022",2022,"Arminia","Bundesliga","Fabian Klos","GER","FW","33",1987,15.8,7,5,0,5,2,2,10,20,8,17,4,13,0,7,31,0,"https://fbref.com/en/players/e21042ae/Fabian-Klos"
"8286","Florian Krüger_2022",2022,"Arminia","Bundesliga","Florian Krüger","GER","FW,MF","22",1999,12.5,3,1,0,3,0,2,10,20,8,12,1,11,2,5,13,0,"https://fbref.com/en/players/f9f92b5f/Florian-Kruger"
"8287","Fabian Kunze_2022",2022,"Arminia","Bundesliga","Fabian Kunze","GER","MF","23",1998,14,35,21,14,20,1,15,32,46.9,17,17,2,15,19,54,27,1,"https://fbref.com/en/players/d25fee56/Fabian-Kunze"
"8288","Bryan Lasme_2022",2022,"Arminia","Bundesliga","Bryan Lasme","FRA","FW","22",1998,9.7,6,6,1,2,3,0,3,0,3,7,0,7,1,7,9,0,"https://fbref.com/en/players/ebac0ace/Bryan-Lasme"
"8289","Nathan de Medina_2022",2022,"Arminia","Bundesliga","Nathan de Medina","BEL","DF","23",1997,8.6,17,10,11,6,0,6,10,60,4,14,3,11,10,27,28,0,"https://fbref.com/en/players/d686dbc0/Nathan-de-Medina"
"8290","Joakim Nilsson_2022",2022,"Arminia","Bundesliga","Joakim Nilsson","SWE","DF","27",1994,30.4,37,19,24,13,0,20,26,76.9,6,36,23,13,56,93,143,1,"https://fbref.com/en/players/c562c5b4/Joakim-Nilsson"
"8291","Masaya Okugawa_2022",2022,"Arminia","Bundesliga","Masaya Okugawa","JPN","MF,FW","25",1996,28.1,46,25,18,22,6,12,37,32.4,25,29,1,28,20,66,13,0,"https://fbref.com/en/players/63b9cc6d/Masaya-Okugawa"
"8292","Stefan Ortega_2022",2022,"Arminia","Bundesliga","Stefan Ortega","GER","GK","28",1992,33,1,0,1,0,0,1,2,50,1,2,0,2,0,1,5,1,"https://fbref.com/en/players/c1242d4e/Stefan-Ortega"
"8293","Amos Pieper_2022",2022,"Arminia","Bundesliga","Amos Pieper","GER","DF","23",1998,26.4,58,29,38,19,1,32,51,62.7,19,37,23,14,50,108,132,1,"https://fbref.com/en/players/526ea7cc/Amos-Pieper"
"8294","Manuel Prietl_2022",2022,"Arminia","Bundesliga","Manuel Prietl","AUT","MF","29",1991,23.6,59,26,23,31,5,23,60,38.3,37,28,3,25,39,98,33,0,"https://fbref.com/en/players/901c0f97/Manuel-Prietl"
"8295","Guilherme Ramos_2022",2022,"Arminia","Bundesliga","Guilherme Ramos","POR","DF","23",1997,10.1,25,15,17,8,0,12,19,63.2,7,21,8,13,27,52,52,0,"https://fbref.com/en/players/df9c3473/Guilherme-Ramos"
"8296","Alessandro Schöpf_2022",2022,"Arminia","Bundesliga","Alessandro Schöpf","AUT","MF","27",1994,26.6,40,22,19,16,5,14,30,46.7,16,31,5,26,30,70,21,1,"https://fbref.com/en/players/106bca06/Alessandro-Schopf"
"8297","Janni Serra_2022",2022,"Arminia","Bundesliga","Janni Serra","GER","FW","23",1998,12.4,4,2,2,0,2,2,7,28.6,5,8,3,5,5,9,19,0,"https://fbref.com/en/players/40b58bfc/Janni-Serra"
"8298","Sebastian Vasiliadis_2022",2022,"Arminia","Bundesliga","Sebastian Vasiliadis","GRE","MF","23",1997,13.3,31,17,12,15,4,15,42,35.7,27,15,2,13,25,56,31,1,"https://fbref.com/en/players/d3112d86/Sebastian-Vasiliadis"
"8299","Patrick Wimmer_2022",2022,"Arminia","Bundesliga","Patrick Wimmer","AUT","FW,MF","20",2001,22.8,53,31,13,31,9,22,61,36.1,39,30,1,29,27,80,13,0,"https://fbref.com/en/players/cb11b429/Patrick-Wimmer"
"8300","Pierre-Emerick Aubameyang_2022",2022,"Arsenal","Premier League","Pierre-Emerick Aubameyang","GAB","FW","32",1989,11.5,11,5,6,4,1,3,10,30,7,12,1,11,0,11,4,0,"https://fbref.com/en/players/d5dd5f1f/Pierre-Emerick-Aubameyang"
"8301","Folarin Balogun_2022",2022,"Arsenal","Premier League","Folarin Balogun","USA","FW","20",2001,0.8,1,1,0,0,1,0,0,NA,0,1,0,1,0,1,1,0,"https://fbref.com/en/players/31822f8c/Folarin-Balogun"
"8302","Calum Chambers_2022",2022,"Arsenal","Premier League","Calum Chambers","ENG","DF","26",1995,1.9,5,3,3,1,1,3,4,75,1,6,3,3,0,5,10,0,"https://fbref.com/en/players/dc6f5bdd/Calum-Chambers"
"8303","Gabriel Dos Santos_2022",2022,"Arsenal","Premier League","Gabriel Dos Santos","BRA","DF","23",1997,34,50,30,36,12,2,30,41,73.2,11,34,26,8,13,63,112,4,"https://fbref.com/en/players/67ac5bb8/Gabriel-Dos-Santos"
"8304","Mohamed Elneny_2022",2022,"Arsenal","Premier League","Mohamed Elneny","EGY","MF","29",1992,9,16,8,10,5,1,7,12,58.3,5,7,1,6,14,30,13,0,"https://fbref.com/en/players/47a34c4f/Mohamed-Elneny"
"8305","Rob Holding_2022",2022,"Arsenal","Premier League","Rob Holding","ENG","DF","25",1995,9.4,13,9,11,1,1,5,6,83.3,1,23,18,5,10,23,42,1,"https://fbref.com/en/players/d79a8c87/Rob-Holding"
"8306","Sead Kolašinac_2022",2022,"Arsenal","Premier League","Sead Kolašinac","BIH","DF","28",1993,1,0,0,0,0,0,0,0,NA,0,0,0,0,4,4,1,0,"https://fbref.com/en/players/3935e52e/Sead-Kolasinac"
"8307","Alexandre Lacazette_2022",2022,"Arsenal","Premier League","Alexandre Lacazette","FRA","FW","30",1991,19.8,27,10,8,13,6,7,21,33.3,14,12,1,11,5,32,6,0,"https://fbref.com/en/players/9dbb75ca/Alexandre-Lacazette"
"8308","Bernd Leno_2022",2022,"Arsenal","Premier League","Bernd Leno","GER","GK","29",1992,4,1,1,1,0,0,1,1,100,0,0,0,0,0,1,1,0,"https://fbref.com/en/players/2628fd2b/Bernd-Leno"
"8309","Ainsley Maitland-Niles_2022",2022,"Arsenal","Premier League","Ainsley Maitland-Niles","ENG","MF","23",1997,3,8,4,5,3,0,2,4,50,2,2,0,2,4,12,4,0,"https://fbref.com/en/players/e3a5814e/Ainsley-Maitland-Niles"
"8310","Pablo Marí_2022",2022,"Arsenal","Premier League","Pablo Marí","ESP","DF","27",1993,2,5,3,1,3,1,3,6,50,3,5,4,1,3,8,10,0,"https://fbref.com/en/players/aa54ec6f/Pablo-Mari"
"8311","Martinelli_2022",2022,"Arsenal","Premier League","Martinelli","BRA","FW,MF","20",2001,20.7,27,19,7,14,6,10,29,34.5,19,26,1,25,20,47,15,0,"https://fbref.com/en/players/48a5a5d6/Martinelli"
"8312","Reiss Nelson_2022",2022,"Arsenal","Premier League","Reiss Nelson","ENG","FW","21",1999,0.2,1,0,0,0,1,0,1,0,1,1,0,1,0,1,0,0,"https://fbref.com/en/players/c5bdb6e3/Reiss-Nelson"
"8313","Eddie Nketiah_2022",2022,"Arsenal","Premier League","Eddie Nketiah","ENG","FW","22",1999,9.3,9,4,1,4,4,1,4,25,3,9,2,7,4,13,5,0,"https://fbref.com/en/players/a53649b7/Eddie-Nketiah"
"8314","Thomas Partey_2022",2022,"Arsenal","Premier League","Thomas Partey","GHA","MF","28",1993,22.5,43,29,22,17,4,18,44,40.9,26,22,4,18,23,66,35,2,"https://fbref.com/en/players/529f49ab/Thomas-Partey"
"8315","Nicolas Pépé_2022",2022,"Arsenal","Premier League","Nicolas Pépé","CIV","FW,MF","26",1995,7.7,8,5,3,5,0,3,9,33.3,6,9,1,8,8,16,2,0,"https://fbref.com/en/players/57e3f0c7/Nicolas-Pepe"
"8316","Aaron Ramsdale_2022",2022,"Arsenal","Premier League","Aaron Ramsdale","ENG","GK","23",1998,34,2,1,2,0,0,1,2,50,1,0,0,0,0,2,26,3,"https://fbref.com/en/players/466fb2c5/Aaron-Ramsdale"
"8317","Bukayo Saka_2022",2022,"Arsenal","Premier League","Bukayo Saka","ENG","FW,MF","19",2001,33.1,40,21,12,17,11,13,39,33.3,26,28,2,26,22,62,23,0,"https://fbref.com/en/players/bc7dc64d/Bukayo-Saka"
"8318","Albert Sambi Lokonga_2022",2022,"Arsenal","Premier League","Albert Sambi Lokonga","BEL","MF","21",1999,12.6,22,18,11,9,2,12,14,85.7,2,12,7,5,13,35,12,4,"https://fbref.com/en/players/1b4f1169/Albert-Sambi-Lokonga"
"8319","Emile Smith Rowe_2022",2022,"Arsenal","Premier League","Emile Smith Rowe","ENG","MF,FW","21",2000,21.3,14,7,7,7,0,4,20,20,16,18,1,17,15,29,10,1,"https://fbref.com/en/players/17695062/Emile-Smith-Rowe"
"8320","Cédric Soares_2022",2022,"Arsenal","Premier League","Cédric Soares","POR","DF","29",1991,16.5,38,26,23,9,6,16,25,64,9,18,7,11,16,54,31,1,"https://fbref.com/en/players/839c14e1/Cedric-Soares"
"8321","Nuno Tavares_2022",2022,"Arsenal","Premier League","Nuno Tavares","POR","DF","21",2000,13.1,21,14,10,7,4,8,18,44.4,10,15,5,10,9,30,33,1,"https://fbref.com/en/players/a65c844b/Nuno-Tavares"
"8322","Kieran Tierney_2022",2022,"Arsenal","Premier League","Kieran Tierney","SCO","DF","24",1997,21.3,18,14,11,7,0,10,11,90.9,1,23,5,18,15,33,54,0,"https://fbref.com/en/players/fce2302c/Kieran-Tierney"
"8323","Takehiro Tomiyasu_2022",2022,"Arsenal","Premier League","Takehiro Tomiyasu","JPN","DF","22",1998,18.7,35,17,19,13,3,21,32,65.6,11,22,3,19,24,59,64,2,"https://fbref.com/en/players/b3af9be1/Takehiro-Tomiyasu"
"8324","Ben White_2022",2022,"Arsenal","Premier League","Ben White","ENG","DF","23",1997,32,44,23,30,8,6,28,45,62.2,17,42,24,18,42,86,102,0,"https://fbref.com/en/players/35e413f1/Ben-White"
"8325","Granit Xhaka_2022",2022,"Arsenal","Premier League","Granit Xhaka","SUI","MF,DF","28",1992,25.9,32,18,16,12,4,16,41,39,25,21,6,15,21,53,31,0,"https://fbref.com/en/players/e61b8aee/Granit-Xhaka"
"8326","Martin Ødegaard_2022",2022,"Arsenal","Premier League","Martin Ødegaard","NOR","MF,FW","22",1998,30.9,49,21,6,24,19,22,61,36.1,39,18,1,17,11,60,11,1,"https://fbref.com/en/players/79300479/Martin-Odegaard"
"8327","Cameron Archer_2022",2022,"Aston Villa","Premier League","Cameron Archer","ENG","FW,MF","20",2001,0.3,0,0,0,0,0,0,0,NA,0,0,0,0,0,0,0,0,"https://fbref.com/en/players/05e8ca6d/Cameron-Archer"
"8328","Leon Bailey_2022",2022,"Aston Villa","Premier League","Leon Bailey","JAM","FW,MF","23",1997,8.5,17,11,6,8,3,6,13,46.2,7,10,1,9,1,18,2,0,"https://fbref.com/en/players/3a233281/Leon-Bailey"
"8329","Emi Buendía_2022",2022,"Aston Villa","Premier League","Emi Buendía","ARG","MF,FW","24",1996,21.1,38,18,16,13,9,21,51,41.2,30,21,3,18,9,47,11,0,"https://fbref.com/en/players/66b76d44/Emi-Buendia"
"8330","Matty Cash_2022",2022,"Aston Villa","Premier League","Matty Cash","POL","DF","23",1997,37.5,89,50,52,34,3,47,78,60.3,31,54,16,38,49,138,100,2,"https://fbref.com/en/players/2389cdc2/Matty-Cash"
"8331","Calum Chambers_2022",2022,"Aston Villa","Premier League","Calum Chambers","ENG","DF","26",1995,9.2,16,8,10,6,0,4,6,66.7,2,14,8,6,5,21,42,0,"https://fbref.com/en/players/dc6f5bdd/Calum-Chambers"
"8332","Carney Chukwuemeka_2022",2022,"Aston Villa","Premier League","Carney Chukwuemeka","ENG","MF,FW","17",2003,3.3,7,1,2,5,0,3,5,60,2,3,0,3,1,8,2,1,"https://fbref.com/en/players/b2f9c73e/Carney-Chukwuemeka"
"8333","Philippe Coutinho_2022",2022,"Aston Villa","Premier League","Philippe Coutinho","BRA","MF,FW","29",1992,14.8,17,12,4,11,2,6,21,28.6,15,11,1,10,7,24,4,0,"https://fbref.com/en/players/0ef89a37/Philippe-Coutinho"
"8334","Keinan Davis_2022",2022,"Aston Villa","Premier League","Keinan Davis","ENG","FW","23",1998,0.1,0,0,0,0,0,0,0,NA,0,0,0,0,0,0,0,0,"https://fbref.com/en/players/9deaf2c8/Keinan-Davis"
"8335","Lucas Digne_2022",2022,"Aston Villa","Premier League","Lucas Digne","FRA","DF","28",1993,14.1,13,10,8,3,2,9,19,47.4,10,15,8,7,23,36,40,0,"https://fbref.com/en/players/1b84dbe1/Lucas-Digne"
"8336","Anwar El Ghazi_2022",2022,"Aston Villa","Premier League","Anwar El Ghazi","NED","FW,MF","26",1995,4.3,4,4,2,2,0,2,7,28.6,5,6,0,6,1,5,2,0,"https://fbref.com/en/players/ffa90327/Anwar-El-Ghazi"
"8337","Kortney Hause_2022",2022,"Aston Villa","Premier League","Kortney Hause","ENG","DF","26",1995,4.4,3,3,2,0,1,3,4,75,1,8,5,3,6,9,13,0,"https://fbref.com/en/players/bf8fad51/Kortney-Hause"
"8338","Danny Ings_2022",2022,"Aston Villa","Premier League","Danny Ings","ENG","FW","29",1992,21.1,23,16,2,16,5,13,37,35.1,24,31,2,29,6,29,22,0,"https://fbref.com/en/players/07802f7f/Danny-Ings"
"8339","Tim Iroegbunam_2022",2022,"Aston Villa","Premier League","Tim Iroegbunam","ENG","MF","18",2003,1,5,4,2,3,0,1,1,100,0,0,0,0,2,7,1,0,"https://fbref.com/en/players/84c5ceea/Tim-Iroegbunam"
"8340","Ezri Konsa_2022",2022,"Aston Villa","Premier League","Ezri Konsa","ENG","DF","23",1997,27.5,25,15,13,11,1,10,13,76.9,3,31,22,9,15,40,86,2,"https://fbref.com/en/players/0313a347/Ezri-Konsa"
"8341","Douglas Luiz_2022",2022,"Aston Villa","Premier League","Douglas Luiz","BRA","MF","23",1998,30.2,59,39,30,24,5,21,72,29.2,51,30,7,23,34,93,28,1,"https://fbref.com/en/players/6f7d826d/Douglas-Luiz"
"8342","Emiliano Martínez_2022",2022,"Aston Villa","Premier League","Emiliano Martínez","ARG","GK","28",1992,36,1,1,1,0,0,1,3,33.3,2,0,0,0,0,1,6,1,"https://fbref.com/en/players/7956236f/Emiliano-Martinez"
"8343","John McGinn_2022",2022,"Aston Villa","Premier League","John McGinn","SCO","MF","26",1994,34.3,106,64,35,55,16,54,104,51.9,50,53,6,47,35,141,34,0,"https://fbref.com/en/players/90f91999/John-McGinn"
"8344","Tyrone Mings_2022",2022,"Aston Villa","Premier League","Tyrone Mings","ENG","DF","28",1993,35.4,23,12,17,3,3,14,22,63.6,8,47,30,17,46,69,153,2,"https://fbref.com/en/players/8397a50c/Tyrone-Mings"
"8345","Wesley Moraes_2022",2022,"Aston Villa","Premier League","Wesley Moraes","BRA","FW","24",1996,0,0,0,0,0,0,0,0,NA,0,0,0,0,0,0,0,0,"https://fbref.com/en/players/bfae110f/Wesley-Moraes"
"8346","Marvelous Nakamba_2022",2022,"Aston Villa","Premier League","Marvelous Nakamba","ZIM","MF","27",1994,10,32,19,18,14,0,12,34,35.3,22,14,4,10,12,44,17,1,"https://fbref.com/en/players/de5b5570/Marvelous-Nakamba"
"8347","Robin Olsen_2022",2022,"Aston Villa","Premier League","Robin Olsen","SWE","GK","31",1990,1,0,0,0,0,0,0,0,NA,0,0,0,0,0,0,0,0,"https://fbref.com/en/players/e7ee38c3/Robin-Olsen"
"8348","Jaden Philogene Bidace_2022",2022,"Aston Villa","Premier League","Jaden Philogene Bidace","ENG","FW","19",2002,0.1,0,0,0,0,0,0,0,NA,0,0,0,0,0,0,0,0,"https://fbref.com/en/players/19f4d211/Jaden-Philogene-Bidace"
"8349","Jacob Ramsey_2022",2022,"Aston Villa","Premier League","Jacob Ramsey","ENG","MF","20",2001,27.4,67,44,31,28,8,30,69,43.5,39,36,7,29,24,91,28,0,"https://fbref.com/en/players/1544f145/Jacob-Ramsey"
"8350","Morgan Sanson_2022",2022,"Aston Villa","Premier League","Morgan Sanson","FRA","MF","26",1994,4,12,8,7,2,3,3,7,42.9,4,13,0,13,10,22,2,1,"https://fbref.com/en/players/6e7f1353/Morgan-Sanson"
"8351","Jed Steer_2022",2022,"Aston Villa","Premier League","Jed Steer","ENG","GK","28",1992,1,0,0,0,0,0,0,0,NA,0,0,0,0,0,0,0,0,"https://fbref.com/en/players/a8a3d139/Jed-Steer"
"8352","Matt Targett_2022",2022,"Aston Villa","Premier League","Matt Targett","ENG","DF","25",1995,15.9,34,18,28,5,1,24,45,53.3,21,16,9,7,23,57,35,0,"https://fbref.com/en/players/e514ab62/Matt-Targett"
"8353","Bertrand Traoré_2022",2022,"Aston Villa","Premier League","Bertrand Traoré","BFA","MF,FW","25",1995,2.4,3,3,0,1,2,1,2,50,1,0,0,0,0,3,1,0,"https://fbref.com/en/players/c47541e0/Bertrand-Traore"
"8354","Trézéguet_2022",2022,"Aston Villa","Premier League","Trézéguet","EGY","FW","26",1994,0.1,0,0,0,0,0,0,0,NA,0,0,0,0,0,0,0,0,"https://fbref.com/en/players/3ae14ed1/Trezeguet"
"8355","Axel Tuanzebe_2022",2022,"Aston Villa","Premier League","Axel Tuanzebe","ENG","DF","23",1997,5.6,5,3,3,2,0,2,5,40,3,5,4,1,5,10,12,1,"https://fbref.com/en/players/2baec6ce/Axel-Tuanzebe"
"8356","Ollie Watkins_2022",2022,"Aston Villa","Premier League","Ollie Watkins","ENG","FW","25",1995,32.8,17,13,2,7,8,2,15,13.3,13,25,3,22,12,29,27,0,"https://fbref.com/en/players/aed3a70f/Ollie-Watkins"
"8357","Ashley Young_2022",2022,"Aston Villa","Premier League","Ashley Young","ENG","DF,FW","36",1985,13.9,18,6,9,6,3,11,16,68.8,5,10,4,6,13,31,25,1,"https://fbref.com/en/players/be927d03/Ashley-Young"
"8358","Jeremie Boga_2022",2022,"Atalanta","Serie A","Jeremie Boga","CIV","FW,MF","24",1997,8.5,7,3,0,4,3,4,6,66.7,2,6,0,6,1,8,3,1,"https://fbref.com/en/players/fe012aca/Jeremie-Boga"
"8359","Moustapha Cissé_2022",2022,"Atalanta","Serie A","Moustapha Cissé","GUI","FW","17",2003,0.4,1,0,0,1,0,0,3,0,3,0,0,0,0,1,0,0,"https://fbref.com/en/players/ee3c4b3f/Moustapha-Cisse"
"8360","Giorgio Cittadini_2022",2022,"Atalanta","Serie A","Giorgio Cittadini","ITA","DF","19",2002,0,0,0,0,0,0,0,0,NA,0,0,0,0,1,1,0,0,"https://fbref.com/en/players/e4ba67f2/Giorgio-Cittadini"
"8361","Tommaso De Nipoti_2022",2022,"Atalanta","Serie A","Tommaso De Nipoti","ITA","FW","18",2003,0.1,0,0,0,0,0,0,0,NA,0,0,0,0,0,0,0,0,"https://fbref.com/en/players/7f9d956a/Tommaso-De-Nipoti"
"8362","Merih Demiral_2022",2022,"Atalanta","Serie A","Merih Demiral","TUR","DF","23",1998,21.3,31,17,18,12,1,15,28,53.6,13,26,14,12,58,89,68,1,"https://fbref.com/en/players/e3cceee6/Merih-Demiral"
"8363","Berat Djimsiti_2022",2022,"Atalanta","Serie A","Berat Djimsiti","ALB","DF","28",1993,25.1,43,24,21,20,2,29,46,63,17,21,11,10,31,74,56,0,"https://fbref.com/en/players/6eee05f1/Berat-Djimsiti"
"8364","Remo Freuler_2022",2022,"Atalanta","Serie A","Remo Freuler","SUI","MF","29",1992,26.3,69,39,22,33,14,30,70,42.9,40,48,8,40,35,104,26,1,"https://fbref.com/en/players/98d2c2c4/Remo-Freuler"
"8365","Robin Gosens_2022",2022,"Atalanta","Serie A","Robin Gosens","GER","DF","27",1994,5.1,7,3,3,4,0,4,8,50,4,4,0,4,9,16,1,0,"https://fbref.com/en/players/2d970560/Robin-Gosens"
"8366","Hans Hateboer_2022",2022,"Atalanta","Serie A","Hans Hateboer","NED","DF,MF","27",1994,15.4,22,14,10,8,4,11,26,42.3,15,11,1,10,7,29,20,0,"https://fbref.com/en/players/3b333ac3/Hans-Hateboer"
"8367","Josip Iličić_2022",2022,"Atalanta","Serie A","Josip Iličić","SVN","MF,FW","33",1988,9.3,7,7,3,2,2,4,17,23.5,13,6,1,5,3,10,1,0,"https://fbref.com/en/players/68252d6d/Josip-Ilicic"
"8368","Teun Koopmeiners_2022",2022,"Atalanta","Serie A","Teun Koopmeiners","NED","MF","23",1998,23.6,40,24,10,19,11,22,54,40.7,32,31,2,29,15,55,19,0,"https://fbref.com/en/players/a26fb8aa/Teun-Koopmeiners"
"8369","Sam Lammers_2022",2022,"Atalanta","Serie A","Sam Lammers","NED","FW,MF","24",1997,0.4,1,0,0,0,1,0,0,NA,0,0,0,0,0,1,0,0,"https://fbref.com/en/players/c283ddef/Sam-Lammers"
"8370","Matteo Lovato_2022",2022,"Atalanta","Serie A","Matteo Lovato","ITA","DF","21",2000,3.4,5,4,4,1,0,0,1,0,1,4,2,2,7,12,8,0,"https://fbref.com/en/players/5fa57166/Matteo-Lovato"
"8371","José Luis Palomino_2022",2022,"Atalanta","Serie A","José Luis Palomino","ARG","DF","31",1990,29.7,78,40,42,33,3,32,50,64,18,43,21,22,100,178,80,2,"https://fbref.com/en/players/921f6058/Jose-Luis-Palomino"
"8372","Ruslan Malinovskyi_2022",2022,"Atalanta","Serie A","Ruslan Malinovskyi","UKR","MF,FW","28",1993,17.7,18,10,3,10,5,5,19,26.3,14,27,3,24,5,23,1,0,"https://fbref.com/en/players/48d5bd33/Ruslan-Malinovskyi"
"8373","Valentin Mihaila_2022",2022,"Atalanta","Serie A","Valentin Mihaila","ROU","MF,FW","21",2000,0.8,1,1,0,1,0,0,1,0,1,2,0,2,0,1,0,0,"https://fbref.com/en/players/81a4c239/Valentin-Mihaila"
"8374","Aleksei Miranchuk_2022",2022,"Atalanta","Serie A","Aleksei Miranchuk","RUS","MF,FW","25",1995,8.6,11,7,3,7,1,4,12,33.3,8,3,0,3,1,12,7,0,"https://fbref.com/en/players/a9aa0d1d/Aleksei-Miranchuk"
"8375","Luis Muriel_2022",2022,"Atalanta","Serie A","Luis Muriel","COL","FW,MF","30",1991,17.1,15,4,2,7,6,3,19,15.8,16,12,0,12,4,19,5,0,"https://fbref.com/en/players/eb2fe5b6/Luis-Muriel"
"8376","Juan Musso_2022",2022,"Atalanta","Serie A","Juan Musso","ARG","GK","27",1994,32.6,1,1,1,0,0,0,0,NA,0,0,0,0,0,1,17,1,"https://fbref.com/en/players/a111cf41/Juan-Musso"
"8377","Joakim Mæhle_2022",2022,"Atalanta","Serie A","Joakim Mæhle","DEN","DF,MF","24",1997,16.3,21,11,6,9,6,12,27,44.4,15,18,2,16,14,35,13,0,"https://fbref.com/en/players/c459a650/Joakim-Maehle"
"8378","Mario Pašalić_2022",2022,"Atalanta","Serie A","Mario Pašalić","CRO","MF,FW","26",1995,22.2,27,12,8,13,6,12,30,40,18,27,6,21,20,47,14,0,"https://fbref.com/en/players/e599253a/Mario-Pasalic"
"8379","Matteo Pessina_2022",2022,"Atalanta","Serie A","Matteo Pessina","ITA","MF,FW","24",1997,16,27,14,10,11,6,14,33,42.4,19,22,3,19,13,40,7,0,"https://fbref.com/en/players/780e3631/Matteo-Pessina"
"8380","Giuseppe Pezzella_2022",2022,"Atalanta","Serie A","Giuseppe Pezzella","ITA","DF,MF","23",1997,11.9,28,13,15,7,6,8,18,44.4,10,13,5,8,9,37,16,0,"https://fbref.com/en/players/149c5f5d/Giuseppe-Pezzella"
"8381","Roberto Piccoli_2022",2022,"Atalanta","Serie A","Roberto Piccoli","ITA","FW","20",2001,2.2,2,0,0,0,2,0,2,0,2,1,0,1,0,2,0,0,"https://fbref.com/en/players/1cadaf34/Roberto-Piccoli"
"8382","Marten de Roon_2022",2022,"Atalanta","Serie A","Marten de Roon","NED","MF,DF","30",1991,28.3,69,42,33,29,7,34,62,54.8,28,36,2,34,45,114,41,0,"https://fbref.com/en/players/2a1beb34/Marten-de-Roon"
"8383","Francesco Rossi_2022",2022,"Atalanta","Serie A","Francesco Rossi","ITA","GK","30",1991,0.4,0,0,0,0,0,0,0,NA,0,0,0,0,0,0,0,0,"https://fbref.com/en/players/7b5f516f/Francesco-Rossi"
"8384","Giorgio Scalvini_2022",2022,"Atalanta","Serie A","Giorgio Scalvini","ITA","DF,MF","17",2003,8.5,22,11,13,8,1,9,19,47.4,10,12,1,11,22,44,16,0,"https://fbref.com/en/players/1e9aa637/Giorgio-Scalvini"
"8385","Alassane Sidibe_2022",2022,"Atalanta","Serie A","Alassane Sidibe","CIV","MF","19",2002,0.1,1,1,1,0,0,0,0,NA,0,0,0,0,0,1,0,0,"https://fbref.com/en/players/f944979d/Alassane-Sidibe"
"8386","Marco Sportiello_2022",2022,"Atalanta","Serie A","Marco Sportiello","ITA","GK","29",1992,5,0,0,0,0,0,0,0,NA,0,0,0,0,0,0,2,0,"https://fbref.com/en/players/ac4003af/Marco-Sportiello"
"8387","Rafael Tolói_2022",2022,"Atalanta","Serie A","Rafael Tolói","ITA","DF","30",1990,16,38,15,12,15,11,24,39,61.5,15,23,11,12,26,64,35,0,"https://fbref.com/en/players/c56dc39e/Rafael-Toloi"
"8388","Duván Zapata_2022",2022,"Atalanta","Serie A","Duván Zapata","COL","FW","30",1991,19.1,6,2,0,4,2,4,8,50,4,8,1,7,3,9,5,0,"https://fbref.com/en/players/d3de9af0/Duvan-Zapata"
"8389","Davide Zappacosta_2022",2022,"Atalanta","Serie A","Davide Zappacosta","ITA","DF","29",1992,26.1,32,22,12,13,7,19,37,51.4,18,32,2,30,12,44,22,0,"https://fbref.com/en/players/7fe90ccd/Davide-Zappacosta"
"8390","Julen Agirrezabala_2022",2022,"Athletic Club","La Liga","Julen Agirrezabala","ESP","GK","20",2000,4,0,0,0,0,0,0,0,NA,0,0,0,0,0,0,2,0,"https://fbref.com/en/players/a2c1a8d3/Julen-Agirrezabala"
"8391","Yeray Álvarez_2022",2022,"Athletic Club","La Liga","Yeray Álvarez","ESP","DF","26",1995,20.7,24,14,15,8,1,10,18,55.6,8,21,16,5,45,69,97,0,"https://fbref.com/en/players/3ecc11d8/Yeray-Alvarez"
"8392","Mikel Balenziaga_2022",2022,"Athletic Club","La Liga","Mikel Balenziaga","ESP","DF","33",1988,22.5,33,24,15,15,3,25,43,58.1,18,27,4,23,21,54,79,0,"https://fbref.com/en/players/1fe67e86/Mikel-Balenziaga"
"8393","Yuri Berchiche_2022",2022,"Athletic Club","La Liga","Yuri Berchiche","ESP","DF","31",1990,11.3,25,11,10,11,4,7,14,50,7,19,6,13,13,38,25,0,"https://fbref.com/en/players/b6e50615/Yuri-Berchiche"
"8394","Álex Berenguer_2022",2022,"Athletic Club","La Liga","Álex Berenguer","ESP","MF","26",1995,24.1,45,26,23,14,8,11,51,21.6,40,40,2,38,16,61,20,0,"https://fbref.com/en/players/dc1c2fce/Alex-Berenguer"
"8395","Ander Capa_2022",2022,"Athletic Club","La Liga","Ander Capa","ESP","DF","29",1992,0,0,0,0,0,0,0,0,NA,0,0,0,0,0,0,0,0,"https://fbref.com/en/players/37f1cf47/Ander-Capa"
"8396","Dani García_2022",2022,"Athletic Club","La Liga","Dani García","ESP","MF","31",1990,24.2,36,22,15,17,4,14,47,29.8,33,27,10,17,24,60,41,1,"https://fbref.com/en/players/240d3a0b/Dani-Garcia"
"8397","Raúl García_2022",2022,"Athletic Club","La Liga","Raúl García","ESP","FW","35",1986,20,27,17,6,11,10,8,36,22.2,28,30,4,26,9,36,21,0,"https://fbref.com/en/players/b418dbd4/Raul-Garcia"
"8398","Iñigo Lekue_2022",2022,"Athletic Club","La Liga","Iñigo Lekue","ESP","DF","28",1993,21.4,32,23,16,12,4,22,44,50,22,37,12,25,23,55,63,0,"https://fbref.com/en/players/59b7d823/Inigo-Lekue"
"8399","Óscar de Marcos_2022",2022,"Athletic Club","La Liga","Óscar de Marcos","ESP","DF","32",1989,18.7,50,37,24,19,7,28,43,65.1,15,20,3,17,19,69,27,0,"https://fbref.com/en/players/9f323c71/Oscar-de-Marcos"
"8400","Iñigo Martínez_2022",2022,"Athletic Club","La Liga","Iñigo Martínez","ESP","DF","30",1991,26,28,13,18,7,3,14,23,60.9,9,22,10,12,39,67,143,0,"https://fbref.com/en/players/3fc45c73/Inigo-Martinez"
"8401","Jon Morcillo_2022",2022,"Athletic Club","La Liga","Jon Morcillo","ESP","MF,FW","22",1998,0.6,3,0,1,2,0,3,4,75,1,1,0,1,0,3,0,0,"https://fbref.com/en/players/b7d7f3bf/Jon-Morcillo"
"8402","Iker Muniain_2022",2022,"Athletic Club","La Liga","Iker Muniain","ESP","MF","28",1992,30.9,32,10,8,19,5,12,40,30,28,20,1,19,17,49,8,1,"https://fbref.com/en/players/c05dfb74/Iker-Muniain"
"8403","Peru Nolaskoain_2022",2022,"Athletic Club","La Liga","Peru Nolaskoain","ESP","DF","22",1998,0,0,0,0,0,0,0,0,NA,0,0,0,0,0,0,0,0,"https://fbref.com/en/players/857cb4f3/Peru-Nolaskoain"
"8404","Unai Núñez_2022",2022,"Athletic Club","La Liga","Unai Núñez","ESP","DF","24",1997,6.9,4,4,2,2,0,3,6,50,3,9,8,1,8,12,26,2,"https://fbref.com/en/players/be170419/Unai-Nunez"
"8405","Alex Petxa_2022",2022,"Athletic Club","La Liga","Alex Petxa","ESP","DF,MF","24",1997,4.6,12,9,4,7,1,4,8,50,4,8,2,6,4,16,6,0,"https://fbref.com/en/players/97d08e60/Alex-Petxa"
"8406","Oihan Sancet_2022",2022,"Athletic Club","La Liga","Oihan Sancet","ESP","FW","21",2000,15.8,12,7,2,8,2,5,20,25,15,2,0,2,5,17,13,0,"https://fbref.com/en/players/bdb624a3/Oihan-Sancet"
"8407","Nicolás Serrano_2022",2022,"Athletic Club","La Liga","Nicolás Serrano","ESP","MF,FW","18",2003,3.5,9,6,3,5,1,3,10,30,7,5,1,4,2,11,3,0,"https://fbref.com/en/players/2ad0e5e5/Nicolas-Serrano"
"8408","Unai Simón_2022",2022,"Athletic Club","La Liga","Unai Simón","ESP","GK","24",1997,34,0,0,0,0,0,0,0,NA,0,0,0,0,1,1,5,1,"https://fbref.com/en/players/5dcf3e90/Unai-Simon"
"8409","Unai Vencedor Paris_2022",2022,"Athletic Club","La Liga","Unai Vencedor Paris","ESP","MF","20",2000,26.5,26,11,11,9,6,8,42,19,34,31,13,18,19,45,22,0,"https://fbref.com/en/players/4112ace5/Unai-Vencedor-Paris"
"8410","Mikel Vesga_2022",2022,"Athletic Club","La Liga","Mikel Vesga","ESP","MF","28",1993,15.1,27,14,7,18,2,11,31,35.5,20,16,5,11,20,47,34,2,"https://fbref.com/en/players/b0fce72c/Mikel-Vesga"
"8411","Asier Villalibre_2022",2022,"Athletic Club","La Liga","Asier Villalibre","ESP","FW","23",1997,6.1,4,3,2,1,1,1,2,50,1,3,1,2,1,5,7,0,"https://fbref.com/en/players/57be54ec/Asier-Villalibre"
"8412","Daniel Vivian_2022",2022,"Athletic Club","La Liga","Daniel Vivian","ESP","DF","22",1999,22.1,32,21,24,7,1,17,24,70.8,7,20,15,5,26,58,107,1,"https://fbref.com/en/players/ab7bf91d/Daniel-Vivian"
"8413","Iñaki Williams_2022",2022,"Athletic Club","La Liga","Iñaki Williams","GHA","FW","27",1994,30.9,14,5,1,6,7,5,17,29.4,12,18,3,15,3,17,20,0,"https://fbref.com/en/players/6a99e0b1/Inaki-Williams"
"8414","Nico Williams_2022",2022,"Athletic Club","La Liga","Nico Williams","ESP","MF","19",2002,14.9,20,10,6,11,3,10,31,32.3,21,18,2,16,5,25,9,0,"https://fbref.com/en/players/afdc14d7/Nico-Williams"
"8415","Oier Zarraga_2022",2022,"Athletic Club","La Liga","Oier Zarraga","ESP","MF","22",1999,13,13,5,4,7,2,3,28,10.7,25,17,10,7,19,32,10,0,"https://fbref.com/en/players/968a1c2f/Oier-Zarraga"
"8416","Yannick Carrasco_2022",2022,"Atlético Madrid","La Liga","Yannick Carrasco","BEL","FW,MF","27",1993,28.7,34,19,16,12,6,19,44,43.2,25,26,5,21,19,53,12,2,"https://fbref.com/en/players/de39485a/Yannick-Carrasco"
"8417","Ángel Correa_2022",2022,"Atlético Madrid","La Liga","Ángel Correa","ARG","FW,MF","26",1995,20.6,16,8,5,10,1,7,29,24.1,22,25,2,23,10,26,4,0,"https://fbref.com/en/players/01eb744d/Angel-Correa"
"8418","Matheus Cunha_2022",2022,"Atlético Madrid","La Liga","Matheus Cunha","BRA","FW","22",1999,11.8,19,12,3,11,5,5,20,25,15,18,2,16,6,25,9,0,"https://fbref.com/en/players/dc62b55d/Matheus-Cunha"
"8419","Rodrigo De Paul_2022",2022,"Atlético Madrid","La Liga","Rodrigo De Paul","ARG","MF","27",1994,23.9,55,30,22,25,8,30,60,50,30,24,3,21,21,76,17,2,"https://fbref.com/en/players/162efffd/Rodrigo-De-Paul"
"8420","Felipe_2022",2022,"Atlético Madrid","La Liga","Felipe","BRA","DF","32",1989,16.7,20,15,11,8,1,8,18,44.4,10,17,11,6,28,48,77,0,"https://fbref.com/en/players/51a3c4c8/Felipe"
"8421","João Félix_2022",2022,"Atlético Madrid","La Liga","João Félix","POR","FW,MF","21",1999,14,5,2,1,4,0,1,5,20,4,4,1,3,7,12,8,0,"https://fbref.com/en/players/8aafd64f/Joao-Felix"
"8422","Antoine Griezmann_2022",2022,"Atlético Madrid","La Liga","Antoine Griezmann","FRA","FW,MF","30",1991,18.8,30,14,11,15,4,12,32,37.5,20,18,1,17,7,37,18,0,"https://fbref.com/en/players/df69b544/Antoine-Griezmann"
"8423","Mario Hermoso_2022",2022,"Atlético Madrid","La Liga","Mario Hermoso","ESP","DF","26",1995,20.7,30,15,23,4,3,20,38,52.6,18,18,3,15,29,59,49,2,"https://fbref.com/en/players/555f3a0b/Mario-Hermoso"
"8424","Héctor Herrera_2022",2022,"Atlético Madrid","La Liga","Héctor Herrera","MEX","MF","31",1990,9.5,16,8,11,4,1,7,20,35,13,13,2,11,12,28,16,0,"https://fbref.com/en/players/a8542814/Hector-Herrera"
"8425","Koke_2022",2022,"Atlético Madrid","La Liga","Koke","ESP","MF","29",1992,27.9,55,30,19,29,7,26,63,41.3,37,21,5,16,24,79,31,1,"https://fbref.com/en/players/55126f3b/Koke"
"8426","Geoffrey Kondogbia_2022",2022,"Atlético Madrid","La Liga","Geoffrey Kondogbia","CTA","MF,DF","28",1993,20.9,74,44,25,40,9,21,49,42.9,28,16,5,11,44,118,24,0,"https://fbref.com/en/players/cce181df/Geoffrey-Kondogbia"
"8427","Thomas Lemar_2022",2022,"Atlético Madrid","La Liga","Thomas Lemar","FRA","MF","25",1995,16,24,14,9,12,3,8,23,34.8,15,18,0,18,8,32,11,0,"https://fbref.com/en/players/4dbd0916/Thomas-Lemar"
"8428","Marcos Llorente_2022",2022,"Atlético Madrid","La Liga","Marcos Llorente","ESP","MF,DF","26",1995,27.2,51,23,25,22,4,28,43,65.1,15,33,10,23,27,78,44,0,"https://fbref.com/en/players/02c15616/Marcos-Llorente"
"8429","Renan Lodi_2022",2022,"Atlético Madrid","La Liga","Renan Lodi","BRA","DF","23",1998,13.1,31,18,14,13,4,11,27,40.7,16,22,4,18,13,44,19,1,"https://fbref.com/en/players/ed9f7cfe/Renan-Lodi"
"8430","Reinildo Mandava_2022",2022,"Atlético Madrid","La Liga","Reinildo Mandava","MOZ","DF","27",1994,14.4,45,25,30,14,1,22,30,73.3,8,18,9,9,21,66,38,0,"https://fbref.com/en/players/c20bdcd7/Reinildo-Mandava"
"8431","José María Giménez_2022",2022,"Atlético Madrid","La Liga","José María Giménez","URU","DF","26",1995,22.7,18,12,12,6,0,8,16,50,8,25,19,6,25,43,96,1,"https://fbref.com/en/players/f0da930c/Jose-Maria-Gimenez"
"8432","Carlos Martín_2022",2022,"Atlético Madrid","La Liga","Carlos Martín","ESP","DF","19",2002,0.1,0,0,0,0,0,0,0,NA,0,0,0,0,0,0,1,0,"https://fbref.com/en/players/64035864/Carlos-Martin"
"8433","Saúl Ñíguez_2022",2022,"Atlético Madrid","La Liga","Saúl Ñíguez","ESP","FW,MF","26",1994,2.2,7,2,0,6,1,3,4,75,1,7,1,6,0,7,3,0,"https://fbref.com/en/players/c14bc029/Saul-Niguez"
"8434","Jan Oblak_2022",2022,"Atlético Madrid","La Liga","Jan Oblak","SVN","GK","28",1993,38,0,0,0,0,0,0,0,NA,0,0,0,0,1,1,10,4,"https://fbref.com/en/players/ee8508c0/Jan-Oblak"
"8435","Stefan Savić_2022",2022,"Atlético Madrid","La Liga","Stefan Savić","MNE","DF","30",1991,27.1,46,20,25,20,1,29,43,67.4,14,19,12,7,37,83,102,1,"https://fbref.com/en/players/f6ac68c1/Stefan-Savic"
"8436","Javier Serrano_2022",2022,"Atlético Madrid","La Liga","Javier Serrano","ESP","MF","18",2003,0.8,3,1,0,3,0,2,4,50,2,0,0,0,3,6,2,0,"https://fbref.com/en/players/0a8fd9cb/Javier-Serrano"
"8437","Giuliano Simeone_2022",2022,"Atlético Madrid","La Liga","Giuliano Simeone","ARG","MF","18",2002,0,0,0,0,0,0,0,0,NA,0,0,0,0,0,0,0,0,"https://fbref.com/en/players/a6536561/Giuliano-Simeone"
"8438","Luis Suárez_2022",2022,"Atlético Madrid","La Liga","Luis Suárez","URU","FW","34",1987,20.4,8,5,2,4,2,2,10,20,8,8,1,7,1,9,14,0,"https://fbref.com/en/players/a6154613/Luis-Suarez"
"8439","Kieran Trippier_2022",2022,"Atlético Madrid","La Liga","Kieran Trippier","ENG","DF,FW","30",1990,10.8,22,12,12,5,5,12,21,57.1,9,12,1,11,10,32,11,0,"https://fbref.com/en/players/21512407/Kieran-Trippier"
"8440","Šime Vrsaljko_2022",2022,"Atlético Madrid","La Liga","Šime Vrsaljko","CRO","DF","29",1992,10.2,27,17,14,12,1,12,20,60,8,10,1,9,12,39,30,0,"https://fbref.com/en/players/46a8347f/Sime-Vrsaljko"
"8441","Daniel Wass_2022",2022,"Atlético Madrid","La Liga","Daniel Wass","DEN","DF,FW","32",1989,0.5,0,0,0,0,0,0,0,NA,0,0,0,0,0,0,3,0,"https://fbref.com/en/players/d83bbc54/Daniel-Wass"
"8442","Noah Joel Sarenren Bazee_2022",2022,"Augsburg","Bundesliga","Noah Joel Sarenren Bazee","NGA","MF,FW","24",1996,2.7,5,2,2,2,1,3,4,75,1,8,2,6,1,6,4,0,"https://fbref.com/en/players/fbbc8e15/Noah-Joel-Sarenren-Bazee"
"8443","Daniel Caligiuri_2022",2022,"Augsburg","Bundesliga","Daniel Caligiuri","ITA","DF,MF","33",1988,22.3,46,30,17,26,3,27,72,37.5,45,36,5,31,18,64,33,0,"https://fbref.com/en/players/d1273f09/Daniel-Caligiuri"
"8444","Sergio Córdova_2022",2022,"Augsburg","Bundesliga","Sergio Córdova","VEN","FW,MF","23",1997,3.6,4,3,2,2,0,1,2,50,1,4,0,4,0,4,4,0,"https://fbref.com/en/players/229cd98a/Sergio-Cordova"
"8445","Niklas Dorsch_2022",2022,"Augsburg","Bundesliga","Niklas Dorsch","GER","MF","23",1998,25.8,76,47,47,23,6,30,60,50,30,34,12,22,35,111,36,3,"https://fbref.com/en/players/7f73bdf4/Niklas-Dorsch"
"8446","Ohis Felix Uduokhai_2022",2022,"Augsburg","Bundesliga","Ohis Felix Uduokhai","GER","DF","23",1997,8.7,9,6,6,3,0,6,11,54.5,5,13,8,5,9,18,33,0,"https://fbref.com/en/players/677da306/Ohis-Felix-Uduokhai"
"8447","Alfreð Finnbogason_2022",2022,"Augsburg","Bundesliga","Alfreð Finnbogason","ISL","FW","32",1989,3.2,3,1,0,2,1,2,4,50,2,5,1,4,2,5,8,0,"https://fbref.com/en/players/f9e7c4ac/Alfred-Finnbogason"
"8448","Raphael Framberger_2022",2022,"Augsburg","Bundesliga","Raphael Framberger","GER","DF","25",1995,9.4,26,19,12,10,4,13,27,48.1,14,8,2,6,9,35,25,0,"https://fbref.com/en/players/626fab5f/Raphael-Framberger"
"8449","Rafał Gikiewicz_2022",2022,"Augsburg","Bundesliga","Rafał Gikiewicz","POL","GK","33",1987,34,2,0,2,0,0,2,7,28.6,5,0,0,0,3,5,11,5,"https://fbref.com/en/players/17376543/Rafal-Gikiewicz"
"8450","Jeffrey Gouweleeuw_2022",2022,"Augsburg","Bundesliga","Jeffrey Gouweleeuw","NED","DF","30",1991,28.6,50,27,33,17,0,22,36,61.1,14,35,18,17,49,99,116,0,"https://fbref.com/en/players/1025db8e/Jeffrey-Gouweleeuw"
"8451","Michael Gregoritsch_2022",2022,"Augsburg","Bundesliga","Michael Gregoritsch","AUT","FW,MF","27",1994,15.5,19,8,4,10,5,2,15,13.3,13,18,2,16,6,25,29,0,"https://fbref.com/en/players/8e235926/Michael-Gregoritsch"
"8452","Carlos Gruezo_2022",2022,"Augsburg","Bundesliga","Carlos Gruezo","ECU","MF","26",1995,10.8,22,11,10,10,2,8,21,38.1,13,11,2,9,9,31,15,0,"https://fbref.com/en/players/f2dd9a21/Carlos-Gruezo"
"8453","Robert Gumny_2022",2022,"Augsburg","Bundesliga","Robert Gumny","POL","DF","23",1998,25.2,48,29,25,20,3,25,43,58.1,18,24,7,17,28,76,57,3,"https://fbref.com/en/players/1df0c0b9/Robert-Gumny"
"8454","Lasse Günther_2022",2022,"Augsburg","Bundesliga","Lasse Günther","GER","DF","18",2003,1.8,8,5,4,3,1,5,9,55.6,4,0,0,0,2,10,2,0,"https://fbref.com/en/players/00672803/Lasse-Gunther"
"8455","André Hahn_2022",2022,"Augsburg","Bundesliga","André Hahn","GER","MF,FW","30",1990,23.3,36,20,9,15,12,17,50,34,33,38,5,33,15,51,43,0,"https://fbref.com/en/players/cd82452e/Andre-Hahn"
"8456","Iago_2022",2022,"Augsburg","Bundesliga","Iago","BRA","DF","24",1997,24.2,49,29,25,19,5,15,34,44.1,19,28,6,22,27,76,62,0,"https://fbref.com/en/players/054849d2/Iago"
"8457","Fredrik Jensen_2022",2022,"Augsburg","Bundesliga","Fredrik Jensen","FIN","MF,FW","23",1997,4.6,5,4,1,3,1,4,7,57.1,3,5,1,4,2,7,4,0,"https://fbref.com/en/players/3eeb80e0/Fredrik-Jensen"
"8458","Arne Maier_2022",2022,"Augsburg","Bundesliga","Arne Maier","GER","MF","22",1999,20.7,20,13,6,10,4,8,26,30.8,18,18,1,17,15,35,13,0,"https://fbref.com/en/players/ab700320/Arne-Maier"
"8459","Jan Morávek_2022",2022,"Augsburg","Bundesliga","Jan Morávek","CZE","MF","31",1989,5.2,11,6,3,7,1,6,18,33.3,12,11,2,9,6,17,8,0,"https://fbref.com/en/players/e7d22eae/Jan-Moravek"
"8460","Florian Niederlechner_2022",2022,"Augsburg","Bundesliga","Florian Niederlechner","GER","FW","30",1990,12.9,6,5,1,3,2,4,13,30.8,9,9,0,9,4,10,7,0,"https://fbref.com/en/players/d6862409/Florian-Niederlechner"
"8461","Reece Oxford_2022",2022,"Augsburg","Bundesliga","Reece Oxford","ENG","DF","22",1998,29.9,27,14,16,9,2,15,31,48.4,16,42,33,9,72,99,172,1,"https://fbref.com/en/players/8b6e0db2/Reece-Oxford"
"8462","Mads Pedersen_2022",2022,"Augsburg","Bundesliga","Mads Pedersen","DEN","MF,DF","24",1996,15.5,28,21,8,15,5,12,27,44.4,15,13,4,9,15,43,30,0,"https://fbref.com/en/players/582a5247/Mads-Pedersen"
"8463","Ricardo Pepi_2022",2022,"Augsburg","Bundesliga","Ricardo Pepi","USA","FW,MF","18",2003,5.3,4,2,1,3,0,1,8,12.5,7,7,0,7,3,7,8,0,"https://fbref.com/en/players/a2b1ed42/Ricardo-Pepi"
"8464","Tobias Strobl_2022",2022,"Augsburg","Bundesliga","Tobias Strobl","GER","MF,DF","31",1990,3.6,8,3,3,5,0,3,11,27.3,8,7,2,5,7,15,3,0,"https://fbref.com/en/players/17780d2b/Tobias-Strobl"
"8465","Ruben Vargas_2022",2022,"Augsburg","Bundesliga","Ruben Vargas","SUI","MF,FW","22",1998,22,28,21,7,14,7,11,30,36.7,19,9,1,8,16,44,13,0,"https://fbref.com/en/players/6ecbddf6/Ruben-Vargas"
"8466","Frederik Winther_2022",2022,"Augsburg","Bundesliga","Frederik Winther","DEN","DF","20",2001,3.6,7,2,7,0,0,5,6,83.3,1,4,1,3,8,15,21,0,"https://fbref.com/en/players/a1257b5e/Frederik-Winther"
"8467","Andi Zeqiri_2022",2022,"Augsburg","Bundesliga","Andi Zeqiri","SUI","FW,MF","22",1999,11.3,14,7,3,5,6,3,12,25,9,10,1,9,2,16,12,0,"https://fbref.com/en/players/d01231f0/Andi-Zeqiri"
"8468","Sergio Agüero_2022",2022,"Barcelona","La Liga","Sergio Agüero","ARG","FW","33",1988,1.7,1,1,0,0,1,0,2,0,2,0,0,0,0,1,0,0,"https://fbref.com/en/players/4d034881/Sergio-Aguero"
"8469","Ilias Akhomach_2022",2022,"Barcelona","La Liga","Ilias Akhomach","ESP","FW","17",2004,1.4,2,0,0,1,1,0,0,NA,0,0,0,0,0,2,0,0,"https://fbref.com/en/players/b8bd60fe/Ilias-Akhomach"
"8470","Jordi Alba_2022",2022,"Barcelona","La Liga","Jordi Alba","ESP","DF","32",1989,29.4,47,34,12,26,9,27,47,57.4,20,26,6,20,33,80,41,1,"https://fbref.com/en/players/4601e194/Jordi-Alba"
"8471","Dani Alves_2022",2022,"Barcelona","La Liga","Dani Alves","BRA","DF","38",1983,12.2,30,19,13,13,4,14,26,53.8,12,10,3,7,11,41,10,2,"https://fbref.com/en/players/c9e99e49/Dani-Alves"
"8472","Ronald Araújo_2022",2022,"Barcelona","La Liga","Ronald Araújo","URU","DF","22",1999,25.2,41,23,29,12,0,21,25,84,4,37,20,17,23,64,66,1,"https://fbref.com/en/players/2bef2bca/Ronald-Araujo"
"8473","Pierre-Emerick Aubameyang_2022",2022,"Barcelona","La Liga","Pierre-Emerick Aubameyang","GAB","FW","32",1989,12,2,2,0,1,1,0,5,0,5,9,1,8,2,4,4,0,"https://fbref.com/en/players/d5dd5f1f/Pierre-Emerick-Aubameyang"
"8474","Alejandro Balde_2022",2022,"Barcelona","La Liga","Alejandro Balde","ESP","DF,FW","17",2003,2.1,2,1,1,0,1,0,0,NA,0,2,2,0,1,3,1,0,"https://fbref.com/en/players/5ccc9672/Alejandro-Balde"
"8475","Martin Braithwaite_2022",2022,"Barcelona","La Liga","Martin Braithwaite","DEN","FW","30",1991,2.6,1,1,0,0,1,0,0,NA,0,2,0,2,1,2,1,0,"https://fbref.com/en/players/fd771f95/Martin-Braithwaite"
"8476","Sergio Busquets_2022",2022,"Barcelona","La Liga","Sergio Busquets","ESP","MF","33",1988,35.5,93,49,31,48,14,46,83,55.4,37,44,8,36,45,138,31,0,"https://fbref.com/en/players/5ab0ea87/Sergio-Busquets"
"8477","Philippe Coutinho_2022",2022,"Barcelona","La Liga","Philippe Coutinho","BRA","MF,FW","29",1992,5.6,6,3,3,3,0,3,11,27.3,8,3,0,3,4,10,3,0,"https://fbref.com/en/players/0ef89a37/Philippe-Coutinho"
"8478","Ousmane Dembélé_2022",2022,"Barcelona","La Liga","Ousmane Dembélé","FRA","FW","24",1997,15.7,24,16,6,10,8,7,23,30.4,16,8,0,8,8,32,3,0,"https://fbref.com/en/players/b19db005/Ousmane-Dembele"
"8479","Yusuf Demir_2022",2022,"Barcelona","La Liga","Yusuf Demir","AUT","FW","18",2003,2.1,3,1,1,1,1,2,5,40,3,1,0,1,2,5,1,0,"https://fbref.com/en/players/fa265f6d/Yusuf-Demir"
"8480","Sergiño Dest_2022",2022,"Barcelona","La Liga","Sergiño Dest","USA","DF,FW","20",2000,16.8,32,15,21,10,1,13,18,72.2,5,22,4,18,2,34,18,0,"https://fbref.com/en/players/5976f83e/Sergino-Dest"
"8481","Emerson_2022",2022,"Barcelona","La Liga","Emerson","BRA","DF","22",1999,1,3,3,2,1,0,1,2,50,1,1,0,1,2,5,1,0,"https://fbref.com/en/players/df8b52a5/Emerson"
"8482","Estanis_2022",2022,"Barcelona","La Liga","Estanis","ESP","FW","17",2003,0.1,1,1,0,1,0,1,1,100,0,0,0,0,0,1,0,0,"https://fbref.com/en/players/ace50e9f/Estanis"
"8483","Abdessamad Ezzalzouli_2022",2022,"Barcelona","La Liga","Abdessamad Ezzalzouli","MAR","FW","19",2001,6.4,17,9,9,5,3,5,8,62.5,3,3,0,3,9,26,0,0,"https://fbref.com/en/players/bed68338/Abdessamad-Ezzalzouli"
"8484","Ansu Fati_2022",2022,"Barcelona","La Liga","Ansu Fati","ESP","FW","18",2002,3.7,3,2,0,2,1,1,1,100,0,4,0,4,1,4,0,0,"https://fbref.com/en/players/0ba976e4/Ansu-Fati"
"8485","Eric García_2022",2022,"Barcelona","La Liga","Eric García","ESP","DF","20",2001,22.7,27,18,13,13,1,11,26,42.3,15,22,12,10,44,71,53,3,"https://fbref.com/en/players/2bed3eab/Eric-Garcia"
"8486","Gavi_2022",2022,"Barcelona","La Liga","Gavi","ESP","MF,FW","16",2004,25.7,38,18,13,18,7,9,33,27.3,24,36,0,36,25,63,13,0,"https://fbref.com/en/players/19cae58d/Gavi"
"8487","Nicolás González_2022",2022,"Barcelona","La Liga","Nicolás González","ESP","MF","19",2002,12.4,31,20,5,23,3,11,27,40.7,16,12,0,12,6,37,12,0,"https://fbref.com/en/players/2c56a792/Nicolas-Gonzalez"
"8488","Antoine Griezmann_2022",2022,"Barcelona","La Liga","Antoine Griezmann","FRA","FW","30",1991,2.9,13,5,3,10,0,2,6,33.3,4,4,0,4,3,16,5,0,"https://fbref.com/en/players/df69b544/Antoine-Griezmann"
"8489","Frenkie de Jong_2022",2022,"Barcelona","La Liga","Frenkie de Jong","NED","MF","24",1997,27.5,35,19,12,18,5,12,23,52.2,11,19,5,14,20,55,16,0,"https://fbref.com/en/players/1bacc518/Frenkie-de-Jong"
"8490","Luuk de Jong_2022",2022,"Barcelona","La Liga","Luuk de Jong","NED","FW","30",1990,7.3,9,7,1,5,3,1,2,50,1,4,0,4,0,9,12,0,"https://fbref.com/en/players/abb3bb95/Luuk-de-Jong"
"8491","Jutglà_2022",2022,"Barcelona","La Liga","Jutglà","ESP","FW","22",1999,3.3,2,1,0,1,1,0,1,0,1,2,0,2,1,3,1,0,"https://fbref.com/en/players/2a9f6b4d/Jutgla"
"8492","Clément Lenglet_2022",2022,"Barcelona","La Liga","Clément Lenglet","FRA","DF","26",1995,9.2,20,11,11,7,2,8,13,61.5,5,7,3,4,13,33,21,0,"https://fbref.com/en/players/4f28a6ff/Clement-Lenglet"
"8493","Mika Màrmol_2022",2022,"Barcelona","La Liga","Mika Màrmol","ESP","DF","19",2002,0,0,0,0,0,0,0,0,NA,0,0,0,0,0,0,0,0,"https://fbref.com/en/players/e7630876/Mika-Marmol"
"8494","Memphis_2022",2022,"Barcelona","La Liga","Memphis","NED","FW","27",1994,20.6,10,4,2,4,4,3,13,23.1,10,9,1,8,3,13,4,0,"https://fbref.com/en/players/8f696594/Memphis"
"8495","Óscar Mingueza_2022",2022,"Barcelona","La Liga","Óscar Mingueza","ESP","DF","22",1999,9.9,25,11,12,11,2,16,23,69.6,7,5,0,5,9,34,22,1,"https://fbref.com/en/players/056269d7/Oscar-Mingueza"
"8496","Neto_2022",2022,"Barcelona","La Liga","Neto","BRA","GK","32",1989,3,0,0,0,0,0,0,0,NA,0,0,0,0,0,0,2,1,"https://fbref.com/en/players/a9dc785c/Neto"
"8497","Pedri_2022",2022,"Barcelona","La Liga","Pedri","ESP","MF","18",2002,9.8,20,12,9,8,3,7,20,35,13,13,0,13,5,25,7,1,"https://fbref.com/en/players/0d9b2d31/Pedri"
"8498","Gerard Piqué_2022",2022,"Barcelona","La Liga","Gerard Piqué","ESP","DF","34",1987,23.2,22,12,18,4,0,11,14,78.6,3,19,16,3,34,56,86,1,"https://fbref.com/en/players/adfc9123/Gerard-Pique"
"8499","Riqui Puig_2022",2022,"Barcelona","La Liga","Riqui Puig","ESP","MF","21",1999,5.4,6,3,2,4,0,2,14,14.3,12,5,0,5,3,9,0,0,"https://fbref.com/en/players/f090a37a/Riqui-Puig"
"8500","Sergi Roberto_2022",2022,"Barcelona","La Liga","Sergi Roberto","ESP","MF,DF","29",1992,4.4,5,1,2,3,0,3,5,60,2,2,0,2,4,9,6,0,"https://fbref.com/en/players/335fa267/Sergi-Roberto"
"8501","Alvaro Sanz_2022",2022,"Barcelona","La Liga","Alvaro Sanz","ESP","MF","20",2001,0.3,0,0,0,0,0,0,1,0,1,0,0,0,0,0,0,0,"https://fbref.com/en/players/eaefa2d0/Alvaro-Sanz"
"8502","Marc-André ter Stegen_2022",2022,"Barcelona","La Liga","Marc-André ter Stegen","GER","GK","29",1992,35,0,0,0,0,0,0,1,0,1,0,0,0,1,1,13,5,"https://fbref.com/en/players/6f51e382/Marc-Andre-ter-Stegen"
"8503","Ferrán Torres_2022",2022,"Barcelona","La Liga","Ferrán Torres","ESP","FW","21",2000,15.7,10,5,3,4,3,3,7,42.9,4,12,3,9,6,16,7,0,"https://fbref.com/en/players/9e1035f8/Ferran-Torres"
"8504","Adama Traoré_2022",2022,"Barcelona","La Liga","Adama Traoré","ESP","FW","25",1996,4.2,4,2,0,3,1,3,5,60,2,2,0,2,4,8,3,1,"https://fbref.com/en/players/9a28eba4/Adama-Traore"
"8505","Samuel Umtiti_2022",2022,"Barcelona","La Liga","Samuel Umtiti","FRA","DF","27",1993,1,2,2,2,0,0,1,2,50,1,1,1,0,0,2,4,0,"https://fbref.com/en/players/3eed9821/Samuel-Umtiti"
"8506","Kingsley Coman_2022",2022,"Bayern Munich","Bundesliga","Kingsley Coman","FRA","FW,DF","25",1996,15.1,14,8,1,9,4,5,16,31.3,11,14,0,14,8,22,5,0,"https://fbref.com/en/players/042e8a49/Kingsley-Coman"
"8507","Lucas Copado_2022",2022,"Bayern Munich","Bundesliga","Lucas Copado","GER","FW","17",2004,0.2,1,0,1,0,0,1,1,100,0,0,0,0,0,1,0,0,"https://fbref.com/en/players/8356931a/Lucas-Copado"
"8508","Mickaël Cuisance_2022",2022,"Bayern Munich","Bundesliga","Mickaël Cuisance","FRA","MF","21",1999,0.1,1,1,0,1,0,0,0,NA,0,0,0,0,0,1,0,0,"https://fbref.com/en/players/5722eced/Mickael-Cuisance"
"8509","Alphonso Davies_2022",2022,"Bayern Munich","Bundesliga","Alphonso Davies","CAN","DF","20",2000,19.3,34,17,17,8,9,13,31,41.9,18,27,1,26,23,57,26,1,"https://fbref.com/en/players/d781d855/Alphonso-Davies"
"8510","Christian Früchtl_2022",2022,"Bayern Munich","Bundesliga","Christian Früchtl","GER","GK","21",2000,0.1,0,0,0,0,0,0,0,NA,0,0,0,0,0,0,0,0,"https://fbref.com/en/players/1940be91/Christian-Fruchtl"
"8511","Serge Gnabry_2022",2022,"Bayern Munich","Bundesliga","Serge Gnabry","GER","FW,DF","26",1995,24.3,47,31,16,20,11,22,57,38.6,35,26,0,26,14,61,3,0,"https://fbref.com/en/players/88e357ef/Serge-Gnabry"
"8512","Leon Goretzka_2022",2022,"Bayern Munich","Bundesliga","Leon Goretzka","GER","MF","26",1995,15.5,25,15,12,9,4,11,26,42.3,15,11,1,10,17,42,23,2,"https://fbref.com/en/players/cc86b9a3/Leon-Goretzka"
"8513","Lucas Hernández_2022",2022,"Bayern Munich","Bundesliga","Lucas Hernández","FRA","DF","25",1996,22.6,50,31,20,24,6,26,42,61.9,16,22,11,11,28,78,54,1,"https://fbref.com/en/players/c3ee18ef/Lucas-Hernandez"
"8514","Joshua Kimmich_2022",2022,"Bayern Munich","Bundesliga","Joshua Kimmich","GER","MF","26",1995,27.5,39,20,14,17,8,18,58,31,40,34,8,26,52,91,29,1,"https://fbref.com/en/players/49296448/Joshua-Kimmich"
"8515","Robert Lewandowski_2022",2022,"Bayern Munich","Bundesliga","Robert Lewandowski","POL","FW","32",1988,32.7,10,3,0,6,4,5,17,29.4,12,17,2,15,6,16,8,0,"https://fbref.com/en/players/8d78e732/Robert-Lewandowski"
"8516","Eric Maxim Choupo-Moting_2022",2022,"Bayern Munich","Bundesliga","Eric Maxim Choupo-Moting","CMR","FW,MF","32",1989,4.2,10,9,3,6,1,3,10,30,7,1,0,1,5,15,2,0,"https://fbref.com/en/players/0e6bc38c/Eric-Maxim-Choupo-Moting"
"8517","Thomas Müller_2022",2022,"Bayern Munich","Bundesliga","Thomas Müller","GER","MF","31",1989,28.4,35,20,7,16,12,16,54,29.6,38,32,1,31,15,50,12,0,"https://fbref.com/en/players/3c6089ab/Thomas-Muller"
"8518","Jamal Musiala_2022",2022,"Bayern Munich","Bundesliga","Jamal Musiala","GER","MF,FW","18",2003,16.3,40,26,11,16,13,15,36,41.7,21,25,0,25,19,59,2,1,"https://fbref.com/en/players/2c0558b8/Jamal-Musiala"
"8519","Manuel Neuer_2022",2022,"Bayern Munich","Bundesliga","Manuel Neuer","GER","GK","35",1986,27.9,2,1,2,0,0,1,2,50,1,0,0,0,0,2,7,1,"https://fbref.com/en/players/8778c910/Manuel-Neuer"
"8520","Tanguy Nianzou_2022",2022,"Bayern Munich","Bundesliga","Tanguy Nianzou","FRA","DF","19",2002,6.5,11,7,7,3,1,7,11,63.6,4,7,2,5,7,18,17,0,"https://fbref.com/en/players/5853ac44/Tanguy-Nianzou"
"8521","Benjamin Pavard_2022",2022,"Bayern Munich","Bundesliga","Benjamin Pavard","FRA","DF","25",1996,23.1,35,20,21,13,1,19,29,65.5,10,28,16,12,36,71,50,1,"https://fbref.com/en/players/45a03961/Benjamin-Pavard"
"8522","Chris Richards_2022",2022,"Bayern Munich","Bundesliga","Chris Richards","USA","DF","21",2000,0,0,0,0,0,0,0,0,NA,0,1,0,1,0,0,0,0,"https://fbref.com/en/players/0a3d6d2b/Chris-Richards"
"8523","Omar Richards_2022",2022,"Bayern Munich","Bundesliga","Omar Richards","ENG","DF","23",1998,4.9,19,12,11,5,3,11,16,68.8,5,7,1,6,4,23,7,0,"https://fbref.com/en/players/f9b1b7bf/Omar-Richards"
"8524","Marc Roca_2022",2022,"Bayern Munich","Bundesliga","Marc Roca","ESP","MF","24",1996,4.2,9,7,2,4,3,2,8,25,6,6,0,6,6,15,4,0,"https://fbref.com/en/players/da27e268/Marc-Roca"
"8525","Marcel Sabitzer_2022",2022,"Bayern Munich","Bundesliga","Marcel Sabitzer","AUT","MF,DF","27",1994,10.1,18,7,8,8,2,9,19,47.4,10,7,0,7,9,27,10,1,"https://fbref.com/en/players/e280527c/Marcel-Sabitzer"
"8526","Leroy Sané_2022",2022,"Bayern Munich","Bundesliga","Leroy Sané","GER","FW,MF","25",1996,22,28,16,5,19,4,9,24,37.5,15,18,0,18,12,40,2,1,"https://fbref.com/en/players/2b114be3/Leroy-Sane"
"8527","Bouna Sarr_2022",2022,"Bayern Munich","Bundesliga","Bouna Sarr","SEN","DF","29",1992,0.7,4,4,2,1,1,4,5,80,1,2,1,1,6,10,1,0,"https://fbref.com/en/players/1a4b9094/Bouna-Sarr"
"8528","Josip Stanišić_2022",2022,"Bayern Munich","Bundesliga","Josip Stanišić","CRO","DF","21",2000,7.2,21,10,7,12,2,12,18,66.7,6,7,0,7,11,32,10,2,"https://fbref.com/en/players/7ed08d5c/Josip-Stanisic"
"8529","Niklas Süle_2022",2022,"Bayern Munich","Bundesliga","Niklas Süle","GER","DF","25",1995,20.4,29,23,21,7,1,18,24,75,6,16,12,4,28,57,49,0,"https://fbref.com/en/players/e33c06cf/Niklas-Sule"
"8530","Malik Tillman_2022",2022,"Bayern Munich","Bundesliga","Malik Tillman","USA","FW,MF","19",2002,1.2,2,1,0,1,1,0,1,0,1,5,1,4,2,4,1,0,"https://fbref.com/en/players/a5420709/Malik-Tillman"
"8531","Corentin Tolisso_2022",2022,"Bayern Munich","Bundesliga","Corentin Tolisso","FRA","MF","26",1994,7.8,11,5,1,9,1,7,17,41.2,10,5,1,4,9,20,10,0,"https://fbref.com/en/players/652d4c37/Corentin-Tolisso"
"8532","Sven Ulreich_2022",2022,"Bayern Munich","Bundesliga","Sven Ulreich","GER","GK","32",1988,6,0,0,0,0,0,0,0,NA,0,0,0,0,0,0,1,0,"https://fbref.com/en/players/7d3e7da6/Sven-Ulreich"
"8533","Dayot Upamecano_2022",2022,"Bayern Munich","Bundesliga","Dayot Upamecano","FRA","DF","22",1998,24.6,66,42,42,21,3,24,36,66.7,12,20,10,10,32,98,71,6,"https://fbref.com/en/players/d248cd8f/Dayot-Upamecano"
"8534","Gabriel Vidovic_2022",2022,"Bayern Munich","Bundesliga","Gabriel Vidovic","CRO","FW,MF","17",2003,0.4,0,0,0,0,0,0,0,NA,0,0,0,0,0,0,0,0,"https://fbref.com/en/players/5360a956/Gabriel-Vidovic"
"8535","Paul Wanner_2022",2022,"Bayern Munich","Bundesliga","Paul Wanner","GER","FW,MF","15",2005,0.4,2,2,0,2,0,1,1,100,0,0,0,0,0,2,0,0,"https://fbref.com/en/players/cb64672e/Paul-Wanner"
"8536","Paul Akouokou_2022",2022,"Betis","La Liga","Paul Akouokou","CIV","MF","23",1997,5.7,14,9,5,7,2,8,12,66.7,4,6,0,6,11,25,6,0,"https://fbref.com/en/players/31f5b89b/Paul-Akouokou"
"8537","Marc Bartra_2022",2022,"Betis","La Liga","Marc Bartra","ESP","DF","30",1991,22.1,39,14,18,17,4,19,35,54.3,16,39,22,17,33,72,105,1,"https://fbref.com/en/players/b742cc0d/Marc-Bartra"
"8538","Héctor Bellerín_2022",2022,"Betis","La Liga","Héctor Bellerín","ESP","DF","26",1995,22,52,32,29,20,3,31,44,70.5,13,11,2,9,23,75,57,1,"https://fbref.com/en/players/f874dd44/Hector-Bellerin"
"8539","Claudio Bravo_2022",2022,"Betis","La Liga","Claudio Bravo","CHI","GK","38",1983,16.2,0,0,0,0,0,0,0,NA,0,0,0,0,0,0,6,2,"https://fbref.com/en/players/10072610/Claudio-Bravo"
"8540","Calderón_2022",2022,"Betis","La Liga","Calderón","ESP","DF","21",2000,0.7,2,0,1,0,1,1,3,33.3,2,0,0,0,0,2,2,0,"https://fbref.com/en/players/da4e70e5/Calderon"
"8541","Víctor Camarasa_2022",2022,"Betis","La Liga","Víctor Camarasa","ESP","MF,FW","27",1994,1.2,2,1,1,1,0,0,1,0,1,2,1,1,2,4,2,0,"https://fbref.com/en/players/b2d03887/Victor-Camarasa"
"8542","Sergio Canales_2022",2022,"Betis","La Liga","Sergio Canales","ESP","FW,MF","30",1991,31,24,14,8,12,4,10,35,28.6,25,16,1,15,10,34,12,0,"https://fbref.com/en/players/a6de370d/Sergio-Canales"
"8543","William Carvalho_2022",2022,"Betis","La Liga","William Carvalho","POR","MF","29",1992,20.1,49,33,20,25,4,15,40,37.5,25,18,7,11,16,65,20,0,"https://fbref.com/en/players/dee86451/William-Carvalho"
"8544","Nabil Fekir_2022",2022,"Betis","La Liga","Nabil Fekir","FRA","MF","28",1993,31,43,29,5,25,13,7,36,19.4,29,14,0,14,7,50,7,0,"https://fbref.com/en/players/bece776f/Nabil-Fekir"
"8545","Édgar González_2022",2022,"Betis","La Liga","Édgar González","ESP","DF","24",1997,16.3,25,19,15,8,2,17,24,70.8,7,17,11,6,23,48,82,0,"https://fbref.com/en/players/49d028db/Edgar-Gonzalez"
"8546","Roberto González_2022",2022,"Betis","La Liga","Roberto González","ESP","FW,MF","20",2001,1.5,5,4,3,2,0,4,6,66.7,2,5,0,5,1,6,1,0,"https://fbref.com/en/players/56545648/Roberto-Gonzalez"
"8547","Andrés Guardado_2022",2022,"Betis","La Liga","Andrés Guardado","MEX","MF","34",1986,15.5,30,13,12,17,1,13,34,38.2,21,18,4,14,21,51,29,1,"https://fbref.com/en/players/ef322658/Andres-Guardado"
"8548","Kike Hermoso_2022",2022,"Betis","La Liga","Kike Hermoso","ESP","DF","21",1999,1,2,1,2,0,0,2,2,100,0,2,1,1,0,2,5,1,"https://fbref.com/en/players/dea912dc/Kike-Hermoso"
"8549","Borja Iglesias_2022",2022,"Betis","La Liga","Borja Iglesias","ESP","FW","28",1993,17.5,6,4,1,2,3,0,8,0,8,11,1,10,4,10,7,0,"https://fbref.com/en/players/75645f0e/Borja-Iglesias"
"8550","Joaquín_2022",2022,"Betis","La Liga","Joaquín","ESP","FW,MF","40",1981,5.2,6,2,4,2,0,3,8,37.5,5,5,2,3,3,9,10,0,"https://fbref.com/en/players/4c5b14d2/Joaquin"
"8551","Willian José_2022",2022,"Betis","La Liga","Willian José","BRA","FW","29",1991,17.8,15,13,2,10,3,2,8,25,6,10,2,8,3,18,16,0,"https://fbref.com/en/players/d87e2cae/Willian-Jose"
"8552","Juanmi_2022",2022,"Betis","La Liga","Juanmi","ESP","FW","28",1993,23.7,39,25,11,19,9,19,49,38.8,30,24,1,23,9,48,10,1,"https://fbref.com/en/players/84399660/Juanmi"
"8553","Diego Lainez_2022",2022,"Betis","La Liga","Diego Lainez","MEX","FW","21",2000,1.6,1,1,0,1,0,0,3,0,3,3,0,3,1,2,0,0,"https://fbref.com/en/players/bf12926c/Diego-Lainez"
"8554","Juan Miranda_2022",2022,"Betis","La Liga","Juan Miranda","ESP","DF","21",2000,8.7,21,11,16,4,1,12,22,54.5,10,10,4,6,15,36,22,0,"https://fbref.com/en/players/ead61f73/Juan-Miranda"
"8555","Martín Montoya_2022",2022,"Betis","La Liga","Martín Montoya","ESP","DF","30",1991,5.8,20,12,11,7,2,15,26,57.7,11,6,0,6,11,31,20,0,"https://fbref.com/en/players/5cec2487/Martin-Montoya"
"8556","Álex Moreno_2022",2022,"Betis","La Liga","Álex Moreno","ESP","DF","28",1993,26.7,76,40,53,15,8,33,60,55,27,28,6,22,34,110,82,1,"https://fbref.com/en/players/16e9d0ea/Alex-Moreno"
"8557","Loren Morón_2022",2022,"Betis","La Liga","Loren Morón","ESP","FW","27",1993,0,1,1,1,0,0,1,1,100,0,0,0,0,0,1,0,0,"https://fbref.com/en/players/3aa4a3be/Loren-Moron"
"8558","Germán Pezzella_2022",2022,"Betis","La Liga","Germán Pezzella","ARG","DF","30",1991,22.1,21,9,16,5,0,16,29,55.2,13,29,18,11,39,60,106,0,"https://fbref.com/en/players/8c725b43/German-Pezzella"
"8559","Raúl_2022",2022,"Betis","La Liga","Raúl","ESP","FW,DF","20",2000,0,0,0,0,0,0,0,0,NA,0,0,0,0,0,0,0,0,"https://fbref.com/en/players/18f0a9f0/Raul"
"8560","Rodri_2022",2022,"Betis","La Liga","Rodri","ESP","FW","21",2000,9.8,10,7,4,5,1,5,22,22.7,17,11,0,11,3,13,4,0,"https://fbref.com/en/players/85bed4ee/Rodri"
"8561","Guido Rodríguez_2022",2022,"Betis","La Liga","Guido Rodríguez","ARG","MF","27",1994,28.1,97,53,46,45,6,54,98,55.1,44,55,12,43,31,128,56,0,"https://fbref.com/en/players/34e393f2/Guido-Rodriguez"
"8562","Aitor Ruibal_2022",2022,"Betis","La Liga","Aitor Ruibal","ESP","FW,DF","25",1996,9.5,21,15,13,3,5,10,34,29.4,24,8,0,8,8,29,6,0,"https://fbref.com/en/players/a55d8df5/Aitor-Ruibal"
"8563","Víctor Ruiz_2022",2022,"Betis","La Liga","Víctor Ruiz","ESP","DF","32",1989,15.8,11,9,7,2,2,6,9,66.7,3,18,13,5,29,40,71,1,"https://fbref.com/en/players/b3dc6eca/Victor-Ruiz"
"8564","Youssouf Sabaly_2022",2022,"Betis","La Liga","Youssouf Sabaly","SEN","DF","28",1993,8.8,12,10,11,0,1,7,13,53.8,6,11,4,7,13,25,16,1,"https://fbref.com/en/players/fbbb9269/Youssouf-Sabaly"
"8565","Rui Silva_2022",2022,"Betis","La Liga","Rui Silva","POR","GK","27",1994,21.8,1,0,1,0,0,1,2,50,1,0,0,0,1,2,11,1,"https://fbref.com/en/players/ea83bfa6/Rui-Silva"
"8566","Cristian Tello_2022",2022,"Betis","La Liga","Cristian Tello","ESP","FW","29",1991,9.1,17,11,6,7,4,13,31,41.9,18,9,0,9,10,27,6,0,"https://fbref.com/en/players/72a99e38/Cristian-Tello"
"8567","Christopher Antwi-Adjei_2022",2022,"Bochum","Bundesliga","Christopher Antwi-Adjei","GHA","FW,MF","27",1994,12.6,21,18,7,8,6,6,26,23.1,20,12,0,12,1,22,8,0,"https://fbref.com/en/players/0a3f6cde/Christopher-Antwi-Adjei"
"8568","Takuma Asano_2022",2022,"Bochum","Bundesliga","Takuma Asano","JPN","FW,MF","26",1994,17.9,11,6,3,6,2,5,19,26.3,14,14,1,13,7,18,7,0,"https://fbref.com/en/players/13ddc856/Takuma-Asano"
"8569","Armel Bella Kotchap_2022",2022,"Bochum","Bundesliga","Armel Bella Kotchap","GER","DF","19",2001,19.6,34,20,25,9,0,18,28,64.3,10,21,16,5,42,76,84,2,"https://fbref.com/en/players/a39d11bc/Armel-Bella-Kotchap"
"8570","Danny Blum_2022",2022,"Bochum","Bundesliga","Danny Blum","GER","FW","30",1991,3.8,2,1,0,0,2,0,2,0,2,4,0,4,2,4,1,0,"https://fbref.com/en/players/eb61713c/Danny-Blum"
"8571","Herbert Bockhorn_2022",2022,"Bochum","Bundesliga","Herbert Bockhorn","GER","DF","26",1995,9.4,20,14,13,4,3,12,20,60,8,10,1,9,14,34,18,0,"https://fbref.com/en/players/5ad8c360/Herbert-Bockhorn"
"8572","Tarsis Bonga_2022",2022,"Bochum","Bundesliga","Tarsis Bonga","GER","MF,FW","24",1997,0.2,0,0,0,0,0,0,0,NA,0,0,0,0,0,0,0,0,"https://fbref.com/en/players/6ebbc28a/Tarsis-Bonga"
"8573","Saulo Decarli_2022",2022,"Bochum","Bundesliga","Saulo Decarli","SUI","DF","29",1992,0.1,0,0,0,0,0,0,0,NA,0,0,0,0,0,0,0,0,"https://fbref.com/en/players/41df88b8/Saulo-Decarli"
"8574","Michael Esser_2022",2022,"Bochum","Bundesliga","Michael Esser","GER","GK","33",1987,3,0,0,0,0,0,0,1,0,1,0,0,0,0,0,2,0,"https://fbref.com/en/players/83e0eeb4/Michael-Esser"
"8575","Cristian Gamboa_2022",2022,"Bochum","Bundesliga","Cristian Gamboa","CRC","DF","31",1989,19.1,59,36,40,16,3,30,61,49.2,31,22,7,15,32,91,35,1,"https://fbref.com/en/players/f27680d9/Cristian-Gamboa"
"8576","Silvère Ganvoula M'Boussy_2022",2022,"Bochum","Bundesliga","Silvère Ganvoula M'Boussy","CGO","FW","25",1996,1.7,0,0,0,0,0,0,1,0,1,0,0,0,0,0,1,0,"https://fbref.com/en/players/6c731625/Silvere-Ganvoula-MBoussy"
"8577","Luis Hartwig_2022",2022,"Bochum","Bundesliga","Luis Hartwig","GER","FW","18",2002,0,0,0,0,0,0,0,0,NA,0,0,0,0,0,0,0,0,"https://fbref.com/en/players/a3f30508/Luis-Hartwig"
"8578","Gerrit Holtmann_2022",2022,"Bochum","Bundesliga","Gerrit Holtmann","PHI","FW,MF","26",1995,20.4,15,9,5,3,7,6,22,27.3,16,26,2,24,8,23,6,0,"https://fbref.com/en/players/2979c05a/Gerrit-Holtmann"
"8579","Vassilis Lambropoulos_2022",2022,"Bochum","Bundesliga","Vassilis Lambropoulos","GRE","DF","31",1990,13,18,12,13,3,2,11,25,44,14,21,10,11,17,35,56,0,"https://fbref.com/en/players/591477c9/Vassilis-Lambropoulos"
"8580","Maxim Leitsch_2022",2022,"Bochum","Bundesliga","Maxim Leitsch","GER","DF","23",1998,17.1,18,10,9,7,2,10,15,66.7,5,31,19,12,31,49,74,1,"https://fbref.com/en/players/7e12a98d/Maxim-Leitsch"
"8581","Jürgen Locadia_2022",2022,"Bochum","Bundesliga","Jürgen Locadia","NED","FW,MF","27",1993,4.9,4,2,1,0,3,1,1,100,0,1,0,1,1,5,2,0,"https://fbref.com/en/players/6cc47ae1/Jurgen-Locadia"
"8582","Anthony Losilla_2022",2022,"Bochum","Bundesliga","Anthony Losilla","FRA","MF","35",1986,32.6,65,39,29,30,6,34,69,49.3,35,32,9,23,70,135,53,1,"https://fbref.com/en/players/07c7eb0c/Anthony-Losilla"
"8583","Eduard Löwen_2022",2022,"Bochum","Bundesliga","Eduard Löwen","GER","MF","24",1997,15.7,28,22,12,11,5,10,43,23.3,33,17,2,15,9,37,15,1,"https://fbref.com/en/players/70678132/Eduard-Lowen"
"8584","Erhan Mašović_2022",2022,"Bochum","Bundesliga","Erhan Mašović","SRB","DF","22",1998,17.2,35,20,21,13,1,21,33,63.6,12,28,19,9,34,69,64,1,"https://fbref.com/en/players/a396fb61/Erhan-Masovic"
"8585","Soma Novothny_2022",2022,"Bochum","Bundesliga","Soma Novothny","HUN","FW,MF","27",1994,0.9,1,1,1,0,0,0,1,0,1,1,0,1,0,1,2,0,"https://fbref.com/en/players/6fb91ea9/Soma-Novothny"
"8586","Patrick Osterhage_2022",2022,"Bochum","Bundesliga","Patrick Osterhage","GER","MF","21",2000,6.7,9,6,3,5,1,3,7,42.9,4,7,1,6,11,20,8,0,"https://fbref.com/en/players/9662c9ec/Patrick-Osterhage"
"8587","Miloš Pantović_2022",2022,"Bochum","Bundesliga","Miloš Pantović","SRB","MF,FW","25",1996,17,19,10,8,7,4,6,25,24,19,26,4,22,18,37,14,0,"https://fbref.com/en/players/5dc15574/Milos-Pantovic"
"8588","Sebastian Polter_2022",2022,"Bochum","Bundesliga","Sebastian Polter","GER","FW","30",1991,26,9,3,1,4,4,2,11,18.2,9,15,5,10,2,11,24,0,"https://fbref.com/en/players/3745e8bd/Sebastian-Polter"
"8589","Elvis Rexhbeçaj_2022",2022,"Bochum","Bundesliga","Elvis Rexhbeçaj","GER","MF","23",1997,28.2,41,20,17,19,5,19,40,47.5,21,41,6,35,27,68,15,0,"https://fbref.com/en/players/1ae836b1/Elvis-Rexhbecaj"
"8590","Manuel Riemann_2022",2022,"Bochum","Bundesliga","Manuel Riemann","GER","GK","32",1988,31,1,0,1,0,0,1,4,25,3,0,0,0,1,2,12,3,"https://fbref.com/en/players/9f941969/Manuel-Riemann"
"8591","Danilo Soares_2022",2022,"Bochum","Bundesliga","Danilo Soares","BRA","DF","29",1991,28.5,109,71,61,39,9,56,84,66.7,28,63,9,54,62,171,65,2,"https://fbref.com/en/players/c05f2f8c/Danilo-Soares"
"8592","Kostas Stafylidis_2022",2022,"Bochum","Bundesliga","Kostas Stafylidis","GRE","DF,MF","27",1993,15.4,37,27,22,13,2,20,26,76.9,6,19,6,13,31,68,43,0,"https://fbref.com/en/players/861e0116/Kostas-Stafylidis"
"8593","Robert Tesche_2022",2022,"Bochum","Bundesliga","Robert Tesche","GER","MF","34",1987,3.9,6,4,4,1,1,5,7,71.4,2,6,2,4,5,11,5,1,"https://fbref.com/en/players/037130ca/Robert-Tesche"
"8594","Simon Zoller_2022",2022,"Bochum","Bundesliga","Simon Zoller","GER","FW","30",1991,6.6,4,2,2,1,1,1,3,33.3,2,3,0,3,4,8,2,0,"https://fbref.com/en/players/29f7cfd9/Simon-Zoller"
"8595","Michel Aebischer_2022",2022,"Bologna","Serie A","Michel Aebischer","SUI","MF","24",1997,4.9,14,5,5,8,1,6,11,54.5,5,4,1,3,6,20,3,0,"https://fbref.com/en/players/f9c927de/Michel-Aebischer"
"8596","Wisdom Amey_2022",2022,"Bologna","Serie A","Wisdom Amey","ITA","DF","15",2005,0.8,3,2,1,1,1,2,3,66.7,1,2,0,2,3,6,1,0,"https://fbref.com/en/players/35b4bc62/Wisdom-Amey"
"8597","Ebenezer Annan_2022",2022,"Bologna","Serie A","Ebenezer Annan","GHA","DF","18",2002,0.3,1,1,1,0,0,0,0,NA,0,0,0,0,1,2,1,0,"https://fbref.com/en/players/39aa05a7/Ebenezer-Annan"
"8598","Marko Arnautović_2022",2022,"Bologna","Serie A","Marko Arnautović","AUT","FW","32",1989,29.9,17,9,1,11,5,7,30,23.3,23,13,2,11,7,24,17,0,"https://fbref.com/en/players/00459419/Marko-Arnautovic"
"8599","Nicola Bagnolini_2022",2022,"Bologna","Serie A","Nicola Bagnolini","ITA","GK","17",2004,0,0,0,0,0,0,0,0,NA,0,0,0,0,0,0,0,0,"https://fbref.com/en/players/ad263695/Nicola-Bagnolini"
"8600","Francesco Bardi_2022",2022,"Bologna","Serie A","Francesco Bardi","ITA","GK","29",1992,2,0,0,0,0,0,0,0,NA,0,0,0,0,0,0,0,0,"https://fbref.com/en/players/0acda699/Francesco-Bardi"
"8601","Musa Barrow_2022",2022,"Bologna","Serie A","Musa Barrow","GAM","FW,MF","22",1998,23.7,12,4,4,4,4,6,20,30,14,20,1,19,6,18,8,0,"https://fbref.com/en/players/e5bf73f3/Musa-Barrow"
"8602","Luis Binks_2022",2022,"Bologna","Serie A","Luis Binks","ENG","DF","19",2001,7.2,8,4,7,1,0,4,6,66.7,2,6,5,1,17,25,33,1,"https://fbref.com/en/players/36e88fbc/Luis-Binks"
"8603","Kevin Bonifazi_2022",2022,"Bologna","Serie A","Kevin Bonifazi","ITA","DF","25",1996,13.4,25,16,16,7,2,13,14,92.9,1,22,7,15,16,41,35,0,"https://fbref.com/en/players/fb77bfef/Kevin-Bonifazi"
"8604","Lorenzo De Silvestri_2022",2022,"Bologna","Serie A","Lorenzo De Silvestri","ITA","DF","33",1988,25.5,23,14,13,8,2,9,31,29,22,25,7,18,26,49,52,0,"https://fbref.com/en/players/e74f0e59/Lorenzo-De-Silvestri"
"8605","Mitchell Dijks_2022",2022,"Bologna","Serie A","Mitchell Dijks","NED","DF,FW","28",1993,7.7,15,6,6,6,3,5,12,41.7,7,11,2,9,3,18,10,1,"https://fbref.com/en/players/0a3065c8/Mitchell-Dijks"
"8606","Nicolás Domínguez_2022",2022,"Bologna","Serie A","Nicolás Domínguez","ARG","MF","23",1998,22.4,76,45,36,32,8,32,76,42.1,44,38,9,29,32,108,34,1,"https://fbref.com/en/players/20b3a502/Nicolas-Dominguez"
"8607","Diego Falcinelli_2022",2022,"Bologna","Serie A","Diego Falcinelli","ITA","FW","30",1991,0.7,2,2,2,0,0,0,0,NA,0,0,0,0,1,3,1,0,"https://fbref.com/en/players/a39b9ef6/Diego-Falcinelli"
"8608","Aaron Hickey_2022",2022,"Bologna","Serie A","Aaron Hickey","SCO","DF","19",2002,31.3,46,29,24,15,7,20,30,66.7,10,36,13,23,29,75,44,0,"https://fbref.com/en/players/1780bb4a/Aaron-Hickey"
"8609","Sydney van Hooijdonk_2022",2022,"Bologna","Serie A","Sydney van Hooijdonk","NED","FW,MF","21",2000,0.4,0,0,0,0,0,0,1,0,1,1,0,1,0,0,0,0,"https://fbref.com/en/players/5b418e15/Sydney-van-Hooijdonk"
"8610","Denso Kasius_2022",2022,"Bologna","Serie A","Denso Kasius","NED","DF,FW","18",2002,2,9,7,5,3,1,2,5,40,3,4,0,4,3,12,4,0,"https://fbref.com/en/players/7ae36711/Denso-Kasius"
"8611","Ibrahima Mbaye_2022",2022,"Bologna","Serie A","Ibrahima Mbaye","SEN","DF","26",1994,1.2,1,1,1,0,0,1,2,50,1,1,1,0,1,2,6,0,"https://fbref.com/en/players/cfbf9881/Ibrahima-Mbaye"
"8612","Gary Medel_2022",2022,"Bologna","Serie A","Gary Medel","CHI","DF","33",1987,31.4,39,23,27,11,1,16,36,44.4,20,30,21,9,44,83,112,0,"https://fbref.com/en/players/563a68ad/Gary-Medel"
"8613","Kingsley Michael_2022",2022,"Bologna","Serie A","Kingsley Michael","NGA","MF","21",1999,0.8,4,1,2,2,0,1,2,50,1,2,1,1,1,5,1,1,"https://fbref.com/en/players/e63e122d/Kingsley-Michael"
"8614","Riccardo Orsolini_2022",2022,"Bologna","Serie A","Riccardo Orsolini","ITA","FW,MF","24",1997,19.8,21,13,9,11,1,13,29,44.8,16,9,4,5,5,26,14,0,"https://fbref.com/en/players/e14ec482/Riccardo-Orsolini"
"8615","Niklas Pyyhtiä_2022",2022,"Bologna","Serie A","Niklas Pyyhtiä","FIN","MF","17",2003,0.2,0,0,0,0,0,0,1,0,1,0,0,0,0,0,0,0,"https://fbref.com/en/players/88f53b75/Niklas-Pyyhtia"
"8616","Antonio Raimondo_2022",2022,"Bologna","Serie A","Antonio Raimondo","ITA","FW","17",2004,0.8,0,0,0,0,0,0,1,0,1,1,0,1,0,0,1,0,"https://fbref.com/en/players/ce1a6c7e/Antonio-Raimondo"
"8617","Nicola Sansone_2022",2022,"Bologna","Serie A","Nicola Sansone","ITA","FW,MF","29",1991,10,13,7,5,6,2,3,15,20,12,1,0,1,4,17,2,0,"https://fbref.com/en/players/7eb97a8e/Nicola-Sansone"
"8618","Federico Santander_2022",2022,"Bologna","Serie A","Federico Santander","PAR","FW,DF","30",1991,0.7,2,1,1,1,0,1,1,100,0,0,0,0,0,2,0,0,"https://fbref.com/en/players/df85d472/Federico-Santander"
"8619","Jerdy Schouten_2022",2022,"Bologna","Serie A","Jerdy Schouten","NED","MF","24",1997,15.5,25,17,10,12,3,9,22,40.9,13,22,5,17,33,58,29,1,"https://fbref.com/en/players/2cfae697/Jerdy-Schouten"
"8620","Łukasz Skorupski_2022",2022,"Bologna","Serie A","Łukasz Skorupski","POL","GK","30",1991,36,0,0,0,0,0,0,1,0,1,0,0,0,0,0,17,0,"https://fbref.com/en/players/ab4449d6/Lukasz-Skorupski"
"8621","Andreas Skov Olsen_2022",2022,"Bologna","Serie A","Andreas Skov Olsen","DEN","FW,DF","21",1999,8.3,12,10,4,4,4,5,11,45.5,6,9,1,8,3,15,11,0,"https://fbref.com/en/players/c50cee19/Andreas-Skov-Olsen"
"8622","Roberto Soriano_2022",2022,"Bologna","Serie A","Roberto Soriano","ITA","MF","30",1991,29.1,57,30,27,22,8,17,56,30.4,39,37,3,34,22,79,32,0,"https://fbref.com/en/players/9d4c45d6/Roberto-Soriano"
"8623","Adama Soumaoro_2022",2022,"Bologna","Serie A","Adama Soumaoro","FRA","DF","29",1992,25.2,15,5,5,8,2,4,9,44.4,5,22,16,6,34,49,95,0,"https://fbref.com/en/players/7b075c75/Adama-Soumaoro"
"8624","Riccardo Stivanello_2022",2022,"Bologna","Serie A","Riccardo Stivanello","ITA","DF","17",2004,0.5,1,1,1,0,0,1,1,100,0,2,2,0,0,1,6,0,"https://fbref.com/en/players/90e1d9dc/Riccardo-Stivanello"
"8625","Mattias Svanberg_2022",2022,"Bologna","Serie A","Mattias Svanberg","SWE","MF","22",1999,28.5,39,15,15,16,8,16,54,29.6,38,31,9,22,28,67,34,0,"https://fbref.com/en/players/92d83c27/Mattias-Svanberg"
"8626","Arthur Theate_2022",2022,"Bologna","Serie A","Arthur Theate","BEL","DF","21",2000,26.9,33,19,26,3,4,14,31,45.2,17,29,16,13,42,75,69,0,"https://fbref.com/en/players/df8d6029/Arthur-Theate"
"8627","Takehiro Tomiyasu_2022",2022,"Bologna","Serie A","Takehiro Tomiyasu","JPN","DF","22",1998,0.1,0,0,0,0,0,0,0,NA,0,1,0,1,1,1,0,0,"https://fbref.com/en/players/b3af9be1/Takehiro-Tomiyasu"
"8628","Kacper Urbanski_2022",2022,"Bologna","Serie A","Kacper Urbanski","POL","MF","16",2004,0.5,3,2,1,2,0,2,2,100,0,2,0,2,0,3,0,0,"https://fbref.com/en/players/2d9d9e42/Kacper-Urbanski"
"8629","Emanuel Vignato_2022",2022,"Bologna","Serie A","Emanuel Vignato","ITA","MF,DF","20",2000,6.6,12,7,5,7,0,6,13,46.2,7,2,0,2,2,14,5,0,"https://fbref.com/en/players/ec5dae45/Emanuel-Vignato"
"8630","Nicolas Viola_2022",2022,"Bologna","Serie A","Nicolas Viola","ITA","MF","31",1989,1.1,2,2,1,1,0,1,2,50,1,1,1,0,0,2,1,0,"https://fbref.com/en/players/45392b06/Nicolas-Viola"
"8631","Yacine Adli_2022",2022,"Bordeaux","Ligue 1","Yacine Adli","FRA","MF,FW","21",2000,25.1,43,27,22,14,7,19,68,27.9,49,33,3,30,37,80,11,2,"https://fbref.com/en/players/26777636/Yacine-Adli"
"8632","Anel Ahmedhodzic_2022",2022,"Bordeaux","Ligue 1","Anel Ahmedhodzic","BIH","DF","22",1999,15,38,26,27,9,2,20,31,64.5,11,16,8,8,22,60,44,0,"https://fbref.com/en/players/eab957a3/Anel-Ahmedhodzic"
"8633","Dilane Bakwa_2022",2022,"Bordeaux","Ligue 1","Dilane Bakwa","FRA","FW,MF","18",2002,0.5,1,1,0,1,0,1,2,50,1,0,0,0,0,1,1,0,"https://fbref.com/en/players/2b5a35e5/Dilane-Bakwa"
"8634","Toma Bašić_2022",2022,"Bordeaux","Ligue 1","Toma Bašić","CRO","MF","24",1996,2.3,2,2,1,0,1,0,4,0,4,4,1,3,2,4,0,0,"https://fbref.com/en/players/80556f08/Toma-Basic"
"8635","Paul Baysse_2022",2022,"Bordeaux","Ligue 1","Paul Baysse","FRA","MF,DF","33",1988,0.1,1,1,0,1,0,0,0,NA,0,0,0,0,0,1,1,0,"https://fbref.com/en/players/2515040a/Paul-Baysse"
"8636","Loris Benito_2022",2022,"Bordeaux","Ligue 1","Loris Benito","SUI","DF","29",1992,0.7,0,0,0,0,0,0,0,NA,0,0,0,0,1,1,3,1,"https://fbref.com/en/players/f5b6fb78/Loris-Benito"
"8637","Jimmy Briand_2022",2022,"Bordeaux","Ligue 1","Jimmy Briand","FRA","FW,MF","35",1985,2.5,2,0,2,0,0,0,2,0,2,0,0,0,1,3,2,0,"https://fbref.com/en/players/f83c8d6c/Jimmy-Briand"
"8638","Benoît Costil_2022",2022,"Bordeaux","Ligue 1","Benoît Costil","FRA","GK","34",1987,25,1,0,1,0,0,1,2,50,1,0,0,0,0,1,6,3,"https://fbref.com/en/players/2434f24a/Benoit-Costil"
"8639","Javairô Dilrosun_2022",2022,"Bordeaux","Ligue 1","Javairô Dilrosun","NED","MF,FW","23",1998,19.2,13,4,2,8,3,7,24,29.2,17,14,1,13,11,24,5,0,"https://fbref.com/en/players/34a0f5ff/Javairo-Dilrosun"
"8640","Alberth Elis_2022",2022,"Bordeaux","Ligue 1","Alberth Elis","HON","FW,MF","25",1996,15.7,19,10,5,5,9,11,25,44,14,9,0,9,7,26,10,0,"https://fbref.com/en/players/104b4ad3/Alberth-Elis"
"8641","Fransérgio_2022",2022,"Bordeaux","Ligue 1","Fransérgio","BRA","MF","30",1990,14,24,10,8,12,4,12,43,27.9,31,18,6,12,23,47,23,0,"https://fbref.com/en/players/deba6b05/Fransergio"
"8642","Josuha Guilavogui_2022",2022,"Bordeaux","Ligue 1","Josuha Guilavogui","FRA","MF,DF","30",1990,14.8,39,16,18,17,4,14,29,48.3,15,16,8,8,36,75,23,0,"https://fbref.com/en/players/e6c43eec/Josuha-Guilavogui"
"8643","Danylo Ihnatenko_2022",2022,"Bordeaux","Ligue 1","Danylo Ihnatenko","UKR","MF","24",1997,7.7,17,9,8,7,2,10,24,41.7,14,9,2,7,6,23,17,1,"https://fbref.com/en/players/65bbfba3/Danylo-Ihnatenko"
"8644","Abdel Jalil Medioub_2022",2022,"Bordeaux","Ligue 1","Abdel Jalil Medioub","ALG","DF","23",1997,6.9,9,5,5,3,1,3,4,75,1,8,4,4,12,21,34,0,"https://fbref.com/en/players/4937a9f7/Abdel-Jalil-Medioub"
"8645","Samuel Kalu_2022",2022,"Bordeaux","Ligue 1","Samuel Kalu","NGA","FW,MF","23",1997,3.6,8,5,3,4,1,2,5,40,3,2,0,2,3,11,1,0,"https://fbref.com/en/players/b8d22478/Samuel-Kalu"
"8646","Thibault Klidje_2022",2022,"Bordeaux","Ligue 1","Thibault Klidje","TOG","MF,FW","20",2001,1,0,0,0,0,0,0,1,0,1,1,1,0,2,2,0,0,"https://fbref.com/en/players/db013c7d/Thibault-Klidje"
"8647","Laurent Koscielny_2022",2022,"Bordeaux","Ligue 1","Laurent Koscielny","FRA","DF","35",1985,10.4,14,9,10,3,1,8,13,61.5,5,17,12,5,12,26,39,0,"https://fbref.com/en/players/f5efb153/Laurent-Koscielny"
"8648","Enock Kwateng_2022",2022,"Bordeaux","Ligue 1","Enock Kwateng","FRA","DF","24",1997,22.2,54,35,31,19,4,33,72,45.8,39,17,4,13,43,97,48,1,"https://fbref.com/en/players/4bf69118/Enock-Kwateng"
"8649","Tom Lacoux_2022",2022,"Bordeaux","Ligue 1","Tom Lacoux","FRA","DF,MF","19",2002,10.1,18,13,11,5,2,9,24,37.5,15,14,4,10,9,27,20,1,"https://fbref.com/en/players/295ba708/Tom-Lacoux"
"8650","Johaneko Louisjean_2022",2022,"Bordeaux","Ligue 1","Johaneko Louisjean","FRA","DF","17",2004,0.1,0,0,0,0,0,0,0,NA,0,0,0,0,0,0,0,0,"https://fbref.com/en/players/9af3613f/Johaneko-Louisjean"
"8651","Josh Maja_2022",2022,"Bordeaux","Ligue 1","Josh Maja","NGA","FW","22",1998,0.1,0,0,0,0,0,0,0,NA,0,1,0,1,0,0,0,0,"https://fbref.com/en/players/bc0bfc64/Josh-Maja"
"8652","Ricardo Mangas_2022",2022,"Bordeaux","Ligue 1","Ricardo Mangas","POR","DF","23",1998,26.1,35,22,22,8,5,26,41,63.4,15,18,4,14,25,60,47,3,"https://fbref.com/en/players/eef2d8ce/Ricardo-Mangas"
"8653","Sekou Mara_2022",2022,"Bordeaux","Ligue 1","Sekou Mara","FRA","FW,MF","19",2002,10.1,8,4,1,1,6,1,8,12.5,7,7,0,7,2,10,6,0,"https://fbref.com/en/players/3544641e/Sekou-Mara"
"8654","Marcelo_2022",2022,"Bordeaux","Ligue 1","Marcelo","BRA","DF","34",1987,10,9,5,7,2,0,4,6,66.7,2,4,3,1,13,22,46,1,"https://fbref.com/en/players/e3d0b0c4/Marcelo"
"8655","Gideon Mensah_2022",2022,"Bordeaux","Ligue 1","Gideon Mensah","GHA","DF","23",1998,13.4,37,24,19,12,6,18,38,47.4,20,11,2,9,16,53,21,0,"https://fbref.com/en/players/9bdd8118/Gideon-Mensah"
"8656","Mexer_2022",2022,"Bordeaux","Ligue 1","Mexer","MOZ","DF","32",1988,13.6,14,10,11,3,0,11,17,64.7,6,12,7,5,21,35,60,2,"https://fbref.com/en/players/ce492295/Mexer"
"8657","Junior Mwanga_2022",2022,"Bordeaux","Ligue 1","Junior Mwanga","FRA","DF","18",2003,1,5,2,4,1,0,3,3,100,0,1,0,1,0,5,1,0,"https://fbref.com/en/players/ee158be5/Junior-Mwanga"
"8658","M'Baye Niang_2022",2022,"Bordeaux","Ligue 1","M'Baye Niang","SEN","FW","26",1994,8.6,4,0,0,2,2,0,4,0,4,9,1,8,1,5,4,0,"https://fbref.com/en/players/2054d037/MBaye-Niang"
"8659","Jean Onana_2022",2022,"Bordeaux","Ligue 1","Jean Onana","CMR","MF","21",2000,20.4,70,49,33,33,4,35,86,40.7,51,37,5,32,36,106,23,1,"https://fbref.com/en/players/b5bb8188/Jean-Onana"
"8660","Otávio_2022",2022,"Bordeaux","Ligue 1","Otávio","BRA","MF","27",1994,12.7,36,23,13,21,2,16,39,41,23,9,3,6,18,54,11,0,"https://fbref.com/en/players/243f4a0b/Otavio"
"8661","Remi Oudin_2022",2022,"Bordeaux","Ligue 1","Remi Oudin","FRA","MF,FW","24",1996,19.3,34,18,19,13,2,18,32,56.3,14,14,3,11,27,61,21,0,"https://fbref.com/en/players/ea02beaf/Remi-Oudin"
"8662","Rubén Pardo_2022",2022,"Bordeaux","Ligue 1","Rubén Pardo","ESP","MF","28",1992,0.1,0,0,0,0,0,0,0,NA,0,0,0,0,0,0,0,0,"https://fbref.com/en/players/2306bfde/Ruben-Pardo"
"8663","Timothee Pembele_2022",2022,"Bordeaux","Ligue 1","Timothee Pembele","FRA","DF","18",2002,15.7,20,8,8,10,2,10,29,34.5,19,12,3,9,16,36,24,0,"https://fbref.com/en/players/f8ce97ca/Timothee-Pembele"
"8664","Gaëtan Poussin_2022",2022,"Bordeaux","Ligue 1","Gaëtan Poussin","FRA","GK","22",1999,13,1,1,1,0,0,1,1,100,0,0,0,0,0,1,15,1,"https://fbref.com/en/players/c252c705/Gaetan-Poussin"
"8665","Stian Rode Gregersen_2022",2022,"Bordeaux","Ligue 1","Stian Rode Gregersen","NOR","DF","26",1995,21.7,39,26,23,12,4,18,33,54.5,15,26,16,10,38,77,103,2,"https://fbref.com/en/players/5f011e05/Stian-Rode-Gregersen"
"8666","Issouf Sissokho_2022",2022,"Bordeaux","Ligue 1","Issouf Sissokho","MLI","MF","19",2002,4.8,17,8,2,13,2,8,17,47.1,9,8,1,7,7,24,0,0,"https://fbref.com/en/players/792a9d41/Issouf-Sissokho"
"8667","Amadou Traore_2022",2022,"Bordeaux","Ligue 1","Amadou Traore","FRA","FW","19",2002,0.2,0,0,0,0,0,0,0,NA,0,0,0,0,0,0,0,0,"https://fbref.com/en/players/4eb0686f/Amadou-Traore"
"8668","Hwang Ui-jo_2022",2022,"Bordeaux","Ligue 1","Hwang Ui-jo","KOR","FW","28",1992,27.9,10,4,4,4,2,4,13,30.8,9,9,1,8,5,15,18,0,"https://fbref.com/en/players/a2d873dd/Hwang-Ui-jo"
"8669","Mehdi Zerkane_2022",2022,"Bordeaux","Ligue 1","Mehdi Zerkane","ALG","MF,DF","22",1999,0.9,0,0,0,0,0,0,1,0,1,1,1,0,2,2,0,0,"https://fbref.com/en/players/53f6306f/Mehdi-Zerkane"
"8670","Kristoffer Ajer_2022",2022,"Brentford","Premier League","Kristoffer Ajer","NOR","DF","23",1998,22.2,29,18,21,6,2,13,21,61.9,8,19,11,8,26,55,74,0,"https://fbref.com/en/players/a8c0acb7/Kristoffer-Ajer"
"8671","Shandon Baptiste_2022",2022,"Brentford","Premier League","Shandon Baptiste","GRN","MF","23",1998,10.1,14,4,9,4,1,6,15,40,9,10,0,10,11,25,12,0,"https://fbref.com/en/players/2886c9b5/Shandon-Baptiste"
"8672","Mads Bech Sørensen_2022",2022,"Brentford","Premier League","Mads Bech Sørensen","DEN","DF","22",1999,9.3,8,7,6,2,0,6,7,85.7,1,9,6,3,6,14,25,0,"https://fbref.com/en/players/30db8574/Mads-Bech-Sorensen"
"8673","Mads Bidstrup_2022",2022,"Brentford","Premier League","Mads Bidstrup","DEN","MF","20",2001,0.5,1,0,0,1,0,0,3,0,3,0,0,0,1,2,2,0,"https://fbref.com/en/players/407db0d5/Mads-Bidstrup"
"8674","Sergi Canós_2022",2022,"Brentford","Premier League","Sergi Canós","ESP","DF,FW","24",1997,23.1,56,25,32,15,9,33,60,55,27,32,3,29,22,78,38,0,"https://fbref.com/en/players/1137759d/Sergi-Canos"
"8675","Josh Dasilva_2022",2022,"Brentford","Premier League","Josh Dasilva","ENG","MF,FW","22",1998,2.9,2,1,0,1,1,1,2,50,1,3,0,3,1,3,7,0,"https://fbref.com/en/players/60344e4f/Josh-Dasilva"
"8676","Christian Eriksen_2022",2022,"Brentford","Premier League","Christian Eriksen","DEN","MF","29",1992,10.4,13,6,4,5,4,8,17,47.1,9,9,1,8,9,22,14,0,"https://fbref.com/en/players/980522ec/Christian-Eriksen"
"8677","Álvaro Fernández_2022",2022,"Brentford","Premier League","Álvaro Fernández","ESP","GK","23",1998,12,0,0,0,0,0,0,0,NA,0,0,0,0,0,0,5,2,"https://fbref.com/en/players/f127d782/Alvaro-Fernandez"
"8678","Marcus Forss_2022",2022,"Brentford","Premier League","Marcus Forss","FIN","FW,MF","22",1999,2.3,3,3,0,2,1,2,4,50,2,5,0,5,1,4,0,0,"https://fbref.com/en/players/82c215a0/Marcus-Forss"
"8679","Tariqe Fosu_2022",2022,"Brentford","Premier League","Tariqe Fosu","GHA","DF","25",1995,0.2,0,0,0,0,0,0,0,NA,0,1,0,1,0,0,0,0,"https://fbref.com/en/players/3dcef539/Tariqe-Fosu"
"8680","Saman Ghoddos_2022",2022,"Brentford","Premier League","Saman Ghoddos","IRN","MF,DF","27",1993,6,17,10,8,6,3,9,15,60,6,2,0,2,3,20,16,0,"https://fbref.com/en/players/f7b1d4e0/Saman-Ghoddos"
"8681","Charlie Goode_2022",2022,"Brentford","Premier League","Charlie Goode","ENG","DF","25",1995,5,7,5,5,2,0,4,4,100,0,4,2,2,2,9,8,0,"https://fbref.com/en/players/7aee4dd3/Charlie-Goode"
"8682","Rico Henry_2022",2022,"Brentford","Premier League","Rico Henry","ENG","DF","24",1997,30.8,28,20,18,8,2,12,34,35.3,22,31,10,21,26,54,76,1,"https://fbref.com/en/players/8a3c1dc7/Rico-Henry"
"8683","Vitaly Janelt_2022",2022,"Brentford","Premier League","Vitaly Janelt","GER","MF","23",1998,25.5,61,32,26,27,8,27,53,50.9,26,23,7,16,28,89,35,0,"https://fbref.com/en/players/8449d35e/Vitaly-Janelt"
"8684","Pontus Jansson_2022",2022,"Brentford","Premier League","Pontus Jansson","SWE","DF","30",1991,36.9,40,21,32,8,0,22,34,64.7,12,37,27,10,52,92,187,0,"https://fbref.com/en/players/172e52d8/Pontus-Jansson"
"8685","Mathias Jensen_2022",2022,"Brentford","Premier League","Mathias Jensen","DEN","MF","25",1996,17.8,33,18,12,16,5,22,63,34.9,41,32,3,29,22,55,13,0,"https://fbref.com/en/players/0f134faf/Mathias-Jensen"
"8686","Mathias Jørgensen_2022",2022,"Brentford","Premier League","Mathias Jørgensen","DEN","DF","31",1990,5.8,10,4,3,5,2,7,10,70,3,6,1,5,10,20,13,0,"https://fbref.com/en/players/0db5d2c8/Mathias-Jorgensen"
"8687","Jonas Lössl_2022",2022,"Brentford","Premier League","Jonas Lössl","DEN","GK","32",1989,2,0,0,0,0,0,0,0,NA,0,0,0,0,0,0,1,0,"https://fbref.com/en/players/939bc634/Jonas-Lossl"
"8688","Bryan Mbeumo_2022",2022,"Brentford","Premier League","Bryan Mbeumo","CMR","FW","21",1999,32.3,28,16,1,12,15,6,20,30,14,21,6,15,11,39,20,0,"https://fbref.com/en/players/6afaebf2/Bryan-Mbeumo"
"8689","Christian Nørgaard_2022",2022,"Brentford","Premier League","Christian Nørgaard","DEN","MF","27",1994,33.9,109,60,42,58,9,52,101,51.5,49,48,9,39,64,173,58,1,"https://fbref.com/en/players/df0a4c90/Christian-Norgaard"
"8690","Frank Onyeka_2022",2022,"Brentford","Premier League","Frank Onyeka","NGA","MF","23",1998,11.6,25,17,13,9,3,8,27,29.6,19,16,2,14,14,39,13,0,"https://fbref.com/en/players/2944f86f/Frank-Onyeka"
"8691","Ethan Pinnock_2022",2022,"Brentford","Premier League","Ethan Pinnock","JAM","DF","28",1993,29.9,51,35,37,12,2,25,38,65.8,13,30,11,19,44,95,154,1,"https://fbref.com/en/players/e541326e/Ethan-Pinnock"
"8692","David Raya_2022",2022,"Brentford","Premier League","David Raya","ESP","GK","25",1995,24,0,0,0,0,0,0,0,NA,0,1,0,1,0,0,10,1,"https://fbref.com/en/players/98ea5115/David-Raya"
"8693","Mads Roerslev_2022",2022,"Brentford","Premier League","Mads Roerslev","DEN","DF","22",1999,13.8,23,12,19,2,2,14,32,43.8,18,14,5,9,16,39,29,0,"https://fbref.com/en/players/57c94db2/Mads-Roerslev"
"8694","Finley Stevens_2022",2022,"Brentford","Premier League","Finley Stevens","WAL","DF","18",2003,0.2,3,1,0,3,0,1,1,100,0,0,0,0,0,3,0,0,"https://fbref.com/en/players/7e003182/Finley-Stevens"
"8695","Dominic Thompson_2022",2022,"Brentford","Premier League","Dominic Thompson","ENG","DF","21",2000,1.6,1,0,1,0,0,0,1,0,1,2,2,0,2,3,3,0,"https://fbref.com/en/players/235a62f8/Dominic-Thompson"
"8696","Ivan Toney_2022",2022,"Brentford","Premier League","Ivan Toney","ENG","FW","25",1996,32.3,33,21,5,20,8,12,38,31.6,26,16,2,14,14,47,44,1,"https://fbref.com/en/players/e09f279b/Ivan-Toney"
"8697","Yoane Wissa_2022",2022,"Brentford","Premier League","Yoane Wissa","COD","FW","24",1996,14.3,12,6,5,4,3,1,16,6.3,15,12,5,7,8,20,6,0,"https://fbref.com/en/players/2500cef9/Yoane-Wissa"
"8698","Nathan Young-Coombes_2022",2022,"Brentford","Premier League","Nathan Young-Coombes","ENG","MF","18",2003,0,0,0,0,0,0,0,0,NA,0,0,0,0,0,0,0,0,"https://fbref.com/en/players/f9682888/Nathan-Young-Coombes"
"8699","Lucien Agoume_2022",2022,"Brest","Ligue 1","Lucien Agoume","FRA","MF","19",2002,20.8,51,31,24,20,7,23,45,51.1,22,30,9,21,52,103,27,1,"https://fbref.com/en/players/8bc8829a/Lucien-Agoume"
"8700","Youssouph Badji_2022",2022,"Brest","Ligue 1","Youssouph Badji","SEN","FW,MF","19",2001,1.5,1,0,0,1,0,0,1,0,1,0,0,0,0,1,0,0,"https://fbref.com/en/players/6a2b9aee/Youssouph-Badji"
"8701","Dénys Bain_2022",2022,"Brest","Ligue 1","Dénys Bain","FRA","DF","28",1993,2,3,3,1,2,0,1,1,100,0,3,1,2,3,6,5,0,"https://fbref.com/en/players/5065d67d/Denys-Bain"
"8702","Youcef Belaïli_2022",2022,"Brest","Ligue 1","Youcef Belaïli","ALG","MF,FW","29",1992,9.2,2,1,0,0,2,2,9,22.2,7,5,1,4,7,9,4,0,"https://fbref.com/en/players/1a248246/Youcef-Belaili"
"8703","Haris Belkebla_2022",2022,"Brest","Ligue 1","Haris Belkebla","ALG","MF","27",1994,25.7,46,23,21,21,4,18,39,46.2,21,26,6,20,48,94,30,1,"https://fbref.com/en/players/2b1bed19/Haris-Belkebla"
"8704","Marco Bizot_2022",2022,"Brest","Ligue 1","Marco Bizot","NED","GK","30",1991,38,3,1,3,0,0,3,5,60,2,1,0,1,0,3,24,1,"https://fbref.com/en/players/3d214e5f/Marco-Bizot"
"8705","Lilian Brassier_2022",2022,"Brest","Ligue 1","Lilian Brassier","FRA","DF","21",1999,25.1,40,24,23,13,4,10,21,47.6,11,31,21,10,32,72,86,0,"https://fbref.com/en/players/5b146df3/Lilian-Brassier"
"8706","Irvin Cardona_2022",2022,"Brest","Ligue 1","Irvin Cardona","FRA","FW,MF","23",1997,14.8,13,7,5,4,4,3,16,18.8,13,10,0,10,5,18,17,0,"https://fbref.com/en/players/5e080f73/Irvin-Cardona"
"8707","Brendan Chardonnet_2022",2022,"Brest","Ligue 1","Brendan Chardonnet","FRA","DF","26",1994,29.8,44,25,32,11,1,29,40,72.5,11,42,29,13,55,99,141,0,"https://fbref.com/en/players/16aa7d4c/Brendan-Chardonnet"
"8708","Romain Del Castillo_2022",2022,"Brest","Ligue 1","Romain Del Castillo","FRA","MF,FW","25",1996,10.8,27,16,3,17,7,12,31,38.7,19,12,0,12,7,34,3,0,"https://fbref.com/en/players/0be95d34/Romain-Del-Castillo"
"8709","Jean-Kevin Duverne_2022",2022,"Brest","Ligue 1","Jean-Kevin Duverne","FRA","DF","24",1997,33.4,71,44,43,21,7,42,90,46.7,48,40,5,35,53,124,92,0,"https://fbref.com/en/players/0cbc8baa/Jean-Kevin-Duverne"
"8710","Romain Faivre_2022",2022,"Brest","Ligue 1","Romain Faivre","FRA","MF","23",1998,19.9,30,18,12,13,5,12,30,40,18,11,0,11,13,43,10,0,"https://fbref.com/en/players/745ca0a3/Romain-Faivre"
"8711","Julien Faussurier_2022",2022,"Brest","Ligue 1","Julien Faussurier","FRA","MF,DF","34",1987,5.4,10,6,3,3,4,6,13,46.2,7,12,1,11,5,15,6,0,"https://fbref.com/en/players/767212e6/Julien-Faussurier"
"8712","Christophe Hérelle_2022",2022,"Brest","Ligue 1","Christophe Hérelle","MTQ","DF","28",1992,21.5,48,28,30,16,2,17,26,65.4,9,20,15,5,44,92,84,1,"https://fbref.com/en/players/3681cfff/Christophe-Herelle"
"8713","Franck Honorat_2022",2022,"Brest","Ligue 1","Franck Honorat","FRA","FW,MF","24",1996,32.2,54,38,25,13,16,27,47,57.4,20,24,2,22,15,69,25,0,"https://fbref.com/en/players/db7849ca/Franck-Honorat"
"8714","Paul Lasne_2022",2022,"Brest","Ligue 1","Paul Lasne","FRA","MF","32",1989,9.4,26,12,6,16,4,8,18,44.4,10,11,2,9,24,50,10,0,"https://fbref.com/en/players/542cc80f/Paul-Lasne"
"8715","Jérémy Le Douaron_2022",2022,"Brest","Ligue 1","Jérémy Le Douaron","FRA","FW,MF","23",1998,16.1,11,5,4,4,3,1,17,5.9,16,15,0,15,4,15,14,0,"https://fbref.com/en/players/88c4d190/Jeremy-Le-Douaron"
"8716","Hugo Magnetti_2022",2022,"Brest","Ligue 1","Hugo Magnetti","FRA","MF","23",1998,16.3,50,34,27,20,3,22,50,44,28,14,3,11,25,75,13,0,"https://fbref.com/en/players/d4d35152/Hugo-Magnetti"
"8717","Hianga Mananga Mbock_2022",2022,"Brest","Ligue 1","Hianga Mananga Mbock","FRA","MF","21",1999,8.9,18,12,8,7,3,9,21,42.9,12,5,2,3,5,23,6,0,"https://fbref.com/en/players/0f86995c/Hianga-Mananga-Mbock"
"8718","Steve Mounié_2022",2022,"Brest","Ligue 1","Steve Mounié","BEN","FW","26",1994,25.7,17,6,3,12,2,4,27,14.8,23,13,1,12,6,23,12,0,"https://fbref.com/en/players/19ba6c6d/Steve-Mounie"
"8719","Romain Philippoteaux_2022",2022,"Brest","Ligue 1","Romain Philippoteaux","FRA","MF","33",1988,0.3,1,1,0,1,0,0,0,NA,0,0,0,0,0,1,0,0,"https://fbref.com/en/players/f98b15f0/Romain-Philippoteaux"
"8720","Ronaël Pierre-Gabriel_2022",2022,"Brest","Ligue 1","Ronaël Pierre-Gabriel","FRA","DF","23",1998,28.3,79,45,52,21,6,42,73,57.5,31,22,7,15,48,127,74,0,"https://fbref.com/en/players/64ba07c0/Ronael-Pierre-Gabriel"
"8721","Rafiki Said Ahamada_2022",2022,"Brest","Ligue 1","Rafiki Said Ahamada","COM","MF,FW","21",2000,1.4,4,3,1,2,1,3,4,75,1,2,0,2,0,4,0,0,"https://fbref.com/en/players/c2e5f306/Rafiki-Said-Ahamada"
"8722","Martin Satriano_2022",2022,"Brest","Ligue 1","Martin Satriano","URU","FW","20",2001,10.4,5,2,1,1,3,2,7,28.6,5,8,0,8,2,7,3,0,"https://fbref.com/en/players/86383d0e/Martin-Satriano"
"8723","Jere Uronen_2022",2022,"Brest","Ligue 1","Jere Uronen","FIN","DF","27",1994,9.8,28,15,15,10,3,14,24,58.3,10,12,3,9,16,44,21,0,"https://fbref.com/en/players/d75f3980/Jere-Uronen"
"8724","Steven Alzate_2022",2022,"Brighton","Premier League","Steven Alzate","COL","MF","22",1998,4.5,10,4,4,5,1,4,7,57.1,3,2,1,1,10,20,10,0,"https://fbref.com/en/players/ad1f61f3/Steven-Alzate"
"8725","Yves Bissouma_2022",2022,"Brighton","Premier League","Yves Bissouma","MLI","MF","24",1996,23.5,76,49,35,37,4,21,37,56.8,16,33,3,30,50,126,49,0,"https://fbref.com/en/players/6c203af0/Yves-Bissouma"
"8726","Dan Burn_2022",2022,"Brighton","Premier League","Dan Burn","ENG","DF","29",1992,11.4,22,12,13,8,1,6,15,40,9,14,10,4,24,46,51,0,"https://fbref.com/en/players/b2d31e83/Dan-Burn"
"8727","Moisés Caicedo_2022",2022,"Brighton","Premier League","Moisés Caicedo","ECU","MF","19",2001,7.3,16,10,7,7,2,5,12,41.7,7,18,4,14,10,26,7,0,"https://fbref.com/en/players/16264a81/Moises-Caicedo"
"8728","Aaron Connolly_2022",2022,"Brighton","Premier League","Aaron Connolly","IRL","FW,MF","21",2000,1.7,0,0,0,0,0,0,1,0,1,2,0,2,0,0,0,0,"https://fbref.com/en/players/27c01749/Aaron-Connolly"
"8729","Marc Cucurella_2022",2022,"Brighton","Premier League","Marc Cucurella","ESP","DF","23",1998,34.3,93,62,43,32,18,44,71,62,27,42,14,28,30,123,74,0,"https://fbref.com/en/players/1daec722/Marc-Cucurella"
"8730","Shane Duffy_2022",2022,"Brighton","Premier League","Shane Duffy","IRL","DF","29",1992,16,15,12,12,3,0,8,14,57.1,6,24,18,6,16,31,76,1,"https://fbref.com/en/players/7314bba4/Shane-Duffy"
"8731","Lewis Dunk_2022",2022,"Brighton","Premier League","Lewis Dunk","ENG","DF","29",1991,28.6,10,8,5,5,0,5,11,45.5,6,32,28,4,27,37,113,3,"https://fbref.com/en/players/282f75f3/Lewis-Dunk"
"8732","Evan Ferguson_2022",2022,"Brighton","Premier League","Evan Ferguson","IRL","MF","16",2004,0.3,0,0,0,0,0,0,0,NA,0,0,0,0,0,0,0,0,"https://fbref.com/en/players/4596da74/Evan-Ferguson"
"8733","Pascal Groß_2022",2022,"Brighton","Premier League","Pascal Groß","GER","MF,DF","30",1991,22.6,28,15,15,11,2,12,33,36.4,21,34,8,26,18,46,23,0,"https://fbref.com/en/players/8aec0537/Pascal-Gross"
"8734","Adam Lallana_2022",2022,"Brighton","Premier League","Adam Lallana","ENG","MF","33",1988,17.3,34,17,14,14,6,12,41,29.3,29,16,6,10,16,50,13,1,"https://fbref.com/en/players/99813635/Adam-Lallana"
"8735","Tariq Lamptey_2022",2022,"Brighton","Premier League","Tariq Lamptey","GHA","DF,FW","20",2000,17.3,36,25,14,17,5,15,25,60,10,13,3,10,21,57,23,0,"https://fbref.com/en/players/f4e433d4/Tariq-Lamptey"
"8736","Jürgen Locadia_2022",2022,"Brighton","Premier League","Jürgen Locadia","NED","MF,FW","27",1993,0.3,0,0,0,0,0,0,0,NA,0,0,0,0,0,0,0,0,"https://fbref.com/en/players/6cc47ae1/Jurgen-Locadia"
"8737","Alexis Mac Allister_2022",2022,"Brighton","Premier League","Alexis Mac Allister","ARG","MF,FW","22",1998,23.6,65,40,23,30,12,29,68,42.6,39,37,7,30,13,78,22,0,"https://fbref.com/en/players/83d074ff/Alexis-Mac-Allister"
"8738","Solly March_2022",2022,"Brighton","Premier League","Solly March","ENG","DF,FW","27",1994,19.4,30,17,11,9,10,7,22,31.8,15,22,3,19,17,47,25,0,"https://fbref.com/en/players/bb5fbd2b/Solly-March"
"8739","Neal Maupay_2022",2022,"Brighton","Premier League","Neal Maupay","FRA","FW","24",1996,25.3,17,10,2,6,9,4,18,22.2,14,21,2,19,2,19,2,0,"https://fbref.com/en/players/4bcf39f6/Neal-Maupay"
"8740","Jakub Moder_2022",2022,"Brighton","Premier League","Jakub Moder","POL","MF","22",1999,18.9,42,25,18,17,7,23,42,54.8,19,25,2,23,10,52,22,1,"https://fbref.com/en/players/f230bc30/Jakub-Moder"
"8741","Enock Mwepu_2022",2022,"Brighton","Premier League","Enock Mwepu","ZAM","MF","23",1998,11.1,22,12,10,10,2,5,27,18.5,22,20,2,18,12,34,19,0,"https://fbref.com/en/players/1d5cab82/Enock-Mwepu"
"8742","Taylor Richards_2022",2022,"Brighton","Premier League","Taylor Richards","ENG","MF","20",2000,0.3,1,0,0,1,0,1,2,50,1,0,0,0,0,1,0,0,"https://fbref.com/en/players/e0243d23/Taylor-Richards"
"8743","Robert Sánchez_2022",2022,"Brighton","Premier League","Robert Sánchez","ESP","GK","23",1997,37,2,1,2,0,0,1,1,100,0,1,0,1,0,2,11,4,"https://fbref.com/en/players/6a713852/Robert-Sanchez"
"8744","Jeremy Sarmiento_2022",2022,"Brighton","Premier League","Jeremy Sarmiento","ECU","FW,MF","19",2002,0.5,1,1,0,0,1,0,2,0,2,2,0,2,0,1,0,0,"https://fbref.com/en/players/ac0d576d/Jeremy-Sarmiento"
"8745","Jason Steele_2022",2022,"Brighton","Premier League","Jason Steele","ENG","GK","30",1990,1,0,0,0,0,0,0,0,NA,0,0,0,0,0,0,0,0,"https://fbref.com/en/players/28300a16/Jason-Steele"
"8746","Leandro Trossard_2022",2022,"Brighton","Premier League","Leandro Trossard","BEL","FW,MF","26",1994,31.2,34,20,12,9,13,4,31,12.9,27,33,4,29,15,49,10,0,"https://fbref.com/en/players/38ceb24a/Leandro-Trossard"
"8747","Joël Veltman_2022",2022,"Brighton","Premier League","Joël Veltman","NED","DF","29",1992,31.9,74,48,47,21,6,21,53,39.6,32,46,16,30,45,119,89,0,"https://fbref.com/en/players/dad4b285/Joel-Veltman"
"8748","Adam Webster_2022",2022,"Brighton","Premier League","Adam Webster","ENG","DF","26",1995,15.9,26,8,17,7,2,13,20,65,7,25,17,8,17,43,66,2,"https://fbref.com/en/players/c40b6180/Adam-Webster"
"8749","Danny Welbeck_2022",2022,"Brighton","Premier League","Danny Welbeck","ENG","FW,MF","30",1990,16.4,14,7,2,8,4,3,10,30,7,18,2,16,5,19,18,0,"https://fbref.com/en/players/ce5143da/Danny-Welbeck"
"8750","Ashley Barnes_2022",2022,"Burnley","Premier League","Ashley Barnes","ENG","FW","31",1989,9,11,2,2,7,2,2,9,22.2,7,8,1,7,2,13,5,0,"https://fbref.com/en/players/2691c772/Ashley-Barnes"
"8751","Jóhann Berg Guðmundsson_2022",2022,"Burnley","Premier League","Jóhann Berg Guðmundsson","ISL","MF","30",1990,12.2,16,6,7,7,2,5,20,25,15,11,2,9,12,28,22,0,"https://fbref.com/en/players/f72293fc/Johann-Berg-Gudmundsson"
"8752","Josh Brownhill_2022",2022,"Burnley","Premier League","Josh Brownhill","ENG","MF","25",1995,32.8,73,37,25,42,6,21,53,39.6,32,37,12,25,68,141,42,1,"https://fbref.com/en/players/47369df8/Josh-Brownhill"
"8753","Nathan Collins_2022",2022,"Burnley","Premier League","Nathan Collins","IRL","DF","20",2001,18.6,37,15,27,8,2,17,27,63,10,38,25,13,24,61,83,2,"https://fbref.com/en/players/a8c19eb8/Nathan-Collins"
"8754","Jack Cork_2022",2022,"Burnley","Premier League","Jack Cork","ENG","MF","32",1989,18.6,20,6,6,11,3,7,20,35,13,17,4,13,17,37,29,1,"https://fbref.com/en/players/74e12f1e/Jack-Cork"
"8755","Maxwel Cornet_2022",2022,"Burnley","Premier League","Maxwel Cornet","CIV","FW,MF","24",1996,19.6,16,9,7,5,4,7,15,46.7,8,13,4,9,10,26,14,0,"https://fbref.com/en/players/beb391dd/Maxwel-Cornet"
"8756","Wayne Hennessey_2022",2022,"Burnley","Premier League","Wayne Hennessey","WAL","GK","34",1987,2,0,0,0,0,0,0,0,NA,0,0,0,0,1,1,0,1,"https://fbref.com/en/players/76eca7e2/Wayne-Hennessey"
"8757","Aaron Lennon_2022",2022,"Burnley","Premier League","Aaron Lennon","ENG","MF,FW","34",1987,17.2,33,17,10,13,10,10,34,29.4,24,26,4,22,9,42,14,0,"https://fbref.com/en/players/2ff964a0/Aaron-Lennon"
"8758","Kevin Long_2022",2022,"Burnley","Premier League","Kevin Long","IRL","DF","30",1990,4.6,3,2,1,2,0,1,2,50,1,4,1,3,1,4,20,0,"https://fbref.com/en/players/5a4280b1/Kevin-Long"
"8759","Matthew Lowton_2022",2022,"Burnley","Premier League","Matthew Lowton","ENG","DF","32",1989,19.7,38,24,20,10,8,20,37,54.1,17,25,11,14,26,64,68,0,"https://fbref.com/en/players/9a9c05db/Matthew-Lowton"
"8760","Dwight McNeil_2022",2022,"Burnley","Premier League","Dwight McNeil","ENG","MF","21",1999,34.5,78,49,27,38,13,33,73,45.2,40,64,11,53,35,113,31,1,"https://fbref.com/en/players/fc15fb84/Dwight-McNeil"
"8761","Ben Mee_2022",2022,"Burnley","Premier League","Ben Mee","ENG","DF","31",1989,20.4,26,12,16,7,3,12,19,63.2,7,28,22,6,24,50,94,1,"https://fbref.com/en/players/8df7a2fb/Ben-Mee"
"8762","Erik Pieters_2022",2022,"Burnley","Premier League","Erik Pieters","NED","DF","32",1988,8.1,28,15,15,11,2,17,28,60.7,11,18,7,11,10,38,38,0,"https://fbref.com/en/players/1ef37668/Erik-Pieters"
"8763","Nick Pope_2022",2022,"Burnley","Premier League","Nick Pope","ENG","GK","29",1992,36,0,0,0,0,0,0,2,0,2,0,0,0,2,2,30,3,"https://fbref.com/en/players/4b40d9ca/Nick-Pope"
"8764","Connor Roberts_2022",2022,"Burnley","Premier League","Connor Roberts","WAL","DF","25",1995,18.8,20,13,10,7,3,10,15,66.7,5,25,5,20,22,42,62,1,"https://fbref.com/en/players/24fae784/Connor-Roberts"
"8765","Jay Rodriguez_2022",2022,"Burnley","Premier League","Jay Rodriguez","ENG","FW","32",1989,15.4,20,12,8,8,4,4,14,28.6,10,19,1,18,4,24,12,0,"https://fbref.com/en/players/4ab53cdb/Jay-Rodriguez"
"8766","Dale Stephens_2022",2022,"Burnley","Premier League","Dale Stephens","ENG","MF","32",1989,1.4,4,1,0,3,1,3,8,37.5,5,4,1,3,1,5,1,0,"https://fbref.com/en/players/653ee42d/Dale-Stephens"
"8767","James Tarkowski_2022",2022,"Burnley","Premier League","James Tarkowski","ENG","DF","28",1992,34.5,65,45,47,17,1,33,47,70.2,14,75,61,14,48,113,186,4,"https://fbref.com/en/players/15ea812b/James-Tarkowski"
"8768","Charlie Taylor_2022",2022,"Burnley","Premier League","Charlie Taylor","ENG","DF","27",1993,30.3,45,26,31,11,3,26,44,59.1,18,42,20,22,58,103,95,2,"https://fbref.com/en/players/cc2d7ad5/Charlie-Taylor"
"8769","Matěj Vydra_2022",2022,"Burnley","Premier League","Matěj Vydra","CZE","FW","29",1992,7.5,12,7,3,4,5,3,7,42.9,4,5,1,4,0,12,9,0,"https://fbref.com/en/players/0d4ceb32/Matej-Vydra"
"8770","Wout Weghorst_2022",2022,"Burnley","Premier League","Wout Weghorst","NED","FW","28",1992,16.1,17,9,3,9,5,6,19,31.6,13,16,5,11,6,23,13,0,"https://fbref.com/en/players/c4e87b8b/Wout-Weghorst"
"8771","Ashley Westwood_2022",2022,"Burnley","Premier League","Ashley Westwood","ENG","MF","31",1990,25.4,21,12,8,12,1,10,31,32.3,21,21,9,12,30,51,16,1,"https://fbref.com/en/players/495945ef/Ashley-Westwood"
"8772","Chris Wood_2022",2022,"Burnley","Premier League","Chris Wood","NZL","FW","29",1991,15.2,7,5,0,3,4,3,10,30,7,13,4,9,0,7,3,0,"https://fbref.com/en/players/4e9a0555/Chris-Wood"
"8773","Giorgio Altare_2022",2022,"Cagliari","Serie A","Giorgio Altare","ITA","DF","22",1998,16.3,39,28,18,18,3,21,26,80.8,5,17,5,12,30,69,70,0,"https://fbref.com/en/players/aa5322d5/Giorgio-Altare"
"8774","Keita Baldé_2022",2022,"Cagliari","Serie A","Keita Baldé","SEN","FW","26",1995,13.7,8,4,1,5,2,1,10,10,9,6,0,6,4,12,6,0,"https://fbref.com/en/players/509a4ccb/Keita-Balde"
"8775","Daniele Baselli_2022",2022,"Cagliari","Serie A","Daniele Baselli","ITA","MF","29",1992,3.2,6,5,3,1,2,1,5,20,4,2,0,2,2,8,5,0,"https://fbref.com/en/players/ea06dd97/Daniele-Baselli"
"8776","Raoul Bellanova_2022",2022,"Cagliari","Serie A","Raoul Bellanova","ITA","DF,FW","21",2000,27.7,29,15,14,12,3,6,27,22.2,21,39,8,31,21,50,51,0,"https://fbref.com/en/players/e3756e72/Raoul-Bellanova"
"8777","Martín Cáceres_2022",2022,"Cagliari","Serie A","Martín Cáceres","URU","DF","34",1987,9.2,13,7,5,5,3,4,12,33.3,8,12,3,9,14,27,21,0,"https://fbref.com/en/players/e94d79e3/Martin-Caceres"
"8778","Andrea Carboni_2022",2022,"Cagliari","Serie A","Andrea Carboni","ITA","DF","20",2001,24.6,53,24,33,16,4,19,42,45.2,23,42,15,27,27,80,87,0,"https://fbref.com/en/players/f7e2af2c/Andrea-Carboni"
"8779","Luca Ceppitelli_2022",2022,"Cagliari","Serie A","Luca Ceppitelli","ITA","DF","31",1989,16.1,23,12,13,10,0,16,27,59.3,11,21,14,7,25,48,54,0,"https://fbref.com/en/players/7d50454d/Luca-Ceppitelli"
"8780","Damir Ceter_2022",2022,"Cagliari","Serie A","Damir Ceter","COL","FW","23",1997,0.1,0,0,0,0,0,0,0,NA,0,0,0,0,0,0,0,0,"https://fbref.com/en/players/eade5337/Damir-Ceter"
"8781","Alessio Cragno_2022",2022,"Cagliari","Serie A","Alessio Cragno","ITA","GK","27",1994,35,3,3,2,1,0,3,3,100,0,0,0,0,1,4,14,1,"https://fbref.com/en/players/f554e29b/Alessio-Cragno"
"8782","Alessandro Deiola_2022",2022,"Cagliari","Serie A","Alessandro Deiola","ITA","MF","25",1995,23.7,47,22,15,25,7,23,58,39.7,35,28,10,18,26,73,45,0,"https://fbref.com/en/players/7f267d66/Alessandro-Deiola"
"8783","Paolo Faragò_2022",2022,"Cagliari","Serie A","Paolo Faragò","ITA","MF","28",1993,0.2,1,1,1,0,0,0,0,NA,0,2,0,2,0,1,0,0,"https://fbref.com/en/players/9085dd7c/Paolo-Farago"
"8784","Diego Farias_2022",2022,"Cagliari","Serie A","Diego Farias","BRA","MF,FW","31",1990,0.7,1,1,0,1,0,1,3,33.3,2,0,0,0,0,1,0,0,"https://fbref.com/en/players/157d29b6/Diego-Farias"
"8785","Luca Gagliano_2022",2022,"Cagliari","Serie A","Luca Gagliano","ITA","FW,DF","21",2000,0.1,0,0,0,0,0,0,0,NA,0,1,0,1,0,0,1,0,"https://fbref.com/en/players/1d00a56c/Luca-Gagliano"
"8786","Diego Godín_2022",2022,"Cagliari","Serie A","Diego Godín","URU","DF","35",1986,9.1,18,7,13,3,2,10,15,66.7,5,7,5,2,13,31,46,0,"https://fbref.com/en/players/fc4f85b1/Diego-Godin"
"8787","Edoardo Goldaniga_2022",2022,"Cagliari","Serie A","Edoardo Goldaniga","ITA","DF","27",1993,10.4,12,5,7,5,0,4,11,36.4,7,8,5,3,22,34,23,0,"https://fbref.com/en/players/4b029b31/Edoardo-Goldaniga"
"8788","Alberto Grassi_2022",2022,"Cagliari","Serie A","Alberto Grassi","ITA","MF","26",1995,24.2,47,26,13,30,4,16,38,42.1,22,27,9,18,63,110,33,1,"https://fbref.com/en/players/6cc97b6a/Alberto-Grassi"
"8789","Dalbert Henrique_2022",2022,"Cagliari","Serie A","Dalbert Henrique","BRA","DF,MF","27",1993,23.1,43,23,23,16,4,11,35,31.4,24,28,5,23,24,67,34,0,"https://fbref.com/en/players/f45f9427/Dalbert-Henrique"
"8790","Christos Kourfalidis_2022",2022,"Cagliari","Serie A","Christos Kourfalidis","GRE","MF,FW","18",2002,0.2,0,0,0,0,0,0,1,0,1,1,0,1,0,0,0,0,"https://fbref.com/en/players/5c522c88/Christos-Kourfalidis"
"8791","Matteo Lovato_2022",2022,"Cagliari","Serie A","Matteo Lovato","ITA","DF","21",2000,13.8,23,15,13,10,0,8,20,40,12,21,10,11,28,51,43,0,"https://fbref.com/en/players/5fa57166/Matteo-Lovato"
"8792","Charalambos Lykogiannis_2022",2022,"Cagliari","Serie A","Charalambos Lykogiannis","GRE","DF,FW","27",1993,20.2,19,12,16,1,2,11,20,55,9,18,8,10,31,50,73,0,"https://fbref.com/en/players/5efc5389/Charalambos-Lykogiannis"
"8793","Răzvan Marin_2022",2022,"Cagliari","Serie A","Răzvan Marin","ROU","MF","25",1996,31.3,42,21,16,22,4,24,54,44.4,30,23,5,18,10,52,17,1,"https://fbref.com/en/players/7fac99d4/Razvan-Marin"
"8794","Nahitan Nández_2022",2022,"Cagliari","Serie A","Nahitan Nández","URU","MF,DF","25",1995,16.9,39,21,16,15,8,18,33,54.5,15,16,1,15,9,48,15,1,"https://fbref.com/en/players/95facda1/Nahitan-Nandez"
"8795","Adam Obert_2022",2022,"Cagliari","Serie A","Adam Obert","SVK","DF,MF","18",2002,3,8,5,6,2,0,5,6,83.3,1,6,4,2,4,12,11,0,"https://fbref.com/en/players/aa25ce92/Adam-Obert"
"8796","Christian Oliva_2022",2022,"Cagliari","Serie A","Christian Oliva","URU","MF","25",1996,0.5,2,2,2,0,0,1,4,25,3,0,0,0,0,2,0,0,"https://fbref.com/en/players/d3b888e3/Christian-Oliva"
"8797","Leonardo Pavoletti_2022",2022,"Cagliari","Serie A","Leonardo Pavoletti","ITA","FW","32",1988,16.9,10,6,2,5,3,3,9,33.3,6,9,5,4,2,12,12,0,"https://fbref.com/en/players/d37b0350/Leonardo-Pavoletti"
"8798","João Pedro_2022",2022,"Cagliari","Serie A","João Pedro","ITA","FW","29",1992,36.9,15,12,2,8,5,4,18,22.2,14,23,5,18,8,23,18,1,"https://fbref.com/en/players/81255c03/Joao-Pedro"
"8799","Gastón Pereiro_2022",2022,"Cagliari","Serie A","Gastón Pereiro","URU","FW,MF","26",1995,10.8,13,5,7,4,2,5,18,27.8,13,12,1,11,1,14,8,0,"https://fbref.com/en/players/7ec7738e/Gaston-Pereiro"
"8800","Boris Radunović_2022",2022,"Cagliari","Serie A","Boris Radunović","SRB","GK","25",1996,3,0,0,0,0,0,0,0,NA,0,0,0,0,0,0,0,0,"https://fbref.com/en/players/0dfce079/Boris-Radunovic"
"8801","Marko Rog_2022",2022,"Cagliari","Serie A","Marko Rog","CRO","MF","26",1995,3.5,5,3,1,2,2,1,8,12.5,7,6,1,5,1,6,3,0,"https://fbref.com/en/players/b6b2b820/Marko-Rog"
"8802","Giovanni Simeone_2022",2022,"Cagliari","Serie A","Giovanni Simeone","ARG","FW","26",1995,0.1,0,0,0,0,0,0,0,NA,0,0,0,0,0,0,0,0,"https://fbref.com/en/players/343c0d52/Giovanni-Simeone"
"8803","Kevin Strootman_2022",2022,"Cagliari","Serie A","Kevin Strootman","NED","MF","31",1990,7.1,8,4,2,4,2,5,12,41.7,7,11,2,9,10,18,15,0,"https://fbref.com/en/players/ef2e5e1a/Kevin-Strootman"
"8804","Sebastian Walukiewicz_2022",2022,"Cagliari","Serie A","Sebastian Walukiewicz","POL","DF","21",2000,3.4,9,5,7,2,0,3,5,60,2,5,2,3,7,16,14,0,"https://fbref.com/en/players/217875a4/Sebastian-Walukiewicz"
"8805","Gabriele Zappa_2022",2022,"Cagliari","Serie A","Gabriele Zappa","ITA","DF","21",1999,12.7,21,9,12,6,3,6,24,25,18,15,5,10,14,35,28,0,"https://fbref.com/en/players/ca3db240/Gabriele-Zappa"
"8806","Joseph Aidoo_2022",2022,"Celta Vigo","La Liga","Joseph Aidoo","GHA","DF","25",1995,29.3,39,26,28,10,1,17,31,54.8,14,23,13,10,38,77,96,3,"https://fbref.com/en/players/18abe173/Joseph-Aidoo"
"8807","Hugo Álvarez_2022",2022,"Celta Vigo","La Liga","Hugo Álvarez","ESP","FW","18",2003,0.1,1,0,1,0,0,0,0,NA,0,0,0,0,0,1,1,0,"https://fbref.com/en/players/6f392eb8/Hugo-Alvarez"
"8808","Néstor Araujo_2022",2022,"Celta Vigo","La Liga","Néstor Araujo","MEX","DF","29",1991,29.1,22,14,17,5,0,9,21,42.9,12,17,10,7,27,49,105,2,"https://fbref.com/en/players/27a013f7/Nestor-Araujo"
"8809","Iago Aspas_2022",2022,"Celta Vigo","La Liga","Iago Aspas","ESP","FW","33",1987,34.3,14,7,1,5,8,4,24,16.7,20,23,2,21,11,25,19,0,"https://fbref.com/en/players/7dcf86f6/Iago-Aspas"
"8810","Miguel Baeza_2022",2022,"Celta Vigo","La Liga","Miguel Baeza","ESP","DF","21",2000,0,0,0,0,0,0,0,0,NA,0,0,0,0,0,0,0,0,"https://fbref.com/en/players/a98f3cbf/Miguel-Baeza"
"8811","Fran Beltrán_2022",2022,"Celta Vigo","La Liga","Fran Beltrán","ESP","MF","22",1999,28.9,56,41,27,23,6,28,68,41.2,40,29,5,24,32,88,39,0,"https://fbref.com/en/players/ed5c5fa3/Fran-Beltran"
"8812","Franco Cervi_2022",2022,"Celta Vigo","La Liga","Franco Cervi","ARG","MF","27",1994,20,73,41,35,22,16,33,77,42.9,44,38,2,36,21,94,19,0,"https://fbref.com/en/players/5e1028e5/Franco-Cervi"
"8813","Matías Dituro_2022",2022,"Celta Vigo","La Liga","Matías Dituro","ARG","GK","34",1987,38,0,0,0,0,0,0,0,NA,0,0,0,0,0,0,10,5,"https://fbref.com/en/players/b6160ad0/Matias-Dituro"
"8814","Carlos Dominguez_2022",2022,"Celta Vigo","La Liga","Carlos Dominguez","ESP","DF","20",2001,3.8,4,1,4,0,0,4,6,66.7,2,2,1,1,4,8,21,0,"https://fbref.com/en/players/3521abfe/Carlos-Dominguez"
"8815","José Fontán_2022",2022,"Celta Vigo","La Liga","José Fontán","ESP","DF","21",2000,3.1,5,3,3,2,0,1,5,20,4,3,1,2,10,15,10,0,"https://fbref.com/en/players/1827a42d/Jose-Fontan"
"8816","Javi Galán_2022",2022,"Celta Vigo","La Liga","Javi Galán","ESP","DF","26",1994,36.6,108,66,60,37,11,42,99,42.4,57,48,8,40,45,153,52,0,"https://fbref.com/en/players/a4b00319/Javi-Galan"
"8817","Thiago Galhardo_2022",2022,"Celta Vigo","La Liga","Thiago Galhardo","BRA","FW,MF","32",1989,12.8,12,6,3,3,6,2,12,16.7,10,15,2,13,6,18,9,0,"https://fbref.com/en/players/766f48dd/Thiago-Galhardo"
"8818","Hugo Mallo_2022",2022,"Celta Vigo","La Liga","Hugo Mallo","ESP","DF","30",1991,20.3,45,25,24,19,2,16,31,51.6,15,23,9,14,20,65,53,0,"https://fbref.com/en/players/cb574619/Hugo-Mallo"
"8819","Brais Méndez_2022",2022,"Celta Vigo","La Liga","Brais Méndez","ESP","MF","24",1997,33.6,68,35,24,35,9,26,87,29.9,61,52,6,46,37,105,30,0,"https://fbref.com/en/players/c9e39d91/Brais-Mendez"
"8820","Santi Mina_2022",2022,"Celta Vigo","La Liga","Santi Mina","ESP","FW","25",1995,26.3,27,17,8,15,4,5,32,15.6,27,28,2,26,6,33,22,0,"https://fbref.com/en/players/0b90bb97/Santi-Mina"
"8821","Jeison Murillo_2022",2022,"Celta Vigo","La Liga","Jeison Murillo","COL","DF","29",1992,12.4,15,10,13,2,0,9,13,69.2,4,11,8,3,17,32,37,0,"https://fbref.com/en/players/b233e8e4/Jeison-Murillo"
"8822","Nolito_2022",2022,"Celta Vigo","La Liga","Nolito","ESP","MF","34",1986,15.4,25,15,14,7,4,13,47,27.7,34,20,1,19,9,34,5,0,"https://fbref.com/en/players/b2d0ec1b/Nolito"
"8823","Orbelín Pineda_2022",2022,"Celta Vigo","La Liga","Orbelín Pineda","MEX","MF,FW","25",1996,1.1,4,1,4,0,0,1,2,50,1,0,0,0,0,4,1,0,"https://fbref.com/en/players/411fabd7/Orbelin-Pineda"
"8824","Augusto Solari_2022",2022,"Celta Vigo","La Liga","Augusto Solari","ARG","MF,DF","29",1992,7.9,24,12,9,12,3,12,32,37.5,20,14,4,10,7,31,10,1,"https://fbref.com/en/players/3ca6106c/Augusto-Solari"
"8825","Hugo Sotelo_2022",2022,"Celta Vigo","La Liga","Hugo Sotelo","ESP","FW","17",2003,0,0,0,0,0,0,0,0,NA,0,0,0,0,0,0,0,0,"https://fbref.com/en/players/3aa74860/Hugo-Sotelo"
"8826","Denis Suárez_2022",2022,"Celta Vigo","La Liga","Denis Suárez","ESP","MF","27",1994,31.3,61,29,20,33,8,25,82,30.5,57,32,4,28,16,77,11,0,"https://fbref.com/en/players/12c50af5/Denis-Suarez"
"8827","Renato Tapia_2022",2022,"Celta Vigo","La Liga","Renato Tapia","PER","MF","26",1995,15.7,50,31,15,31,4,20,50,40,30,21,5,16,28,78,43,0,"https://fbref.com/en/players/34269bdf/Renato-Tapia"
"8828","Kevin Vázquez_2022",2022,"Celta Vigo","La Liga","Kevin Vázquez","ESP","DF","28",1993,14.8,34,24,12,13,9,14,28,50,14,20,7,13,36,70,34,0,"https://fbref.com/en/players/ee923664/Kevin-Vazquez"
"8829","Gabriel Veiga_2022",2022,"Celta Vigo","La Liga","Gabriel Veiga","ESP","MF","19",2002,1.2,5,4,0,4,1,3,12,25,9,2,0,2,4,9,1,0,"https://fbref.com/en/players/35a6e5c7/Gabriel-Veiga"
"8830","Okay Yokuşlu_2022",2022,"Celta Vigo","La Liga","Okay Yokuşlu","TUR","DF,MF","27",1994,1.6,4,1,2,1,1,2,3,66.7,1,2,1,1,2,6,6,0,"https://fbref.com/en/players/e49ce451/Okay-Yokuslu"
"8831","Marcos Alonso_2022",2022,"Chelsea","Premier League","Marcos Alonso","ESP","DF","30",1990,24.1,41,29,20,12,9,17,36,47.2,19,29,5,24,43,84,53,0,"https://fbref.com/en/players/f4290206/Marcos-Alonso"
"8832","Kepa Arrizabalaga_2022",2022,"Chelsea","Premier League","Kepa Arrizabalaga","ESP","GK","26",1994,4,0,0,0,0,0,0,0,NA,0,0,0,0,0,0,4,0,"https://fbref.com/en/players/28d596a0/Kepa-Arrizabalaga"
"8833","César Azpilicueta_2022",2022,"Chelsea","Premier League","César Azpilicueta","ESP","DF","31",1989,23,51,28,18,27,6,16,35,45.7,19,32,9,23,23,74,65,1,"https://fbref.com/en/players/53cad200/Cesar-Azpilicueta"
"8834","Ross Barkley_2022",2022,"Chelsea","Premier League","Ross Barkley","ENG","MF,FW","27",1993,2,0,0,0,0,0,0,1,0,1,1,0,1,1,1,0,0,"https://fbref.com/en/players/3a24769f/Ross-Barkley"
"8835","Trevoh Chalobah_2022",2022,"Chelsea","Premier League","Trevoh Chalobah","ENG","DF","22",1999,16.1,40,27,22,18,0,24,31,77.4,7,16,6,10,19,59,43,2,"https://fbref.com/en/players/5515376c/Trevoh-Chalobah"
"8836","Ben Chilwell_2022",2022,"Chelsea","Premier League","Ben Chilwell","ENG","DF","24",1996,6,8,3,2,6,0,2,5,40,3,7,0,7,4,12,14,1,"https://fbref.com/en/players/d2424d1b/Ben-Chilwell"
"8837","Andreas Christensen_2022",2022,"Chelsea","Premier League","Andreas Christensen","DEN","DF","25",1996,16.6,14,8,9,4,1,4,7,57.1,3,14,6,8,29,43,57,1,"https://fbref.com/en/players/1cb49278/Andreas-Christensen"
"8838","Kai Havertz_2022",2022,"Chelsea","Premier League","Kai Havertz","GER","FW,MF","22",1999,20.1,17,8,5,7,5,4,14,28.6,10,28,1,27,4,21,32,1,"https://fbref.com/en/players/fed7cb61/Kai-Havertz"
"8839","Callum Hudson-Odoi_2022",2022,"Chelsea","Premier League","Callum Hudson-Odoi","ENG","MF,FW","20",2000,10.7,14,10,5,6,3,8,23,34.8,15,8,0,8,2,16,6,1,"https://fbref.com/en/players/15f3ec41/Callum-Hudson-Odoi"
"8840","Reece James_2022",2022,"Chelsea","Premier League","Reece James","ENG","DF","21",1999,20.7,33,25,14,18,1,9,22,40.9,13,20,2,18,17,50,22,0,"https://fbref.com/en/players/1265a93a/Reece-James"
"8841","Jorginho_2022",2022,"Chelsea","Premier League","Jorginho","ITA","MF","29",1991,25.3,64,33,27,31,6,29,83,34.9,54,27,4,23,36,100,21,1,"https://fbref.com/en/players/45db685d/Jorginho"
"8842","N'Golo Kanté_2022",2022,"Chelsea","Premier League","N'Golo Kanté","FRA","MF","30",1991,19.7,59,31,20,27,12,25,40,62.5,15,37,2,35,31,90,8,0,"https://fbref.com/en/players/b9fbae28/NGolo-Kante"
"8843","Kenedy_2022",2022,"Chelsea","Premier League","Kenedy","BRA","DF","25",1996,0.6,5,2,1,2,2,2,3,66.7,1,0,0,0,0,5,0,0,"https://fbref.com/en/players/5eebbfdf/Kenedy"
"8844","Mateo Kovačić_2022",2022,"Chelsea","Premier League","Mateo Kovačić","CRO","MF","27",1994,17.3,51,31,14,26,11,17,35,48.6,18,19,4,15,7,58,9,1,"https://fbref.com/en/players/79c0821a/Mateo-Kovacic"
"8845","Ruben Loftus-Cheek_2022",2022,"Chelsea","Premier League","Ruben Loftus-Cheek","ENG","MF,DF","25",1996,15.5,29,10,16,11,2,10,19,52.6,9,15,6,9,11,40,17,0,"https://fbref.com/en/players/e97fd090/Ruben-Loftus-Cheek"
"8846","Romelu Lukaku_2022",2022,"Chelsea","Premier League","Romelu Lukaku","BEL","FW","28",1993,17.7,2,1,0,1,1,1,5,20,4,11,1,10,0,2,20,0,"https://fbref.com/en/players/5eae500a/Romelu-Lukaku"
"8847","Edouard Mendy_2022",2022,"Chelsea","Premier League","Edouard Mendy","SEN","GK","29",1992,34,1,0,1,0,0,1,3,33.3,2,0,0,0,0,1,13,4,"https://fbref.com/en/players/33887998/Edouard-Mendy"
"8848","Mason Mount_2022",2022,"Chelsea","Premier League","Mason Mount","ENG","MF","22",1999,26.3,41,16,10,17,14,10,34,29.4,24,18,1,17,13,54,12,0,"https://fbref.com/en/players/9674002f/Mason-Mount"
"8849","Saúl Ñíguez_2022",2022,"Chelsea","Premier League","Saúl Ñíguez","ESP","DF,MF","26",1994,5.3,20,9,11,9,0,9,16,56.3,7,14,3,11,7,27,10,1,"https://fbref.com/en/players/c14bc029/Saul-Niguez"
"8850","Emerson Palmieri_2022",2022,"Chelsea","Premier League","Emerson Palmieri","ITA","DF","26",1994,0.1,0,0,0,0,0,0,0,NA,0,0,0,0,0,0,0,0,"https://fbref.com/en/players/e0bc6fdc/Emerson-Palmieri"
"8851","Christian Pulisic_2022",2022,"Chelsea","Premier League","Christian Pulisic","USA","MF,FW","22",1998,14.3,10,7,6,3,1,3,17,17.6,14,12,0,12,5,15,10,0,"https://fbref.com/en/players/1bf33a9a/Christian-Pulisic"
"8852","Antonio Rüdiger_2022",2022,"Chelsea","Premier League","Antonio Rüdiger","GER","DF","28",1993,33.7,48,28,29,15,4,36,48,75,12,20,11,9,28,76,91,1,"https://fbref.com/en/players/18b896d6/Antonio-Rudiger"
"8853","Malang Sarr_2022",2022,"Chelsea","Premier League","Malang Sarr","FRA","DF","22",1999,6.1,14,7,10,2,2,7,12,58.3,5,6,3,3,11,25,20,0,"https://fbref.com/en/players/4315f30d/Malang-Sarr"
"8854","Thiago Silva_2022",2022,"Chelsea","Premier League","Thiago Silva","BRA","DF","36",1984,29.4,32,21,19,12,1,11,22,50,11,54,31,23,44,76,100,0,"https://fbref.com/en/players/86e7deaf/Thiago-Silva"
"8855","Timo Werner_2022",2022,"Chelsea","Premier League","Timo Werner","GER","FW,MF","25",1996,14.3,8,4,3,3,2,2,20,10,18,9,0,9,2,10,4,0,"https://fbref.com/en/players/49fe9070/Timo-Werner"
"8856","Hakim Ziyech_2022",2022,"Chelsea","Premier League","Hakim Ziyech","MAR","MF,FW","28",1993,14.7,19,10,5,12,2,10,36,27.8,26,11,1,10,10,29,10,0,"https://fbref.com/en/players/6622454d/Hakim-Ziyech"
"8857","Salis Abdul Samed_2022",2022,"Clermont Foot","Ligue 1","Salis Abdul Samed","GHA","MF","21",2000,27.4,43,23,25,16,2,20,57,35.1,37,18,1,17,42,85,15,0,"https://fbref.com/en/players/82464ce3/Salis-Abdul-Samed"
"8858","Josué Albert_2022",2022,"Clermont Foot","Ligue 1","Josué Albert","GUF","DF","29",1992,0.2,0,0,0,0,0,0,0,NA,0,0,0,0,1,1,2,0,"https://fbref.com/en/players/3d738df0/Josue-Albert"
"8859","Jim Allevinah_2022",2022,"Clermont Foot","Ligue 1","Jim Allevinah","GAB","FW","26",1995,16.5,18,13,8,8,2,5,18,27.8,13,11,0,11,6,24,4,0,"https://fbref.com/en/players/1956b948/Jim-Allevinah"
"8860","Jason Berthomier_2022",2022,"Clermont Foot","Ligue 1","Jason Berthomier","FRA","MF","31",1990,19.2,29,14,5,17,7,12,34,35.3,22,14,2,12,8,37,4,1,"https://fbref.com/en/players/03e91055/Jason-Berthomier"
"8861","Jean-Claude Billong_2022",2022,"Clermont Foot","Ligue 1","Jean-Claude Billong","CMR","DF","27",1993,10.9,17,8,14,1,2,8,11,72.7,3,9,1,8,10,27,35,0,"https://fbref.com/en/players/a3e1d20d/Jean-Claude-Billong"
"8862","Oriol Busquets_2022",2022,"Clermont Foot","Ligue 1","Oriol Busquets","ESP","MF","22",1999,2.2,3,3,0,3,0,2,6,33.3,4,7,4,3,1,4,2,0,"https://fbref.com/en/players/49712367/Oriol-Busquets"
"8863","Lucas Da Cunha_2022",2022,"Clermont Foot","Ligue 1","Lucas Da Cunha","FRA","FW,MF","20",2001,9.3,17,11,5,8,4,9,18,50,9,13,0,13,1,18,3,0,"https://fbref.com/en/players/007faf7a/Lucas-Da-Cunha"
"8864","Arthur Desmas_2022",2022,"Clermont Foot","Ligue 1","Arthur Desmas","FRA","GK","27",1994,14.5,0,0,0,0,0,0,3,0,3,0,0,0,0,0,1,3,"https://fbref.com/en/players/e8c5dd4d/Arthur-Desmas"
"8865","Yadaly Diaby_2022",2022,"Clermont Foot","Ligue 1","Yadaly Diaby","GUI","FW,MF","20",2000,0.7,0,0,0,0,0,0,1,0,1,0,0,0,2,2,2,0,"https://fbref.com/en/players/5630a6e0/Yadaly-Diaby"
"8866","Ouparine Djoco_2022",2022,"Clermont Foot","Ligue 1","Ouparine Djoco","SEN","GK","23",1998,23.5,0,0,0,0,0,0,0,NA,0,0,0,0,1,1,14,2,"https://fbref.com/en/players/62124972/Ouparine-Djoco"
"8867","Jodel Dossou_2022",2022,"Clermont Foot","Ligue 1","Jodel Dossou","BEN","FW","29",1992,22.3,36,17,15,14,7,15,43,34.9,28,14,0,14,5,41,7,0,"https://fbref.com/en/players/a1dbfcb1/Jodel-Dossou"
"8868","Johan Gastien_2022",2022,"Clermont Foot","Ligue 1","Johan Gastien","FRA","MF","33",1988,30.5,56,34,26,25,5,27,74,36.5,47,45,11,34,53,109,49,1,"https://fbref.com/en/players/868eaba0/Johan-Gastien"
"8869","Pierre-Yves Hamel_2022",2022,"Clermont Foot","Ligue 1","Pierre-Yves Hamel","FRA","FW","27",1994,5.8,11,6,0,5,6,5,6,83.3,1,2,1,1,0,11,0,0,"https://fbref.com/en/players/a99da9ec/Pierre-Yves-Hamel"
"8870","Cédric Hountondji_2022",2022,"Clermont Foot","Ligue 1","Cédric Hountondji","BEN","DF","27",1994,22.6,33,17,20,12,1,16,24,66.7,8,23,12,11,34,67,76,0,"https://fbref.com/en/players/00891164/Cedric-Hountondji"
"8871","Jonathan Iglesias_2022",2022,"Clermont Foot","Ligue 1","Jonathan Iglesias","URU","MF","32",1988,6.4,18,11,6,10,2,10,18,55.6,8,8,2,6,5,23,2,1,"https://fbref.com/en/players/639ca1cf/Jonathan-Iglesias"
"8872","Saîf-Eddine Khaoui_2022",2022,"Clermont Foot","Ligue 1","Saîf-Eddine Khaoui","TUN","MF,FW","26",1995,10.3,19,10,5,10,4,9,18,50,9,9,0,9,14,33,5,0,"https://fbref.com/en/players/796b1c41/Saif-Eddine-Khaoui"
"8873","Grejohn Kyei_2022",2022,"Clermont Foot","Ligue 1","Grejohn Kyei","FRA","FW","25",1995,4.4,3,2,1,1,1,0,6,0,6,6,0,6,0,3,1,0,"https://fbref.com/en/players/397ba086/Grejohn-Kyei"
"8874","Mohamed Lamine Bayo_2022",2022,"Clermont Foot","Ligue 1","Mohamed Lamine Bayo","GUI","FW","23",1998,26.8,12,5,4,3,5,3,24,12.5,21,7,1,6,7,19,14,0,"https://fbref.com/en/players/01870104/Mohamed-Lamine-Bayo"
"8875","Yohann Magnin_2022",2022,"Clermont Foot","Ligue 1","Yohann Magnin","FRA","MF,DF","24",1997,19.1,53,31,22,26,5,24,42,57.1,18,17,7,10,20,73,36,0,"https://fbref.com/en/players/caa7aaea/Yohann-Magnin"
"8876","Arial Mendy_2022",2022,"Clermont Foot","Ligue 1","Arial Mendy","SEN","DF,FW","26",1994,8.8,6,4,4,2,0,2,11,18.2,9,6,1,5,7,13,17,0,"https://fbref.com/en/players/9f0f4b49/Arial-Mendy"
"8877","Vital N'Simba_2022",2022,"Clermont Foot","Ligue 1","Vital N'Simba","COD","DF","28",1993,31,66,45,38,23,5,36,63,57.1,27,28,7,21,29,95,30,0,"https://fbref.com/en/players/249ac66d/Vital-NSimba"
"8878","Florent Ogier_2022",2022,"Clermont Foot","Ligue 1","Florent Ogier","FRA","DF","32",1989,27,31,17,18,12,1,17,31,54.8,14,41,27,14,37,68,89,0,"https://fbref.com/en/players/6993927b/Florent-Ogier"
"8879","Jérôme Phojo_2022",2022,"Clermont Foot","Ligue 1","Jérôme Phojo","FRA","DF","28",1993,0.1,0,0,0,0,0,0,0,NA,0,0,0,0,0,0,1,0,"https://fbref.com/en/players/ff44d058/Jerome-Phojo"
"8880","Elba Rashani_2022",2022,"Clermont Foot","Ligue 1","Elba Rashani","KVX","FW,MF","28",1993,19.5,40,21,15,21,4,17,55,30.9,38,34,3,31,11,51,20,0,"https://fbref.com/en/players/25749008/Elba-Rashani"
"8881","Alidu Seidu_2022",2022,"Clermont Foot","Ligue 1","Alidu Seidu","GHA","DF","21",2000,15.7,34,20,20,13,1,16,27,59.3,11,25,11,14,34,68,49,1,"https://fbref.com/en/players/cea59f02/Alidu-Seidu"
"8882","Aboubakar Sidibé_2022",2022,"Clermont Foot","Ligue 1","Aboubakar Sidibé","FRA","DF","25",1996,0.1,0,0,0,0,0,0,0,NA,0,0,0,0,0,0,0,0,"https://fbref.com/en/players/ae5b93a0/Aboubakar-Sidibe"
"8883","Jordan Tell_2022",2022,"Clermont Foot","Ligue 1","Jordan Tell","GLP","FW","24",1997,3.2,5,5,0,3,2,1,4,25,3,3,0,3,0,5,1,0,"https://fbref.com/en/players/4f093689/Jordan-Tell"
"8884","Akim Zedadka_2022",2022,"Clermont Foot","Ligue 1","Akim Zedadka","ALG","DF","26",1995,37.1,72,44,34,29,9,37,71,52.1,34,32,8,24,58,130,48,0,"https://fbref.com/en/players/0ff630d0/Akim-Zedadka"
"8885","Joachim Andersen_2022",2022,"Crystal Palace","Premier League","Joachim Andersen","DEN","DF","25",1996,32.4,30,23,21,9,0,16,27,59.3,11,29,19,10,37,67,125,3,"https://fbref.com/en/players/e34fc66d/Joachim-Andersen"
"8886","Jordan Ayew_2022",2022,"Crystal Palace","Premier League","Jordan Ayew","GHA","FW","29",1991,22.4,47,30,20,20,7,17,31,54.8,14,33,3,30,15,62,15,0,"https://fbref.com/en/players/da052c14/Jordan-Ayew"
"8887","Christian Benteke_2022",2022,"Crystal Palace","Premier League","Christian Benteke","BEL","FW","30",1990,12.7,3,2,1,2,0,2,6,33.3,4,7,3,4,2,5,33,0,"https://fbref.com/en/players/ab070c55/Christian-Benteke"
"8888","Jack Butland_2022",2022,"Crystal Palace","Premier League","Jack Butland","ENG","GK","28",1993,8.5,0,0,0,0,0,0,0,NA,0,0,0,0,0,0,1,0,"https://fbref.com/en/players/cc70a1d5/Jack-Butland"
"8889","Nathaniel Clyne_2022",2022,"Crystal Palace","Premier League","Nathaniel Clyne","ENG","DF","30",1991,15,21,10,11,9,1,10,20,50,10,7,2,5,15,36,32,0,"https://fbref.com/en/players/0442183b/Nathaniel-Clyne"
"8890","Odsonne Édouard_2022",2022,"Crystal Palace","Premier League","Odsonne Édouard","FRA","FW","23",1998,17.4,16,10,2,7,7,7,21,33.3,14,20,5,15,0,16,18,0,"https://fbref.com/en/players/0562b7f1/Odsonne-Edouard"
"8891","Eberechi Eze_2022",2022,"Crystal Palace","Premier League","Eberechi Eze","ENG","MF,FW","23",1998,6.7,10,6,5,2,3,6,11,54.5,5,4,1,3,5,15,1,0,"https://fbref.com/en/players/ae4fc6a4/Eberechi-Eze"
"8892","Nathan Ferguson_2022",2022,"Crystal Palace","Premier League","Nathan Ferguson","ENG","DF","20",2000,0.1,0,0,0,0,0,0,0,NA,0,0,0,0,0,0,0,0,"https://fbref.com/en/players/2f8d27bc/Nathan-Ferguson"
"8893","Conor Gallagher_2022",2022,"Crystal Palace","Premier League","Conor Gallagher","ENG","MF","21",2000,31.6,69,38,35,20,14,21,69,30.4,48,58,9,49,29,98,26,0,"https://fbref.com/en/players/c2731c10/Conor-Gallagher"
"8894","Vicente Guaita_2022",2022,"Crystal Palace","Premier League","Vicente Guaita","ESP","GK","34",1987,29.5,1,0,1,0,0,1,1,100,0,0,0,0,1,2,8,1,"https://fbref.com/en/players/ab13a5aa/Vicente-Guaita"
"8895","Marc Guéhi_2022",2022,"Crystal Palace","Premier League","Marc Guéhi","ENG","DF","21",2000,35.8,35,17,24,10,1,15,16,93.8,1,34,26,8,30,65,127,0,"https://fbref.com/en/players/d0706b27/Marc-Guehi"
"8896","Will Hughes_2022",2022,"Crystal Palace","Premier League","Will Hughes","ENG","MF","26",1995,11.7,29,14,10,16,3,7,16,43.8,9,13,7,6,8,37,10,0,"https://fbref.com/en/players/a0666d3e/Will-Hughes"
"8897","Cheikhou Kouyaté_2022",2022,"Crystal Palace","Premier League","Cheikhou Kouyaté","SEN","MF","31",1989,21.9,52,38,28,22,2,18,39,46.2,21,40,14,26,38,90,39,0,"https://fbref.com/en/players/8d3c902d/Cheikhou-Kouyate"
"8898","Jean-Philippe Mateta_2022",2022,"Crystal Palace","Premier League","Jean-Philippe Mateta","FRA","FW","24",1997,12.7,8,4,2,5,1,3,18,16.7,15,11,3,8,4,12,13,0,"https://fbref.com/en/players/50e6dc35/Jean-Philippe-Mateta"
"8899","James McArthur_2022",2022,"Crystal Palace","Premier League","James McArthur","SCO","MF","33",1987,16,33,23,13,19,1,16,44,36.4,28,23,9,14,30,63,27,0,"https://fbref.com/en/players/cee31595/James-McArthur"
"8900","Luka Milivojević_2022",2022,"Crystal Palace","Premier League","Luka Milivojević","SRB","MF","30",1991,8.6,18,9,9,6,3,10,16,62.5,6,6,1,5,11,29,15,0,"https://fbref.com/en/players/2ce2508a/Luka-Milivojevic"
"8901","Tyrick Mitchell_2022",2022,"Crystal Palace","Premier League","Tyrick Mitchell","ENG","DF","21",1999,34.5,104,57,67,26,11,46,67,68.7,21,47,5,42,41,145,101,0,"https://fbref.com/en/players/5cbd1eb0/Tyrick-Mitchell"
"8902","Michael Olise_2022",2022,"Crystal Palace","Premier League","Michael Olise","FRA","FW,MF","19",2001,12.7,22,18,8,11,3,7,24,29.2,17,17,0,17,6,28,6,0,"https://fbref.com/en/players/c4486bac/Michael-Olise"
"8903","Jesuran Rak Sakyi_2022",2022,"Crystal Palace","Premier League","Jesuran Rak Sakyi","ENG","FW,MF","18",2002,0.9,0,0,0,0,0,0,1,0,1,3,0,3,1,1,0,0,"https://fbref.com/en/players/45685411/Jesuran-Rak-Sakyi"
"8904","Jaïro Riedewald_2022",2022,"Crystal Palace","Premier League","Jaïro Riedewald","NED","MF","24",1996,1.3,1,1,0,1,0,1,2,50,1,1,0,1,1,2,2,0,"https://fbref.com/en/players/7a1f2c08/Jairo-Riedewald"
"8905","Jeffrey Schlupp_2022",2022,"Crystal Palace","Premier League","Jeffrey Schlupp","GHA","MF,FW","28",1992,20.6,46,25,16,23,7,24,50,48,26,39,9,30,18,64,32,0,"https://fbref.com/en/players/3312f911/Jeffrey-Schlupp"
"8906","James Tomkins_2022",2022,"Crystal Palace","Premier League","James Tomkins","ENG","DF","32",1989,6.1,8,3,6,2,0,6,8,75,2,8,8,0,4,12,18,0,"https://fbref.com/en/players/e7ca0439/James-Tomkins"
"8907","Joel Ward_2022",2022,"Crystal Palace","Premier League","Joel Ward","ENG","DF","31",1989,27.6,44,26,30,11,3,30,57,52.6,27,24,11,13,32,76,107,1,"https://fbref.com/en/players/8a7ff278/Joel-Ward"
"8908","Wilfried Zaha_2022",2022,"Crystal Palace","Premier League","Wilfried Zaha","CIV","FW","28",1992,30.7,40,20,14,15,11,10,31,32.3,21,28,0,28,5,45,5,0,"https://fbref.com/en/players/b2bc3b1f/Wilfried-Zaha"
"8909","Carlos Akapo_2022",2022,"Cádiz","La Liga","Carlos Akapo","EQG","DF","28",1993,20.5,43,31,26,15,2,21,37,56.8,16,26,7,19,51,94,61,0,"https://fbref.com/en/players/f2a68b97/Carlos-Akapo"
"8910","Tomás Alarcón_2022",2022,"Cádiz","La Liga","Tomás Alarcón","CHI","MF","22",1999,15.8,31,20,17,10,4,10,31,32.3,21,19,7,12,30,61,31,0,"https://fbref.com/en/players/99ea2ddd/Tomas-Alarcon"
"8911","Rubén Alcaraz_2022",2022,"Cádiz","La Liga","Rubén Alcaraz","ESP","MF","30",1991,12.3,41,20,14,24,3,22,45,48.9,23,10,2,8,13,54,14,0,"https://fbref.com/en/players/036bba5f/Ruben-Alcaraz"
"8912","Iván Alejo_2022",2022,"Cádiz","La Liga","Iván Alejo","ESP","MF,FW","26",1995,11.8,33,15,21,10,2,15,44,34.1,29,12,0,12,8,41,17,0,"https://fbref.com/en/players/3d7e48ce/Ivan-Alejo"
"8913","Florin Andone_2022",2022,"Cádiz","La Liga","Florin Andone","ROU","FW","28",1993,2,1,1,1,0,0,0,1,0,1,2,0,2,0,1,1,0,"https://fbref.com/en/players/dc008610/Florin-Andone"
"8914","Santiago Arzamendia_2022",2022,"Cádiz","La Liga","Santiago Arzamendia","PAR","MF","23",1998,5.2,14,6,6,5,3,6,13,46.2,7,6,0,6,4,18,7,0,"https://fbref.com/en/players/759d8dd7/Santiago-Arzamendia"
"8915","Álvaro Bastida_2022",2022,"Cádiz","La Liga","Álvaro Bastida","ESP","MF","17",2004,2.2,7,4,2,4,1,4,5,80,1,1,0,1,3,10,1,0,"https://fbref.com/en/players/42a028c5/Alvaro-Bastida"
"8916","Pedro Benito_2022",2022,"Cádiz","La Liga","Pedro Benito","ESP","FW","21",2000,0.3,0,0,0,0,0,0,1,0,1,0,0,0,0,0,0,0,"https://fbref.com/en/players/a7416105/Pedro-Benito"
"8917","Cala_2022",2022,"Cádiz","La Liga","Cala","ESP","DF","31",1989,10.5,9,4,9,0,0,8,17,47.1,9,12,6,6,12,21,56,0,"https://fbref.com/en/players/fe05804b/Cala"
"8918","Isaac Carcelen_2022",2022,"Cádiz","La Liga","Isaac Carcelen","ESP","DF,MF","28",1993,17.2,43,29,29,12,2,28,56,50,28,25,6,19,34,77,42,0,"https://fbref.com/en/players/c4b888df/Isaac-Carcelen"
"8919","Chapela_2022",2022,"Cádiz","La Liga","Chapela","ESP","MF,FW","22",1999,4.4,4,2,1,0,3,2,4,50,2,6,1,5,4,8,5,0,"https://fbref.com/en/players/9ed40a69/Chapela"
"8920","Víctor Chust_2022",2022,"Cádiz","La Liga","Víctor Chust","ESP","DF","21",2000,20.3,19,10,14,4,1,11,17,64.7,6,20,8,12,16,35,87,0,"https://fbref.com/en/players/ec1a731e/Victor-Chust"
"8921","Alfonso Espino_2022",2022,"Cádiz","La Liga","Alfonso Espino","URU","DF","29",1992,37,107,63,58,39,10,44,112,39.3,68,45,10,35,54,161,87,1,"https://fbref.com/en/players/db001fa9/Alfonso-Espino"
"8922","Fali_2022",2022,"Cádiz","La Liga","Fali","ESP","DF,MF","27",1993,20,32,19,24,8,0,17,32,53.1,15,26,16,10,24,56,82,0,"https://fbref.com/en/players/72a84002/Fali"
"8923","Álex Fernández_2022",2022,"Cádiz","La Liga","Álex Fernández","ESP","MF","28",1992,22.8,47,31,22,17,8,21,61,34.4,40,30,7,23,30,77,31,0,"https://fbref.com/en/players/aa677a35/Alex-Fernandez"
"8924","Marcos Mauro López Gutiérrez_2022",2022,"Cádiz","La Liga","Marcos Mauro López Gutiérrez","ARG","DF","30",1991,1.5,1,0,0,1,0,0,2,0,2,2,1,1,1,2,9,0,"https://fbref.com/en/players/b3b62f94/Marcos-Mauro-Lopez-Gutierrez"
"8925","Varazdat Haroyan_2022",2022,"Cádiz","La Liga","Varazdat Haroyan","ARM","DF","28",1992,16,31,21,20,10,1,19,29,65.5,10,22,12,10,15,46,62,0,"https://fbref.com/en/players/be32269e/Varazdat-Haroyan"
"8926","Luis Hernández_2022",2022,"Cádiz","La Liga","Luis Hernández","ESP","DF","32",1989,15.2,9,5,9,0,0,5,8,62.5,3,5,3,2,16,25,34,0,"https://fbref.com/en/players/02d2c436/Luis-Hernandez"
"8927","Oussama Idrissi_2022",2022,"Cádiz","La Liga","Oussama Idrissi","MAR","MF","25",1996,10,8,4,3,4,1,4,15,26.7,11,8,0,8,3,11,5,0,"https://fbref.com/en/players/34caa4b3/Oussama-Idrissi"
"8928","Álvaro Jiménez_2022",2022,"Cádiz","La Liga","Álvaro Jiménez","ESP","MF,FW","26",1995,2.6,6,3,3,2,1,4,7,57.1,3,3,0,3,3,9,0,0,"https://fbref.com/en/players/5f5501ed/Alvaro-Jimenez"
"8929","Jens Jønsson_2022",2022,"Cádiz","La Liga","Jens Jønsson","DEN","MF","28",1993,14.5,40,29,22,17,1,17,35,48.6,18,17,7,10,34,74,32,0,"https://fbref.com/en/players/53520a67/Jens-Jonsson"
"8930","Jeremías Ledesma_2022",2022,"Cádiz","La Liga","Jeremías Ledesma","ARG","GK","28",1993,38,3,1,3,0,0,3,4,75,1,0,0,0,1,4,21,4,"https://fbref.com/en/players/6c4776b1/Jeremias-Ledesma"
"8931","Anthony Lozano_2022",2022,"Cádiz","La Liga","Anthony Lozano","HON","FW,MF","28",1993,18.6,8,4,2,3,3,5,18,27.8,13,16,2,14,2,10,7,0,"https://fbref.com/en/players/38699c72/Anthony-Lozano"
"8932","José Mari_2022",2022,"Cádiz","La Liga","José Mari","ESP","MF","33",1987,4.3,14,7,3,10,1,7,8,87.5,1,4,1,3,7,21,2,0,"https://fbref.com/en/players/6f4c734d/Jose-Mari"
"8933","Martín_2022",2022,"Cádiz","La Liga","Martín","ESP","MF","22",1999,1.3,2,2,0,2,0,0,0,NA,0,1,0,1,1,3,3,0,"https://fbref.com/en/players/cbec0059/Martin"
"8934","Álvaro Negredo_2022",2022,"Cádiz","La Liga","Álvaro Negredo","ESP","FW","35",1985,24,5,3,1,4,0,3,6,50,3,11,5,6,2,7,23,0,"https://fbref.com/en/players/63b0ca6b/Alvaro-Negredo"
"8935","Milutin Osmajić_2022",2022,"Cádiz","La Liga","Milutin Osmajić","MNE","FW,MF","22",1999,2.9,1,1,0,1,0,0,0,NA,0,0,0,0,1,2,3,0,"https://fbref.com/en/players/375ed9d7/Milutin-Osmajic"
"8936","Raúl Parra_2022",2022,"Cádiz","La Liga","Raúl Parra","ESP","DF","21",1999,1,2,1,2,0,0,1,3,33.3,2,0,0,0,0,2,5,0,"https://fbref.com/en/players/647d39d2/Raul-Parra"
"8937","Alberto Perea_2022",2022,"Cádiz","La Liga","Alberto Perea","ESP","MF","30",1990,8.6,19,9,7,9,3,6,20,30,14,15,1,14,9,28,4,0,"https://fbref.com/en/players/5496cc91/Alberto-Perea"
"8938","Lucas Pérez_2022",2022,"Cádiz","La Liga","Lucas Pérez","ESP","FW,MF","32",1988,11.8,3,3,2,1,0,0,10,0,10,3,1,2,0,3,1,0,"https://fbref.com/en/players/a300ac7e/Lucas-Perez"
"8939","Salvi_2022",2022,"Cádiz","La Liga","Salvi","ESP","MF,FW","30",1991,15.5,20,10,9,8,3,8,20,40,12,17,2,15,6,26,11,0,"https://fbref.com/en/players/405f267a/Salvi"
"8940","Fede San Emeterio_2022",2022,"Cádiz","La Liga","Fede San Emeterio","ESP","MF","24",1997,9.2,16,5,5,8,3,5,15,33.3,10,5,0,5,8,24,6,0,"https://fbref.com/en/players/efecd633/Fede-San-Emeterio"
"8941","Rubén Sobrino_2022",2022,"Cádiz","La Liga","Rubén Sobrino","ESP","FW,MF","29",1992,20.7,28,17,11,10,7,5,35,14.3,30,21,1,20,21,49,18,0,"https://fbref.com/en/players/19b776e9/Ruben-Sobrino"
"8942","Manuel Akanji_2022",2022,"Dortmund","Bundesliga","Manuel Akanji","SUI","DF","26",1995,25.1,33,23,20,11,2,22,32,68.8,10,26,15,11,35,68,58,0,"https://fbref.com/en/players/89ac64a6/Manuel-Akanji"
"8943","Jude Bellingham_2022",2022,"Dortmund","Bundesliga","Jude Bellingham","ENG","MF","18",2003,31,52,34,15,31,6,21,53,39.6,32,50,4,46,42,94,32,0,"https://fbref.com/en/players/57d88cf9/Jude-Bellingham"
"8944","Julian Brandt_2022",2022,"Dortmund","Bundesliga","Julian Brandt","GER","MF,FW","25",1996,23.1,37,19,13,20,4,17,54,31.5,37,19,2,17,24,61,14,1,"https://fbref.com/en/players/a167537f/Julian-Brandt"
"8945","Roman Bürki_2022",2022,"Dortmund","Bundesliga","Roman Bürki","SUI","GK","30",1990,1,0,0,0,0,0,0,0,NA,0,0,0,0,0,0,0,0,"https://fbref.com/en/players/9d12e142/Roman-Burki"
"8946","Jamie Bynoe-Gittens_2022",2022,"Dortmund","Bundesliga","Jamie Bynoe-Gittens","ENG","FW","16",2004,1.5,3,2,0,2,1,2,5,40,3,4,1,3,1,4,1,0,"https://fbref.com/en/players/10745192/Jamie-Bynoe-Gittens"
"8947","Emre Can_2022",2022,"Dortmund","Bundesliga","Emre Can","GER","DF,MF","27",1994,18.8,36,22,20,16,0,15,30,50,15,26,10,16,36,72,40,2,"https://fbref.com/en/players/a65ce836/Emre-Can"
"8948","Mahmoud Dahoud_2022",2022,"Dortmund","Bundesliga","Mahmoud Dahoud","GER","MF","25",1996,18.4,42,19,10,24,8,20,46,43.5,26,18,3,15,17,59,16,0,"https://fbref.com/en/players/db4ed67b/Mahmoud-Dahoud"
"8949","Thomas Delaney_2022",2022,"Dortmund","Bundesliga","Thomas Delaney","DEN","MF","29",1991,0.2,0,0,0,0,0,0,0,NA,0,0,0,0,0,0,0,0,"https://fbref.com/en/players/fe641c1a/Thomas-Delaney"
"8950","Raphaël Guerreiro_2022",2022,"Dortmund","Bundesliga","Raphaël Guerreiro","POR","DF","27",1993,19.9,35,19,19,12,4,16,31,51.6,15,18,2,16,25,60,14,1,"https://fbref.com/en/players/048a1cbc/Raphael-Guerreiro"
"8951","Erling Haaland_2022",2022,"Dortmund","Bundesliga","Erling Haaland","NOR","FW","21",2000,21.2,2,1,0,1,1,0,1,0,1,8,1,7,1,3,31,0,"https://fbref.com/en/players/1f44ac21/Erling-Haaland"
"8952","Thorgan Hazard_2022",2022,"Dortmund","Bundesliga","Thorgan Hazard","BEL","FW,DF","28",1993,14.9,23,13,8,10,5,15,40,37.5,25,23,1,22,6,29,4,0,"https://fbref.com/en/players/50871bcc/Thorgan-Hazard"
"8953","Marwin Hitz_2022",2022,"Dortmund","Bundesliga","Marwin Hitz","SUI","GK","33",1987,4.5,0,0,0,0,0,0,0,NA,0,0,0,0,0,0,2,0,"https://fbref.com/en/players/2e7ff968/Marwin-Hitz"
"8954","Mats Hummels_2022",2022,"Dortmund","Bundesliga","Mats Hummels","GER","DF","32",1988,19.6,34,22,20,13,1,20,36,55.6,16,18,13,5,32,66,66,1,"https://fbref.com/en/players/05d548d8/Mats-Hummels"
"8955","Ansgar Knauff_2022",2022,"Dortmund","Bundesliga","Ansgar Knauff","GER","FW,MF","19",2002,1.3,3,1,1,1,1,0,4,0,4,2,0,2,0,3,4,0,"https://fbref.com/en/players/19a967ab/Ansgar-Knauff"
"8956","Gregor Kobel_2022",2022,"Dortmund","Bundesliga","Gregor Kobel","SUI","GK","23",1997,28.5,0,0,0,0,0,0,2,0,2,0,0,0,1,1,20,0,"https://fbref.com/en/players/cd59b9df/Gregor-Kobel"
"8957","Donyell Malen_2022",2022,"Dortmund","Bundesliga","Donyell Malen","NED","FW","22",1999,18.7,13,10,4,5,4,7,13,53.8,6,10,0,10,10,23,11,0,"https://fbref.com/en/players/864163f3/Donyell-Malen"
"8958","Lennard Maloney_2022",2022,"Dortmund","Bundesliga","Lennard Maloney","USA","DF","21",1999,0.1,1,0,1,0,0,1,1,100,0,0,0,0,0,1,0,0,"https://fbref.com/en/players/75402e99/Lennard-Maloney"
"8959","Thomas Meunier_2022",2022,"Dortmund","Bundesliga","Thomas Meunier","BEL","DF","29",1991,15.6,29,19,13,12,4,16,33,48.5,17,10,2,8,12,41,25,1,"https://fbref.com/en/players/e162b013/Thomas-Meunier"
"8960","Youssoufa Moukoko_2022",2022,"Dortmund","Bundesliga","Youssoufa Moukoko","GER","FW,MF","16",2004,2.5,1,0,0,1,0,0,1,0,1,5,0,5,3,4,0,0,"https://fbref.com/en/players/6ce43701/Youssoufa-Moukoko"
"8961","Antonios Papadopoulos_2022",2022,"Dortmund","Bundesliga","Antonios Papadopoulos","GER","DF,MF","21",1999,0.2,0,0,0,0,0,0,0,NA,0,1,0,1,0,0,0,0,"https://fbref.com/en/players/13d23b29/Antonios-Papadopoulos"
"8962","Felix Passlack_2022",2022,"Dortmund","Bundesliga","Felix Passlack","GER","DF","23",1998,5.2,13,9,8,4,1,6,12,50,6,5,1,4,4,17,7,0,"https://fbref.com/en/players/5c899683/Felix-Passlack"
"8963","Immanuel Pherai_2022",2022,"Dortmund","Bundesliga","Immanuel Pherai","NED","MF","20",2001,0,0,0,0,0,0,0,0,NA,0,0,0,0,0,0,0,0,"https://fbref.com/en/players/f168d9b9/Immanuel-Pherai"
"8964","Marin Pongračić_2022",2022,"Dortmund","Bundesliga","Marin Pongračić","CRO","DF","23",1997,9.2,17,10,13,4,0,6,10,60,4,11,5,6,17,34,32,2,"https://fbref.com/en/players/2a6cd437/Marin-Pongracic"
"8965","Reinier_2022",2022,"Dortmund","Bundesliga","Reinier","BRA","FW,MF","19",2002,1.8,5,3,4,0,1,1,1,100,0,3,0,3,0,5,0,0,"https://fbref.com/en/players/6b21b7b5/Reinier"
"8966","Marco Reus_2022",2022,"Dortmund","Bundesliga","Marco Reus","GER","MF,FW","32",1989,27.8,45,30,13,21,11,16,42,38.1,26,23,6,17,12,57,41,1,"https://fbref.com/en/players/36a3ff67/Marco-Reus"
"8967","Gio Reyna_2022",2022,"Dortmund","Bundesliga","Gio Reyna","USA","MF","18",2002,4.9,7,4,2,4,1,3,9,33.3,6,6,0,6,1,8,3,0,"https://fbref.com/en/players/7fa4e703/Gio-Reyna"
"8968","Tom Rothe_2022",2022,"Dortmund","Bundesliga","Tom Rothe","GER","DF","16",2004,1,4,3,2,2,0,3,6,50,3,2,0,2,2,6,3,0,"https://fbref.com/en/players/90c1f9a4/Tom-Rothe"
"8969","Nico Schulz_2022",2022,"Dortmund","Bundesliga","Nico Schulz","GER","DF","28",1993,9.3,21,12,9,7,5,9,21,42.9,12,8,1,7,11,32,8,0,"https://fbref.com/en/players/fa274d97/Nico-Schulz"
"8970","Lion Semić_2022",2022,"Dortmund","Bundesliga","Lion Semić","GER","DF","17",2003,0,0,0,0,0,0,0,0,NA,0,0,0,0,0,0,0,0,"https://fbref.com/en/players/87ebd8c9/Lion-Semic"
"8971","Steffen Tigges_2022",2022,"Dortmund","Bundesliga","Steffen Tigges","GER","FW,MF","23",1998,1.2,4,3,1,2,1,2,3,66.7,1,3,1,2,0,4,3,0,"https://fbref.com/en/players/6b8887c2/Steffen-Tigges"
"8972","Axel Witsel_2022",2022,"Dortmund","Bundesliga","Axel Witsel","BEL","MF,DF","32",1989,21.6,42,27,12,23,7,18,30,60,12,24,9,15,27,69,38,0,"https://fbref.com/en/players/5dfc6ad5/Axel-Witsel"
"8973","Marius Wolf_2022",2022,"Dortmund","Bundesliga","Marius Wolf","GER","DF,FW","26",1995,14.7,26,10,13,9,4,12,24,50,12,14,1,13,13,39,8,0,"https://fbref.com/en/players/fa661778/Marius-Wolf"
"8974","Dan-Axel Zagadou_2022",2022,"Dortmund","Bundesliga","Dan-Axel Zagadou","FRA","DF","22",1999,10.6,13,7,11,1,1,7,10,70,3,14,4,10,15,28,38,2,"https://fbref.com/en/players/a4effc55/Dan-Axel-Zagadou"
"8975","Ragnar Ache_2022",2022,"Eint Frankfurt","Bundesliga","Ragnar Ache","GER","MF,FW","23",1998,2.9,2,0,0,1,1,1,4,25,3,3,0,3,0,2,1,0,"https://fbref.com/en/players/dc38e3bc/Ragnar-Ache"
"8976","Aymen Barkok_2022",2022,"Eint Frankfurt","Bundesliga","Aymen Barkok","MAR","MF,DF","23",1998,1.8,6,2,2,3,1,2,7,28.6,5,4,1,3,5,11,6,0,"https://fbref.com/en/players/a2a85828/Aymen-Barkok"
"8977","Rafael Borré_2022",2022,"Eint Frankfurt","Bundesliga","Rafael Borré","COL","FW","25",1995,26.4,31,22,4,13,14,7,33,21.2,26,24,4,20,5,36,9,0,"https://fbref.com/en/players/c68da769/Rafael-Borre"
"8978","Timothy Chandler_2022",2022,"Eint Frankfurt","Bundesliga","Timothy Chandler","USA","DF","31",1990,13.5,18,12,10,8,0,11,24,45.8,13,10,3,7,19,37,28,1,"https://fbref.com/en/players/b3b7f5a6/Timothy-Chandler"
"8979","Danny da Costa_2022",2022,"Eint Frankfurt","Bundesliga","Danny da Costa","GER","DF,MF","28",1993,8.1,15,4,6,7,2,6,18,33.3,12,14,1,13,11,26,18,1,"https://fbref.com/en/players/5ddb8f9f/Danny-da-Costa"
"8980","Erik Durm_2022",2022,"Eint Frankfurt","Bundesliga","Erik Durm","GER","DF","29",1992,5.3,13,7,6,5,2,10,13,76.9,3,8,1,7,10,23,7,0,"https://fbref.com/en/players/cf623c78/Erik-Durm"
"8981","Jens Grahl_2022",2022,"Eint Frankfurt","Bundesliga","Jens Grahl","GER","GK","32",1988,1,0,0,0,0,0,0,0,NA,0,0,0,0,0,0,1,0,"https://fbref.com/en/players/f26dee6b/Jens-Grahl"
"8982","Makoto Hasebe_2022",2022,"Eint Frankfurt","Bundesliga","Makoto Hasebe","JPN","DF","37",1984,13.2,27,12,15,11,1,13,29,44.8,16,24,8,16,22,49,36,0,"https://fbref.com/en/players/9ab16552/Makoto-Hasebe"
"8983","Martin Hinteregger_2022",2022,"Eint Frankfurt","Bundesliga","Martin Hinteregger","AUT","DF","28",1992,24.7,45,28,28,16,1,28,43,65.1,15,36,16,20,42,87,78,3,"https://fbref.com/en/players/080440a4/Martin-Hinteregger"
"8984","Ajdin Hrustic_2022",2022,"Eint Frankfurt","Bundesliga","Ajdin Hrustic","AUS","MF","25",1996,10.7,16,11,5,7,4,11,32,34.4,21,18,1,17,10,26,7,0,"https://fbref.com/en/players/1f2d714c/Ajdin-Hrustic"
"8985","Stefan Ilsanker_2022",2022,"Eint Frankfurt","Bundesliga","Stefan Ilsanker","AUT","DF,MF","32",1989,3,14,8,7,6,1,5,10,50,5,6,2,4,6,20,15,1,"https://fbref.com/en/players/8494acc4/Stefan-Ilsanker"
"8986","Kristijan Jakić_2022",2022,"Eint Frankfurt","Bundesliga","Kristijan Jakić","CRO","MF","24",1997,20.9,37,22,10,21,6,15,62,24.2,47,33,3,30,21,58,25,1,"https://fbref.com/en/players/a8ee54ad/Kristijan-Jakic"
"8987","Daichi Kamada_2022",2022,"Eint Frankfurt","Bundesliga","Daichi Kamada","JPN","MF","24",1996,23.8,40,21,7,26,7,11,40,27.5,29,18,0,18,8,48,10,0,"https://fbref.com/en/players/15b287da/Daichi-Kamada"
"8988","Ansgar Knauff_2022",2022,"Eint Frankfurt","Bundesliga","Ansgar Knauff","GER","DF,MF","19",2002,8.4,18,14,8,5,5,8,15,53.3,7,11,1,10,8,26,6,0,"https://fbref.com/en/players/19a967ab/Ansgar-Knauff"
"8989","Filip Kostić_2022",2022,"Eint Frankfurt","Bundesliga","Filip Kostić","SRB","DF,FW","28",1992,28,44,17,26,9,9,20,53,37.7,33,24,1,23,15,59,24,0,"https://fbref.com/en/players/b1cd37e6/Filip-Kostic"
"8990","Sam Lammers_2022",2022,"Eint Frankfurt","Bundesliga","Sam Lammers","NED","FW,MF","24",1997,5.7,4,4,0,2,2,2,6,33.3,4,9,2,7,2,6,4,0,"https://fbref.com/en/players/c283ddef/Sam-Lammers"
"8991","Christopher Lenz_2022",2022,"Eint Frankfurt","Bundesliga","Christopher Lenz","GER","DF","26",1994,7.4,29,15,22,6,1,12,21,57.1,9,9,4,5,7,36,21,0,"https://fbref.com/en/players/bbd86530/Christopher-Lenz"
"8992","Jesper Lindstrøm_2022",2022,"Eint Frankfurt","Bundesliga","Jesper Lindstrøm","DEN","MF,FW","21",2000,22,28,13,6,13,9,12,36,33.3,24,30,0,30,24,52,11,1,"https://fbref.com/en/players/37dc1a48/Jesper-Lindstrom"
"8993","Obite N'Dicka_2022",2022,"Eint Frankfurt","Bundesliga","Obite N'Dicka","FRA","DF","21",1999,31.7,60,34,29,27,4,44,59,74.6,15,46,20,26,48,108,137,0,"https://fbref.com/en/players/441197b8/Obite-NDicka"
"8994","Gonçalo Paciência_2022",2022,"Eint Frankfurt","Bundesliga","Gonçalo Paciência","POR","FW","26",1994,5.7,4,2,2,1,1,1,3,33.3,2,2,0,2,1,5,4,0,"https://fbref.com/en/players/962e54cb/Goncalo-Paciencia"
"8995","Jens Petter Hauge_2022",2022,"Eint Frankfurt","Bundesliga","Jens Petter Hauge","NOR","MF,FW","21",1999,11.6,14,5,6,7,1,7,23,30.4,16,7,0,7,3,17,5,0,"https://fbref.com/en/players/12c35abe/Jens-Petter-Hauge"
"8996","Diant Ramaj_2022",2022,"Eint Frankfurt","Bundesliga","Diant Ramaj","GER","GK","19",2001,1,0,0,0,0,0,0,0,NA,0,0,0,0,0,0,3,0,"https://fbref.com/en/players/b90c4a43/Diant-Ramaj"
"8997","Sebastian Rode_2022",2022,"Eint Frankfurt","Bundesliga","Sebastian Rode","GER","MF","30",1990,8.4,15,7,5,8,2,5,17,29.4,12,11,1,10,13,28,8,0,"https://fbref.com/en/players/e12b0b5b/Sebastian-Rode"
"8998","Djibril Sow_2022",2022,"Eint Frankfurt","Bundesliga","Djibril Sow","SUI","MF","24",1997,26.8,57,33,28,25,4,22,60,36.7,38,35,8,27,50,107,20,1,"https://fbref.com/en/players/4c6facae/Djibril-Sow"
"8999","Almamy Touré_2022",2022,"Eint Frankfurt","Bundesliga","Almamy Touré","MLI","DF,MF","25",1996,5.6,12,9,8,3,1,4,17,23.5,13,10,3,7,5,17,19,0,"https://fbref.com/en/players/c8c60119/Almamy-Toure"
"9000","Kevin Trapp_2022",2022,"Eint Frankfurt","Bundesliga","Kevin Trapp","GER","GK","31",1990,32,0,0,0,0,0,0,1,0,1,0,0,0,1,1,13,2,"https://fbref.com/en/players/ce17b5eb/Kevin-Trapp"
"9001","Tuta_2022",2022,"Eint Frankfurt","Bundesliga","Tuta","BRA","DF","22",1999,24.3,46,28,20,22,4,26,47,55.3,21,43,15,28,41,87,76,1,"https://fbref.com/en/players/35d64857/Tuta"
"9002","Édgar Badía_2022",2022,"Elche","La Liga","Édgar Badía","ESP","GK","29",1992,24,0,0,0,0,0,0,0,NA,0,0,0,0,0,0,16,2,"https://fbref.com/en/players/e4346678/Edgar-Badia"
"9003","Antonio Barragán_2022",2022,"Elche","La Liga","Antonio Barragán","ESP","DF","34",1987,11.3,21,14,13,7,1,11,17,64.7,6,5,3,2,17,38,34,0,"https://fbref.com/en/players/487d9b09/Antonio-Barragan"
"9004","Darío Benedetto_2022",2022,"Elche","La Liga","Darío Benedetto","ARG","FW,MF","31",1990,6.6,5,1,2,2,1,3,6,50,3,4,0,4,1,6,1,0,"https://fbref.com/en/players/bef0a7ac/Dario-Benedetto"
"9005","Pedro Bigas_2022",2022,"Elche","La Liga","Pedro Bigas","ESP","DF","30",1990,17.2,24,10,16,8,0,9,20,45,11,21,16,5,18,42,77,1,"https://fbref.com/en/players/697295b1/Pedro-Bigas"
"9006","Lucas Boyé_2022",2022,"Elche","La Liga","Lucas Boyé","ARG","FW","25",1996,19,27,13,5,15,7,9,24,37.5,15,24,1,23,2,29,23,0,"https://fbref.com/en/players/d49f3e6b/Lucas-Boye"
"9007","Guido Carrillo_2022",2022,"Elche","La Liga","Guido Carrillo","ARG","FW","30",1991,13,7,4,2,4,1,3,13,23.1,10,9,2,7,1,8,27,0,"https://fbref.com/en/players/8f898ba8/Guido-Carrillo"
"9008","Kiko Casilla_2022",2022,"Elche","La Liga","Kiko Casilla","ESP","GK","34",1986,14,0,0,0,0,0,0,1,0,1,0,0,0,1,1,2,2,"https://fbref.com/en/players/58bc7d18/Kiko-Casilla"
"9009","John Donald_2022",2022,"Elche","La Liga","John Donald","ESP","DF","20",2000,2,7,4,4,2,1,5,8,62.5,3,5,3,2,3,10,3,0,"https://fbref.com/en/players/5e95c000/John-Donald"
"9010","Fidel_2022",2022,"Elche","La Liga","Fidel","ESP","MF","31",1989,25.1,44,23,18,17,9,14,57,24.6,43,9,1,8,7,51,20,0,"https://fbref.com/en/players/eb82b6f1/Fidel"
"9011","Diego González_2022",2022,"Elche","La Liga","Diego González","ESP","DF","26",1995,19.9,25,16,18,7,0,9,16,56.3,7,21,13,8,19,44,87,0,"https://fbref.com/en/players/4ac7608e/Diego-Gonzalez"
"9012","Gerard Gumbau_2022",2022,"Elche","La Liga","Gerard Gumbau","ESP","MF","26",1994,21,46,19,22,19,5,22,51,43.1,29,18,4,14,23,69,25,0,"https://fbref.com/en/players/ac454a4f/Gerard-Gumbau"
"9013","Raúl Guti_2022",2022,"Elche","La Liga","Raúl Guti","ESP","MF","24",1996,18.1,25,15,7,14,4,10,30,33.3,20,9,3,6,25,50,7,0,"https://fbref.com/en/players/0b2c8585/Raul-Guti"
"9014","Josan_2022",2022,"Elche","La Liga","Josan","ESP","DF,MF","31",1989,13.5,36,22,23,9,4,26,44,59.1,18,11,4,7,10,46,21,0,"https://fbref.com/en/players/5b28b2f6/Josan"
"9015","Josema_2022",2022,"Elche","La Liga","Josema","ESP","DF","25",1996,2,3,2,1,1,1,0,2,0,2,1,1,0,0,3,11,0,"https://fbref.com/en/players/ed3f5f4c/Josema"
"9016","Iván Marcone_2022",2022,"Elche","La Liga","Iván Marcone","ARG","MF","31",1990,9,24,14,17,6,1,12,24,50,12,8,3,5,12,36,13,0,"https://fbref.com/en/players/b14f755d/Ivan-Marcone"
"9017","Omar Mascarell_2022",2022,"Elche","La Liga","Omar Mascarell","ESP","MF","28",1993,27.7,46,26,16,23,7,24,60,40,36,42,14,28,48,94,52,2,"https://fbref.com/en/players/11fd2b75/Omar-Mascarell"
"9018","Pere Milla_2022",2022,"Elche","La Liga","Pere Milla","ESP","MF,FW","28",1992,18.3,20,15,14,5,1,8,44,18.2,36,21,1,20,5,25,21,0,"https://fbref.com/en/players/335039a2/Pere-Milla"
"9019","Johan Mojica_2022",2022,"Elche","La Liga","Johan Mojica","COL","DF","28",1992,31.7,46,25,34,7,5,23,31,74.2,8,22,3,19,25,71,61,3,"https://fbref.com/en/players/608f2092/Johan-Mojica"
"9020","Tete Morente_2022",2022,"Elche","La Liga","Tete Morente","ESP","MF","24",1996,18.1,21,14,13,7,1,7,28,25,21,30,1,29,12,33,12,0,"https://fbref.com/en/players/004d185e/Tete-Morente"
"9021","Lucas Olaza_2022",2022,"Elche","La Liga","Lucas Olaza","URU","DF","27",1994,3.3,5,3,3,1,1,1,1,100,0,5,1,4,4,9,6,0,"https://fbref.com/en/players/4cee5954/Lucas-Olaza"
"9022","Helibelton Palacios_2022",2022,"Elche","La Liga","Helibelton Palacios","COL","DF","28",1993,21.5,69,38,56,10,3,37,55,67.3,18,21,8,13,18,87,61,0,"https://fbref.com/en/players/ac8b2421/Helibelton-Palacios"
"9023","Javier Pastore_2022",2022,"Elche","La Liga","Javier Pastore","ARG","MF,FW","32",1989,5.8,7,3,3,2,2,3,12,25,9,5,1,4,4,11,2,0,"https://fbref.com/en/players/881ef58c/Javier-Pastore"
"9024","Kike Pérez_2022",2022,"Elche","La Liga","Kike Pérez","ESP","MF,FW","24",1997,5.8,8,6,1,3,4,0,10,0,10,6,1,5,3,11,4,0,"https://fbref.com/en/players/237a3851/Kike-Perez"
"9025","Lucas Pérez_2022",2022,"Elche","La Liga","Lucas Pérez","ESP","FW","32",1988,14.1,4,1,2,1,1,3,10,30,7,2,0,2,3,7,4,0,"https://fbref.com/en/players/a300ac7e/Lucas-Perez"
"9026","Pablo Piatti_2022",2022,"Elche","La Liga","Pablo Piatti","ARG","MF,FW","32",1989,3.5,9,4,5,3,1,3,8,37.5,5,5,1,4,2,11,3,0,"https://fbref.com/en/players/48e89655/Pablo-Piatti"
"9027","Ezequiel Ponce_2022",2022,"Elche","La Liga","Ezequiel Ponce","ARG","FW","24",1997,7.4,5,4,1,3,1,3,10,30,7,5,0,5,1,6,7,0,"https://fbref.com/en/players/ccbbe661/Ezequiel-Ponce"
"9028","Enzo Roco_2022",2022,"Elche","La Liga","Enzo Roco","CHI","DF","28",1992,28.4,36,20,24,11,1,15,24,62.5,9,38,27,11,28,64,110,3,"https://fbref.com/en/players/37f827ec/Enzo-Roco"
"9029","Gonzalo Verdú_2022",2022,"Elche","La Liga","Gonzalo Verdú","ESP","DF","32",1988,15.5,19,9,15,4,0,8,16,50,8,20,14,6,13,32,59,1,"https://fbref.com/en/players/1c2c55fc/Gonzalo-Verdu"
"9030","Kristjan Asllani_2022",2022,"Empoli","Serie A","Kristjan Asllani","ALB","MF","19",2002,15,18,9,9,8,1,11,29,37.9,18,16,7,9,19,37,15,1,"https://fbref.com/en/players/0fdcef0e/Kristjan-Asllani"
"9031","Nedim Bajrami_2022",2022,"Empoli","Serie A","Nedim Bajrami","ALB","MF,FW","22",1999,22.8,21,14,5,13,3,4,14,28.6,10,11,0,11,3,24,8,0,"https://fbref.com/en/players/f42d6c13/Nedim-Bajrami"
"9032","Tommaso Baldanzi_2022",2022,"Empoli","Serie A","Tommaso Baldanzi","ITA","FW","18",2003,0.2,0,0,0,0,0,0,0,NA,0,1,0,1,0,0,0,0,"https://fbref.com/en/players/102e2599/Tommaso-Baldanzi"
"9033","Filippo Bandinelli_2022",2022,"Empoli","Serie A","Filippo Bandinelli","ITA","MF","26",1995,21.7,33,20,10,17,6,15,31,48.4,16,22,5,17,10,43,37,2,"https://fbref.com/en/players/d44360be/Filippo-Bandinelli"
"9034","Marco Benassi_2022",2022,"Empoli","Serie A","Marco Benassi","ITA","MF","26",1994,4.2,6,3,3,2,1,1,10,10,9,4,0,4,3,9,6,0,"https://fbref.com/en/players/0000acda/Marco-Benassi"
"9035","Liberato Cacace_2022",2022,"Empoli","Serie A","Liberato Cacace","NZL","DF","20",2000,5.2,15,6,8,4,3,8,8,100,0,7,2,5,8,23,9,0,"https://fbref.com/en/players/dd86e8e4/Liberato-Cacace"
"9036","Giovanni Crociata_2022",2022,"Empoli","Serie A","Giovanni Crociata","ITA","FW","23",1997,0.2,0,0,0,0,0,0,1,0,1,0,0,0,0,0,0,0,"https://fbref.com/en/players/8c964914/Giovanni-Crociata"
"9037","Patrick Cutrone_2022",2022,"Empoli","Serie A","Patrick Cutrone","ITA","FW","23",1998,15.6,5,2,0,3,2,1,9,11.1,8,11,1,10,5,10,1,0,"https://fbref.com/en/players/a4fe8cda/Patrick-Cutrone"
"9038","Federico Di Francesco_2022",2022,"Empoli","Serie A","Federico Di Francesco","ITA","FW,MF","27",1994,15.2,16,5,2,8,6,9,23,39.1,14,17,1,16,9,25,11,0,"https://fbref.com/en/players/1fca9171/Federico-Di-Francesco"
"9039","Riccardo Fiamozzi_2022",2022,"Empoli","Serie A","Riccardo Fiamozzi","ITA","DF","28",1993,6.9,7,5,2,2,3,2,4,50,2,6,5,1,7,14,12,0,"https://fbref.com/en/players/9f9b9269/Riccardo-Fiamozzi"
"9040","Nicolas Haas_2022",2022,"Empoli","Serie A","Nicolas Haas","SUI","MF","25",1996,11.1,35,22,15,10,10,17,39,43.6,22,24,4,20,9,44,17,1,"https://fbref.com/en/players/fa449bba/Nicolas-Haas"
"9041","Liam Henderson_2022",2022,"Empoli","Serie A","Liam Henderson","SCO","MF","25",1996,22.4,22,13,7,8,7,9,31,29,22,14,4,10,9,31,13,0,"https://fbref.com/en/players/d7918b13/Liam-Henderson"
"9042","Ardian Ismajli_2022",2022,"Empoli","Serie A","Ardian Ismajli","ALB","DF","24",1996,14.1,13,9,8,4,1,5,14,35.7,9,21,11,10,24,37,80,0,"https://fbref.com/en/players/6b635f5c/Ardian-Ismajli"
"9043","Andrea La Mantia_2022",2022,"Empoli","Serie A","Andrea La Mantia","ITA","FW,MF","30",1991,5.4,2,0,0,0,2,1,2,50,1,3,1,2,1,3,6,0,"https://fbref.com/en/players/c375dfa5/Andrea-La-Mantia"
"9044","Sebastiano Luperto_2022",2022,"Empoli","Serie A","Sebastiano Luperto","ITA","DF","24",1996,21.8,29,17,17,10,2,10,20,50,10,32,26,6,45,74,132,0,"https://fbref.com/en/players/997fff07/Sebastiano-Luperto"
"9045","Leonardo Mancuso_2022",2022,"Empoli","Serie A","Leonardo Mancuso","ITA","FW","29",1992,4.7,1,1,0,1,0,0,6,0,6,2,0,2,1,2,2,0,"https://fbref.com/en/players/311027cb/Leonardo-Mancuso"
"9046","Riccardo Marchizza_2022",2022,"Empoli","Serie A","Riccardo Marchizza","ITA","DF","23",1998,15,21,15,11,8,2,11,16,68.8,5,15,6,9,10,31,24,0,"https://fbref.com/en/players/91d0fabf/Riccardo-Marchizza"
"9047","Fabiano Parisi_2022",2022,"Empoli","Serie A","Fabiano Parisi","ITA","DF","20",2000,16.4,35,19,25,5,5,13,31,41.9,18,30,10,20,22,57,42,0,"https://fbref.com/en/players/0967845b/Fabiano-Parisi"
"9048","Andrea Pinamonti_2022",2022,"Empoli","Serie A","Andrea Pinamonti","ITA","FW","22",1999,31.9,11,6,0,7,4,2,18,11.1,16,24,3,21,7,18,23,0,"https://fbref.com/en/players/08aa9cd1/Andrea-Pinamonti"
"9049","Samuele Ricci_2022",2022,"Empoli","Serie A","Samuele Ricci","ITA","MF","19",2001,17,33,19,17,13,3,20,34,58.8,14,24,5,19,31,64,18,0,"https://fbref.com/en/players/9823be92/Samuele-Ricci"
"9050","Simone Romagnoli_2022",2022,"Empoli","Serie A","Simone Romagnoli","ITA","DF","31",1990,16.6,28,12,14,12,2,15,20,75,5,34,28,6,9,37,86,0,"https://fbref.com/en/players/09899de8/Simone-Romagnoli"
"9051","Petar Stojanović_2022",2022,"Empoli","Serie A","Petar Stojanović","SVN","DF","25",1995,30.4,96,63,55,32,9,59,114,51.8,55,39,13,26,27,123,65,1,"https://fbref.com/en/players/13b44b02/Petar-Stojanovic"
"9052","Leo Štulac_2022",2022,"Empoli","Serie A","Leo Štulac","SVN","MF","26",1994,9.3,13,6,5,6,2,7,19,36.8,12,6,2,4,8,21,15,0,"https://fbref.com/en/players/92948398/Leo-Stulac"
"9053","Lorenzo Tonelli_2022",2022,"Empoli","Serie A","Lorenzo Tonelli","ITA","DF","31",1990,9.7,17,9,11,4,2,6,13,46.2,7,14,8,6,19,36,28,2,"https://fbref.com/en/players/8cc29864/Lorenzo-Tonelli"
"9054","Valerio Verre_2022",2022,"Empoli","Serie A","Valerio Verre","ITA","MF","27",1994,3.4,4,2,3,1,0,2,7,28.6,5,2,0,2,1,5,0,0,"https://fbref.com/en/players/33ecf462/Valerio-Verre"
"9055","Guglielmo Vicario_2022",2022,"Empoli","Serie A","Guglielmo Vicario","ITA","GK","24",1996,38,1,1,1,0,0,1,1,100,0,1,0,1,1,2,21,1,"https://fbref.com/en/players/77d6fd4d/Guglielmo-Vicario"
"9056","Mattia Viti_2022",2022,"Empoli","Serie A","Mattia Viti","ITA","DF","19",2002,16.6,28,16,16,9,3,15,24,62.5,9,28,25,3,29,57,69,1,"https://fbref.com/en/players/75438a9a/Mattia-Viti"
"9057","Szymon Żurkowski_2022",2022,"Empoli","Serie A","Szymon Żurkowski","POL","MF","23",1997,25.6,58,33,24,21,13,29,68,42.6,39,43,10,33,35,93,32,1,"https://fbref.com/en/players/4e1d5e59/Szymon-Zurkowski"
"9058","Keidi Bare_2022",2022,"Espanyol","La Liga","Keidi Bare","ALB","MF","23",1997,16.5,27,17,14,12,1,11,31,35.5,20,20,10,10,15,42,26,1,"https://fbref.com/en/players/03049c8c/Keidi-Bare"
"9059","Leandro Cabrera_2022",2022,"Espanyol","La Liga","Leandro Cabrera","URU","DF","30",1991,37,37,24,27,10,0,21,34,61.8,13,32,23,9,44,81,222,2,"https://fbref.com/en/players/69cbc8b6/Leandro-Cabrera"
"9060","Fernando Calero_2022",2022,"Espanyol","La Liga","Fernando Calero","ESP","DF","25",1995,12.1,17,10,12,5,0,8,13,61.5,5,7,2,5,16,33,63,1,"https://fbref.com/en/players/41b3069f/Fernando-Calero"
"9061","Sergi Darder_2022",2022,"Espanyol","La Liga","Sergi Darder","ESP","MF","27",1993,34.7,45,22,16,19,10,18,54,33.3,36,16,1,15,26,71,32,1,"https://fbref.com/en/players/070a3904/Sergi-Darder"
"9062","Landry Dimata_2022",2022,"Espanyol","La Liga","Landry Dimata","BEL","FW,MF","23",1997,6,2,2,1,1,0,1,4,25,3,0,0,0,1,3,7,0,"https://fbref.com/en/players/b5f63410/Landry-Dimata"
"9063","Adri Embarba_2022",2022,"Espanyol","La Liga","Adri Embarba","ESP","FW,MF","29",1992,22.1,44,29,22,15,7,26,69,37.7,43,35,3,32,19,63,30,0,"https://fbref.com/en/players/db8f0eba/Adri-Embarba"
"9064","Joan García_2022",2022,"Espanyol","La Liga","Joan García","ESP","GK","20",2001,1.2,0,0,0,0,0,0,0,NA,0,0,0,0,1,1,1,2,"https://fbref.com/en/players/87b498b0/Joan-Garcia"
"9065","Óscar Gil_2022",2022,"Espanyol","La Liga","Óscar Gil","ESP","DF","24",1997,18.8,52,35,27,20,5,25,46,54.3,21,33,9,24,19,71,33,2,"https://fbref.com/en/players/6652cf96/Oscar-Gil"
"9066","Sergi Gómez_2022",2022,"Espanyol","La Liga","Sergi Gómez","ESP","DF","29",1992,30.2,33,24,29,3,1,18,27,66.7,9,33,23,10,40,73,125,2,"https://fbref.com/en/players/bc6f5f06/Sergi-Gomez"
"9067","Gori_2022",2022,"Espanyol","La Liga","Gori","ESP","MF","19",2002,0.1,0,0,0,0,0,0,0,NA,0,2,0,2,0,0,0,0,"https://fbref.com/en/players/f3451c66/Gori"
"9068","Yangel Herrera_2022",2022,"Espanyol","La Liga","Yangel Herrera","VEN","MF","23",1998,18.3,41,31,19,19,3,18,39,46.2,21,27,5,22,19,60,33,1,"https://fbref.com/en/players/e778654a/Yangel-Herrera"
"9069","Jofre_2022",2022,"Espanyol","La Liga","Jofre","ESP","MF,DF","20",2001,0.2,1,1,0,0,1,1,1,100,0,0,0,0,0,1,0,0,"https://fbref.com/en/players/030ef8d6/Jofre"
"9070","Miguel Juan Llambrich_2022",2022,"Espanyol","La Liga","Miguel Juan Llambrich","ESP","DF","25",1996,0.8,2,2,1,1,0,0,0,NA,0,1,0,1,0,2,5,0,"https://fbref.com/en/players/d83f09ff/Miguel-Juan-Llambrich"
"9071","Luca Koleosho_2022",2022,"Espanyol","La Liga","Luca Koleosho","ITA","FW","16",2004,0,0,0,0,0,0,0,0,NA,0,0,0,0,0,0,0,0,"https://fbref.com/en/players/fc076f78/Luca-Koleosho"
"9072","Wu Lei_2022",2022,"Espanyol","La Liga","Wu Lei","CHN","FW,MF","29",1991,5.3,3,2,1,2,0,3,8,37.5,5,4,0,4,4,7,3,0,"https://fbref.com/en/players/e3fabb0a/Wu-Lei"
"9073","David López_2022",2022,"Espanyol","La Liga","David López","ESP","MF,DF","31",1989,8.3,18,13,9,8,1,9,16,56.3,7,10,8,2,10,28,25,2,"https://fbref.com/en/players/f03f284b/David-Lopez"
"9074","Diego López_2022",2022,"Espanyol","La Liga","Diego López","ESP","GK","39",1981,35.3,0,0,0,0,0,0,2,0,2,0,0,0,1,1,21,1,"https://fbref.com/en/players/73683fa9/Diego-Lopez"
"9075","Óscar Melendo_2022",2022,"Espanyol","La Liga","Óscar Melendo","ESP","MF,FW","23",1997,11,11,5,4,4,3,3,13,23.1,10,4,1,3,1,12,10,0,"https://fbref.com/en/players/379652be/Oscar-Melendo"
"9076","Fran Mérida_2022",2022,"Espanyol","La Liga","Fran Mérida","ESP","MF","31",1990,3,7,3,5,2,0,4,10,40,6,1,0,1,6,13,1,0,"https://fbref.com/en/players/0e50f929/Fran-Merida"
"9077","Manu Morlanes_2022",2022,"Espanyol","La Liga","Manu Morlanes","ESP","MF","22",1999,12.7,36,15,16,17,3,18,43,41.9,25,24,5,19,13,49,17,0,"https://fbref.com/en/players/a0255c67/Manu-Morlanes"
"9078","Loren Morón_2022",2022,"Espanyol","La Liga","Loren Morón","ESP","FW,MF","27",1993,6.3,6,4,1,3,2,0,12,0,12,11,1,10,2,8,9,0,"https://fbref.com/en/players/3aa4a3be/Loren-Moron"
"9079","Oier Olazábal_2022",2022,"Espanyol","La Liga","Oier Olazábal","ESP","GK","31",1989,1.5,0,0,0,0,0,0,0,NA,0,0,0,0,0,0,0,0,"https://fbref.com/en/players/b5bdf144/Oier-Olazabal"
"9080","Pedrosa_2022",2022,"Espanyol","La Liga","Pedrosa","ESP","DF","23",1998,30.2,58,30,38,14,6,26,57,45.6,31,25,7,18,25,83,92,2,"https://fbref.com/en/players/112521d1/Pedrosa"
"9081","Victor Perea_2022",2022,"Espanyol","La Liga","Victor Perea","ESP","DF","21",2000,0,0,0,0,0,0,0,0,NA,0,0,0,0,0,0,0,0,"https://fbref.com/en/players/b7de5bad/Victor-Perea"
"9082","Javi Puado_2022",2022,"Espanyol","La Liga","Javi Puado","ESP","MF,FW","23",1998,24.9,24,14,18,5,1,12,37,32.4,25,18,2,16,11,35,24,0,"https://fbref.com/en/players/2683eda7/Javi-Puado"
"9083","Lluís Recasens_2022",2022,"Espanyol","La Liga","Lluís Recasens","ESP","DF","19",2002,0.5,2,0,2,0,0,1,1,100,0,0,0,0,2,4,2,0,"https://fbref.com/en/players/c31ea173/Lluis-Recasens"
"9084","Nico Ribaudo_2022",2022,"Espanyol","La Liga","Nico Ribaudo","ESP","MF,FW","20",2001,12.4,15,6,9,5,1,11,34,32.4,23,14,2,12,7,22,3,0,"https://fbref.com/en/players/ce8039aa/Nico-Ribaudo"
"9085","Rubén_2022",2022,"Espanyol","La Liga","Rubén","ESP","DF","20",2001,1.7,6,1,4,2,0,4,7,57.1,3,0,0,0,2,8,4,0,"https://fbref.com/en/players/35d4f151/Ruben"
"9086","Raúl de Tomás_2022",2022,"Espanyol","La Liga","Raúl de Tomás","ESP","FW","26",1994,32.4,15,11,6,7,2,6,17,35.3,11,12,3,9,6,21,42,1,"https://fbref.com/en/players/02ef8778/Raul-de-Tomas"
"9087","Álvaro Vadillo_2022",2022,"Espanyol","La Liga","Álvaro Vadillo","ESP","DF,MF","26",1994,0.1,1,1,1,0,0,1,2,50,1,0,0,0,0,1,1,0,"https://fbref.com/en/players/61b62b33/Alvaro-Vadillo"
"9088","Aleix Vidal_2022",2022,"Espanyol","La Liga","Aleix Vidal","ESP","DF,MF","31",1989,21.1,31,25,17,9,5,19,39,48.7,20,19,6,13,25,56,35,2,"https://fbref.com/en/players/04965583/Aleix-Vidal"
"9089","Dídac Vilà_2022",2022,"Espanyol","La Liga","Dídac Vilà","ESP","DF,MF","32",1989,2.3,7,5,2,5,0,4,9,44.4,5,2,1,1,3,10,8,0,"https://fbref.com/en/players/bad38a94/Didac-Vila"
"9090","Tonny Vilhena_2022",2022,"Espanyol","La Liga","Tonny Vilhena","NED","MF,FW","26",1995,10.3,16,6,7,8,1,7,21,33.3,14,10,2,8,8,24,17,0,"https://fbref.com/en/players/c7069d87/Tonny-Vilhena"
"9091","Daniel Villahermosa_2022",2022,"Espanyol","La Liga","Daniel Villahermosa","ESP","MF","20",2001,0.3,0,0,0,0,0,0,0,NA,0,0,0,0,0,0,1,0,"https://fbref.com/en/players/de903ae2/Daniel-Villahermosa"
"9092","Allan_2022",2022,"Everton","Premier League","Allan","BRA","MF","30",1991,24.3,74,44,28,39,7,34,105,32.4,71,40,9,31,23,97,39,1,"https://fbref.com/en/players/cc700722/Allan"
"9093","Dele Alli_2022",2022,"Everton","Premier League","Dele Alli","ENG","MF,FW","25",1996,3.8,7,2,3,4,0,0,4,0,4,7,2,5,6,13,10,0,"https://fbref.com/en/players/cea4ee8f/Dele-Alli"
"9094","Donny van de Beek_2022",2022,"Everton","Premier League","Donny van de Beek","NED","MF","24",1997,5.4,15,7,8,6,1,6,13,46.2,7,6,2,4,6,21,4,0,"https://fbref.com/en/players/50dc94ce/Donny-van-de-Beek"
"9095","Asmir Begović_2022",2022,"Everton","Premier League","Asmir Begović","BIH","GK","34",1987,3,0,0,0,0,0,0,0,NA,0,0,0,0,0,0,3,0,"https://fbref.com/en/players/7b4de647/Asmir-Begovic"
"9096","Jarrad Branthwaite_2022",2022,"Everton","Premier League","Jarrad Branthwaite","ENG","DF","19",2002,4.3,4,1,3,1,0,3,8,37.5,5,3,2,1,1,5,20,0,"https://fbref.com/en/players/c1949191/Jarrad-Branthwaite"
"9097","Dominic Calvert-Lewin_2022",2022,"Everton","Premier League","Dominic Calvert-Lewin","ENG","FW","24",1997,14.3,11,8,1,6,4,3,8,37.5,5,5,2,3,3,14,12,0,"https://fbref.com/en/players/59e6e5bf/Dominic-Calvert-Lewin"
"9098","Séamus Coleman_2022",2022,"Everton","Premier League","Séamus Coleman","IRL","DF","32",1988,29.5,61,36,35,16,10,33,51,64.7,18,30,11,19,32,93,80,2,"https://fbref.com/en/players/0420d84f/Seamus-Coleman"
"9099","Tom Davies_2022",2022,"Everton","Premier League","Tom Davies","ENG","MF","23",1998,2.6,3,1,1,1,1,2,5,40,3,2,1,1,2,5,9,0,"https://fbref.com/en/players/9228b07c/Tom-Davies"
"9100","Fabian Delph_2022",2022,"Everton","Premier League","Fabian Delph","ENG","MF","31",1989,7.4,18,15,10,7,1,8,21,38.1,13,12,5,7,14,32,10,0,"https://fbref.com/en/players/111c3236/Fabian-Delph"
"9101","Lucas Digne_2022",2022,"Everton","Premier League","Lucas Digne","FRA","DF","28",1993,13,33,19,26,4,3,21,28,75,7,16,5,11,14,47,30,0,"https://fbref.com/en/players/1b84dbe1/Lucas-Digne"
"9102","Lewis Dobbin_2022",2022,"Everton","Premier League","Lewis Dobbin","ENG","FW,MF","18",2003,0.4,2,1,0,1,1,1,2,50,1,0,0,0,0,2,0,0,"https://fbref.com/en/players/e814e1cf/Lewis-Dobbin"
"9103","Abdoulaye Doucouré_2022",2022,"Everton","Premier League","Abdoulaye Doucouré","MLI","MF","28",1993,28.2,75,43,30,37,8,32,71,45.1,39,33,8,25,28,103,32,0,"https://fbref.com/en/players/02b29014/Abdoulaye-Doucoure"
"9104","Jean-Philippe Gbamin_2022",2022,"Everton","Premier League","Jean-Philippe Gbamin","CIV","MF","25",1995,0.7,1,1,1,0,0,0,2,0,2,0,0,0,1,2,1,0,"https://fbref.com/en/players/6bd603db/Jean-Philippe-Gbamin"
"9105","Anwar El Ghazi_2022",2022,"Everton","Premier League","Anwar El Ghazi","NED","FW,MF","26",1995,0.1,1,1,1,0,0,1,1,100,0,3,0,3,0,1,0,0,"https://fbref.com/en/players/ffa90327/Anwar-El-Ghazi"
"9106","Ben Godfrey_2022",2022,"Everton","Premier League","Ben Godfrey","ENG","DF","23",1998,22.5,47,32,29,14,4,24,39,61.5,15,41,19,22,15,62,100,2,"https://fbref.com/en/players/9f7c837d/Ben-Godfrey"
"9107","André Gomes_2022",2022,"Everton","Premier League","André Gomes","POR","MF","28",1993,6.9,16,4,6,6,4,8,32,25,24,8,2,6,1,17,7,1,"https://fbref.com/en/players/1961b2aa/Andre-Gomes"
"9108","Anthony Gordon_2022",2022,"Everton","Premier League","Anthony Gordon","ENG","MF,FW","20",2001,25.4,54,32,20,30,4,21,59,35.6,38,49,3,46,22,76,17,0,"https://fbref.com/en/players/2bd83368/Anthony-Gordon"
"9109","Demarai Gray_2022",2022,"Everton","Premier League","Demarai Gray","JAM","MF,FW","25",1996,26,30,19,13,10,7,10,22,45.5,12,30,2,28,15,45,21,1,"https://fbref.com/en/players/4468ec10/Demarai-Gray"
"9110","Mason Holgate_2022",2022,"Everton","Premier League","Mason Holgate","ENG","DF","24",1996,23.7,35,18,26,9,0,11,26,42.3,15,25,17,8,26,61,95,1,"https://fbref.com/en/players/d0042ab9/Mason-Holgate"
"9111","Alex Iwobi_2022",2022,"Everton","Premier League","Alex Iwobi","NGA","MF,DF","25",1996,22.6,40,19,23,12,5,21,52,40.4,31,39,3,36,20,60,25,2,"https://fbref.com/en/players/6ca5ec4b/Alex-Iwobi"
"9112","Moise Kean_2022",2022,"Everton","Premier League","Moise Kean","ITA","FW","21",2000,0,0,0,0,0,0,0,0,NA,0,0,0,0,0,0,0,0,"https://fbref.com/en/players/3d50bcdb/Moise-Kean"
"9113","Michael Keane_2022",2022,"Everton","Premier League","Michael Keane","ENG","DF","28",1993,31,46,25,32,13,1,28,45,62.2,17,33,28,5,62,108,128,2,"https://fbref.com/en/players/c5b7c315/Michael-Keane"
"9114","Jonjoe Kenny_2022",2022,"Everton","Premier League","Jonjoe Kenny","ENG","DF","24",1997,11.3,17,7,11,6,0,13,21,61.9,8,8,1,7,20,37,31,0,"https://fbref.com/en/players/099e666f/Jonjoe-Kenny"
"9115","Yerry Mina_2022",2022,"Everton","Premier League","Yerry Mina","COL","DF","26",1994,9.4,12,10,12,0,0,10,13,76.9,3,13,9,4,11,23,38,1,"https://fbref.com/en/players/6d5701f2/Yerry-Mina"
"9116","Vitaliy Mykolenko_2022",2022,"Everton","Premier League","Vitaliy Mykolenko","UKR","DF","22",1999,11.7,25,15,15,7,3,12,21,57.1,9,15,2,13,16,41,37,0,"https://fbref.com/en/players/30d4a2e5/Vitaliy-Mykolenko"
"9117","Tyler Onyango_2022",2022,"Everton","Premier League","Tyler Onyango","ENG","MF","18",2003,0.3,0,0,0,0,0,0,0,NA,0,0,0,0,0,0,1,0,"https://fbref.com/en/players/d86a1f3e/Tyler-Onyango"
"9118","Jordan Pickford_2022",2022,"Everton","Premier League","Jordan Pickford","ENG","GK","27",1994,35,1,1,1,0,0,0,1,0,1,1,0,1,1,2,14,1,"https://fbref.com/en/players/4806ec67/Jordan-Pickford"
"9119","Isaac Price_2022",2022,"Everton","Premier League","Isaac Price","NIR","MF","17",2003,0.2,0,0,0,0,0,0,0,NA,0,1,0,1,0,0,0,0,"https://fbref.com/en/players/b9403c99/Isaac-Price"
"9120","Richarlison_2022",2022,"Everton","Premier League","Richarlison","BRA","FW","24",1997,28,40,23,18,15,7,15,31,48.4,16,42,4,38,12,52,34,0,"https://fbref.com/en/players/fa031b34/Richarlison"
"9121","Salomón Rondón_2022",2022,"Everton","Premier League","Salomón Rondón","VEN","FW","31",1989,8.8,6,1,1,2,3,4,14,28.6,10,5,0,5,0,6,10,0,"https://fbref.com/en/players/b318a643/Salomon-Rondon"
"9122","Ellis Simms_2022",2022,"Everton","Premier League","Ellis Simms","ENG","FW","20",2001,0.7,0,0,0,0,0,0,0,NA,0,1,1,0,0,0,1,0,"https://fbref.com/en/players/26d3b5be/Ellis-Simms"
"9123","Cenk Tosun_2022",2022,"Everton","Premier League","Cenk Tosun","TUR","MF","30",1991,0.1,0,0,0,0,0,0,0,NA,0,0,0,0,0,0,0,0,"https://fbref.com/en/players/9a104dee/Cenk-Tosun"
"9124","Andros Townsend_2022",2022,"Everton","Premier League","Andros Townsend","ENG","MF,FW","30",1991,16.2,31,17,15,6,10,15,40,37.5,25,28,2,26,14,45,6,1,"https://fbref.com/en/players/b28bbd58/Andros-Townsend"
"9125","Sofyan Amrabat_2022",2022,"Fiorentina","Serie A","Sofyan Amrabat","MAR","MF","24",1996,10.5,24,13,9,13,2,11,19,57.9,8,25,8,17,5,29,6,1,"https://fbref.com/en/players/5a2cb25d/Sofyan-Amrabat"
"9126","Arthur_2022",2022,"Fiorentina","Serie A","Arthur","BRA","FW","23",1998,8.3,9,5,2,5,2,4,7,57.1,3,4,1,3,1,10,8,0,"https://fbref.com/en/players/a820e429/Arthur"
"9127","Marco Benassi_2022",2022,"Fiorentina","Serie A","Marco Benassi","ITA","DF,MF","26",1994,1.8,1,0,1,0,0,1,2,50,1,3,0,3,3,4,3,0,"https://fbref.com/en/players/0000acda/Marco-Benassi"
"9128","Cristiano Biraghi_2022",2022,"Fiorentina","Serie A","Cristiano Biraghi","ITA","DF","28",1992,35,37,24,17,15,5,22,53,41.5,31,28,10,18,19,56,31,1,"https://fbref.com/en/players/9e1577aa/Cristiano-Biraghi"
"9129","Giacomo Bonaventura_2022",2022,"Fiorentina","Serie A","Giacomo Bonaventura","ITA","MF","31",1989,25.2,33,17,12,16,5,21,46,45.7,25,20,2,18,14,47,9,1,"https://fbref.com/en/players/d995ed27/Giacomo-Bonaventura"
"9130","José Callejón_2022",2022,"Fiorentina","Serie A","José Callejón","ESP","FW","34",1987,14.4,15,6,6,6,3,13,31,41.9,18,6,0,6,3,18,1,1,"https://fbref.com/en/players/78841da9/Jose-Callejon"
"9131","Gaetano Castrovilli_2022",2022,"Fiorentina","Serie A","Gaetano Castrovilli","ITA","MF","24",1997,15.5,25,17,15,6,4,12,23,52.2,11,18,4,14,11,36,6,0,"https://fbref.com/en/players/0728bebe/Gaetano-Castrovilli"
"9132","Filippo Distefano_2022",2022,"Fiorentina","Serie A","Filippo Distefano","ITA","FW","17",2003,0,0,0,0,0,0,0,0,NA,0,0,0,0,0,0,0,0,"https://fbref.com/en/players/2110f96c/Filippo-Distefano"
"9133","Bartłomiej Drągowski_2022",2022,"Fiorentina","Serie A","Bartłomiej Drągowski","POL","GK","23",1997,6.2,0,0,0,0,0,0,0,NA,0,0,0,0,1,1,5,2,"https://fbref.com/en/players/085e71a7/Bartlomiej-Dragowski"
"9134","Alfred Duncan_2022",2022,"Fiorentina","Serie A","Alfred Duncan","GHA","MF","28",1993,21.5,34,19,13,16,5,11,32,34.4,21,32,3,29,10,44,7,0,"https://fbref.com/en/players/528492ea/Alfred-Duncan"
"9135","Nicolás González_2022",2022,"Fiorentina","Serie A","Nicolás González","ARG","FW","23",1998,26.2,21,16,6,8,7,9,28,32.1,19,26,2,24,21,42,4,1,"https://fbref.com/en/players/2374aaca/Nicolas-Gonzalez"
"9136","Igor_2022",2022,"Fiorentina","Serie A","Igor","BRA","DF","23",1998,24.9,53,31,34,16,3,30,40,75,10,37,19,18,31,84,46,4,"https://fbref.com/en/players/a4e85758/Igor"
"9137","Jonathan Ikone_2022",2022,"Fiorentina","Serie A","Jonathan Ikone","FRA","FW","23",1998,7.2,7,3,2,3,2,3,10,30,7,10,2,8,1,8,2,0,"https://fbref.com/en/players/42eaa028/Jonathan-Ikone"
"9138","Aleksandr Kokorin_2022",2022,"Fiorentina","Serie A","Aleksandr Kokorin","RUS","FW,MF","30",1991,0.6,1,1,1,0,0,0,0,NA,0,1,0,1,0,1,0,0,"https://fbref.com/en/players/fec5accc/Aleksandr-Kokorin"
"9139","Youssef Maleh_2022",2022,"Fiorentina","Serie A","Youssef Maleh","MAR","MF","22",1998,11.3,27,16,8,13,6,12,25,48,13,14,1,13,6,33,2,0,"https://fbref.com/en/players/4c8845f7/Youssef-Maleh"
"9140","Lucas Martínez Quarta_2022",2022,"Fiorentina","Serie A","Lucas Martínez Quarta","ARG","DF","25",1996,15.9,36,25,23,11,2,21,34,61.8,13,22,9,13,19,55,46,0,"https://fbref.com/en/players/3ec3c1c9/Lucas-Martinez-Quarta"
"9141","Nikola Milenković_2022",2022,"Fiorentina","Serie A","Nikola Milenković","SRB","DF","23",1997,32.5,54,32,31,20,3,29,34,85.3,5,30,15,15,39,93,94,0,"https://fbref.com/en/players/bee704fc/Nikola-Milenkovic"
"9142","Matija Nastasić_2022",2022,"Fiorentina","Serie A","Matija Nastasić","SRB","DF","28",1993,2.4,1,1,1,0,0,1,1,100,0,1,1,0,5,6,11,0,"https://fbref.com/en/players/f35430a4/Matija-Nastasic"
"9143","Álvaro Odriozola_2022",2022,"Fiorentina","Serie A","Álvaro Odriozola","ESP","DF","25",1995,19.3,25,15,12,6,7,15,32,46.9,17,17,6,11,8,33,25,2,"https://fbref.com/en/players/1d1691ad/Alvaro-Odriozola"
"9144","Krzysztof Piątek_2022",2022,"Fiorentina","Serie A","Krzysztof Piątek","POL","FW","26",1995,8.1,5,4,1,1,3,2,3,66.7,1,6,0,6,2,7,8,0,"https://fbref.com/en/players/17f3620a/Krzysztof-Piatek"
"9145","Erick Pulgar_2022",2022,"Fiorentina","Serie A","Erick Pulgar","CHI","MF","27",1994,3.8,6,6,4,2,0,4,9,44.4,5,5,1,4,5,11,2,1,"https://fbref.com/en/players/4611e028/Erick-Pulgar"
"9146","Riccardo Saponara_2022",2022,"Fiorentina","Serie A","Riccardo Saponara","ITA","FW","29",1991,14.3,10,2,1,6,3,6,16,37.5,10,5,0,5,1,11,3,0,"https://fbref.com/en/players/3bb7af3b/Riccardo-Saponara"
"9147","Riccardo Sottil_2022",2022,"Fiorentina","Serie A","Riccardo Sottil","ITA","FW","22",1999,13.8,9,4,4,4,1,3,9,33.3,6,3,0,3,1,10,2,0,"https://fbref.com/en/players/94816803/Riccardo-Sottil"
"9148","Pietro Terracciano_2022",2022,"Fiorentina","Serie A","Pietro Terracciano","ITA","GK","31",1990,31.8,0,0,0,0,0,0,4,0,4,0,0,0,2,2,20,1,"https://fbref.com/en/players/e1b0a70d/Pietro-Terracciano"
"9149","Aleksa Terzić_2022",2022,"Fiorentina","Serie A","Aleksa Terzić","SRB","DF","21",1999,3,8,5,3,3,2,4,7,57.1,3,7,0,7,4,12,5,0,"https://fbref.com/en/players/3ef0a2d7/Aleksa-Terzic"
"9150","Lucas Torreira_2022",2022,"Fiorentina","Serie A","Lucas Torreira","URU","MF","25",1996,24.4,37,29,13,21,3,18,40,45,22,18,1,17,26,63,18,0,"https://fbref.com/en/players/52611641/Lucas-Torreira"
"9151","Lorenzo Venuti_2022",2022,"Fiorentina","Serie A","Lorenzo Venuti","ITA","DF","26",1995,17.5,25,10,13,10,2,14,24,58.3,10,13,4,9,5,30,27,0,"https://fbref.com/en/players/983ff2c7/Lorenzo-Venuti"
"9152","Dušan Vlahović_2022",2022,"Fiorentina","Serie A","Dušan Vlahović","SRB","FW","21",2000,20.6,5,0,0,2,3,2,11,18.2,9,6,2,4,1,6,16,0,"https://fbref.com/en/players/79443529/Dusan-Vlahovic"
"9153","Ermedin Demirović_2022",2022,"Freiburg","Bundesliga","Ermedin Demirović","BIH","FW","23",1998,9.7,12,6,4,4,4,1,10,10,9,14,1,13,1,13,7,0,"https://fbref.com/en/players/ed79b7d3/Ermedin-Demirovic"
"9154","Maximilian Eggestein_2022",2022,"Freiburg","Bundesliga","Maximilian Eggestein","GER","MF","24",1996,24.4,48,28,17,25,6,22,50,44,28,35,11,24,30,78,32,1,"https://fbref.com/en/players/beb882a8/Maximilian-Eggestein"
"9155","Mark Flekken_2022",2022,"Freiburg","Bundesliga","Mark Flekken","NED","GK","28",1993,32,0,0,0,0,0,0,2,0,2,1,0,1,2,2,10,1,"https://fbref.com/en/players/a92ab7be/Mark-Flekken"
"9156","Vincenzo Grifo_2022",2022,"Freiburg","Bundesliga","Vincenzo Grifo","ITA","MF,FW","28",1993,30.8,27,15,9,13,5,9,26,34.6,17,12,2,10,13,40,28,0,"https://fbref.com/en/players/54e4866f/Vincenzo-Grifo"
"9157","Manuel Gulde_2022",2022,"Freiburg","Bundesliga","Manuel Gulde","GER","DF","30",1991,13.6,18,10,14,3,1,8,11,72.7,3,16,8,8,17,35,37,0,"https://fbref.com/en/players/25ab9c9c/Manuel-Gulde"
"9158","Christian Günter_2022",2022,"Freiburg","Bundesliga","Christian Günter","GER","DF,MF","28",1993,34,34,20,16,15,3,18,50,36,32,23,6,17,17,51,49,2,"https://fbref.com/en/players/8593f88c/Christian-Gunter"
"9159","Janik Haberer_2022",2022,"Freiburg","Bundesliga","Janik Haberer","GER","MF","27",1994,9.1,14,8,5,6,3,7,19,36.8,12,11,4,7,16,30,11,0,"https://fbref.com/en/players/70dcf94d/Janik-Haberer"
"9160","Dominique Heintz_2022",2022,"Freiburg","Bundesliga","Dominique Heintz","GER","DF","27",1993,0.3,0,0,0,0,0,0,0,NA,0,0,0,0,1,1,0,0,"https://fbref.com/en/players/699fb8db/Dominique-Heintz"
"9161","Nicolas Höfler_2022",2022,"Freiburg","Bundesliga","Nicolas Höfler","GER","MF","31",1990,28.9,73,42,37,29,7,28,62,45.2,34,50,21,29,46,119,42,0,"https://fbref.com/en/players/5d8e331f/Nicolas-Hofler"
"9162","Lucas Höler_2022",2022,"Freiburg","Bundesliga","Lucas Höler","GER","FW","27",1994,28.7,41,25,10,17,14,13,28,46.4,15,25,4,21,17,58,39,2,"https://fbref.com/en/players/ca618d23/Lucas-Holer"
"9163","Yannik Keitel_2022",2022,"Freiburg","Bundesliga","Yannik Keitel","GER","MF","21",2000,5.6,11,4,5,4,2,5,15,33.3,10,7,1,6,1,12,8,0,"https://fbref.com/en/players/d2c580ce/Yannik-Keitel"
"9164","Lukas Kübler_2022",2022,"Freiburg","Bundesliga","Lukas Kübler","GER","DF,MF","28",1992,25.9,62,35,38,16,8,28,49,57.1,21,24,8,16,44,106,70,0,"https://fbref.com/en/players/2a29eb9b/Lukas-Kubler"
"9165","Philipp Lienhart_2022",2022,"Freiburg","Bundesliga","Philipp Lienhart","AUT","DF","25",1996,31.9,24,13,17,6,1,13,24,54.2,11,33,23,10,50,74,158,1,"https://fbref.com/en/players/302527b2/Philipp-Lienhart"
"9166","Nils Petersen_2022",2022,"Freiburg","Bundesliga","Nils Petersen","GER","FW","32",1988,6.4,5,3,2,3,0,1,13,7.7,12,7,0,7,2,7,17,0,"https://fbref.com/en/players/f93e6e94/Nils-Petersen"
"9167","Roland Sallai_2022",2022,"Freiburg","Bundesliga","Roland Sallai","HUN","MF,FW","24",1997,17.2,22,16,8,11,3,7,23,30.4,16,12,0,12,11,33,12,0,"https://fbref.com/en/players/bf075f6b/Roland-Sallai"
"9168","Baptiste Santamaria_2022",2022,"Freiburg","Bundesliga","Baptiste Santamaria","FRA","MF","26",1995,0.2,0,0,0,0,0,0,1,0,1,0,0,0,1,1,1,0,"https://fbref.com/en/players/5e22e2a4/Baptiste-Santamaria"
"9169","Kevin Schade_2022",2022,"Freiburg","Bundesliga","Kevin Schade","GER","MF,FW","19",2001,9.2,9,7,6,2,1,3,10,30,7,15,3,12,3,12,16,0,"https://fbref.com/en/players/52afb588/Kevin-Schade"
"9170","Keven Schlotterbeck_2022",2022,"Freiburg","Bundesliga","Keven Schlotterbeck","GER","DF,FW","24",1997,3.5,11,5,6,5,0,5,6,83.3,1,7,4,3,11,22,24,1,"https://fbref.com/en/players/f6bdc830/Keven-Schlotterbeck"
"9171","Nico Schlotterbeck_2022",2022,"Freiburg","Bundesliga","Nico Schlotterbeck","GER","DF","21",1999,30.9,72,43,36,34,2,33,48,68.8,15,41,32,9,56,128,154,1,"https://fbref.com/en/players/34e12499/Nico-Schlotterbeck"
"9172","Jonathan Schmid_2022",2022,"Freiburg","Bundesliga","Jonathan Schmid","FRA","DF","31",1990,6.5,12,6,6,3,3,5,7,71.4,2,7,1,6,6,18,15,0,"https://fbref.com/en/players/088ca1bd/Jonathan-Schmid"
"9173","Kiliann Sildillia_2022",2022,"Freiburg","Bundesliga","Kiliann Sildillia","FRA","DF,MF","19",2002,1.9,7,3,3,4,0,3,6,50,3,1,0,1,2,9,7,1,"https://fbref.com/en/players/313254a3/Kiliann-Sildillia"
"9174","Hugo Siquet_2022",2022,"Freiburg","Bundesliga","Hugo Siquet","BEL","DF","19",2002,0.2,0,0,0,0,0,0,0,NA,0,0,0,0,0,0,0,0,"https://fbref.com/en/players/c6cf860f/Hugo-Siquet"
"9175","Benjamin Uphoff_2022",2022,"Freiburg","Bundesliga","Benjamin Uphoff","GER","GK","27",1993,2,0,0,0,0,0,0,0,NA,0,0,0,0,0,0,2,2,"https://fbref.com/en/players/a9a6fc08/Benjamin-Uphoff"
"9176","Vincent Vermeij_2022",2022,"Freiburg","Bundesliga","Vincent Vermeij","NED","MF","26",1994,0,0,0,0,0,0,0,0,NA,0,1,0,1,0,0,0,0,"https://fbref.com/en/players/7e629adc/Vincent-Vermeij"
"9177","Noah Weißhaupt_2022",2022,"Freiburg","Bundesliga","Noah Weißhaupt","GER","MF,FW","19",2001,1.1,1,1,1,0,0,1,2,50,1,2,0,2,1,2,1,1,"https://fbref.com/en/players/dd676a97/Noah-Weisshaupt"
"9178","Jeong Woo-yeong_2022",2022,"Freiburg","Bundesliga","Jeong Woo-yeong","KOR","FW,MF","21",1999,19.8,15,9,6,7,2,5,15,33.3,10,8,1,7,7,22,11,0,"https://fbref.com/en/players/6190474d/Jeong-Woo-yeong"
"9179","Nadiem Amiri_2022",2022,"Genoa","Serie A","Nadiem Amiri","GER","MF,FW","24",1996,7.6,6,4,2,2,2,2,9,22.2,7,7,0,7,0,6,0,0,"https://fbref.com/en/players/555d5edd/Nadiem-Amiri"
"9180","Milan Badelj_2022",2022,"Genoa","Serie A","Milan Badelj","CRO","MF","32",1989,31.6,64,37,25,30,9,34,80,42.5,46,39,7,32,85,149,43,0,"https://fbref.com/en/players/e8c930bb/Milan-Badelj"
"9181","Mattia Bani_2022",2022,"Genoa","Serie A","Mattia Bani","ITA","DF","27",1993,13.5,23,13,17,6,0,14,18,77.8,4,19,11,8,20,43,76,0,"https://fbref.com/en/players/0821331c/Mattia-Bani"
"9182","Valon Behrami_2022",2022,"Genoa","Serie A","Valon Behrami","SUI","MF,FW","36",1985,3.5,3,1,0,2,1,0,7,0,7,4,1,3,1,4,4,0,"https://fbref.com/en/players/d3d758d8/Valon-Behrami"
"9183","Davide Biraschi_2022",2022,"Genoa","Serie A","Davide Biraschi","ITA","DF","27",1994,10.3,31,16,19,9,3,17,24,70.8,7,16,9,7,16,47,26,0,"https://fbref.com/en/players/64cd167d/Davide-Biraschi"
"9184","Aleksander Buksa_2022",2022,"Genoa","Serie A","Aleksander Buksa","POL","FW","18",2003,0.7,0,0,0,0,0,0,1,0,1,0,0,0,0,0,1,0,"https://fbref.com/en/players/59f2d958/Aleksander-Buksa"
"9185","Felipe Caicedo_2022",2022,"Genoa","Serie A","Felipe Caicedo","ECU","FW","32",1988,3.2,3,3,0,2,1,0,1,0,1,1,0,1,0,3,4,0,"https://fbref.com/en/players/93b891d1/Felipe-Caicedo"
"9186","Riccardo Calafiori_2022",2022,"Genoa","Serie A","Riccardo Calafiori","ITA","DF","19",2002,0.9,1,0,0,0,1,1,2,50,1,2,1,1,2,3,4,0,"https://fbref.com/en/players/aded8e6f/Riccardo-Calafiori"
"9187","Andrea Cambiaso_2022",2022,"Genoa","Serie A","Andrea Cambiaso","ITA","DF","21",2000,19.9,46,20,28,14,4,18,32,56.3,14,33,8,25,23,69,37,1,"https://fbref.com/en/players/247ed022/Andrea-Cambiaso"
"9188","Francesco Cassata_2022",2022,"Genoa","Serie A","Francesco Cassata","ITA","MF","24",1997,0.1,0,0,0,0,0,0,0,NA,0,0,0,0,0,0,0,0,"https://fbref.com/en/players/96960855/Francesco-Cassata"
"9189","Domenico Criscito_2022",2022,"Genoa","Serie A","Domenico Criscito","ITA","DF","34",1986,18,37,21,19,14,4,16,25,64,9,22,12,10,39,76,57,0,"https://fbref.com/en/players/35dd6d80/Domenico-Criscito"
"9190","Mattia Destro_2022",2022,"Genoa","Serie A","Mattia Destro","ITA","FW","30",1991,19.4,9,4,1,4,4,1,6,16.7,5,14,1,13,2,11,16,0,"https://fbref.com/en/players/d7d32194/Mattia-Destro"
"9191","Caleb Ekuban_2022",2022,"Genoa","Serie A","Caleb Ekuban","GHA","FW,MF","27",1994,19.1,19,12,2,12,5,7,23,30.4,16,19,5,14,9,28,6,0,"https://fbref.com/en/players/7afbd2c3/Caleb-Ekuban"
"9192","Mohamed Fares_2022",2022,"Genoa","Serie A","Mohamed Fares","ALG","DF,FW","25",1996,6.5,4,2,1,3,0,0,4,0,4,8,3,5,8,12,11,0,"https://fbref.com/en/players/b7a5bc86/Mohamed-Fares"
"9193","Andrea Favilli_2022",2022,"Genoa","Serie A","Andrea Favilli","ITA","FW","24",1997,0.4,1,1,0,0,1,0,0,NA,0,0,0,0,0,1,2,0,"https://fbref.com/en/players/44510fde/Andrea-Favilli"
"9194","Morten Frendrup_2022",2022,"Genoa","Serie A","Morten Frendrup","DEN","DF,MF","20",2001,7.7,40,24,19,13,8,13,29,44.8,16,19,2,17,17,57,7,1,"https://fbref.com/en/players/f4d60499/Morten-Frendrup"
"9195","Pablo Galdames Millán_2022",2022,"Genoa","Serie A","Pablo Galdames Millán","CHI","MF","24",1996,11.4,28,12,6,16,6,12,35,34.3,23,16,2,14,8,36,9,1,"https://fbref.com/en/players/dd403465/Pablo-Galdames-Millan"
"9196","Paolo Ghiglione_2022",2022,"Genoa","Serie A","Paolo Ghiglione","ITA","DF","24",1997,6.7,17,12,8,6,3,9,14,64.3,5,11,5,6,10,27,12,1,"https://fbref.com/en/players/71dc23da/Paolo-Ghiglione"
"9197","Albert Guðmundsson_2022",2022,"Genoa","Serie A","Albert Guðmundsson","ISL","FW,MF","24",1997,6.7,5,3,2,1,2,3,8,37.5,5,2,0,2,5,10,4,0,"https://fbref.com/en/players/b79858d5/Albert-Gudmundsson"
"9198","Silvan Hefti_2022",2022,"Genoa","Serie A","Silvan Hefti","SUI","DF","23",1997,14.3,50,30,23,22,5,32,58,55.2,26,20,4,16,20,70,34,1,"https://fbref.com/en/players/f8342731/Silvan-Hefti"
"9199","Hernani_2022",2022,"Genoa","Serie A","Hernani","BRA","MF,FW","27",1994,7.6,20,10,8,9,3,13,32,40.6,19,17,4,13,13,33,5,1,"https://fbref.com/en/players/6f5ead86/Hernani"
"9200","Flavio Junior Bianchi_2022",2022,"Genoa","Serie A","Flavio Junior Bianchi","ITA","FW,MF","21",2000,3.5,2,2,1,0,1,0,2,0,2,0,0,0,0,2,0,0,"https://fbref.com/en/players/3ef965c1/Flavio-Junior-Bianchi"
"9201","Yayah Kallon_2022",2022,"Genoa","Serie A","Yayah Kallon","SLE","FW,MF","20",2001,7.1,15,11,5,6,4,3,11,27.3,8,7,1,6,1,16,5,0,"https://fbref.com/en/players/f95f49d2/Yayah-Kallon"
"9202","Nikola Maksimović_2022",2022,"Genoa","Serie A","Nikola Maksimović","SRB","DF","29",1991,12.4,14,6,10,4,0,7,9,77.8,2,17,11,6,12,26,61,1,"https://fbref.com/en/players/16b9d5cf/Nikola-Maksimovic"
"9203","Andrea Masiello_2022",2022,"Genoa","Serie A","Andrea Masiello","ITA","DF","35",1986,5.7,5,3,4,1,0,4,7,57.1,3,8,4,4,11,16,20,1,"https://fbref.com/en/players/e0314d87/Andrea-Masiello"
"9204","Filippo Melegoni_2022",2022,"Genoa","Serie A","Filippo Melegoni","ITA","MF,FW","22",1999,10.9,20,12,5,8,7,8,16,50,8,10,1,9,11,31,8,1,"https://fbref.com/en/players/6604165d/Filippo-Melegoni"
"9205","Goran Pandev_2022",2022,"Genoa","Serie A","Goran Pandev","MKD","FW,MF","38",1983,9.4,2,0,1,0,1,0,9,0,9,3,1,2,2,4,0,0,"https://fbref.com/en/players/d711d04f/Goran-Pandev"
"9206","Roberto Piccoli_2022",2022,"Genoa","Serie A","Roberto Piccoli","ITA","FW","20",2001,2.4,1,1,0,1,0,0,0,NA,0,0,0,0,1,2,1,1,"https://fbref.com/en/players/1cadaf34/Roberto-Piccoli"
"9207","Manolo Portanova_2022",2022,"Genoa","Serie A","Manolo Portanova","ITA","FW,MF","21",2000,14.7,46,28,9,26,11,14,34,41.2,20,26,2,24,17,63,22,0,"https://fbref.com/en/players/c8c0dccd/Manolo-Portanova"
"9208","Nicolò Rovella_2022",2022,"Genoa","Serie A","Nicolò Rovella","ITA","MF","19",2001,16.3,37,26,16,14,7,15,40,37.5,25,21,1,20,20,57,20,0,"https://fbref.com/en/players/e58cbfd5/Nicolo-Rovella"
"9209","Stefano Sabelli_2022",2022,"Genoa","Serie A","Stefano Sabelli","ITA","DF","28",1993,3.9,6,3,3,2,1,3,9,33.3,6,5,1,4,3,9,12,0,"https://fbref.com/en/players/0ccac09c/Stefano-Sabelli"
"9210","Adrian Šemper_2022",2022,"Genoa","Serie A","Adrian Šemper","CRO","GK","23",1998,1,0,0,0,0,0,0,0,NA,0,0,0,0,0,0,0,0,"https://fbref.com/en/players/f02dde20/Adrian-Semper"
"9211","Laurens Serpe_2022",2022,"Genoa","Serie A","Laurens Serpe","ITA","DF","20",2001,0.5,1,0,1,0,0,1,2,50,1,0,0,0,0,1,1,0,"https://fbref.com/en/players/79d60e74/Laurens-Serpe"
"9212","Salvatore Sirigu_2022",2022,"Genoa","Serie A","Salvatore Sirigu","ITA","GK","34",1987,37,1,1,1,0,0,1,2,50,1,0,0,0,0,1,19,2,"https://fbref.com/en/players/10dc46f0/Salvatore-Sirigu"
"9213","Leo Skiri Østigård_2022",2022,"Genoa","Serie A","Leo Skiri Østigård","NOR","DF","21",1999,13,16,9,8,7,1,9,11,81.8,2,17,10,7,8,24,55,1,"https://fbref.com/en/players/b35a7399/Leo-Skiri-Ostigard"
"9214","Stefano Sturaro_2022",2022,"Genoa","Serie A","Stefano Sturaro","ITA","MF","28",1993,19.6,43,26,16,16,11,22,48,45.8,26,25,1,24,15,58,29,2,"https://fbref.com/en/players/2334478a/Stefano-Sturaro"
"9215","Abdoulaye Touré_2022",2022,"Genoa","Serie A","Abdoulaye Touré","FRA","MF","27",1994,4.8,12,4,3,8,1,5,11,45.5,6,6,1,5,4,16,6,0,"https://fbref.com/en/players/ef7cd87a/Abdoulaye-Toure"
"9216","Zinho Vanheusden_2022",2022,"Genoa","Serie A","Zinho Vanheusden","BEL","DF","22",1999,11,18,6,12,5,1,8,14,57.1,6,19,14,5,23,41,42,0,"https://fbref.com/en/players/afbf187b/Zinho-Vanheusden"
"9217","Johan Vásquez_2022",2022,"Genoa","Serie A","Johan Vásquez","MEX","DF","22",1998,25.3,79,46,44,32,3,48,75,64,27,32,10,22,42,121,85,0,"https://fbref.com/en/players/5eaed77a/Johan-Vasquez"
"9218","Kelvin Yeboah_2022",2022,"Genoa","Serie A","Kelvin Yeboah","ITA","FW,MF","21",2000,9.4,14,7,5,7,2,9,19,47.4,10,22,1,21,1,15,7,0,"https://fbref.com/en/players/ea0893d6/Kelvin-Yeboah"
"9219","Carles Aleñá_2022",2022,"Getafe","La Liga","Carles Aleñá","ESP","MF","23",1998,25.8,27,19,11,13,3,9,48,18.8,39,21,2,19,15,42,16,0,"https://fbref.com/en/players/6c811eb7/Carles-Alena"
"9220","Emmanuel Amankwaa Akurugu_2022",2022,"Getafe","La Liga","Emmanuel Amankwaa Akurugu","GHA","DF","19",2001,0.9,0,0,0,0,0,0,2,0,2,1,0,1,0,0,0,0,"https://fbref.com/en/players/69c5633e/Emmanuel-Amankwaa-Akurugu"
"9221","Mauro Arambarri_2022",2022,"Getafe","La Liga","Mauro Arambarri","URU","MF","25",1995,29.6,62,37,19,32,11,20,68,29.4,48,35,5,30,32,94,18,0,"https://fbref.com/en/players/58afe001/Mauro-Arambarri"
"9222","Erick Cabaco_2022",2022,"Getafe","La Liga","Erick Cabaco","URU","DF","26",1995,4.5,2,1,1,1,0,2,5,40,3,5,2,3,4,6,10,0,"https://fbref.com/en/players/e7ab4179/Erick-Cabaco"
"9223","Chema_2022",2022,"Getafe","La Liga","Chema","ESP","MF","29",1992,0.5,0,0,0,0,0,0,1,0,1,0,0,0,0,0,0,0,"https://fbref.com/en/players/7f203b54/Chema"
"9224","Diego Conde_2022",2022,"Getafe","La Liga","Diego Conde","ESP","GK","22",1998,0.1,0,0,0,0,0,0,0,NA,0,0,0,0,0,0,0,0,"https://fbref.com/en/players/4eae5bc4/Diego-Conde"
"9225","Marc Cucurella_2022",2022,"Getafe","La Liga","Marc Cucurella","ESP","MF,DF","23",1998,0.3,0,0,0,0,0,0,0,NA,0,0,0,0,0,0,0,0,"https://fbref.com/en/players/1daec722/Marc-Cucurella"
"9226","Jorge Cuenca_2022",2022,"Getafe","La Liga","Jorge Cuenca","ESP","DF","21",1999,29.8,46,32,30,15,1,21,28,75,7,29,14,15,39,85,155,0,"https://fbref.com/en/players/0abc51f2/Jorge-Cuenca"
"9227","Djené_2022",2022,"Getafe","La Liga","Djené","TOG","DF","29",1991,34.6,44,26,24,16,4,23,34,67.6,11,24,5,19,59,103,109,2,"https://fbref.com/en/players/a4971d84/Djene"
"9228","Hugo Duro_2022",2022,"Getafe","La Liga","Hugo Duro","ESP","DF,MF","21",1999,0.1,0,0,0,0,0,0,0,NA,0,0,0,0,0,0,0,0,"https://fbref.com/en/players/37e103f8/Hugo-Duro"
"9229","Iglesias_2022",2022,"Getafe","La Liga","Iglesias","ESP","DF","23",1998,8,19,10,11,8,0,7,17,41.2,10,8,2,6,10,29,28,0,"https://fbref.com/en/players/974322dc/Iglesias"
"9230","Jakub Jankto_2022",2022,"Getafe","La Liga","Jakub Jankto","CZE","DF,MF","25",1996,6.5,11,7,5,5,1,10,17,58.8,7,4,0,4,4,15,7,0,"https://fbref.com/en/players/1ea5f91c/Jakub-Jankto"
"9231","José Juan Macías_2022",2022,"Getafe","La Liga","José Juan Macías","MEX","FW,MF","21",1999,2.2,1,0,0,0,1,0,1,0,1,1,0,1,1,2,0,0,"https://fbref.com/en/players/1f1c8a15/Jose-Juan-Macias"
"9232","Florentino Luís_2022",2022,"Getafe","La Liga","Florentino Luís","POR","MF","21",1999,11,42,25,22,17,3,17,35,48.6,18,21,2,19,21,63,11,1,"https://fbref.com/en/players/881cd6be/Florentino-Luis"
"9233","Nemanja Maksimović_2022",2022,"Getafe","La Liga","Nemanja Maksimović","SRB","MF","26",1995,32.6,56,32,24,26,6,18,49,36.7,31,42,13,29,71,127,41,0,"https://fbref.com/en/players/00b28772/Nemanja-Maksimovic"
"9234","Jaime Mata_2022",2022,"Getafe","La Liga","Jaime Mata","ESP","FW","32",1988,7.5,7,5,3,1,3,1,9,11.1,8,4,1,3,1,8,5,0,"https://fbref.com/en/players/02319ad7/Jaime-Mata"
"9235","Borja Mayoral_2022",2022,"Getafe","La Liga","Borja Mayoral","ESP","FW","24",1997,11.6,7,5,2,3,2,1,2,50,1,10,4,6,4,11,3,0,"https://fbref.com/en/players/64e8ed6d/Borja-Mayoral"
"9236","Stefan Mitrović_2022",2022,"Getafe","La Liga","Stefan Mitrović","SRB","DF","31",1990,29.6,16,8,12,4,0,8,13,61.5,5,28,18,10,22,38,114,1,"https://fbref.com/en/players/e6777e6b/Stefan-Mitrovic"
"9237","Allan Nyom_2022",2022,"Getafe","La Liga","Allan Nyom","CMR","DF","33",1988,2.7,3,1,2,1,0,2,2,100,0,2,1,1,2,5,7,0,"https://fbref.com/en/players/97572117/Allan-Nyom"
"9238","Mathías Olivera_2022",2022,"Getafe","La Liga","Mathías Olivera","URU","DF","23",1997,31.1,79,47,39,34,6,40,69,58,29,45,4,41,55,134,67,1,"https://fbref.com/en/players/41c12f75/Mathias-Olivera"
"9239","Darío Poveda_2022",2022,"Getafe","La Liga","Darío Poveda","ESP","FW,MF","24",1997,4.2,2,0,1,0,1,0,5,0,5,7,1,6,1,3,1,0,"https://fbref.com/en/players/cbdf7d5c/Dario-Poveda"
"9240","Sandro Ramírez_2022",2022,"Getafe","La Liga","Sandro Ramírez","ESP","FW","26",1995,16.2,7,3,1,3,3,1,12,8.3,11,14,3,11,2,9,3,0,"https://fbref.com/en/players/833fb62e/Sandro-Ramirez"
"9241","Óscar Rodríguez Arnaiz_2022",2022,"Getafe","La Liga","Óscar Rodríguez Arnaiz","ESP","MF,FW","23",1998,10.5,16,11,6,8,2,4,12,33.3,8,7,1,6,11,27,6,0,"https://fbref.com/en/players/19709006/Oscar-Rodriguez-Arnaiz"
"9242","Jonathan Silva_2022",2022,"Getafe","La Liga","Jonathan Silva","ARG","DF,FW","27",1994,2.5,10,8,4,4,2,7,12,58.3,5,4,0,4,3,13,7,0,"https://fbref.com/en/players/f2308b33/Jonathan-Silva"
"9243","David Soria_2022",2022,"Getafe","La Liga","David Soria","ESP","GK","28",1993,37.9,1,0,1,0,0,1,2,50,1,0,0,0,0,1,22,2,"https://fbref.com/en/players/8f8c6934/David-Soria"
"9244","Damián Suárez_2022",2022,"Getafe","La Liga","Damián Suárez","URU","DF","33",1988,30.1,74,47,34,30,10,42,91,46.2,49,46,5,41,31,105,30,0,"https://fbref.com/en/players/ba5004e1/Damian-Suarez"
"9245","David Timor_2022",2022,"Getafe","La Liga","David Timor","ESP","MF","31",1989,3.8,1,1,1,0,0,0,3,0,3,3,2,1,1,2,4,1,"https://fbref.com/en/players/174651c8/David-Timor"
"9246","Enes Ünal_2022",2022,"Getafe","La Liga","Enes Ünal","TUR","FW","24",1997,31.1,37,22,2,18,17,5,42,11.9,37,25,5,20,5,42,36,0,"https://fbref.com/en/players/f8eca1b6/Enes-Unal"
"9247","Gonzalo Villar_2022",2022,"Getafe","La Liga","Gonzalo Villar","ESP","MF","23",1998,3.3,5,3,4,1,0,2,5,40,3,4,1,3,1,6,1,0,"https://fbref.com/en/players/bdc74a8f/Gonzalo-Villar"
"9248","Vitolo_2022",2022,"Getafe","La Liga","Vitolo","ESP","MF","31",1989,2.5,3,2,1,1,1,2,5,40,3,3,0,3,1,4,1,0,"https://fbref.com/en/players/db750822/Vitolo"
"9249","Okay Yokuşlu_2022",2022,"Getafe","La Liga","Okay Yokuşlu","TUR","DF,MF","27",1994,5.2,9,8,6,2,1,5,5,100,0,7,5,2,5,14,17,0,"https://fbref.com/en/players/e49ce451/Okay-Yokuslu"
"9250","Luis Abram_2022",2022,"Granada","La Liga","Luis Abram","PER","DF","25",1996,6.2,6,3,3,3,0,2,4,50,2,6,5,1,5,11,37,1,"https://fbref.com/en/players/1f462f95/Luis-Abram"
"9251","Matias Arezo_2022",2022,"Granada","La Liga","Matias Arezo","URU","FW,MF","18",2002,1.8,5,3,2,1,2,4,9,44.4,5,1,0,1,1,6,1,0,"https://fbref.com/en/players/484ebdb0/Matias-Arezo"
"9252","Santiago Arias_2022",2022,"Granada","La Liga","Santiago Arias","COL","DF","29",1992,4.9,12,5,8,3,1,4,9,44.4,5,8,4,4,5,17,10,0,"https://fbref.com/en/players/fdd60087/Santiago-Arias"
"9253","Carlos Bacca_2022",2022,"Granada","La Liga","Carlos Bacca","COL","FW","34",1986,5.7,4,4,2,0,2,0,3,0,3,5,0,5,1,5,5,0,"https://fbref.com/en/players/09a9e921/Carlos-Bacca"
"9254","Barcia_2022",2022,"Granada","La Liga","Barcia","ESP","DF","20",2000,0.8,0,0,0,0,0,0,0,NA,0,1,1,0,1,1,0,1,"https://fbref.com/en/players/0c717ae6/Barcia"
"9255","Yan Brice Eteki_2022",2022,"Granada","La Liga","Yan Brice Eteki","CMR","MF","23",1997,3.8,6,3,3,2,1,3,7,42.9,4,7,3,4,4,10,6,1,"https://fbref.com/en/players/3d688b46/Yan-Brice-Eteki"
"9256","Adrián Butzke_2022",2022,"Granada","La Liga","Adrián Butzke","ESP","FW","22",1999,0,0,0,0,0,0,0,0,NA,0,0,0,0,0,0,0,0,"https://fbref.com/en/players/505dce2b/Adrian-Butzke"
"9257","Álex Collado_2022",2022,"Granada","La Liga","Álex Collado","ESP","MF,FW","22",1999,11.3,27,12,6,16,5,12,31,38.7,19,28,2,26,6,33,11,0,"https://fbref.com/en/players/85dace26/Alex-Collado"
"9258","Víctor Díaz_2022",2022,"Granada","La Liga","Víctor Díaz","ESP","DF","33",1988,16.7,23,15,14,9,0,12,25,48,13,19,11,8,17,40,71,1,"https://fbref.com/en/players/3624ce4c/Victor-Diaz"
"9259","Domingos Duarte_2022",2022,"Granada","La Liga","Domingos Duarte","POR","DF","26",1995,18.7,18,14,9,9,0,6,11,54.5,5,27,20,7,22,40,82,0,"https://fbref.com/en/players/93090f69/Domingos-Duarte"
"9260","Aarón Escandell_2022",2022,"Granada","La Liga","Aarón Escandell","ESP","GK","25",1995,3.2,0,0,0,0,0,0,1,0,1,0,0,0,0,0,4,0,"https://fbref.com/en/players/67669ce7/Aaron-Escandell"
"9261","Sergio Escudero_2022",2022,"Granada","La Liga","Sergio Escudero","ESP","DF,MF","31",1989,15.9,46,24,25,17,4,26,54,48.1,28,18,3,15,26,72,35,0,"https://fbref.com/en/players/b0616e3d/Sergio-Escudero"
"9262","Dimitri Foulquier_2022",2022,"Granada","La Liga","Dimitri Foulquier","FRA","DF","28",1993,2,0,0,0,0,0,0,1,0,1,2,1,1,1,1,2,0,"https://fbref.com/en/players/45e17712/Dimitri-Foulquier"
"9263","Maxime Gonalons_2022",2022,"Granada","La Liga","Maxime Gonalons","FRA","MF","32",1989,17.2,43,28,17,22,4,14,39,35.9,25,33,10,23,18,61,29,0,"https://fbref.com/en/players/b8c1de25/Maxime-Gonalons"
"9264","Luis Javier Suárez_2022",2022,"Granada","La Liga","Luis Javier Suárez","COL","FW","23",1997,31.6,26,14,9,9,8,8,27,29.6,19,25,3,22,6,32,23,0,"https://fbref.com/en/players/eeba07f8/Luis-Javier-Suarez"
"9265","Darwin Machís_2022",2022,"Granada","La Liga","Darwin Machís","VEN","MF,FW","28",1993,15.3,23,13,11,8,4,9,23,39.1,14,10,0,10,15,38,17,0,"https://fbref.com/en/players/ed6ea4d9/Darwin-Machis"
"9266","Luís Maximiano_2022",2022,"Granada","La Liga","Luís Maximiano","POR","GK","22",1999,34.8,3,1,3,0,0,3,6,50,3,0,0,0,1,4,16,2,"https://fbref.com/en/players/3318286e/Luis-Maximiano"
"9267","Luis Milla_2022",2022,"Granada","La Liga","Luis Milla","ESP","MF","26",1994,30.8,59,29,25,30,4,25,64,39.1,39,28,4,24,25,84,34,0,"https://fbref.com/en/players/19c36442/Luis-Milla"
"9268","Jorge Molina_2022",2022,"Granada","La Liga","Jorge Molina","ESP","FW","39",1982,21.8,4,2,2,1,1,2,18,11.1,16,13,2,11,6,10,11,0,"https://fbref.com/en/players/43f71e77/Jorge-Molina"
"9269","Monchu_2022",2022,"Granada","La Liga","Monchu","ESP","MF","21",1999,7.4,15,6,5,9,1,5,10,50,5,8,3,5,4,19,4,0,"https://fbref.com/en/players/8ac501f5/Monchu"
"9270","Ángel Montoro_2022",2022,"Granada","La Liga","Ángel Montoro","ESP","MF","33",1988,14.8,26,13,16,7,3,17,27,63,10,11,1,10,11,37,29,1,"https://fbref.com/en/players/719384c1/Angel-Montoro"
"9271","Carlos Neva_2022",2022,"Granada","La Liga","Carlos Neva","ESP","DF","25",1996,23.4,31,19,24,7,0,16,28,57.1,12,27,9,18,32,63,81,0,"https://fbref.com/en/players/8d47bb39/Carlos-Neva"
"9272","Njegoš Petrović_2022",2022,"Granada","La Liga","Njegoš Petrović","SRB","MF","22",1999,10.2,24,11,4,19,1,8,14,57.1,6,16,4,12,9,33,11,0,"https://fbref.com/en/players/0cb29e91/Njegos-Petrovic"
"9273","Antonio Puertas_2022",2022,"Granada","La Liga","Antonio Puertas","ESP","MF,FW","29",1992,25.1,34,20,18,12,4,17,44,38.6,27,33,3,30,11,45,36,0,"https://fbref.com/en/players/c77a8043/Antonio-Puertas"
"9274","Quini_2022",2022,"Granada","La Liga","Quini","ESP","DF","31",1989,25.6,73,34,48,21,4,42,79,53.2,37,28,10,18,36,109,62,0,"https://fbref.com/en/players/7a538238/Quini"
"9275","Dani Raba_2022",2022,"Granada","La Liga","Dani Raba","ESP","MF,FW","25",1995,0.3,2,2,1,0,1,2,3,66.7,1,0,0,0,1,3,0,0,"https://fbref.com/en/players/ea6a7ab4/Dani-Raba"
"9276","Rubén Rochina_2022",2022,"Granada","La Liga","Rubén Rochina","ESP","MF,FW","30",1991,8.3,21,13,7,8,6,8,28,28.6,20,11,1,10,6,27,5,1,"https://fbref.com/en/players/ecd8c01e/Ruben-Rochina"
"9277","Isma Ruiz_2022",2022,"Granada","La Liga","Isma Ruiz","ESP","MF","20",2001,3.1,3,1,3,0,0,1,9,11.1,8,5,2,3,3,6,2,0,"https://fbref.com/en/players/6e36226f/Isma-Ruiz"
"9278","Germán Sánchez_2022",2022,"Granada","La Liga","Germán Sánchez","ESP","DF","34",1986,25.5,27,19,18,9,0,11,20,55,9,19,16,3,28,55,137,0,"https://fbref.com/en/players/ea9b2ef9/German-Sanchez"
"9279","Alberto Soro_2022",2022,"Granada","La Liga","Alberto Soro","ESP","MF,FW","22",1999,6.4,12,10,3,6,3,1,7,14.3,6,21,2,19,3,15,4,0,"https://fbref.com/en/players/452c3055/Alberto-Soro"
"9280","Raúl Torrente_2022",2022,"Granada","La Liga","Raúl Torrente","ESP","DF","19",2001,14.2,31,21,18,11,2,16,29,55.2,13,14,9,5,12,43,69,0,"https://fbref.com/en/players/4d753a3f/Raul-Torrente"
"9281","Myrto Uzuni_2022",2022,"Granada","La Liga","Myrto Uzuni","ALB","FW,MF","26",1995,9.5,7,4,6,1,0,0,2,0,2,13,1,12,10,17,7,0,"https://fbref.com/en/players/01da7812/Myrto-Uzuni"
"9282","Dickson Abiama_2022",2022,"Greuther Fürth","Bundesliga","Dickson Abiama","NGA","FW","22",1998,8.1,11,7,4,5,2,2,10,20,8,12,1,11,4,15,8,0,"https://fbref.com/en/players/cadd666a/Dickson-Abiama"
"9283","Simon Asta_2022",2022,"Greuther Fürth","Bundesliga","Simon Asta","GER","DF","20",2001,8.7,13,6,4,5,4,4,8,50,4,14,2,12,8,21,16,0,"https://fbref.com/en/players/dfc85b89/Simon-Asta"
"9284","Abdourahmane Barry_2022",2022,"Greuther Fürth","Bundesliga","Abdourahmane Barry","FRA","DF","21",2000,2.3,6,4,3,3,0,5,7,71.4,2,5,2,3,4,10,1,0,"https://fbref.com/en/players/8df328f4/Abdourahmane-Barry"
"9285","Maximilian Bauer_2022",2022,"Greuther Fürth","Bundesliga","Maximilian Bauer","GER","DF","21",2000,18.8,28,15,17,10,1,11,28,39.3,17,24,14,10,29,57,99,0,"https://fbref.com/en/players/44a20f0c/Maximilian-Bauer"
"9286","Sascha Burchert_2022",2022,"Greuther Fürth","Bundesliga","Sascha Burchert","GER","GK","31",1989,14,1,1,1,0,0,1,2,50,1,0,0,0,0,1,11,1,"https://fbref.com/en/players/25bdea4b/Sascha-Burchert"
"9287","Max Christiansen_2022",2022,"Greuther Fürth","Bundesliga","Max Christiansen","GER","MF","24",1996,22.8,46,25,19,22,5,18,43,41.9,25,52,16,36,68,114,56,0,"https://fbref.com/en/players/e7b899b8/Max-Christiansen"
"9288","Jeremy Dudziak_2022",2022,"Greuther Fürth","Bundesliga","Jeremy Dudziak","TUN","MF,FW","25",1995,12.6,17,6,5,8,4,3,14,21.4,11,8,0,8,10,27,4,0,"https://fbref.com/en/players/5a8d6540/Jeremy-Dudziak"
"9289","Adrian Fein_2022",2022,"Greuther Fürth","Bundesliga","Adrian Fein","GER","MF","22",1999,0.4,0,0,0,0,0,0,1,0,1,0,0,0,2,2,0,0,"https://fbref.com/en/players/60097ff6/Adrian-Fein"
"9290","Marius Funk_2022",2022,"Greuther Fürth","Bundesliga","Marius Funk","GER","GK","25",1996,8,0,0,0,0,0,0,0,NA,0,0,0,0,0,0,8,1,"https://fbref.com/en/players/86314793/Marius-Funk"
"9291","Julian Green_2022",2022,"Greuther Fürth","Bundesliga","Julian Green","USA","MF","26",1995,11.7,9,5,0,8,1,2,8,25,6,10,2,8,7,16,10,0,"https://fbref.com/en/players/ad1d6fa4/Julian-Green"
"9292","Sebastian Griesbeck_2022",2022,"Greuther Fürth","Bundesliga","Sebastian Griesbeck","GER","DF,MF","30",1990,27.1,60,31,38,19,3,39,62,62.9,23,38,13,25,43,103,100,1,"https://fbref.com/en/players/a8db7ebb/Sebastian-Griesbeck"
"9293","Justin Hoogma_2022",2022,"Greuther Fürth","Bundesliga","Justin Hoogma","NED","DF","23",1998,3,6,5,4,2,0,4,6,66.7,2,5,5,0,4,10,4,0,"https://fbref.com/en/players/816192f0/Justin-Hoogma"
"9294","Branimir Hrgota_2022",2022,"Greuther Fürth","Bundesliga","Branimir Hrgota","SWE","FW","28",1993,30.9,46,29,10,31,5,21,72,29.2,51,27,1,26,11,57,3,1,"https://fbref.com/en/players/710fbdd1/Branimir-Hrgota"
"9295","Cedric Itten_2022",2022,"Greuther Fürth","Bundesliga","Cedric Itten","SUI","FW","24",1996,7.1,5,2,1,2,2,1,6,16.7,5,3,0,3,2,7,4,0,"https://fbref.com/en/players/ef233486/Cedric-Itten"
"9296","Gian-Luca Itter_2022",2022,"Greuther Fürth","Bundesliga","Gian-Luca Itter","GER","DF","22",1999,16.2,44,26,30,11,3,21,38,55.3,17,24,9,15,13,57,51,0,"https://fbref.com/en/players/e6c15f6e/Gian-Luca-Itter"
"9297","Gideon Jung_2022",2022,"Greuther Fürth","Bundesliga","Gideon Jung","GER","DF","26",1994,1.6,3,1,1,2,0,2,4,50,2,1,1,0,2,5,5,0,"https://fbref.com/en/players/a2e7de6f/Gideon-Jung"
"9298","Jamie Leweling_2022",2022,"Greuther Fürth","Bundesliga","Jamie Leweling","GER","FW,MF","20",2001,21.8,13,8,3,7,3,3,16,18.8,13,9,0,9,13,26,5,0,"https://fbref.com/en/players/13fe7b69/Jamie-Leweling"
"9299","Andreas Linde_2022",2022,"Greuther Fürth","Bundesliga","Andreas Linde","SWE","GK","28",1993,12,0,0,0,0,0,0,0,NA,0,0,0,0,1,1,1,1,"https://fbref.com/en/players/4d6a842d/Andreas-Linde"
"9300","Marco Meyerhöfer_2022",2022,"Greuther Fürth","Bundesliga","Marco Meyerhöfer","GER","DF","25",1995,25.3,53,35,22,22,9,24,37,64.9,13,38,19,19,47,100,64,1,"https://fbref.com/en/players/0b104510/Marco-Meyerhofer"
"9301","Jessic Ngankam_2022",2022,"Greuther Fürth","Bundesliga","Jessic Ngankam","GER","FW","21",2000,3.8,3,1,1,1,1,1,2,50,1,3,0,3,0,3,1,0,"https://fbref.com/en/players/bc249af8/Jessic-Ngankam"
"9302","Håvard Nielsen_2022",2022,"Greuther Fürth","Bundesliga","Håvard Nielsen","NOR","MF,FW","28",1993,15.2,17,12,5,11,1,8,21,38.1,13,18,1,17,7,24,22,0,"https://fbref.com/en/players/b18ef366/Havard-Nielsen"
"9303","Hans Nunoo Sarpei_2022",2022,"Greuther Fürth","Bundesliga","Hans Nunoo Sarpei","GHA","DF,MF","22",1998,7.1,16,11,9,7,0,10,14,71.4,4,8,5,3,14,30,21,0,"https://fbref.com/en/players/9593331d/Hans-Nunoo-Sarpei"
"9304","Afimico Pululu_2022",2022,"Greuther Fürth","Bundesliga","Afimico Pululu","FRA","FW,MF","22",1999,0.8,1,0,1,0,0,1,2,50,1,1,0,1,0,1,0,0,"https://fbref.com/en/players/32c016f8/Afimico-Pululu"
"9305","Tobias Raschl_2022",2022,"Greuther Fürth","Bundesliga","Tobias Raschl","GER","MF","21",2000,6.6,12,9,4,8,0,5,7,71.4,2,10,1,9,3,15,1,0,"https://fbref.com/en/players/bd992863/Tobias-Raschl"
"9306","Paul Seguin_2022",2022,"Greuther Fürth","Bundesliga","Paul Seguin","GER","MF","26",1995,23.4,50,31,15,32,3,26,56,46.4,30,27,3,24,19,69,30,1,"https://fbref.com/en/players/8872ed17/Paul-Seguin"
"9307","Nils Seufert_2022",2022,"Greuther Fürth","Bundesliga","Nils Seufert","GER","MF","24",1997,1.1,3,2,1,1,1,0,1,0,1,0,0,0,0,3,0,0,"https://fbref.com/en/players/0da32a38/Nils-Seufert"
"9308","Timothy Tillman_2022",2022,"Greuther Fürth","Bundesliga","Timothy Tillman","GER","MF","22",1999,22.3,43,26,17,18,8,19,42,45.2,23,33,4,29,12,55,26,0,"https://fbref.com/en/players/a5bea1fb/Timothy-Tillman"
"9309","Nick Viergever_2022",2022,"Greuther Fürth","Bundesliga","Nick Viergever","NED","DF","31",1989,23.7,32,23,25,7,0,24,34,70.6,10,31,22,9,37,69,119,1,"https://fbref.com/en/players/e38f1636/Nick-Viergever"
"9310","Jetro Willems_2022",2022,"Greuther Fürth","Bundesliga","Jetro Willems","NED","DF","27",1994,17.8,30,15,18,10,2,15,26,57.7,11,15,3,12,14,44,42,0,"https://fbref.com/en/players/9050ddc4/Jetro-Willems"
"9311","Antonín Barák_2022",2022,"Hellas Verona","Serie A","Antonín Barák","CZE","MF,FW","26",1994,26,18,8,9,8,1,5,17,29.4,12,32,5,27,6,24,26,0,"https://fbref.com/en/players/01efac19/Antonin-Barak"
"9312","Alessandro Berardi_2022",2022,"Hellas Verona","Serie A","Alessandro Berardi","ITA","GK","30",1991,1,0,0,0,0,0,0,0,NA,0,0,0,0,0,0,0,0,"https://fbref.com/en/players/ec1f737d/Alessandro-Berardi"
"9313","Daniel Bessa_2022",2022,"Hellas Verona","Serie A","Daniel Bessa","ITA","MF","28",1993,8.5,7,2,3,3,1,4,15,26.7,11,13,3,10,5,12,11,0,"https://fbref.com/en/players/88895312/Daniel-Bessa"
"9314","Matteo Cancellieri_2022",2022,"Hellas Verona","Serie A","Matteo Cancellieri","ITA","MF,DF","19",2002,2.5,4,4,2,2,0,0,5,0,5,2,0,2,1,5,0,0,"https://fbref.com/en/players/b6a1cdf9/Matteo-Cancellieri"
"9315","Gianluca Caprari_2022",2022,"Hellas Verona","Serie A","Gianluca Caprari","ITA","MF,FW","28",1993,30.4,43,25,10,22,11,17,51,33.3,34,32,0,32,4,47,7,0,"https://fbref.com/en/players/54e53b7e/Gianluca-Caprari"
"9316","Nicolò Casale_2022",2022,"Hellas Verona","Serie A","Nicolò Casale","ITA","DF","23",1998,28.7,46,30,25,19,2,21,37,56.8,16,31,12,19,49,95,95,0,"https://fbref.com/en/players/3f5f38fb/Nicolo-Casale"
"9317","Federico Ceccherini_2022",2022,"Hellas Verona","Serie A","Federico Ceccherini","ITA","DF","29",1992,26.2,32,16,19,10,3,19,33,57.6,14,13,8,5,50,82,76,1,"https://fbref.com/en/players/d9624b51/Federico-Ceccherini"
"9318","Diego Coppola_2022",2022,"Hellas Verona","Serie A","Diego Coppola","ITA","DF","17",2003,2.8,8,4,4,4,0,3,3,100,0,5,1,4,4,12,5,0,"https://fbref.com/en/players/22ae86f9/Diego-Coppola"
"9319","Paweł Dawidowicz_2022",2022,"Hellas Verona","Serie A","Paweł Dawidowicz","POL","DF","26",1995,13.3,30,18,16,10,4,16,25,64,9,14,11,3,21,51,53,0,"https://fbref.com/en/players/16bb656a/Pawel-Dawidowicz"
"9320","Fabio Depaoli_2022",2022,"Hellas Verona","Serie A","Fabio Depaoli","ITA","DF","24",1997,7.8,12,7,6,4,2,1,7,14.3,6,9,2,7,8,20,14,0,"https://fbref.com/en/players/d97f2e8d/Fabio-Depaoli"
"9321","Samuel Di Carmine_2022",2022,"Hellas Verona","Serie A","Samuel Di Carmine","ITA","FW","32",1988,0.4,0,0,0,0,0,0,0,NA,0,0,0,0,0,0,0,0,"https://fbref.com/en/players/ef94dc2f/Samuel-Di-Carmine"
"9322","Davide Faraoni_2022",2022,"Hellas Verona","Serie A","Davide Faraoni","ITA","DF","29",1991,28.6,62,40,38,21,3,29,62,46.8,33,38,5,33,23,85,62,1,"https://fbref.com/en/players/aae9d04a/Davide-Faraoni"
"9323","Gianluca Frabotta_2022",2022,"Hellas Verona","Serie A","Gianluca Frabotta","ITA","DF,MF","22",1999,0.2,0,0,0,0,0,0,1,0,1,1,0,1,1,1,0,0,"https://fbref.com/en/players/d80b1835/Gianluca-Frabotta"
"9324","Koray Günter_2022",2022,"Hellas Verona","Serie A","Koray Günter","GER","DF","26",1994,26.8,32,18,19,11,2,16,32,50,16,27,21,6,69,101,110,1,"https://fbref.com/en/players/f1f1f238/Koray-Gunter"
"9325","Martin Hongla_2022",2022,"Hellas Verona","Serie A","Martin Hongla","CMR","MF","23",1998,7.2,14,8,5,6,3,4,8,50,4,6,2,4,4,18,16,1,"https://fbref.com/en/players/b85bf253/Martin-Hongla"
"9326","Ivan Ilić_2022",2022,"Hellas Verona","Serie A","Ivan Ilić","SRB","MF","20",2001,28.1,39,18,16,19,4,20,54,37,34,34,12,22,22,61,55,0,"https://fbref.com/en/players/bb376bed/Ivan-Ilic"
"9327","Nikola Kalinić_2022",2022,"Hellas Verona","Serie A","Nikola Kalinić","CRO","FW","33",1988,4.5,2,0,0,1,1,1,2,50,1,2,0,2,0,2,2,0,"https://fbref.com/en/players/d4931a5a/Nikola-Kalinic"
"9328","Kevin Lasagna_2022",2022,"Hellas Verona","Serie A","Kevin Lasagna","ITA","MF,FW","28",1992,13.2,13,7,4,5,4,4,15,26.7,11,16,0,16,3,16,7,0,"https://fbref.com/en/players/09538fdb/Kevin-Lasagna"
"9329","Darko Lazović_2022",2022,"Hellas Verona","Serie A","Darko Lazović","SRB","DF","30",1990,30.7,36,23,20,8,8,21,39,53.8,18,28,4,24,19,55,49,1,"https://fbref.com/en/players/5128bde4/Darko-Lazovic"
"9330","Giangiacomo Magnani_2022",2022,"Hellas Verona","Serie A","Giangiacomo Magnani","ITA","DF","25",1995,5.9,10,7,5,5,0,8,16,50,8,5,3,2,10,20,46,0,"https://fbref.com/en/players/cce9f582/Giangiacomo-Magnani"
"9331","Yıldırım Mert Çetin_2022",2022,"Hellas Verona","Serie A","Yıldırım Mert Çetin","TUR","MF","24",1997,0.5,1,0,1,0,0,1,1,100,0,0,0,0,0,1,2,0,"https://fbref.com/en/players/c730da00/Yildirim-Mert-Cetin"
"9332","Lorenzo Montipò_2022",2022,"Hellas Verona","Serie A","Lorenzo Montipò","ITA","GK","25",1996,34,0,0,0,0,0,0,0,NA,0,0,0,0,1,1,16,3,"https://fbref.com/en/players/c1d95617/Lorenzo-Montipo"
"9333","Ivor Pandur_2022",2022,"Hellas Verona","Serie A","Ivor Pandur","CRO","GK","21",2000,3,0,0,0,0,0,0,0,NA,0,0,0,0,0,0,2,0,"https://fbref.com/en/players/457cb02f/Ivor-Pandur"
"9334","Mateusz Praszelik_2022",2022,"Hellas Verona","Serie A","Mateusz Praszelik","POL","MF","20",2000,0.3,0,0,0,0,0,0,0,NA,0,0,0,0,0,0,0,0,"https://fbref.com/en/players/ec6773f5/Mateusz-Praszelik"
"9335","Panagiotis Retsos_2022",2022,"Hellas Verona","Serie A","Panagiotis Retsos","GRE","DF","22",1998,0.6,0,0,0,0,0,0,2,0,2,0,0,0,2,2,3,0,"https://fbref.com/en/players/4bd00a50/Panagiotis-Retsos"
"9336","Giovanni Simeone_2022",2022,"Hellas Verona","Serie A","Giovanni Simeone","ARG","FW","26",1995,29.5,27,15,6,12,9,9,39,23.1,30,37,3,34,6,33,23,0,"https://fbref.com/en/players/343c0d52/Giovanni-Simeone"
"9337","Bosko Sutalo_2022",2022,"Hellas Verona","Serie A","Bosko Sutalo","CRO","DF","21",2000,10.2,20,13,11,6,3,8,16,50,8,10,5,5,17,37,39,0,"https://fbref.com/en/players/1d0bb7e4/Bosko-Sutalo"
"9338","Adrien Tameze_2022",2022,"Hellas Verona","Serie A","Adrien Tameze","CMR","MF,DF","27",1994,28.6,52,29,24,21,7,20,59,33.9,39,40,5,35,52,104,41,0,"https://fbref.com/en/players/8da74c05/Adrien-Tameze"
"9339","Filippo Terracciano_2022",2022,"Hellas Verona","Serie A","Filippo Terracciano","ITA","DF","18",2003,0.1,0,0,0,0,0,0,0,NA,0,0,0,0,0,0,1,0,"https://fbref.com/en/players/5cbb5ad6/Filippo-Terracciano"
"9340","Miguel Veloso_2022",2022,"Hellas Verona","Serie A","Miguel Veloso","POR","MF","35",1986,14.9,23,15,4,17,2,10,16,62.5,6,18,5,13,11,34,18,1,"https://fbref.com/en/players/ab1ca213/Miguel-Veloso"
"9341","Mattia Zaccagni_2022",2022,"Hellas Verona","Serie A","Mattia Zaccagni","ITA","MF","26",1995,2,3,1,1,0,2,1,2,50,1,1,0,1,4,7,0,0,"https://fbref.com/en/players/d85c238b/Mattia-Zaccagni"
"9342","Fredrik André Bjørkan_2022",2022,"Hertha BSC","Bundesliga","Fredrik André Bjørkan","NOR","DF","22",1998,3.9,12,10,7,4,1,7,9,77.8,2,6,2,4,6,18,8,0,"https://fbref.com/en/players/3724baa1/Fredrik-Andre-Bjorkan"
"9343","Santiago Ascacíbar_2022",2022,"Hertha BSC","Bundesliga","Santiago Ascacíbar","ARG","MF","24",1997,26.4,93,54,50,37,6,38,89,42.7,51,31,6,25,41,134,42,0,"https://fbref.com/en/players/e26fcca3/Santiago-Ascacibar"
"9344","Ishak Belfodil_2022",2022,"Hertha BSC","Bundesliga","Ishak Belfodil","ALG","FW","29",1992,18.2,9,6,4,4,1,4,8,50,4,9,1,8,5,14,16,0,"https://fbref.com/en/players/ff182fdc/Ishak-Belfodil"
"9345","Kevin-Prince Boateng_2022",2022,"Hertha BSC","Bundesliga","Kevin-Prince Boateng","GHA","MF,FW","34",1987,7.7,6,5,1,4,1,3,9,33.3,6,7,2,5,6,12,11,0,"https://fbref.com/en/players/f4ec4fd0/Kevin-Prince-Boateng"
"9346","Dedryck Boyata_2022",2022,"Hertha BSC","Bundesliga","Dedryck Boyata","BEL","DF","30",1990,21.1,15,13,11,3,1,8,11,72.7,3,17,13,4,17,32,134,1,"https://fbref.com/en/players/7c473e12/Dedryck-Boyata"
"9347","Matheus Cunha_2022",2022,"Hertha BSC","Bundesliga","Matheus Cunha","BRA","FW","22",1999,0.7,0,0,0,0,0,0,0,NA,0,0,0,0,0,0,0,0,"https://fbref.com/en/players/dc62b55d/Matheus-Cunha"
"9348","Márton Dárdai_2022",2022,"Hertha BSC","Bundesliga","Márton Dárdai","GER","DF","19",2002,8.4,10,4,8,2,0,8,18,44.4,10,16,6,10,20,30,33,2,"https://fbref.com/en/players/41bff4fa/Marton-Dardai"
"9349","Vladimír Darida_2022",2022,"Hertha BSC","Bundesliga","Vladimír Darida","CZE","MF","30",1990,19.8,32,18,15,13,4,13,32,40.6,19,22,3,19,20,52,17,2,"https://fbref.com/en/players/3eb0f2df/Vladimir-Darida"
"9350","Javairô Dilrosun_2022",2022,"Hertha BSC","Bundesliga","Javairô Dilrosun","NED","FW","23",1998,1.5,3,1,1,2,0,1,1,100,0,1,0,1,0,3,0,0,"https://fbref.com/en/players/34a0f5ff/Javairo-Dilrosun"
"9351","Lee Dongjun_2022",2022,"Hertha BSC","Bundesliga","Lee Dongjun","KOR","MF,FW","24",1997,1.3,2,1,0,2,0,1,3,33.3,2,2,0,2,2,4,1,0,"https://fbref.com/en/players/96d0b6f0/Lee-Dongjun"
"9352","Julian Eitschberger_2022",2022,"Hertha BSC","Bundesliga","Julian Eitschberger","GER","DF","17",2004,0.5,0,0,0,0,0,0,1,0,1,1,1,0,2,2,2,0,"https://fbref.com/en/players/943b9602/Julian-Eitschberger"
"9353","Jurgen Ekkelenkamp_2022",2022,"Hertha BSC","Bundesliga","Jurgen Ekkelenkamp","NED","MF,FW","21",2000,8,8,3,2,6,0,2,7,28.6,5,9,2,7,4,12,5,0,"https://fbref.com/en/players/73d6a176/Jurgen-Ekkelenkamp"
"9354","Linus Gechter_2022",2022,"Hertha BSC","Bundesliga","Linus Gechter","GER","DF","17",2004,8,15,8,13,2,0,7,14,50,7,12,7,5,11,26,29,0,"https://fbref.com/en/players/ad2b068c/Linus-Gechter"
"9355","Dennis Jastrzembski_2022",2022,"Hertha BSC","Bundesliga","Dennis Jastrzembski","POL","DF,FW","21",2000,2.5,2,1,1,1,0,2,8,25,6,1,0,1,5,7,3,0,"https://fbref.com/en/players/6bba916f/Dennis-Jastrzembski"
"9356","Stevan Jovetić_2022",2022,"Hertha BSC","Bundesliga","Stevan Jovetić","MNE","FW,MF","31",1989,11.3,5,2,0,2,3,1,6,16.7,5,3,0,3,1,6,6,0,"https://fbref.com/en/players/f36c432f/Stevan-Jovetic"
"9357","Anton Kade_2022",2022,"Hertha BSC","Bundesliga","Anton Kade","GER","FW,MF","17",2004,0.9,4,2,3,1,0,2,8,25,6,3,0,3,3,7,1,0,"https://fbref.com/en/players/6d7598d5/Anton-Kade"
"9358","Marc-Oliver Kempf_2022",2022,"Hertha BSC","Bundesliga","Marc-Oliver Kempf","GER","DF","26",1995,11.7,10,9,9,1,0,5,14,35.7,9,14,7,7,25,35,49,1,"https://fbref.com/en/players/815c314f/Marc-Oliver-Kempf"
"9359","Lukas Klünter_2022",2022,"Hertha BSC","Bundesliga","Lukas Klünter","GER","DF","25",1996,2.2,1,1,1,0,0,1,5,20,4,1,0,1,2,3,2,0,"https://fbref.com/en/players/92948149/Lukas-Klunter"
"9360","Marcel Lotka_2022",2022,"Hertha BSC","Bundesliga","Marcel Lotka","POL","GK","20",2001,9.8,1,0,1,0,0,1,1,100,0,0,0,0,1,2,3,3,"https://fbref.com/en/players/5584552e/Marcel-Lotka"
"9361","Dodi Lukebakio_2022",2022,"Hertha BSC","Bundesliga","Dodi Lukebakio","BEL","FW","23",1997,2,2,1,2,0,0,1,3,33.3,2,2,0,2,2,4,0,0,"https://fbref.com/en/players/0c61c77c/Dodi-Lukebakio"
"9362","Myziane Maolida_2022",2022,"Hertha BSC","Bundesliga","Myziane Maolida","FRA","FW,MF","22",1999,8.6,7,4,5,1,1,3,9,33.3,6,5,0,5,1,8,6,0,"https://fbref.com/en/players/706a60e1/Myziane-Maolida"
"9363","Maximilian Mittelstädt_2022",2022,"Hertha BSC","Bundesliga","Maximilian Mittelstädt","GER","DF,FW","24",1997,16.6,52,33,30,12,10,26,50,52,24,28,5,23,46,98,37,0,"https://fbref.com/en/players/88d4144a/Maximilian-Mittelstadt"
"9364","Peter Pekarík_2022",2022,"Hertha BSC","Bundesliga","Peter Pekarík","SVK","DF","34",1986,24.8,45,29,33,11,1,32,46,69.6,14,28,10,18,29,74,58,0,"https://fbref.com/en/players/c18d22f5/Peter-Pekarik"
"9365","Krzysztof Piątek_2022",2022,"Hertha BSC","Bundesliga","Krzysztof Piątek","POL","FW","26",1995,3.9,2,2,0,1,1,0,1,0,1,0,0,0,0,2,6,0,"https://fbref.com/en/players/17f3620a/Krzysztof-Piatek"
"9366","Marvin Plattenhardt_2022",2022,"Hertha BSC","Bundesliga","Marvin Plattenhardt","GER","DF","29",1992,18.2,25,11,18,6,1,15,27,55.6,12,18,3,15,17,42,52,0,"https://fbref.com/en/players/f7aa75bd/Marvin-Plattenhardt"
"9367","Marco Richter_2022",2022,"Hertha BSC","Bundesliga","Marco Richter","GER","FW,MF","23",1997,18.9,30,16,14,10,6,13,36,36.1,23,30,4,26,16,46,24,0,"https://fbref.com/en/players/f972644c/Marco-Richter"
"9368","Cimo Röcker_2022",2022,"Hertha BSC","Bundesliga","Cimo Röcker","GER","DF","27",1994,0.2,0,0,0,0,0,0,0,NA,0,0,0,0,2,2,0,0,"https://fbref.com/en/players/611b1aae/Cimo-Rocker"
"9369","Alexander Schwolow_2022",2022,"Hertha BSC","Bundesliga","Alexander Schwolow","GER","GK","29",1992,24.2,0,0,0,0,0,0,1,0,1,0,0,0,2,2,18,3,"https://fbref.com/en/players/0d55d942/Alexander-Schwolow"
"9370","Davie Selke_2022",2022,"Hertha BSC","Bundesliga","Davie Selke","GER","FW","26",1995,11.2,5,4,1,3,1,1,3,33.3,2,6,1,5,1,6,11,0,"https://fbref.com/en/players/1238a3f9/Davie-Selke"
"9371","Suat Serdar_2022",2022,"Hertha BSC","Bundesliga","Suat Serdar","GER","MF,FW","24",1997,24.6,64,30,24,29,11,25,55,45.5,30,32,3,29,20,84,14,0,"https://fbref.com/en/players/b3325a30/Suat-Serdar"
"9372","Niklas Stark_2022",2022,"Hertha BSC","Bundesliga","Niklas Stark","GER","DF","26",1995,22.6,28,16,18,10,0,12,17,70.6,5,27,17,10,36,64,122,2,"https://fbref.com/en/players/aad48be9/Niklas-Stark"
"9373","Jordan Torunarigha_2022",2022,"Hertha BSC","Bundesliga","Jordan Torunarigha","GER","DF","23",1997,5.4,4,1,1,3,0,4,5,80,1,4,2,2,17,21,30,0,"https://fbref.com/en/players/f86cabbd/Jordan-Torunarigha"
"9374","Lucas Tousart_2022",2022,"Hertha BSC","Bundesliga","Lucas Tousart","FRA","MF","24",1997,21.8,42,25,15,22,5,10,34,29.4,24,30,6,24,35,77,55,0,"https://fbref.com/en/players/71ec39ef/Lucas-Tousart"
"9375","Marten Winkler_2022",2022,"Hertha BSC","Bundesliga","Marten Winkler","GER","MF","18",2002,0.3,0,0,0,0,0,0,0,NA,0,0,0,0,0,0,0,0,"https://fbref.com/en/players/e0d515ef/Marten-Winkler"
"9376","Luca Wollschläger_2022",2022,"Hertha BSC","Bundesliga","Luca Wollschläger","GER","FW,MF","18",2003,0.2,1,1,0,1,0,0,1,0,1,0,0,0,0,1,0,0,"https://fbref.com/en/players/24b8e7bd/Luca-Wollschlager"
"9377","Deyovaisio Zeefuik_2022",2022,"Hertha BSC","Bundesliga","Deyovaisio Zeefuik","NED","DF","23",1998,6.3,11,10,6,4,1,6,12,50,6,12,4,8,11,22,21,1,"https://fbref.com/en/players/58a2e9f6/Deyovaisio-Zeefuik"
"9378","Sargis Adamyan_2022",2022,"Hoffenheim","Bundesliga","Sargis Adamyan","ARM","FW,MF","28",1993,3.7,8,6,3,4,1,3,11,27.3,8,4,0,4,1,9,2,0,"https://fbref.com/en/players/22919e97/Sargis-Adamyan"
"9379","Kevin Akpoguma_2022",2022,"Hoffenheim","Bundesliga","Kevin Akpoguma","NGA","DF,FW","26",1995,17,33,19,16,11,6,16,28,57.1,12,32,2,30,20,53,29,2,"https://fbref.com/en/players/6ec6fde0/Kevin-Akpoguma"
"9380","Fisnik Asllani_2022",2022,"Hoffenheim","Bundesliga","Fisnik Asllani","KVX","MF,FW","18",2002,0.1,0,0,0,0,0,0,1,0,1,0,0,0,0,0,0,0,"https://fbref.com/en/players/35f67a30/Fisnik-Asllani"
"9381","Oliver Baumann_2022",2022,"Hoffenheim","Bundesliga","Oliver Baumann","GER","GK","31",1990,33,0,0,0,0,0,0,3,0,3,0,0,0,0,0,19,1,"https://fbref.com/en/players/47064058/Oliver-Baumann"
"9382","Christoph Baumgartner_2022",2022,"Hoffenheim","Bundesliga","Christoph Baumgartner","AUT","MF,FW","21",1999,21,28,15,14,7,7,13,32,40.6,19,24,3,21,8,36,16,0,"https://fbref.com/en/players/437f2b00/Christoph-Baumgartner"
"9383","Ihlas Bebou_2022",2022,"Hoffenheim","Bundesliga","Ihlas Bebou","TOG","FW,DF","27",1994,23.2,22,14,5,12,5,7,21,33.3,14,20,3,17,12,34,25,0,"https://fbref.com/en/players/a53b661f/Ihlas-Bebou"
"9384","Ermin Bičakčić_2022",2022,"Hoffenheim","Bundesliga","Ermin Bičakčić","BIH","DF","31",1990,0.1,0,0,0,0,0,0,0,NA,0,0,0,0,0,0,0,0,"https://fbref.com/en/players/7aac47fe/Ermin-Bicakcic"
"9385","Tom Bischof_2022",2022,"Hoffenheim","Bundesliga","Tom Bischof","GER","MF","16",2005,0.2,0,0,0,0,0,0,0,NA,0,1,0,1,0,0,1,0,"https://fbref.com/en/players/07d3bfec/Tom-Bischof"
"9386","Jacob Bruun Larsen_2022",2022,"Hoffenheim","Bundesliga","Jacob Bruun Larsen","DEN","FW,MF","22",1998,9,2,1,1,1,0,0,5,0,5,14,3,11,5,7,5,2,"https://fbref.com/en/players/4e204552/Jacob-Bruun-Larsen"
"9387","Justin Che_2022",2022,"Hoffenheim","Bundesliga","Justin Che","USA","FW,DF","17",2003,0.5,2,0,1,0,1,1,2,50,1,0,0,0,1,3,0,0,"https://fbref.com/en/players/3c569f37/Justin-Che"
"9388","Moanes Dabbur_2022",2022,"Hoffenheim","Bundesliga","Moanes Dabbur","ISR","FW,MF","29",1992,14.6,18,10,3,5,10,4,17,23.5,13,10,0,10,5,23,4,0,"https://fbref.com/en/players/eac044ad/Moanes-Dabbur"
"9389","Mijat Gaćinović_2022",2022,"Hoffenheim","Bundesliga","Mijat Gaćinović","SRB","FW,MF","26",1995,1.2,3,3,1,1,1,3,3,100,0,1,0,1,1,4,2,0,"https://fbref.com/en/players/16daec92/Mijat-Gacinovic"
"9390","Dennis Geiger_2022",2022,"Hoffenheim","Bundesliga","Dennis Geiger","GER","MF","23",1998,15.3,34,23,9,20,5,17,30,56.7,13,15,1,14,14,48,7,1,"https://fbref.com/en/players/37f606f0/Dennis-Geiger"
"9391","Florian Grillitsch_2022",2022,"Hoffenheim","Bundesliga","Florian Grillitsch","AUT","DF,MF","25",1995,16.6,37,19,15,21,1,17,31,54.8,14,18,7,11,29,66,36,1,"https://fbref.com/en/players/ffbbc83b/Florian-Grillitsch"
"9392","Benjamin Hübner_2022",2022,"Hoffenheim","Bundesliga","Benjamin Hübner","GER","DF","32",1989,4.2,9,5,0,7,2,3,5,60,2,2,2,0,9,18,7,0,"https://fbref.com/en/players/99de6b6f/Benjamin-Hubner"
"9393","Marco John_2022",2022,"Hoffenheim","Bundesliga","Marco John","GER","DF","19",2002,0.5,0,0,0,0,0,0,1,0,1,1,0,1,1,1,1,0,"https://fbref.com/en/players/d9e196bf/Marco-John"
"9394","Pavel Kadeřábek_2022",2022,"Hoffenheim","Bundesliga","Pavel Kadeřábek","CZE","DF,MF","29",1992,13.3,11,10,6,3,2,5,16,31.3,11,18,6,12,13,24,22,0,"https://fbref.com/en/players/79c90e45/Pavel-Kaderabek"
"9395","Andrej Kramarić_2022",2022,"Hoffenheim","Bundesliga","Andrej Kramarić","CRO","FW,MF","30",1991,30.1,8,4,1,5,2,7,17,41.2,10,10,0,10,9,17,7,1,"https://fbref.com/en/players/603cb947/Andrej-Kramaric"
"9396","Håvard Nordtveit_2022",2022,"Hoffenheim","Bundesliga","Håvard Nordtveit","NOR","DF","31",1990,3.4,7,6,2,4,1,4,4,100,0,2,1,1,10,17,11,0,"https://fbref.com/en/players/6cafd68d/Havard-Nordtveit"
"9397","Kasim Nuhu_2022",2022,"Hoffenheim","Bundesliga","Kasim Nuhu","GHA","DF","26",1995,0.1,0,0,0,0,0,0,1,0,1,0,0,0,0,0,1,0,"https://fbref.com/en/players/93a50d2c/Kasim-Nuhu"
"9398","Philipp Pentke_2022",2022,"Hoffenheim","Bundesliga","Philipp Pentke","GER","GK","36",1985,1,0,0,0,0,0,0,0,NA,0,0,0,0,0,0,0,0,"https://fbref.com/en/players/c41f7379/Philipp-Pentke"
"9399","Stefan Posch_2022",2022,"Hoffenheim","Bundesliga","Stefan Posch","AUT","DF","24",1997,24.4,48,30,20,26,2,22,39,56.4,17,43,18,25,28,76,71,2,"https://fbref.com/en/players/7f609bfc/Stefan-Posch"
"9400","Nick Proschwitz_2022",2022,"Hoffenheim","Bundesliga","Nick Proschwitz","GER","FW","34",1986,0.3,0,0,0,0,0,0,0,NA,0,0,0,0,0,0,0,0,"https://fbref.com/en/players/9cf4fd68/Nick-Proschwitz"
"9401","David Raum_2022",2022,"Hoffenheim","Bundesliga","David Raum","GER","DF,FW","23",1998,30.6,52,29,30,10,12,30,64,46.9,34,38,5,33,27,79,39,1,"https://fbref.com/en/players/7d450ed3/David-Raum"
"9402","Chris Richards_2022",2022,"Hoffenheim","Bundesliga","Chris Richards","USA","DF","21",2000,14.5,26,15,10,15,1,11,18,61.1,7,21,9,12,22,48,50,1,"https://fbref.com/en/players/0a3d6d2b/Chris-Richards"
"9403","Sebastian Rudy_2022",2022,"Hoffenheim","Bundesliga","Sebastian Rudy","GER","MF","31",1990,8.6,22,12,9,13,0,11,21,52.4,10,8,3,5,11,33,8,1,"https://fbref.com/en/players/80f36c88/Sebastian-Rudy"
"9404","Georginio Rutter_2022",2022,"Hoffenheim","Bundesliga","Georginio Rutter","FRA","FW,MF","19",2002,17.9,18,13,4,8,6,6,17,35.3,11,29,1,28,6,24,11,1,"https://fbref.com/en/players/c64c01fc/Georginio-Rutter"
"9405","Diadie Samassékou_2022",2022,"Hoffenheim","Bundesliga","Diadie Samassékou","MLI","MF","25",1996,18.4,41,26,14,21,6,21,44,47.7,23,27,11,16,28,69,26,0,"https://fbref.com/en/players/08593525/Diadie-Samassekou"
"9406","Robert Skov_2022",2022,"Hoffenheim","Bundesliga","Robert Skov","DEN","FW,DF","25",1996,4.1,3,2,1,1,1,2,9,22.2,7,2,0,2,3,6,3,0,"https://fbref.com/en/players/ff98492b/Robert-Skov"
"9407","Angelo Stiller_2022",2022,"Hoffenheim","Bundesliga","Angelo Stiller","GER","MF","20",2001,18.8,30,17,11,15,4,9,23,39.1,14,32,6,26,9,39,16,2,"https://fbref.com/en/players/3b1ed320/Angelo-Stiller"
"9408","Umut Tohumcu_2022",2022,"Hoffenheim","Bundesliga","Umut Tohumcu","GER","MF","16",2004,0.1,0,0,0,0,0,0,0,NA,0,0,0,0,0,0,0,0,"https://fbref.com/en/players/e547d3cf/Umut-Tohumcu"
"9409","Kevin Vogt_2022",2022,"Hoffenheim","Bundesliga","Kevin Vogt","GER","DF","29",1991,28.5,21,12,15,6,0,11,21,52.4,10,18,7,11,13,34,101,1,"https://fbref.com/en/players/1d8e9add/Kevin-Vogt"
"9410","Nicolò Barella_2022",2022,"Inter","Serie A","Nicolò Barella","ITA","MF","24",1997,32.4,63,42,17,35,11,29,55,52.7,26,26,2,24,21,84,8,2,"https://fbref.com/en/players/6928979a/Nicolo-Barella"
"9411","Alessandro Bastoni_2022",2022,"Inter","Serie A","Alessandro Bastoni","ITA","DF","22",1999,25.7,44,25,28,13,3,17,34,50,17,22,12,10,35,79,59,1,"https://fbref.com/en/players/75b86fb3/Alessandro-Bastoni"
"9412","Marcelo Brozović_2022",2022,"Inter","Serie A","Marcelo Brozović","CRO","MF","28",1992,32.6,77,45,34,35,8,34,68,50,34,28,10,18,37,114,36,2,"https://fbref.com/en/players/33b8d077/Marcelo-Brozovic"
"9413","Felipe Caicedo_2022",2022,"Inter","Serie A","Felipe Caicedo","ECU","FW,DF","32",1988,0.3,0,0,0,0,0,0,0,NA,0,1,0,1,0,0,0,0,"https://fbref.com/en/players/93b891d1/Felipe-Caicedo"
"9414","Hakan Çalhanoğlu_2022",2022,"Inter","Serie A","Hakan Çalhanoğlu","TUR","MF","27",1994,27.6,41,23,16,19,6,11,40,27.5,29,29,5,24,25,66,12,0,"https://fbref.com/en/players/cd0fa27b/Hakan-Calhanoglu"
"9415","Joaquín Correa_2022",2022,"Inter","Serie A","Joaquín Correa","ARG","FW","26",1994,11.4,11,5,2,6,3,1,13,7.7,12,8,1,7,3,14,2,0,"https://fbref.com/en/players/45b9b619/Joaquin-Correa"
"9416","Danilo D'Ambrosio_2022",2022,"Inter","Serie A","Danilo D'Ambrosio","ITA","DF","32",1988,11.1,30,15,21,8,1,11,22,50,11,21,10,11,8,38,20,0,"https://fbref.com/en/players/44eb9093/Danilo-DAmbrosio"
"9417","Matteo Darmian_2022",2022,"Inter","Serie A","Matteo Darmian","ITA","DF","31",1989,16.7,32,16,17,9,6,16,41,39,25,16,1,15,19,51,25,0,"https://fbref.com/en/players/96e0490d/Matteo-Darmian"
"9418","Federico Dimarco_2022",2022,"Inter","Serie A","Federico Dimarco","ITA","DF","23",1997,15.9,28,15,10,15,3,13,24,54.2,11,6,1,5,19,47,19,0,"https://fbref.com/en/players/970b8574/Federico-Dimarco"
"9419","Denzel Dumfries_2022",2022,"Inter","Serie A","Denzel Dumfries","NED","DF","25",1996,22.5,32,12,9,14,9,16,32,50,16,15,6,9,9,41,26,0,"https://fbref.com/en/players/481c9ece/Denzel-Dumfries"
"9420","Edin Džeko_2022",2022,"Inter","Serie A","Edin Džeko","BIH","FW","35",1986,27.4,14,8,7,4,3,8,25,32,17,22,5,17,4,18,35,0,"https://fbref.com/en/players/3bb7f478/Edin-Dzeko"
"9421","Roberto Gagliardini_2022",2022,"Inter","Serie A","Roberto Gagliardini","ITA","MF","27",1994,7.2,12,6,7,4,1,1,13,7.7,12,14,5,9,9,21,7,0,"https://fbref.com/en/players/ce30bfc8/Roberto-Gagliardini"
"9422","Robin Gosens_2022",2022,"Inter","Serie A","Robin Gosens","GER","DF","27",1994,1.9,3,1,1,2,0,0,0,NA,0,5,2,3,3,6,3,0,"https://fbref.com/en/players/2d970560/Robin-Gosens"
"9423","Samir Handanović_2022",2022,"Inter","Serie A","Samir Handanović","SVN","GK","37",1984,37,1,0,1,0,0,1,2,50,1,1,0,1,0,1,6,3,"https://fbref.com/en/players/74419746/Samir-Handanovic"
"9424","Aleksandar Kolarov_2022",2022,"Inter","Serie A","Aleksandar Kolarov","SRB","DF","35",1985,0.5,1,1,1,0,0,1,1,100,0,0,0,0,1,2,2,0,"https://fbref.com/en/players/eda40760/Aleksandar-Kolarov"
"9425","Lautaro Martínez_2022",2022,"Inter","Serie A","Lautaro Martínez","ARG","FW","23",1997,25.4,20,10,3,10,7,6,11,54.5,5,21,1,20,18,38,6,0,"https://fbref.com/en/players/f7036e1c/Lautaro-Martinez"
"9426","Ivan Perišić_2022",2022,"Inter","Serie A","Ivan Perišić","CRO","DF","32",1989,31.3,38,22,18,11,9,28,50,56,22,39,7,32,47,85,42,0,"https://fbref.com/en/players/6fe90922/Ivan-Perisic"
"9427","Ionuț Radu_2022",2022,"Inter","Serie A","Ionuț Radu","ROU","GK","24",1997,1,0,0,0,0,0,0,0,NA,0,0,0,0,0,0,0,1,"https://fbref.com/en/players/67f649be/Ionut-Radu"
"9428","Andrea Ranocchia_2022",2022,"Inter","Serie A","Andrea Ranocchia","ITA","DF","33",1988,3.8,8,4,5,1,2,1,3,33.3,2,4,3,1,4,12,16,0,"https://fbref.com/en/players/539230cf/Andrea-Ranocchia"
"9429","Alexis Sánchez_2022",2022,"Inter","Serie A","Alexis Sánchez","CHI","FW","32",1988,9.8,9,8,0,6,3,2,11,18.2,9,4,0,4,2,11,3,0,"https://fbref.com/en/players/2c0f8e9e/Alexis-Sanchez"
"9430","Martin Satriano_2022",2022,"Inter","Serie A","Martin Satriano","URU","FW,MF","20",2001,0.4,1,0,0,0,1,1,1,100,0,0,0,0,0,1,0,0,"https://fbref.com/en/players/86383d0e/Martin-Satriano"
"9431","Stefano Sensi_2022",2022,"Inter","Serie A","Stefano Sensi","ITA","MF,FW","25",1995,1.9,4,3,1,3,0,2,4,50,2,2,0,2,0,4,2,0,"https://fbref.com/en/players/b70bde8f/Stefano-Sensi"
"9432","Milan Škriniar_2022",2022,"Inter","Serie A","Milan Škriniar","SVK","DF","26",1995,35,47,27,26,17,4,24,42,57.1,18,36,25,11,25,72,90,1,"https://fbref.com/en/players/30f5ffa9/Milan-Skriniar"
"9433","Matías Vecino_2022",2022,"Inter","Serie A","Matías Vecino","URU","MF","29",1991,4.2,7,5,2,3,2,3,9,33.3,6,10,1,9,4,11,7,0,"https://fbref.com/en/players/44ac04e9/Matias-Vecino"
"9434","Arturo Vidal_2022",2022,"Inter","Serie A","Arturo Vidal","CHI","MF","34",1987,8.2,26,10,16,9,1,9,26,34.6,17,13,5,8,7,33,7,1,"https://fbref.com/en/players/67cdbc0e/Arturo-Vidal"
"9435","Stefan de Vrij_2022",2022,"Inter","Serie A","Stefan de Vrij","NED","DF","29",1992,26.8,38,29,22,16,0,12,17,70.6,5,17,8,9,32,70,52,0,"https://fbref.com/en/players/d0d8dd44/Stefan-de-Vrij"
"9436","Mattia Zanotti_2022",2022,"Inter","Serie A","Mattia Zanotti","ITA","DF","18",2003,0.1,1,0,1,0,0,0,1,0,1,0,0,0,0,1,0,0,"https://fbref.com/en/players/875d65d1/Mattia-Zanotti"
"9437","Marley Aké_2022",2022,"Juventus","Serie A","Marley Aké","FRA","FW,MF","20",2001,0.9,0,0,0,0,0,0,2,0,2,0,0,0,1,1,0,0,"https://fbref.com/en/players/414e1f69/Marley-Ake"
"9438","Rodrigo Bentancur_2022",2022,"Juventus","Serie A","Rodrigo Bentancur","URU","MF","24",1997,12.8,32,18,11,18,3,7,20,35,13,15,2,13,26,58,15,1,"https://fbref.com/en/players/3b8674e6/Rodrigo-Bentancur"
"9439","Federico Bernardeschi_2022",2022,"Juventus","Serie A","Federico Bernardeschi","ITA","MF,FW","27",1994,16.4,16,10,7,4,5,6,13,46.2,7,12,4,8,5,21,15,0,"https://fbref.com/en/players/ee93c1a9/Federico-Bernardeschi"
"9440","Leonardo Bonucci_2022",2022,"Juventus","Serie A","Leonardo Bonucci","ITA","DF","34",1987,22.3,14,5,4,10,0,8,13,61.5,5,22,17,5,26,40,82,0,"https://fbref.com/en/players/52ec54d0/Leonardo-Bonucci"
"9441","Giorgio Chiellini_2022",2022,"Juventus","Serie A","Giorgio Chiellini","ITA","DF","36",1984,15,22,13,17,4,1,7,13,53.8,6,24,18,6,22,44,59,0,"https://fbref.com/en/players/e85fb9b8/Giorgio-Chiellini"
"9442","Federico Chiesa_2022",2022,"Juventus","Serie A","Federico Chiesa","ITA","MF,FW","23",1997,9.6,26,19,9,9,8,12,26,46.2,14,7,0,7,4,30,3,0,"https://fbref.com/en/players/b0f7e36c/Federico-Chiesa"
"9443","Juan Cuadrado_2022",2022,"Juventus","Serie A","Juan Cuadrado","COL","DF,MF","33",1988,27.6,48,23,30,13,5,30,55,54.5,25,23,5,18,29,77,34,0,"https://fbref.com/en/players/0ab1f153/Juan-Cuadrado"
"9444","Danilo_2022",2022,"Juventus","Serie A","Danilo","BRA","DF,MF","30",1991,21,37,26,20,13,4,18,28,64.3,10,21,12,9,32,69,53,1,"https://fbref.com/en/players/94b2001f/Danilo"
"9445","Mattia De Sciglio_2022",2022,"Juventus","Serie A","Mattia De Sciglio","ITA","DF","28",1992,13,24,12,7,9,8,11,24,45.8,13,10,0,10,10,34,30,0,"https://fbref.com/en/players/ae4e2852/Mattia-De-Sciglio"
"9446","Paulo Dybala_2022",2022,"Juventus","Serie A","Paulo Dybala","ARG","FW,MF","27",1993,22.9,30,13,7,14,9,8,35,22.9,27,19,0,19,9,39,4,3,"https://fbref.com/en/players/e0921a4f/Paulo-Dybala"
"9447","Kaio Jorge_2022",2022,"Juventus","Serie A","Kaio Jorge","BRA","MF,FW","19",2002,1.3,2,1,0,2,0,1,3,33.3,2,1,0,1,0,2,2,0,"https://fbref.com/en/players/0cf465f2/Kaio-Jorge"
"9448","Moise Kean_2022",2022,"Juventus","Serie A","Moise Kean","ITA","FW","21",2000,12.2,9,4,2,5,2,6,16,37.5,10,5,0,5,3,12,8,1,"https://fbref.com/en/players/3d50bcdb/Moise-Kean"
"9449","Dejan Kulusevski_2022",2022,"Juventus","Serie A","Dejan Kulusevski","SWE","FW,MF","21",2000,8.6,15,12,9,6,0,8,21,38.1,13,14,0,14,5,20,5,0,"https://fbref.com/en/players/df3cda47/Dejan-Kulusevski"
"9450","Matthijs de Ligt_2022",2022,"Juventus","Serie A","Matthijs de Ligt","NED","DF","21",1999,29.7,34,19,21,13,0,15,18,83.3,3,31,21,10,26,60,103,0,"https://fbref.com/en/players/d6e53a3a/Matthijs-de-Ligt"
"9451","Manuel Locatelli_2022",2022,"Juventus","Serie A","Manuel Locatelli","ITA","MF","23",1998,24,44,25,21,16,7,21,47,44.7,26,43,21,22,22,66,33,0,"https://fbref.com/en/players/a8a874f1/Manuel-Locatelli"
"9452","Weston McKennie_2022",2022,"Juventus","Serie A","Weston McKennie","USA","MF","22",1998,15.2,20,11,11,7,2,8,26,30.8,18,17,8,9,23,43,20,0,"https://fbref.com/en/players/01c3aff5/Weston-McKennie"
"9453","Arthur Melo_2022",2022,"Juventus","Serie A","Arthur Melo","BRA","MF","24",1996,10.7,25,12,10,14,1,13,24,54.2,11,11,2,9,7,32,8,1,"https://fbref.com/en/players/48b3dd60/Arthur-Melo"
"9454","Fabio Miretti_2022",2022,"Juventus","Serie A","Fabio Miretti","ITA","MF","17",2003,3.6,4,2,2,2,0,2,9,22.2,7,3,1,2,2,6,3,0,"https://fbref.com/en/players/34693494/Fabio-Miretti"
"9455","Álvaro Morata_2022",2022,"Juventus","Serie A","Álvaro Morata","ESP","FW","28",1992,25.6,18,9,4,9,5,8,31,25.8,23,26,1,25,5,23,24,0,"https://fbref.com/en/players/129af0db/Alvaro-Morata"
"9456","Martin Palumbo_2022",2022,"Juventus","Serie A","Martin Palumbo","NOR","FW","19",2002,0.1,0,0,0,0,0,0,1,0,1,0,0,0,0,0,0,0,"https://fbref.com/en/players/f8d41a8c/Martin-Palumbo"
"9457","Luca Pellegrini_2022",2022,"Juventus","Serie A","Luca Pellegrini","ITA","DF","22",1999,12.3,23,10,13,5,5,12,19,63.2,7,9,1,8,5,28,23,0,"https://fbref.com/en/players/3b61c9ec/Luca-Pellegrini"
"9458","Mattia Perin_2022",2022,"Juventus","Serie A","Mattia Perin","ITA","GK","28",1992,4.5,0,0,0,0,0,0,0,NA,0,0,0,0,0,0,3,0,"https://fbref.com/en/players/4c62d0c8/Mattia-Perin"
"9459","Carlo Pinsoglio_2022",2022,"Juventus","Serie A","Carlo Pinsoglio","ITA","GK","31",1990,0.5,0,0,0,0,0,0,0,NA,0,0,0,0,0,0,0,0,"https://fbref.com/en/players/f6a06749/Carlo-Pinsoglio"
"9460","Adrien Rabiot_2022",2022,"Juventus","Serie A","Adrien Rabiot","FRA","MF","26",1995,25.4,64,43,32,24,8,15,34,44.1,19,34,8,26,20,84,41,1,"https://fbref.com/en/players/8794e251/Adrien-Rabiot"
"9461","Aaron Ramsey_2022",2022,"Juventus","Serie A","Aaron Ramsey","WAL","MF","30",1990,1.1,0,0,0,0,0,0,0,NA,0,0,0,0,1,1,0,0,"https://fbref.com/en/players/ef619b0b/Aaron-Ramsey"
"9462","Cristiano Ronaldo_2022",2022,"Juventus","Serie A","Cristiano Ronaldo","POR","FW","36",1985,0.3,1,0,0,1,0,1,1,100,0,0,0,0,0,1,0,0,"https://fbref.com/en/players/dea698d9/Cristiano-Ronaldo"
"9463","Daniele Rugani_2022",2022,"Juventus","Serie A","Daniele Rugani","ITA","DF","27",1994,9.8,8,5,4,4,0,4,7,57.1,3,9,4,5,11,19,47,0,"https://fbref.com/en/players/14b8fcdf/Daniele-Rugani"
"9464","Alex Sandro_2022",2022,"Juventus","Serie A","Alex Sandro","BRA","DF","30",1991,19.8,27,16,15,9,3,11,25,44,14,17,6,11,27,54,40,0,"https://fbref.com/en/players/0d82903c/Alex-Sandro"
"9465","Matìas Soulé_2022",2022,"Juventus","Serie A","Matìas Soulé","ARG","FW","18",2003,0.1,0,0,0,0,0,0,1,0,1,0,0,0,0,0,0,0,"https://fbref.com/en/players/c13ddd3e/Matias-Soule"
"9466","Wojciech Szczęsny_2022",2022,"Juventus","Serie A","Wojciech Szczęsny","POL","GK","31",1990,33,1,1,1,0,0,1,2,50,1,0,0,0,0,1,8,1,"https://fbref.com/en/players/01b8a2b2/Wojciech-Szczesny"
"9467","Dušan Vlahović_2022",2022,"Juventus","Serie A","Dušan Vlahović","SRB","FW","21",2000,12,0,0,0,0,0,0,4,0,4,3,0,3,0,0,7,0,"https://fbref.com/en/players/79443529/Dusan-Vlahovic"
"9468","Denis Zakaria_2022",2022,"Juventus","Serie A","Denis Zakaria","SUI","MF","24",1996,6.6,11,7,3,6,2,3,11,27.3,8,16,3,13,11,22,7,0,"https://fbref.com/en/players/384d58d9/Denis-Zakaria"
"9469","Sebastian Andersson_2022",2022,"Köln","Bundesliga","Sebastian Andersson","SWE","FW","30",1991,14,11,7,0,3,8,3,9,33.3,6,8,0,8,3,14,14,0,"https://fbref.com/en/players/b4cf5806/Sebastian-Andersson"
"9470","Julian Chabot_2022",2022,"Köln","Bundesliga","Julian Chabot","GER","DF","23",1998,2.3,8,3,4,4,0,2,5,40,3,4,2,2,3,11,5,1,"https://fbref.com/en/players/ae7058f9/Julian-Chabot"
"9471","Rafael Czichos_2022",2022,"Köln","Bundesliga","Rafael Czichos","GER","DF","31",1990,15.6,29,18,18,9,2,14,28,50,14,23,13,10,19,48,53,2,"https://fbref.com/en/players/b0a0698b/Rafael-Czichos"
"9472","Ondrej Duda_2022",2022,"Köln","Bundesliga","Ondrej Duda","SVK","MF,FW","26",1994,17.9,23,16,4,12,7,6,23,26.1,17,14,2,12,17,40,9,0,"https://fbref.com/en/players/79ca3e23/Ondrej-Duda"
"9473","Kingsley Ehizibue_2022",2022,"Köln","Bundesliga","Kingsley Ehizibue","NED","DF","26",1995,7.6,32,18,27,5,0,15,24,62.5,9,13,4,9,9,41,26,0,"https://fbref.com/en/players/76b2817e/Kingsley-Ehizibue"
"9474","Jonas Hector_2022",2022,"Köln","Bundesliga","Jonas Hector","GER","DF","31",1990,28.4,76,39,36,26,14,29,74,39.2,45,59,8,51,50,126,68,1,"https://fbref.com/en/players/c2009df3/Jonas-Hector"
"9475","Jannes Horn_2022",2022,"Köln","Bundesliga","Jannes Horn","GER","DF","24",1997,5.3,6,4,4,2,0,4,8,50,4,1,1,0,3,9,9,0,"https://fbref.com/en/players/2b83fa49/Jannes-Horn"
"9476","Timo Horn_2022",2022,"Köln","Bundesliga","Timo Horn","GER","GK","28",1993,13,0,0,0,0,0,0,1,0,1,0,0,0,0,0,5,0,"https://fbref.com/en/players/3cd9e95a/Timo-Horn"
"9477","Timo Hübers_2022",2022,"Köln","Bundesliga","Timo Hübers","GER","DF","25",1996,19.3,45,27,28,17,0,27,45,60,18,31,19,12,52,97,95,0,"https://fbref.com/en/players/94302c52/Timo-Hubers"
"9478","Florian Kainz_2022",2022,"Köln","Bundesliga","Florian Kainz","AUT","MF,FW","28",1992,25.8,41,26,9,25,7,23,51,45.1,28,27,3,24,32,73,24,0,"https://fbref.com/en/players/94c18565/Florian-Kainz"
"9479","Noah Katterbach_2022",2022,"Köln","Bundesliga","Noah Katterbach","GER","DF","20",2001,0.2,1,1,1,0,0,1,1,100,0,0,0,0,0,1,1,0,"https://fbref.com/en/players/e27de4fa/Noah-Katterbach"
"9480","Luca Kilian_2022",2022,"Köln","Bundesliga","Luca Kilian","GER","DF","21",1999,25.3,42,24,30,9,3,21,41,51.2,20,31,13,18,46,88,109,3,"https://fbref.com/en/players/610aa1e9/Luca-Kilian"
"9481","Tim Lemperle_2022",2022,"Köln","Bundesliga","Tim Lemperle","GER","FW,MF","19",2002,1.7,4,1,2,1,1,1,3,33.3,2,1,0,1,2,6,2,0,"https://fbref.com/en/players/792ffa71/Tim-Lemperle"
"9482","Dejan Ljubicic_2022",2022,"Köln","Bundesliga","Dejan Ljubicic","AUT","MF,FW","23",1997,21.9,33,19,12,13,8,13,49,26.5,36,19,1,18,15,48,11,0,"https://fbref.com/en/players/c455a2b2/Dejan-Ljubicic"
"9483","Jorge Meré_2022",2022,"Köln","Bundesliga","Jorge Meré","ESP","DF","24",1997,5.4,9,6,3,6,0,4,7,57.1,3,6,4,2,10,19,19,0,"https://fbref.com/en/players/9f979eb2/Jorge-Mere"
"9484","Anthony Modeste_2022",2022,"Köln","Bundesliga","Anthony Modeste","FRA","FW","33",1988,29,10,6,4,5,1,3,18,16.7,15,11,2,9,4,14,29,0,"https://fbref.com/en/players/34e4343c/Anthony-Modeste"
"9485","Mathias Olesen_2022",2022,"Köln","Bundesliga","Mathias Olesen","LUX","MF,FW","20",2001,0.2,0,0,0,0,0,0,0,NA,0,0,0,0,1,1,0,0,"https://fbref.com/en/players/86adbcc7/Mathias-Olesen"
"9486","Tomáš Ostrák_2022",2022,"Köln","Bundesliga","Tomáš Ostrák","CZE","MF,FW","21",2000,0.3,1,0,0,0,1,1,3,33.3,2,0,0,0,1,2,0,0,"https://fbref.com/en/players/3ba95f20/Tomas-Ostrak"
"9487","Salih Özcan_2022",2022,"Köln","Bundesliga","Salih Özcan","TUR","MF","23",1998,25.7,42,30,14,23,5,22,51,43.1,29,37,5,32,51,93,35,1,"https://fbref.com/en/players/15413fa5/Salih-Ozcan"
"9488","Louis Schaub_2022",2022,"Köln","Bundesliga","Louis Schaub","AUT","MF,FW","26",1994,7.3,16,10,7,7,2,11,20,55,9,17,3,14,3,19,3,0,"https://fbref.com/en/players/b50ec54b/Louis-Schaub"
"9489","Kingsley Schindler_2022",2022,"Köln","Bundesliga","Kingsley Schindler","GHA","DF,FW","28",1993,3.9,1,0,0,0,1,1,5,20,4,5,1,4,5,6,5,0,"https://fbref.com/en/players/bd527260/Kingsley-Schindler"
"9490","Benno Schmitz_2022",2022,"Köln","Bundesliga","Benno Schmitz","GER","DF","26",1994,26.9,57,37,21,27,9,42,86,48.8,44,44,8,36,39,96,39,0,"https://fbref.com/en/players/ad00b1a8/Benno-Schmitz"
"9491","Marvin Schwäbe_2022",2022,"Köln","Bundesliga","Marvin Schwäbe","GER","GK","26",1995,21,0,0,0,0,0,0,0,NA,0,0,0,0,0,0,8,1,"https://fbref.com/en/players/87436846/Marvin-Schwabe"
"9492","Ellyes Skhiri_2022",2022,"Köln","Bundesliga","Ellyes Skhiri","TUN","MF","26",1995,20.2,55,33,25,26,4,22,41,53.7,19,41,7,34,37,92,35,1,"https://fbref.com/en/players/c2211709/Ellyes-Skhiri"
"9493","Jan Thielmann_2022",2022,"Köln","Bundesliga","Jan Thielmann","GER","MF,FW","19",2002,13.2,24,16,6,12,6,8,23,34.8,15,23,2,21,10,34,11,0,"https://fbref.com/en/players/fd53759d/Jan-Thielmann"
"9494","Mark Uth_2022",2022,"Köln","Bundesliga","Mark Uth","GER","MF,FW","29",1991,22.5,32,20,9,14,9,15,49,30.6,34,27,1,26,14,46,13,0,"https://fbref.com/en/players/a3ddb1b9/Mark-Uth"
"9495","Francesco Acerbi_2022",2022,"Lazio","Serie A","Francesco Acerbi","ITA","DF","33",1988,28.2,25,12,15,9,1,12,19,63.2,7,37,28,9,34,59,92,0,"https://fbref.com/en/players/b96b595c/Francesco-Acerbi"
"9496","Jean-Daniel Akpa-Akpro_2022",2022,"Lazio","Serie A","Jean-Daniel Akpa-Akpro","CIV","MF","28",1992,3.5,17,10,7,9,1,7,12,58.3,5,4,2,2,2,19,6,0,"https://fbref.com/en/players/fdf4b948/Jean-Daniel-Akpa-Akpro"
"9497","Luis Alberto_2022",2022,"Lazio","Serie A","Luis Alberto","ESP","MF","28",1992,26.1,29,17,8,11,10,8,52,15.4,44,32,4,28,13,42,7,0,"https://fbref.com/en/players/5294a83f/Luis-Alberto"
"9498","Felipe Anderson_2022",2022,"Lazio","Serie A","Felipe Anderson","BRA","FW","28",1993,32.1,71,45,30,33,8,27,99,27.3,72,65,6,59,20,91,16,0,"https://fbref.com/en/players/9f1893b9/Felipe-Anderson"
"9499","Toma Bašić_2022",2022,"Lazio","Serie A","Toma Bašić","CRO","MF","24",1996,10.9,12,8,3,9,0,5,17,29.4,12,13,4,9,4,16,21,0,"https://fbref.com/en/players/80556f08/Toma-Basic"
"9500","Jovane Cabral_2022",2022,"Lazio","Serie A","Jovane Cabral","CPV","FW","23",1998,2.1,2,1,1,0,1,0,0,NA,0,1,1,0,1,3,1,0,"https://fbref.com/en/players/e34e086c/Jovane-Cabral"
"9501","Danilo Cataldi_2022",2022,"Lazio","Serie A","Danilo Cataldi","ITA","MF","26",1994,19,36,17,15,17,4,12,38,31.6,26,24,12,12,17,53,19,1,"https://fbref.com/en/players/ba3d3bea/Danilo-Cataldi"
"9502","Gonzalo Escalante_2022",2022,"Lazio","Serie A","Gonzalo Escalante","ARG","MF","28",1993,0.1,1,0,1,0,0,1,1,100,0,2,1,1,1,2,0,0,"https://fbref.com/en/players/3f79a1c8/Gonzalo-Escalante"
"9503","Luiz Felipe_2022",2022,"Lazio","Serie A","Luiz Felipe","ITA","DF","24",1997,27.7,41,23,21,16,4,20,34,58.8,14,40,33,7,33,74,102,1,"https://fbref.com/en/players/15d0c248/Luiz-Felipe"
"9504","Elseid Hysaj_2022",2022,"Lazio","Serie A","Elseid Hysaj","ALB","DF","27",1994,22.5,46,30,25,17,4,29,45,64.4,16,18,6,12,24,70,34,1,"https://fbref.com/en/players/2f3452eb/Elseid-Hysaj"
"9505","Ciro Immobile_2022",2022,"Lazio","Serie A","Ciro Immobile","ITA","FW","31",1990,30.1,10,5,4,4,2,1,15,6.7,14,7,1,6,3,13,16,0,"https://fbref.com/en/players/4431aed2/Ciro-Immobile"
"9506","Dimitrije Kamenović_2022",2022,"Lazio","Serie A","Dimitrije Kamenović","SRB","DF","21",2000,0.5,1,1,1,0,0,1,1,100,0,0,0,0,2,3,1,0,"https://fbref.com/en/players/d3e0c826/Dimitrije-Kamenovic"
"9507","Manuel Lazzari_2022",2022,"Lazio","Serie A","Manuel Lazzari","ITA","DF","27",1993,18.5,28,14,13,15,0,16,26,61.5,10,10,2,8,12,40,16,1,"https://fbref.com/en/players/02caf6e0/Manuel-Lazzari"
"9508","Lucas Leiva_2022",2022,"Lazio","Serie A","Lucas Leiva","BRA","MF","34",1987,18.9,55,30,26,25,4,15,53,28.3,38,27,10,17,28,83,37,0,"https://fbref.com/en/players/4c78b5ed/Lucas-Leiva"
"9509","Anderson Lima_2022",2022,"Lazio","Serie A","Anderson Lima","BRA","MF","21",1999,0.7,2,0,1,1,0,0,2,0,2,1,0,1,2,4,1,0,"https://fbref.com/en/players/59be3a74/Anderson-Lima"
"9510","Adam Marušić_2022",2022,"Lazio","Serie A","Adam Marušić","MNE","DF","28",1992,30.2,30,18,16,12,2,13,32,40.6,19,19,8,11,41,71,71,0,"https://fbref.com/en/players/d4535821/Adam-Marusic"
"9511","Sergej Milinković-Savić_2022",2022,"Lazio","Serie A","Sergej Milinković-Savić","SRB","MF","26",1995,34.4,67,44,20,32,15,29,67,43.3,38,50,9,41,34,101,43,1,"https://fbref.com/en/players/4e6dbac4/Sergej-Milinkovic-Savic"
"9512","Raúl Moro_2022",2022,"Lazio","Serie A","Raúl Moro","ESP","FW","18",2002,2.2,3,3,0,2,1,1,5,20,4,2,0,2,0,3,0,0,"https://fbref.com/en/players/919dd4b1/Raul-Moro"
"9513","Vedat Muriqi_2022",2022,"Lazio","Serie A","Vedat Muriqi","KVX","FW","27",1994,2.4,1,0,1,0,0,0,5,0,5,0,0,0,0,1,2,0,"https://fbref.com/en/players/0cadc46d/Vedat-Muriqi"
"9514","Patric_2022",2022,"Lazio","Serie A","Patric","ESP","DF","28",1993,18.3,21,15,17,4,0,9,20,45,11,22,11,11,12,33,44,2,"https://fbref.com/en/players/f7223718/Patric"
"9515","Pedro_2022",2022,"Lazio","Serie A","Pedro","ESP","FW","34",1987,22.6,36,23,8,19,9,16,47,34,31,18,2,16,6,42,8,0,"https://fbref.com/en/players/3ca7254a/Pedro"
"9516","Ștefan Radu_2022",2022,"Lazio","Serie A","Ștefan Radu","ROU","DF","34",1986,6.2,9,6,3,6,0,5,9,55.6,4,7,2,5,5,14,15,0,"https://fbref.com/en/players/53de807a/Stefan-Radu"
"9517","Pepe Reina_2022",2022,"Lazio","Serie A","Pepe Reina","ESP","GK","38",1982,15,0,0,0,0,0,0,1,0,1,0,0,0,0,0,1,1,"https://fbref.com/en/players/e358587b/Pepe-Reina"
"9518","Luka Romero_2022",2022,"Lazio","Serie A","Luka Romero","ARG","FW","16",2004,0.9,2,1,0,1,1,0,2,0,2,0,0,0,1,3,0,0,"https://fbref.com/en/players/ca6edaa0/Luka-Romero"
"9519","Thomas Strakosha_2022",2022,"Lazio","Serie A","Thomas Strakosha","ALB","GK","26",1995,23,0,0,0,0,0,0,0,NA,0,0,0,0,0,0,7,2,"https://fbref.com/en/players/339fe0e8/Thomas-Strakosha"
"9520","Denis Vavro_2022",2022,"Lazio","Serie A","Denis Vavro","SVK","DF","25",1996,0.1,0,0,0,0,0,0,0,NA,0,0,0,0,0,0,0,0,"https://fbref.com/en/players/08990838/Denis-Vavro"
"9521","Mattia Zaccagni_2022",2022,"Lazio","Serie A","Mattia Zaccagni","ITA","FW","26",1995,20.8,33,16,10,13,10,11,19,57.9,8,17,2,15,20,53,5,0,"https://fbref.com/en/players/d85c238b/Mattia-Zaccagni"
"9522","Luke Ayling_2022",2022,"Leeds United","Premier League","Luke Ayling","ENG","DF","29",1991,25.2,74,42,46,23,5,51,97,52.6,46,46,25,21,28,102,52,1,"https://fbref.com/en/players/420d7c7d/Luke-Ayling"
"9523","Patrick Bamford_2022",2022,"Leeds United","Premier League","Patrick Bamford","ENG","FW","27",1993,6.2,1,0,0,1,0,0,3,0,3,8,2,6,2,3,8,0,"https://fbref.com/en/players/93feac6e/Patrick-Bamford"
"9524","Lewis Bate_2022",2022,"Leeds United","Premier League","Lewis Bate","ENG","MF","18",2002,1.6,1,0,0,0,1,0,8,0,8,1,0,1,1,2,1,0,"https://fbref.com/en/players/cd4256d3/Lewis-Bate"
"9525","Liam Cooper_2022",2022,"Leeds United","Premier League","Liam Cooper","SCO","DF","29",1991,20.2,41,23,27,13,1,23,33,69.7,10,29,18,11,43,84,72,2,"https://fbref.com/en/players/dc64b8b3/Liam-Cooper"
"9526","Hélder Costa_2022",2022,"Leeds United","Premier League","Hélder Costa","ANG","MF","27",1994,0.2,0,0,0,0,0,0,0,NA,0,1,0,1,0,0,0,0,"https://fbref.com/en/players/f13d02a6/Helder-Costa"
"9527","Charlie Cresswell_2022",2022,"Leeds United","Premier League","Charlie Cresswell","ENG","DF","18",2002,1.6,5,2,1,4,0,3,3,100,0,1,1,0,2,7,6,0,"https://fbref.com/en/players/4654e5f5/Charlie-Cresswell"
"9528","Stuart Dallas_2022",2022,"Leeds United","Premier League","Stuart Dallas","NIR","DF,MF","30",1991,32.4,93,55,58,31,4,56,105,53.3,49,45,14,31,57,150,63,2,"https://fbref.com/en/players/67ca8566/Stuart-Dallas"
"9529","Cody Drameh_2022",2022,"Leeds United","Premier League","Cody Drameh","ENG","DF,MF","19",2001,1.4,4,2,3,1,0,1,3,33.3,2,0,0,0,1,5,4,0,"https://fbref.com/en/players/e0d1510a/Cody-Drameh"
"9530","Junior Firpo_2022",2022,"Leeds United","Premier League","Junior Firpo","ESP","DF,MF","24",1996,19,61,29,30,26,5,31,59,52.5,28,22,6,16,24,85,37,0,"https://fbref.com/en/players/24f59bb2/Junior-Firpo"
"9531","Adam Forshaw_2022",2022,"Leeds United","Premier League","Adam Forshaw","ENG","MF","29",1991,17,53,23,21,27,5,21,54,38.9,33,17,1,16,19,72,12,2,"https://fbref.com/en/players/9f1938ab/Adam-Forshaw"
"9532","Leo Fuhr Hjelde_2022",2022,"Leeds United","Premier League","Leo Fuhr Hjelde","NOR","MF,DF","17",2003,1.7,5,4,3,2,0,3,3,100,0,3,3,0,4,9,7,0,"https://fbref.com/en/players/d102b8a2/Leo-Fuhr-Hjelde"
"9533","Joe Gelhardt_2022",2022,"Leeds United","Premier League","Joe Gelhardt","ENG","FW,MF","19",2002,8.3,4,3,1,0,3,2,10,20,8,9,0,9,0,4,3,0,"https://fbref.com/en/players/01962d0d/Joe-Gelhardt"
"9534","Sam Greenwood_2022",2022,"Leeds United","Premier League","Sam Greenwood","ENG","MF,FW","19",2002,2.6,8,5,0,5,3,4,7,57.1,3,3,0,3,2,10,1,0,"https://fbref.com/en/players/f3354c07/Sam-Greenwood"
"9535","Jack Harrison_2022",2022,"Leeds United","Premier League","Jack Harrison","ENG","FW,MF","24",1996,29.3,57,37,22,22,13,31,76,40.8,45,35,1,34,21,78,19,0,"https://fbref.com/en/players/aa849a12/Jack-Harrison"
"9536","Daniel James_2022",2022,"Leeds United","Premier League","Daniel James","WAL","FW,MF","23",1997,26.3,24,14,8,8,8,10,23,43.5,13,18,1,17,8,32,12,0,"https://fbref.com/en/players/c931d9f9/Daniel-James"
"9537","Kristoffer Klaesson_2022",2022,"Leeds United","Premier League","Kristoffer Klaesson","NOR","GK","20",2000,0.4,0,0,0,0,0,0,0,NA,0,0,0,0,0,0,0,0,"https://fbref.com/en/players/3f70db80/Kristoffer-Klaesson"
"9538","Mateusz Klich_2022",2022,"Leeds United","Premier League","Mateusz Klich","POL","MF","31",1990,23,47,25,18,23,6,25,66,37.9,41,22,4,18,11,58,20,0,"https://fbref.com/en/players/282679b4/Mateusz-Klich"
"9539","Robin Koch_2022",2022,"Leeds United","Premier League","Robin Koch","GER","MF,DF","25",1996,17.5,21,13,9,10,2,9,34,26.5,25,26,10,16,20,41,44,0,"https://fbref.com/en/players/ea6bc03a/Robin-Koch"
"9540","Diego Llorente_2022",2022,"Leeds United","Premier League","Diego Llorente","ESP","DF","27",1993,26,53,31,32,19,2,33,47,70.2,14,35,17,18,40,93,77,2,"https://fbref.com/en/players/bba30585/Diego-Llorente"
"9541","Liam McCarron_2022",2022,"Leeds United","Premier League","Liam McCarron","SCO","FW","20",2001,0.1,0,0,0,0,0,0,0,NA,0,1,0,1,0,0,0,0,"https://fbref.com/en/players/076bb352/Liam-McCarron"
"9542","Stuart McKinstry_2022",2022,"Leeds United","Premier League","Stuart McKinstry","SCO","MF","18",2002,0,0,0,0,0,0,0,0,NA,0,0,0,0,0,0,0,0,"https://fbref.com/en/players/1000a059/Stuart-McKinstry"
"9543","Illan Meslier_2022",2022,"Leeds United","Premier League","Illan Meslier","FRA","GK","21",2000,37.6,1,1,1,0,0,1,1,100,0,0,0,0,0,1,27,1,"https://fbref.com/en/players/6b625ac2/Illan-Meslier"
"9544","Kalvin Phillips_2022",2022,"Leeds United","Premier League","Kalvin Phillips","ENG","MF","25",1995,17.7,54,25,24,25,5,24,57,42.1,33,37,9,28,24,78,18,0,"https://fbref.com/en/players/4f565d77/Kalvin-Phillips"
"9545","Raphinha_2022",2022,"Leeds United","Premier League","Raphinha","BRA","FW,MF","24",1996,32.4,51,29,25,14,12,22,71,31,49,43,0,43,29,80,28,1,"https://fbref.com/en/players/3423f250/Raphinha"
"9546","Tyler Roberts_2022",2022,"Leeds United","Premier League","Tyler Roberts","WAL","MF,FW","22",1999,11,16,7,6,7,3,9,16,56.3,7,11,1,10,5,21,11,0,"https://fbref.com/en/players/6c17e046/Tyler-Roberts"
"9547","Rodrigo_2022",2022,"Leeds United","Premier League","Rodrigo","ESP","MF,FW","30",1991,25.2,20,9,7,6,7,4,32,12.5,28,12,0,12,11,31,27,1,"https://fbref.com/en/players/1fb1c435/Rodrigo"
"9548","Jamie Shackleton_2022",2022,"Leeds United","Premier League","Jamie Shackleton","ENG","DF,MF","21",1999,7.9,27,16,19,7,1,13,25,52,12,11,7,4,8,35,12,1,"https://fbref.com/en/players/8d03ca5a/Jamie-Shackleton"
"9549","Pascal Struijk_2022",2022,"Leeds United","Premier League","Pascal Struijk","NED","DF,MF","21",1999,22.8,61,39,34,23,4,30,50,60,20,35,23,12,33,94,60,2,"https://fbref.com/en/players/f4d296e4/Pascal-Struijk"
"9550","Crysencio Summerville_2022",2022,"Leeds United","Premier League","Crysencio Summerville","NED","MF,FW","19",2001,1.4,5,3,1,1,3,2,3,66.7,1,2,0,2,2,7,0,0,"https://fbref.com/en/players/df04eb4b/Crysencio-Summerville"
"9551","Marc Albrighton_2022",2022,"Leicester City","Premier League","Marc Albrighton","ENG","FW,DF","31",1989,12.6,31,19,16,9,6,10,47,21.3,37,15,3,12,14,45,20,0,"https://fbref.com/en/players/b827d5b3/Marc-Albrighton"
"9552","Daniel Amartey_2022",2022,"Leicester City","Premier League","Daniel Amartey","GHA","DF","26",1994,23.6,26,13,19,7,0,19,29,65.5,10,30,22,8,21,47,93,4,"https://fbref.com/en/players/1a4ef233/Daniel-Amartey"
"9553","Harvey Barnes_2022",2022,"Leicester City","Premier League","Harvey Barnes","ENG","FW,MF","23",1997,23.3,31,16,9,11,11,7,23,30.4,16,24,1,23,5,36,7,0,"https://fbref.com/en/players/3ea50f67/Harvey-Barnes"
"9554","Ryan Bertrand_2022",2022,"Leicester City","Premier League","Ryan Bertrand","ENG","DF","31",1989,3.7,8,5,3,4,1,2,5,40,3,8,3,5,1,9,7,0,"https://fbref.com/en/players/01226327/Ryan-Bertrand"
"9555","Lewis Brunt_2022",2022,"Leicester City","Premier League","Lewis Brunt","ENG","MF","20",2000,0.3,0,0,0,0,0,0,0,NA,0,1,0,1,0,0,0,0,"https://fbref.com/en/players/a2081c6b/Lewis-Brunt"
"9556","Timothy Castagne_2022",2022,"Leicester City","Premier League","Timothy Castagne","BEL","DF","25",1995,23.6,67,31,38,22,7,27,43,62.8,16,28,9,19,29,96,54,1,"https://fbref.com/en/players/197640fd/Timothy-Castagne"
"9557","Hamza Choudhury_2022",2022,"Leicester City","Premier League","Hamza Choudhury","ENG","DF,MF","23",1997,3.2,9,3,4,4,1,3,5,60,2,0,0,0,12,21,10,0,"https://fbref.com/en/players/7d2d3329/Hamza-Choudhury"
"9558","Patson Daka_2022",2022,"Leicester City","Premier League","Patson Daka","ZAM","FW","22",1998,12.9,15,10,2,8,5,2,19,10.5,17,7,0,7,2,17,8,0,"https://fbref.com/en/players/ca45605e/Patson-Daka"
"9559","Kiernan Dewsbury-Hall_2022",2022,"Leicester City","Premier League","Kiernan Dewsbury-Hall","ENG","MF","22",1998,23.4,39,24,20,14,5,19,40,47.5,21,37,8,29,21,60,26,1,"https://fbref.com/en/players/5c74c0f5/Kiernan-Dewsbury-Hall"
"9560","Jonny Evans_2022",2022,"Leicester City","Premier League","Jonny Evans","NIR","DF","33",1988,15,24,14,14,8,2,14,22,63.6,8,17,13,4,20,44,59,0,"https://fbref.com/en/players/f8fcd2a5/Jonny-Evans"
"9561","Wesley Fofana_2022",2022,"Leicester City","Premier League","Wesley Fofana","FRA","DF","20",2000,7,12,8,11,1,0,7,11,63.6,4,5,2,3,12,24,26,1,"https://fbref.com/en/players/132a82f1/Wesley-Fofana"
"9562","Kelechi Iheanacho_2022",2022,"Leicester City","Premier League","Kelechi Iheanacho","NGA","FW","24",1996,14,10,7,2,5,3,3,14,21.4,11,19,0,19,4,14,10,0,"https://fbref.com/en/players/c92e1a31/Kelechi-Iheanacho"
"9563","James Justin_2022",2022,"Leicester City","Premier League","James Justin","ENG","DF","23",1998,11.1,22,13,11,8,3,7,15,46.7,8,16,4,12,17,39,34,0,"https://fbref.com/en/players/fb614c44/James-Justin"
"9564","Ademola Lookman_2022",2022,"Leicester City","Premier League","Ademola Lookman","NGA","FW,MF","23",1997,16.1,32,14,10,13,9,10,28,35.7,18,19,1,18,10,42,4,0,"https://fbref.com/en/players/7c104bb7/Ademola-Lookman"
"9565","James Maddison_2022",2022,"Leicester City","Premier League","James Maddison","ENG","MF,FW","24",1996,27.3,40,20,8,24,8,14,46,30.4,32,18,3,15,11,51,12,0,"https://fbref.com/en/players/ee38d9c5/James-Maddison"
"9566","Kasey McAteer_2022",2022,"Leicester City","Premier League","Kasey McAteer","ENG","FW","19",2001,0,0,0,0,0,0,0,0,NA,0,0,0,0,0,0,0,0,"https://fbref.com/en/players/b2c66859/Kasey-McAteer"
"9567","Nampalys Mendy_2022",2022,"Leicester City","Premier League","Nampalys Mendy","SEN","MF","29",1992,11.5,12,6,8,4,0,6,17,35.3,11,7,4,3,11,23,11,1,"https://fbref.com/en/players/1598599e/Nampalys-Mendy"
"9568","Wilfred Ndidi_2022",2022,"Leicester City","Premier League","Wilfred Ndidi","NGA","MF,DF","24",1996,18,60,32,32,27,1,22,55,40,33,36,8,28,42,102,54,1,"https://fbref.com/en/players/6b47c5db/Wilfred-Ndidi"
"9569","Ricardo Pereira_2022",2022,"Leicester City","Premier League","Ricardo Pereira","POR","DF","27",1993,11,37,20,19,13,5,21,40,52.5,19,13,1,12,17,54,39,0,"https://fbref.com/en/players/75a72a99/Ricardo-Pereira"
"9570","Ayoze Pérez_2022",2022,"Leicester City","Premier League","Ayoze Pérez","ESP","MF,FW","28",1993,4.9,4,2,0,3,1,0,13,0,13,11,1,10,2,6,5,0,"https://fbref.com/en/players/819aa8e7/Ayoze-Perez"
"9571","Kasper Schmeichel_2022",2022,"Leicester City","Premier League","Kasper Schmeichel","DEN","GK","34",1986,37,0,0,0,0,0,0,2,0,2,0,0,0,1,1,15,2,"https://fbref.com/en/players/53af52f3/Kasper-Schmeichel"
"9572","Boubakary Soumaré_2022",2022,"Leicester City","Premier League","Boubakary Soumaré","FRA","MF","22",1999,12.2,19,13,10,8,1,8,17,47.1,9,13,1,12,14,33,18,0,"https://fbref.com/en/players/ae59b359/Boubakary-Soumare"
"9573","Çağlar Söyüncü_2022",2022,"Leicester City","Premier League","Çağlar Söyüncü","TUR","DF","25",1996,27.7,47,30,32,12,3,26,42,61.9,16,44,27,17,32,79,115,1,"https://fbref.com/en/players/21166ff4/Caglar-Soyuncu"
"9574","Luke Thomas_2022",2022,"Leicester City","Premier League","Luke Thomas","ENG","DF","20",2001,21.2,50,31,33,13,4,28,65,43.1,37,35,14,21,40,90,55,0,"https://fbref.com/en/players/fc027d02/Luke-Thomas"
"9575","Youri Tielemans_2022",2022,"Leicester City","Premier League","Youri Tielemans","BEL","MF","24",1997,29.2,74,38,23,45,6,42,100,42,58,47,13,34,21,95,41,3,"https://fbref.com/en/players/56f7a928/Youri-Tielemans"
"9576","Jamie Vardy_2022",2022,"Leicester City","Premier League","Jamie Vardy","ENG","FW","34",1987,20.1,6,5,0,4,2,1,7,14.3,6,9,0,9,1,7,17,0,"https://fbref.com/en/players/45963054/Jamie-Vardy"
"9577","Jannik Vestergaard_2022",2022,"Leicester City","Premier League","Jannik Vestergaard","DEN","DF","28",1992,6.3,15,10,12,3,0,8,15,53.3,7,10,8,2,7,22,36,0,"https://fbref.com/en/players/1900032e/Jannik-Vestergaard"
"9578","Danny Ward_2022",2022,"Leicester City","Premier League","Danny Ward","WAL","GK","28",1993,1,0,0,0,0,0,0,0,NA,0,0,0,0,0,0,1,0,"https://fbref.com/en/players/d3ce0e89/Danny-Ward"
"9579","Ibrahima Baldé_2022",2022,"Lens","Ligue 1","Ibrahima Baldé","FRA","FW,MF","18",2003,0.6,0,0,0,0,0,0,0,NA,0,0,0,0,0,0,0,0,"https://fbref.com/en/players/a30cb0d4/Ibrahima-Balde"
"9580","Simon Banza_2022",2022,"Lens","Ligue 1","Simon Banza","FRA","FW","24",1996,1.4,2,1,0,0,2,0,2,0,2,1,0,1,1,3,2,0,"https://fbref.com/en/players/be47b750/Simon-Banza"
"9581","Patrick Berg_2022",2022,"Lens","Ligue 1","Patrick Berg","NOR","MF","23",1997,3.4,14,6,6,8,0,0,4,0,4,2,1,1,4,18,3,0,"https://fbref.com/en/players/e4114f5d/Patrick-Berg"
"9582","Charles Boli_2022",2022,"Lens","Ligue 1","Charles Boli","FRA","MF,DF","22",1998,0.4,2,1,0,2,0,0,0,NA,0,0,0,0,0,2,0,0,"https://fbref.com/en/players/bbdd999a/Charles-Boli"
"9583","Ismaëlben Boura_2022",2022,"Lens","Ligue 1","Ismaëlben Boura","FRA","DF","20",2000,1.1,2,2,1,1,0,0,0,NA,0,1,1,0,2,4,5,0,"https://fbref.com/en/players/62e02107/Ismaelben-Boura"
"9584","Yannick Cahuzac_2022",2022,"Lens","Ligue 1","Yannick Cahuzac","FRA","MF","36",1985,6.9,5,2,2,3,0,0,5,0,5,8,2,6,9,14,12,0,"https://fbref.com/en/players/677ee102/Yannick-Cahuzac"
"9585","Jonathan Clauss_2022",2022,"Lens","Ligue 1","Jonathan Clauss","FRA","DF","28",1992,33.8,63,34,33,20,10,22,55,40,33,43,1,42,73,136,51,0,"https://fbref.com/en/players/5219ab4a/Jonathan-Clauss"
"9586","David Pereira da Costa_2022",2022,"Lens","Ligue 1","David Pereira da Costa","POR","MF,FW","20",2001,16.3,22,12,9,6,7,11,26,42.3,15,12,0,12,13,35,5,0,"https://fbref.com/en/players/59948ef7/David-Pereira-da-Costa"
"9587","Kevin Danso_2022",2022,"Lens","Ligue 1","Kevin Danso","AUT","DF","22",1998,31,41,29,29,12,0,23,34,67.6,11,38,25,13,40,81,111,0,"https://fbref.com/en/players/6e33125f/Kevin-Danso"
"9588","Cheick Doucouré_2022",2022,"Lens","Ligue 1","Cheick Doucouré","MLI","MF","21",2000,32.7,75,43,34,34,7,35,79,44.3,44,30,7,23,68,143,24,0,"https://fbref.com/en/players/ce4f40c7/Cheick-Doucoure"
"9589","Wuilker Faríñez_2022",2022,"Lens","Ligue 1","Wuilker Faríñez","VEN","GK","23",1998,12.3,0,0,0,0,0,0,0,NA,0,0,0,0,0,0,4,0,"https://fbref.com/en/players/2c127b6f/Wuilker-Farinez"
"9590","Seko Fofana_2022",2022,"Lens","Ligue 1","Seko Fofana","CIV","MF","26",1995,37.3,27,19,11,13,3,12,58,20.7,46,24,2,22,26,53,17,1,"https://fbref.com/en/players/5313ed43/Seko-Fofana"
"9591","Steven Fortes_2022",2022,"Lens","Ligue 1","Steven Fortes","CPV","DF","29",1992,1,2,0,2,0,0,1,2,50,1,2,1,1,0,2,4,0,"https://fbref.com/en/players/574aa9ec/Steven-Fortes"
"9592","Przemysław Frankowski_2022",2022,"Lens","Ligue 1","Przemysław Frankowski","POL","DF","26",1995,27.2,57,39,22,27,8,36,74,48.6,38,27,0,27,28,85,52,0,"https://fbref.com/en/players/00a8d210/Przemyslaw-Frankowski"
"9593","Ignatius Ganago_2022",2022,"Lens","Ligue 1","Ignatius Ganago","CMR","FW","22",1999,11.4,3,2,1,2,0,2,6,33.3,4,4,0,4,2,5,3,0,"https://fbref.com/en/players/23c63b7f/Ignatius-Ganago"
"9594","Jonathan Gradit_2022",2022,"Lens","Ligue 1","Jonathan Gradit","FRA","DF","28",1992,34.1,60,28,24,28,8,25,45,55.6,20,39,27,12,65,125,106,0,"https://fbref.com/en/players/06c48679/Jonathan-Gradit"
"9595","Massadio Haïdara_2022",2022,"Lens","Ligue 1","Massadio Haïdara","MLI","DF","28",1992,12,28,21,18,7,3,15,24,62.5,9,18,4,14,22,50,31,0,"https://fbref.com/en/players/5167c97e/Massadio-Haidara"
"9596","Corentin Jean_2022",2022,"Lens","Ligue 1","Corentin Jean","FRA","FW,MF","26",1995,2.8,9,6,4,4,1,3,6,50,3,5,0,5,1,10,0,0,"https://fbref.com/en/players/7d9b37bf/Corentin-Jean"
"9597","Gaël Kakuta_2022",2022,"Lens","Ligue 1","Gaël Kakuta","COD","MF,FW","30",1991,18.6,22,14,2,13,7,4,20,20,16,10,0,10,4,26,3,0,"https://fbref.com/en/players/5b1bf5e3/Gael-Kakuta"
"9598","Arnaud Kalimuendo_2022",2022,"Lens","Ligue 1","Arnaud Kalimuendo","FRA","FW","19",2002,23.9,9,8,1,3,5,2,7,28.6,5,6,1,5,8,17,0,0,"https://fbref.com/en/players/bf4c41f9/Arnaud-Kalimuendo"
"9599","Jean-Louis Leca_2022",2022,"Lens","Ligue 1","Jean-Louis Leca","FRA","GK","35",1985,25.7,0,0,0,0,0,0,0,NA,0,1,0,1,1,1,11,1,"https://fbref.com/en/players/edbe46dc/Jean-Louis-Leca"
"9600","Deiver Machado_2022",2022,"Lens","Ligue 1","Deiver Machado","COL","DF,MF","27",1993,5.8,16,14,11,1,4,12,14,85.7,2,9,1,8,3,19,12,1,"https://fbref.com/en/players/b3f8bdef/Deiver-Machado"
"9601","Facundo Medina_2022",2022,"Lens","Ligue 1","Facundo Medina","ARG","DF","22",1999,28.8,61,42,34,23,4,38,62,61.3,24,24,8,16,37,98,78,3,"https://fbref.com/en/players/6f5ec8bb/Facundo-Medina"
"9602","Brayann Pereira_2022",2022,"Lens","Ligue 1","Brayann Pereira","FRA","DF,MF","18",2003,0.2,1,1,1,0,0,1,1,100,0,0,0,0,0,1,1,0,"https://fbref.com/en/players/5c42e7ce/Brayann-Pereira"
"9603","Wesley Saïd_2022",2022,"Lens","Ligue 1","Wesley Saïd","FRA","FW,MF","26",1995,7.3,10,5,1,8,1,1,9,11.1,8,4,0,4,2,12,0,0,"https://fbref.com/en/players/90fcf472/Wesley-Said"
"9604","Florian Sotoca_2022",2022,"Lens","Ligue 1","Florian Sotoca","FRA","FW,MF","30",1990,27.6,31,19,7,20,4,12,51,23.5,39,31,4,27,25,56,41,0,"https://fbref.com/en/players/7a42d0df/Florian-Sotoca"
"9605","Jonathan Varane_2022",2022,"Lens","Ligue 1","Jonathan Varane","FRA","MF","19",2001,0,0,0,0,0,0,0,0,NA,0,0,0,0,0,0,0,0,"https://fbref.com/en/players/4ade359f/Jonathan-Varane"
"9606","Christopher Wooh_2022",2022,"Lens","Ligue 1","Christopher Wooh","CMR","DF","19",2001,11.7,29,11,20,8,1,11,18,61.1,7,21,14,7,21,50,40,1,"https://fbref.com/en/players/b003239d/Christopher-Wooh"
"9607","Enis Bardhi_2022",2022,"Levante","La Liga","Enis Bardhi","MKD","MF,FW","26",1995,18.9,29,12,12,14,3,12,35,34.3,23,13,2,11,10,39,7,0,"https://fbref.com/en/players/cac2537b/Enis-Bardhi"
"9608","Martín Cáceres_2022",2022,"Levante","La Liga","Martín Cáceres","URU","DF","34",1987,7.4,2,2,2,0,0,1,5,20,4,2,2,0,11,13,16,1,"https://fbref.com/en/players/e94d79e3/Martin-Caceres"
"9609","José Campaña_2022",2022,"Levante","La Liga","José Campaña","ESP","MF","28",1993,15.8,27,16,13,10,4,12,32,37.5,20,13,2,11,21,48,19,1,"https://fbref.com/en/players/61220da2/Jose-Campana"
"9610","Álex Cantero_2022",2022,"Levante","La Liga","Álex Cantero","ESP","FW,MF","21",2000,6.8,6,4,2,3,1,1,8,12.5,7,2,0,2,1,7,0,0,"https://fbref.com/en/players/4aa253fd/Alex-Cantero"
"9611","Cárdenas_2022",2022,"Levante","La Liga","Cárdenas","ESP","GK","24",1997,24,1,1,1,0,0,0,3,0,3,0,0,0,1,2,19,0,"https://fbref.com/en/players/e1846dde/Cardenas"
"9612","Carlos Clerc_2022",2022,"Levante","La Liga","Carlos Clerc","ESP","DF","29",1992,16.8,35,17,21,10,4,7,19,36.8,12,8,3,5,26,61,32,1,"https://fbref.com/en/players/33a61a52/Carlos-Clerc"
"9613","Coke_2022",2022,"Levante","La Liga","Coke","ESP","DF","34",1987,1.3,3,2,1,1,1,3,4,75,1,1,0,1,2,5,7,0,"https://fbref.com/en/players/6d8f8441/Coke"
"9614","Óscar Duarte_2022",2022,"Levante","La Liga","Óscar Duarte","CRC","DF","32",1989,19.7,18,8,12,6,0,8,23,34.8,15,18,9,9,24,42,102,0,"https://fbref.com/en/players/aa0ac32d/Oscar-Duarte"
"9615","Omar Faraj_2022",2022,"Levante","La Liga","Omar Faraj","SWE","FW","19",2002,0,1,0,1,0,0,1,1,100,0,0,0,0,0,1,0,0,"https://fbref.com/en/players/de627c8a/Omar-Faraj"
"9616","Aitor Fernández_2022",2022,"Levante","La Liga","Aitor Fernández","ESP","GK","30",1991,13,2,1,2,0,0,2,2,100,0,0,0,0,0,2,7,0,"https://fbref.com/en/players/a01c3d54/Aitor-Fernandez"
"9617","Enric Franquesa_2022",2022,"Levante","La Liga","Enric Franquesa","ESP","DF,FW","24",1997,6.9,5,3,4,0,1,0,1,0,1,4,0,4,7,12,11,0,"https://fbref.com/en/players/40883e3a/Enric-Franquesa"
"9618","Jorge de Frutos_2022",2022,"Levante","La Liga","Jorge de Frutos","ESP","MF,FW","24",1997,19.6,33,15,14,11,8,10,51,19.6,41,11,1,10,12,45,13,0,"https://fbref.com/en/players/38ce1150/Jorge-de-Frutos"
"9619","Dani Gómez_2022",2022,"Levante","La Liga","Dani Gómez","ESP","FW","23",1998,11.8,7,4,3,2,2,4,12,33.3,8,3,0,3,3,10,5,0,"https://fbref.com/en/players/0e5ddc7c/Dani-Gomez"
"9620","José Luis Morales_2022",2022,"Levante","La Liga","José Luis Morales","ESP","FW,MF","34",1987,30.2,27,17,6,9,12,12,42,28.6,30,29,0,29,4,31,7,0,"https://fbref.com/en/players/4a478107/Jose-Luis-Morales"
"9621","Mickael Malsa_2022",2022,"Levante","La Liga","Mickael Malsa","MTQ","MF","25",1995,12.7,37,17,16,18,3,15,42,35.7,27,20,8,12,18,55,15,0,"https://fbref.com/en/players/bbc19252/Mickael-Malsa"
"9622","Roger Martí_2022",2022,"Levante","La Liga","Roger Martí","ESP","FW","30",1991,23.5,23,14,3,13,7,8,30,26.7,22,14,0,14,2,25,8,0,"https://fbref.com/en/players/0ae4e09a/Roger-Marti"
"9623","Pablo Martínez_2022",2022,"Levante","La Liga","Pablo Martínez","ESP","MF","23",1998,7.3,15,8,7,8,0,4,13,30.8,9,6,3,3,15,30,5,0,"https://fbref.com/en/players/ecc77652/Pablo-Martinez"
"9624","Gonzalo Melero_2022",2022,"Levante","La Liga","Gonzalo Melero","ESP","MF","27",1994,18.8,29,16,10,15,4,16,36,44.4,20,21,8,13,7,36,22,0,"https://fbref.com/en/players/3902e91b/Gonzalo-Melero"
"9625","Jorge Miramón_2022",2022,"Levante","La Liga","Jorge Miramón","ESP","DF","32",1989,22,36,19,16,12,8,15,44,34.1,29,15,3,12,35,71,58,0,"https://fbref.com/en/players/7f4c7c9f/Jorge-Miramon"
"9626","Shkodran Mustafi_2022",2022,"Levante","La Liga","Shkodran Mustafi","GER","DF","29",1992,7.3,9,6,6,3,0,5,9,55.6,4,6,3,3,15,24,40,0,"https://fbref.com/en/players/3f2d59fe/Shkodran-Mustafi"
"9627","Sergio Postigo_2022",2022,"Levante","La Liga","Sergio Postigo","ESP","DF","32",1988,9.4,11,7,8,2,1,4,8,50,4,7,5,2,7,18,45,1,"https://fbref.com/en/players/474ecac8/Sergio-Postigo"
"9628","Alejandro Primo_2022",2022,"Levante","La Liga","Alejandro Primo","ESP","GK","17",2004,1,0,0,0,0,0,0,0,NA,0,0,0,0,0,0,0,0,"https://fbref.com/en/players/f38284bb/Alejandro-Primo"
"9629","Pubill_2022",2022,"Levante","La Liga","Pubill","ESP","DF,MF","18",2003,5.7,12,6,10,2,0,4,8,50,4,7,2,5,4,16,8,2,"https://fbref.com/en/players/365113c0/Pubill"
"9630","Nemanja Radoja_2022",2022,"Levante","La Liga","Nemanja Radoja","SRB","MF","28",1993,13.5,25,8,9,13,3,8,20,40,12,16,9,7,22,47,16,2,"https://fbref.com/en/players/b5dd3469/Nemanja-Radoja"
"9631","Rober_2022",2022,"Levante","La Liga","Rober","ESP","DF","26",1995,22.3,36,20,27,7,2,23,39,59,16,25,15,10,30,66,90,1,"https://fbref.com/en/players/c00097d2/Rober"
"9632","Marcelo Saracchi_2022",2022,"Levante","La Liga","Marcelo Saracchi","URU","DF","23",1998,2.1,8,5,6,1,1,2,4,50,2,3,0,3,4,12,7,1,"https://fbref.com/en/players/1c96ad85/Marcelo-Saracchi"
"9633","Roberto Soldado_2022",2022,"Levante","La Liga","Roberto Soldado","ESP","FW","36",1985,7.4,3,1,0,1,2,1,3,33.3,2,4,0,4,1,4,7,0,"https://fbref.com/en/players/9d66fbe3/Roberto-Soldado"
"9634","Son_2022",2022,"Levante","La Liga","Son","ESP","DF","27",1994,21.9,28,18,16,7,5,17,34,50,17,11,5,6,19,47,33,1,"https://fbref.com/en/players/037dbd30/Son"
"9635","José Luis García Vayá_2022",2022,"Levante","La Liga","José Luis García Vayá","ESP","MF","22",1998,22.4,46,27,10,31,5,16,41,39,25,24,5,19,38,84,30,0,"https://fbref.com/en/players/27dc1378/Jose-Luis-Garcia-Vaya"
"9636","Rúben Vezo_2022",2022,"Levante","La Liga","Rúben Vezo","POR","DF","27",1994,26.9,41,29,28,12,1,26,41,63.4,15,41,25,16,36,77,105,1,"https://fbref.com/en/players/c67cd65c/Ruben-Vezo"
"9637","Nikola Vukčević_2022",2022,"Levante","La Liga","Nikola Vukčević","MNE","MF","29",1991,1.3,3,2,2,1,0,0,1,0,1,2,0,2,2,5,1,0,"https://fbref.com/en/players/4442fbcd/Nikola-Vukcevic"
"9638","Amine Adli_2022",2022,"Leverkusen","Bundesliga","Amine Adli","FRA","FW,MF","21",2000,14,27,14,10,14,3,8,15,53.3,7,26,2,24,11,38,12,0,"https://fbref.com/en/players/dcfb17f4/Amine-Adli"
"9639","Lucas Alario_2022",2022,"Leverkusen","Bundesliga","Lucas Alario","ARG","FW","28",1992,7.3,6,5,0,2,4,2,5,40,3,5,0,5,1,7,6,0,"https://fbref.com/en/players/834d0be5/Lucas-Alario"
"9640","Nadiem Amiri_2022",2022,"Leverkusen","Bundesliga","Nadiem Amiri","GER","MF,FW","24",1996,4.1,8,4,3,2,3,4,8,50,4,4,2,2,5,13,0,0,"https://fbref.com/en/players/555d5edd/Nadiem-Amiri"
"9641","Robert Andrich_2022",2022,"Leverkusen","Bundesliga","Robert Andrich","GER","MF","26",1994,20.2,33,17,18,14,1,14,28,50,14,19,7,12,31,64,46,0,"https://fbref.com/en/players/e0b113a7/Robert-Andrich"
"9642","Charles Aránguiz_2022",2022,"Leverkusen","Bundesliga","Charles Aránguiz","CHI","MF","32",1989,17.5,45,25,18,21,6,22,52,42.3,30,24,4,20,33,78,21,0,"https://fbref.com/en/players/56413b1f/Charles-Aranguiz"
"9643","Sardar Azmoun_2022",2022,"Leverkusen","Bundesliga","Sardar Azmoun","IRN","FW,MF","26",1995,4,3,1,0,2,1,0,5,0,5,2,0,2,0,3,8,0,"https://fbref.com/en/players/10549b49/Sardar-Azmoun"
"9644","Mitchel Bakker_2022",2022,"Leverkusen","Bundesliga","Mitchel Bakker","NED","DF","21",2000,20.2,33,22,16,12,5,20,34,58.8,14,13,2,11,23,56,42,3,"https://fbref.com/en/players/a8567629/Mitchel-Bakker"
"9645","Julian Baumgartlinger_2022",2022,"Leverkusen","Bundesliga","Julian Baumgartlinger","AUT","MF,FW","33",1988,1,3,1,2,1,0,1,2,50,1,1,0,1,2,5,0,0,"https://fbref.com/en/players/69374ff5/Julian-Baumgartlinger"
"9646","Karim Bellarabi_2022",2022,"Leverkusen","Bundesliga","Karim Bellarabi","GER","FW,MF","31",1990,7.6,9,4,4,4,1,3,13,23.1,10,5,0,5,9,18,4,0,"https://fbref.com/en/players/bee0bab1/Karim-Bellarabi"
"9647","Iker Bravo_2022",2022,"Leverkusen","Bundesliga","Iker Bravo","ESP","FW","16",2005,0.1,1,1,0,1,0,0,0,NA,0,0,0,0,0,1,0,0,"https://fbref.com/en/players/db8c8860/Iker-Bravo"
"9648","Kerem Demirbay_2022",2022,"Leverkusen","Bundesliga","Kerem Demirbay","GER","MF","28",1993,22.8,52,31,19,30,3,16,41,39,25,32,9,23,33,85,21,0,"https://fbref.com/en/players/54b4dc4e/Kerem-Demirbay"
"9649","Moussa Diaby_2022",2022,"Leverkusen","Bundesliga","Moussa Diaby","FRA","FW,MF","22",1999,30.7,20,11,8,9,3,5,38,13.2,33,11,0,11,8,28,2,0,"https://fbref.com/en/players/aeed5c06/Moussa-Diaby"
"9650","Timothy Fosu-Mensah_2022",2022,"Leverkusen","Bundesliga","Timothy Fosu-Mensah","NED","DF","23",1998,1.6,5,3,3,1,1,4,4,100,0,1,0,1,2,7,2,0,"https://fbref.com/en/players/a9142dc3/Timothy-Fosu-Mensah"
"9651","Jeremie Frimpong_2022",2022,"Leverkusen","Bundesliga","Jeremie Frimpong","NED","DF","20",2000,22.8,32,18,19,12,1,12,23,52.2,11,24,6,18,17,49,40,2,"https://fbref.com/en/players/74f2e748/Jeremie-Frimpong"
"9652","Lennart Grill_2022",2022,"Leverkusen","Bundesliga","Lennart Grill","GER","GK","22",1999,1,0,0,0,0,0,0,0,NA,0,0,0,0,0,0,0,0,"https://fbref.com/en/players/37998008/Lennart-Grill"
"9653","Piero Hincapié_2022",2022,"Leverkusen","Bundesliga","Piero Hincapié","ECU","DF","19",2002,19.5,33,23,23,8,2,19,25,76,6,34,15,19,33,66,56,2,"https://fbref.com/en/players/0c7a48f8/Piero-Hincapie"
"9654","Lukáš Hrádecký_2022",2022,"Leverkusen","Bundesliga","Lukáš Hrádecký","FIN","GK","31",1989,32,1,1,1,0,0,1,1,100,0,0,0,0,0,1,10,1,"https://fbref.com/en/players/ad3389d5/Lukas-Hradecky"
"9655","Odilon Kossonou_2022",2022,"Leverkusen","Bundesliga","Odilon Kossonou","CIV","DF","20",2001,19.9,23,17,16,6,1,15,25,60,10,36,14,22,26,49,66,0,"https://fbref.com/en/players/1f3afdcb/Odilon-Kossonou"
"9656","Andrey Lunyov_2022",2022,"Leverkusen","Bundesliga","Andrey Lunyov","RUS","GK","29",1991,1,0,0,0,0,0,0,0,NA,0,0,0,0,0,0,0,0,"https://fbref.com/en/players/8a6ab963/Andrey-Lunyov"
"9657","Exequiel Palacios_2022",2022,"Leverkusen","Bundesliga","Exequiel Palacios","ARG","MF","22",1998,12.2,30,19,12,14,4,15,38,39.5,23,20,1,19,28,58,11,2,"https://fbref.com/en/players/e82adcab/Exequiel-Palacios"
"9658","Paulinho_2022",2022,"Leverkusen","Bundesliga","Paulinho","BRA","FW,MF","21",2000,13.5,22,13,6,13,3,13,27,48.1,14,14,1,13,6,28,7,0,"https://fbref.com/en/players/53070b63/Paulinho"
"9659","Joel Pohjanpalo_2022",2022,"Leverkusen","Bundesliga","Joel Pohjanpalo","FIN","FW","26",1994,0.1,0,0,0,0,0,0,0,NA,0,0,0,0,0,0,0,0,"https://fbref.com/en/players/ea003d07/Joel-Pohjanpalo"
"9660","Panagiotis Retsos_2022",2022,"Leverkusen","Bundesliga","Panagiotis Retsos","GRE","DF,FW","22",1998,0.4,0,0,0,0,0,0,0,NA,0,0,0,0,1,1,0,1,"https://fbref.com/en/players/4bd00a50/Panagiotis-Retsos"
"9661","Patrik Schick_2022",2022,"Leverkusen","Bundesliga","Patrik Schick","CZE","FW","25",1996,23.1,5,2,2,2,1,1,9,11.1,8,6,1,5,3,8,28,0,"https://fbref.com/en/players/5d4f7d61/Patrik-Schick"
"9662","Zidan Sertdemir_2022",2022,"Leverkusen","Bundesliga","Zidan Sertdemir","DEN","MF,FW","16",2005,0.2,2,2,2,0,0,0,0,NA,0,0,0,0,0,2,0,0,"https://fbref.com/en/players/eec1f7f4/Zidan-Sertdemir"
"9663","Daley Sinkgraven_2022",2022,"Leverkusen","Bundesliga","Daley Sinkgraven","NED","DF","26",1995,3.9,6,2,4,0,2,3,7,42.9,4,3,1,2,3,9,6,0,"https://fbref.com/en/players/73000a79/Daley-Sinkgraven"
"9664","Jonathan Tah_2022",2022,"Leverkusen","Bundesliga","Jonathan Tah","GER","DF","25",1996,32,25,18,19,5,1,17,33,51.5,16,31,20,11,43,68,156,0,"https://fbref.com/en/players/bd142efb/Jonathan-Tah"
"9665","Edmond Tapsoba_2022",2022,"Leverkusen","Bundesliga","Edmond Tapsoba","BFA","DF","22",1999,20.2,35,17,24,10,1,20,32,62.5,12,27,15,12,29,64,72,1,"https://fbref.com/en/players/a73c8f95/Edmond-Tapsoba"
"9666","Florian Wirtz_2022",2022,"Leverkusen","Bundesliga","Florian Wirtz","GER","MF,FW","18",2003,20.6,25,10,6,16,3,10,28,35.7,18,12,1,11,13,38,4,0,"https://fbref.com/en/players/e7fcf289/Florian-Wirtz"
"9667","Benjamin André_2022",2022,"Lille","Ligue 1","Benjamin André","FRA","MF","30",1990,30.6,123,69,49,65,9,51,113,45.1,62,49,11,38,50,173,56,0,"https://fbref.com/en/players/ef9c1c95/Benjamin-Andre"
"9668","Jonathan Bamba_2022",2022,"Lille","Ligue 1","Jonathan Bamba","CIV","MF,FW","25",1996,27,30,12,13,9,8,13,36,36.1,23,24,1,23,21,51,10,0,"https://fbref.com/en/players/b2bd0f6c/Jonathan-Bamba"
"9669","Hatem Ben Arfa_2022",2022,"Lille","Ligue 1","Hatem Ben Arfa","FRA","FW,MF","34",1987,3.5,4,2,2,1,1,2,4,50,2,3,0,3,0,4,1,0,"https://fbref.com/en/players/74dc806c/Hatem-Ben-Arfa"
"9670","Sven Botman_2022",2022,"Lille","Ligue 1","Sven Botman","NED","DF","21",2000,25,24,11,13,11,0,12,18,66.7,6,32,21,11,26,50,116,0,"https://fbref.com/en/players/ccce7025/Sven-Botman"
"9671","Domagoj Bradarić_2022",2022,"Lille","Ligue 1","Domagoj Bradarić","CRO","DF","21",1999,4.6,11,9,8,2,1,7,12,58.3,5,5,2,3,10,21,7,1,"https://fbref.com/en/players/8bbe2df5/Domagoj-Bradaric"
"9672","Zeki Çelik_2022",2022,"Lille","Ligue 1","Zeki Çelik","TUR","DF","24",1997,30,64,37,43,17,4,36,63,57.1,27,32,9,23,43,107,62,2,"https://fbref.com/en/players/31a62dc7/Zeki-Celik"
"9673","Leonardo César Jardim_2022",2022,"Lille","Ligue 1","Leonardo César Jardim","BRA","GK","26",1995,17,NA,0,NA,NA,NA,NA,NA,NA,NA,NA,NA,NA,1,NA,NA,NA,"https://fbref.com/en/players/f5dfc256/Leonardo-Cesar-Jardim"
"9674","Jonathan David_2022",2022,"Lille","Ligue 1","Jonathan David","CAN","FW","21",2000,31.2,24,9,7,11,6,9,30,30,21,14,4,10,5,29,15,0,"https://fbref.com/en/players/ce50fd99/Jonathan-David"
"9675","Tiago Djaló_2022",2022,"Lille","Ligue 1","Tiago Djaló","POR","DF","21",2000,25.9,60,39,39,19,2,26,39,66.7,13,26,10,16,24,84,71,0,"https://fbref.com/en/players/b2336681/Tiago-Djalo"
"9676","José Fonte_2022",2022,"Lille","Ligue 1","José Fonte","POR","DF","37",1983,38,23,12,14,7,2,11,25,44,14,39,32,7,44,67,159,1,"https://fbref.com/en/players/90f87966/Jose-Fonte"
"9677","Angel Gomes_2022",2022,"Lille","Ligue 1","Angel Gomes","ENG","MF,FW","20",2000,10.6,23,13,6,12,5,10,15,66.7,5,4,0,4,3,26,4,0,"https://fbref.com/en/players/645a3363/Angel-Gomes"
"9678","Ivo Grbić_2022",2022,"Lille","Ligue 1","Ivo Grbić","CRO","GK","25",1996,21,0,0,0,0,0,0,0,NA,0,0,0,0,0,0,14,1,"https://fbref.com/en/players/3f034750/Ivo-Grbic"
"9679","Gabriel Gudmundsson_2022",2022,"Lille","Ligue 1","Gabriel Gudmundsson","SWE","DF,MF","22",1999,14.9,43,31,24,16,3,17,35,48.6,18,15,3,12,20,63,13,0,"https://fbref.com/en/players/d5d22a58/Gabriel-Gudmundsson"
"9680","Jonathan Ikone_2022",2022,"Lille","Ligue 1","Jonathan Ikone","FRA","MF,FW","23",1998,11.8,11,3,6,4,1,4,11,36.4,7,13,1,12,5,16,4,0,"https://fbref.com/en/players/42eaa028/Jonathan-Ikone"
"9681","Isaac Lihadji_2022",2022,"Lille","Ligue 1","Isaac Lihadji","FRA","MF,FW","19",2002,2.6,3,3,1,1,1,1,5,20,4,1,0,1,2,5,0,0,"https://fbref.com/en/players/57a46f3f/Isaac-Lihadji"
"9682","Reinildo Mandava_2022",2022,"Lille","Ligue 1","Reinildo Mandava","MOZ","DF","27",1994,16.9,43,23,29,11,3,32,51,62.7,19,13,4,9,37,80,55,0,"https://fbref.com/en/players/c20bdcd7/Reinildo-Mandava"
"9683","Cheikh Niasse_2022",2022,"Lille","Ligue 1","Cheikh Niasse","SEN","FW,MF","21",2000,0.5,2,2,0,2,0,2,3,66.7,1,1,1,0,1,3,2,0,"https://fbref.com/en/players/ff20acfe/Cheikh-Niasse"
"9684","Amadou Onana_2022",2022,"Lille","Ligue 1","Amadou Onana","BEL","MF","19",2001,15.1,48,31,17,27,4,18,25,72,7,10,3,7,30,78,19,0,"https://fbref.com/en/players/828657ff/Amadou-Onana"
"9685","Jérémy Pied_2022",2022,"Lille","Ligue 1","Jérémy Pied","FRA","DF,FW","32",1989,0.1,0,0,0,0,0,0,0,NA,0,0,0,0,1,1,0,0,"https://fbref.com/en/players/a634b9d2/Jeremy-Pied"
"9686","Renato Sanches_2022",2022,"Lille","Ligue 1","Renato Sanches","POR","MF,FW","23",1997,18.3,19,7,8,10,1,9,26,34.6,17,14,3,11,14,33,7,0,"https://fbref.com/en/players/032f894e/Renato-Sanches"
"9687","Timothy Weah_2022",2022,"Lille","Ligue 1","Timothy Weah","USA","MF,FW","21",2000,18,19,7,8,8,3,10,20,50,10,16,1,15,10,29,7,0,"https://fbref.com/en/players/8eec784d/Timothy-Weah"
"9688","Xeka_2022",2022,"Lille","Ligue 1","Xeka","POR","MF","26",1994,18,47,27,18,24,5,27,56,48.2,29,23,3,20,24,71,26,1,"https://fbref.com/en/players/f3600c02/Xeka"
"9689","Yusuf Yazıcı_2022",2022,"Lille","Ligue 1","Yusuf Yazıcı","TUR","MF,FW","24",1997,5.7,10,5,3,6,1,1,9,11.1,8,4,0,4,2,12,1,0,"https://fbref.com/en/players/f5c8b425/Yusuf-Yazici"
"9690","Burak Yılmaz_2022",2022,"Lille","Ligue 1","Burak Yılmaz","TUR","FW","36",1985,24.6,7,2,0,2,5,2,17,11.8,15,8,1,7,2,9,11,0,"https://fbref.com/en/players/165a2e40/Burak-Yilmaz"
"9691","Leny Yoro_2022",2022,"Lille","Ligue 1","Leny Yoro","FRA","MF","15",2005,0.1,1,0,0,1,0,0,0,NA,0,1,0,1,0,1,0,0,"https://fbref.com/en/players/6763f716/Leny-Yoro"
"9692","Edon Zhegrova_2022",2022,"Lille","Ligue 1","Edon Zhegrova","KVX","MF,FW","22",1999,5.3,14,5,2,8,4,5,6,83.3,1,4,1,3,2,16,2,0,"https://fbref.com/en/players/34a88e3e/Edon-Zhegrova"
"9693","Thiago Alcántara_2022",2022,"Liverpool","Premier League","Thiago Alcántara","ESP","MF","30",1991,17,48,29,14,24,10,10,42,23.8,32,22,2,20,26,74,13,2,"https://fbref.com/en/players/77e84962/Thiago-Alcantara"
"9694","Trent Alexander-Arnold_2022",2022,"Liverpool","Premier League","Trent Alexander-Arnold","ENG","DF","22",1998,31.7,40,23,19,13,8,27,60,45,33,22,4,18,43,83,40,0,"https://fbref.com/en/players/cd1acf9d/Trent-Alexander-Arnold"
"9695","Alisson_2022",2022,"Liverpool","Premier League","Alisson","BRA","GK","28",1992,36,3,1,3,0,0,3,5,60,2,1,0,1,0,3,28,1,"https://fbref.com/en/players/7a2e46a8/Alisson"
"9696","Luis Díaz_2022",2022,"Liverpool","Premier League","Luis Díaz","COL","FW","24",1997,10.6,9,7,3,5,1,2,8,25,6,7,0,7,4,13,2,0,"https://fbref.com/en/players/4a1a9578/Luis-Diaz"
"9697","Harvey Elliott_2022",2022,"Liverpool","Premier League","Harvey Elliott","ENG","MF","18",2003,3.8,3,0,1,1,1,0,6,0,6,8,1,7,4,7,2,0,"https://fbref.com/en/players/c8387671/Harvey-Elliott"
"9698","Fabinho_2022",2022,"Liverpool","Premier League","Fabinho","BRA","MF","27",1993,25.7,46,25,17,23,6,24,70,34.3,46,33,10,23,39,85,25,1,"https://fbref.com/en/players/7f3b388c/Fabinho"
"9699","Roberto Firmino_2022",2022,"Liverpool","Premier League","Roberto Firmino","BRA","FW","29",1991,11,23,14,5,8,10,3,16,18.8,13,20,0,20,4,27,3,0,"https://fbref.com/en/players/4c370d81/Roberto-Firmino"
"9700","Joe Gomez_2022",2022,"Liverpool","Premier League","Joe Gomez","ENG","DF","24",1997,3.7,10,6,5,2,3,5,9,55.6,4,4,1,3,5,15,6,0,"https://fbref.com/en/players/7a11550b/Joe-Gomez"
"9701","Kaide Gordon_2022",2022,"Liverpool","Premier League","Kaide Gordon","ENG","FW","16",2004,0.1,1,0,0,0,1,0,0,NA,0,0,0,0,0,1,0,0,"https://fbref.com/en/players/19a9cb70/Kaide-Gordon"
"9702","Jordan Henderson_2022",2022,"Liverpool","Premier League","Jordan Henderson","ENG","MF","31",1990,28.9,36,20,9,25,2,17,44,38.6,27,25,1,24,23,59,14,0,"https://fbref.com/en/players/935e6b8f/Jordan-Henderson"
"9703","Curtis Jones_2022",2022,"Liverpool","Premier League","Curtis Jones","ENG","MF","20",2001,9.5,11,9,3,6,2,1,10,10,9,4,0,4,6,17,4,0,"https://fbref.com/en/players/4fb9c88f/Curtis-Jones"
"9704","Diogo Jota_2022",2022,"Liverpool","Premier League","Diogo Jota","POR","FW","24",1996,26.3,39,18,12,18,9,13,55,23.6,42,19,2,17,6,45,6,0,"https://fbref.com/en/players/178ae8f8/Diogo-Jota"
"9705","Naby Keïta_2022",2022,"Liverpool","Premier League","Naby Keïta","GUI","MF","26",1995,13,46,23,17,19,10,26,42,61.9,16,33,2,31,14,60,8,0,"https://fbref.com/en/players/f25c8e3a/Naby-Keita"
"9706","Caoimhín Kelleher_2022",2022,"Liverpool","Premier League","Caoimhín Kelleher","IRL","GK","22",1998,2,1,1,1,0,0,1,1,100,0,0,0,0,0,1,1,0,"https://fbref.com/en/players/62d7ef38/Caoimhin-Kelleher"
"9707","Ibrahima Konaté_2022",2022,"Liverpool","Premier League","Ibrahima Konaté","FRA","DF","22",1999,11,16,10,9,6,1,7,10,70,3,13,9,4,16,32,37,1,"https://fbref.com/en/players/5ed9b537/Ibrahima-Konate"
"9708","Sadio Mané_2022",2022,"Liverpool","Premier League","Sadio Mané","SEN","FW","29",1992,31.3,33,20,7,14,12,8,26,30.8,18,30,1,29,8,41,15,0,"https://fbref.com/en/players/c691bfe2/Sadio-Mane"
"9709","Joël Matip_2022",2022,"Liverpool","Premier League","Joël Matip","CMR","DF","29",1991,31,47,34,23,19,5,20,31,64.5,11,26,14,12,44,91,93,1,"https://fbref.com/en/players/b217ef29/Joel-Matip"
"9710","James Milner_2022",2022,"Liverpool","Premier League","James Milner","ENG","MF,DF","35",1986,9.5,28,16,12,11,5,12,29,41.4,17,19,5,14,17,45,20,0,"https://fbref.com/en/players/2f90f6b8/James-Milner"
"9711","Takumi Minamino_2022",2022,"Liverpool","Premier League","Takumi Minamino","JPN","FW,MF","26",1995,2.1,3,2,1,1,1,2,8,25,6,2,0,2,1,4,2,0,"https://fbref.com/en/players/f833a830/Takumi-Minamino"
"9712","Tyler Morton_2022",2022,"Liverpool","Premier League","Tyler Morton","ENG","MF","18",2002,0.7,0,0,0,0,0,0,2,0,2,0,0,0,3,3,0,0,"https://fbref.com/en/players/2bc28bb9/Tyler-Morton"
"9713","Divock Origi_2022",2022,"Liverpool","Premier League","Divock Origi","BEL","FW","26",1995,1.5,0,0,0,0,0,0,2,0,2,1,0,1,1,1,2,0,"https://fbref.com/en/players/43a166b4/Divock-Origi"
"9714","Alex Oxlade-Chamberlain_2022",2022,"Liverpool","Premier League","Alex Oxlade-Chamberlain","ENG","MF,FW","27",1993,8.7,15,11,2,8,5,3,14,21.4,11,12,2,10,6,21,5,0,"https://fbref.com/en/players/38c7feef/Alex-Oxlade-Chamberlain"
"9715","Andrew Robertson_2022",2022,"Liverpool","Premier League","Andrew Robertson","SCO","DF","27",1994,28.2,36,21,16,15,5,20,35,57.1,15,24,3,21,23,59,61,0,"https://fbref.com/en/players/2e4f5f03/Andrew-Robertson"
"9716","Mohamed Salah_2022",2022,"Liverpool","Premier League","Mohamed Salah","EGY","FW","29",1992,30.7,17,8,5,9,3,6,19,31.6,13,7,1,6,6,23,5,0,"https://fbref.com/en/players/e342ad68/Mohamed-Salah"
"9717","Kostas Tsimikas_2022",2022,"Liverpool","Premier League","Kostas Tsimikas","GRE","DF","25",1996,9.7,27,12,12,8,7,12,16,75,4,6,2,4,10,37,22,2,"https://fbref.com/en/players/f315ca93/Kostas-Tsimikas"
"9718","Virgil van Dijk_2022",2022,"Liverpool","Premier League","Virgil van Dijk","NED","DF","30",1991,34,16,10,11,5,0,11,16,68.8,5,21,14,7,31,47,109,0,"https://fbref.com/en/players/e06683ca/Virgil-van-Dijk"
"9719","Neco Williams_2022",2022,"Liverpool","Premier League","Neco Williams","WAL","DF","20",2001,0.1,0,0,0,0,0,0,0,NA,0,0,0,0,0,0,0,0,"https://fbref.com/en/players/dd323728/Neco-Williams"
"9720","Laurent Abergel_2022",2022,"Lorient","Ligue 1","Laurent Abergel","FRA","MF","28",1993,32.8,110,60,44,53,13,71,166,42.8,95,58,1,57,55,165,13,0,"https://fbref.com/en/players/31626657/Laurent-Abergel"
"9721","Quentin Boisgard_2022",2022,"Lorient","Ligue 1","Quentin Boisgard","FRA","MF,FW","24",1997,10.6,19,11,6,10,3,8,17,47.1,9,15,0,15,6,25,5,0,"https://fbref.com/en/players/f6496133/Quentin-Boisgard"
"9722","Redwan Bourles_2022",2022,"Lorient","Ligue 1","Redwan Bourles","FRA","MF,FW","18",2003,0.2,0,0,0,0,0,0,0,NA,0,0,0,0,0,0,0,0,"https://fbref.com/en/players/5c7895a0/Redwan-Bourles"
"9723","Igor Carioca_2022",2022,"Lorient","Ligue 1","Igor Carioca","BRA","DF","24",1996,17.5,27,16,16,8,3,15,43,34.9,28,17,2,15,25,52,28,0,"https://fbref.com/en/players/e3e32fbb/Igor-Carioca"
"9724","Stéphane Diarra_2022",2022,"Lorient","Ligue 1","Stéphane Diarra","FRA","MF,FW","22",1998,5.8,11,9,7,3,1,5,10,50,5,4,0,4,7,18,1,0,"https://fbref.com/en/players/29939a1d/Stephane-Diarra"
"9725","Matthieu Dreyer_2022",2022,"Lorient","Ligue 1","Matthieu Dreyer","FRA","GK","32",1989,16,1,1,1,0,0,1,1,100,0,0,0,0,0,1,9,0,"https://fbref.com/en/players/fbf83734/Matthieu-Dreyer"
"9726","Thomas Fontaine_2022",2022,"Lorient","Ligue 1","Thomas Fontaine","MAD","DF","30",1991,1.9,2,0,1,0,1,0,1,0,1,3,3,0,2,4,4,0,"https://fbref.com/en/players/9f90c06b/Thomas-Fontaine"
"9727","Adrian Grbić_2022",2022,"Lorient","Ligue 1","Adrian Grbić","AUT","FW,MF","24",1996,5.8,2,1,0,2,0,2,6,33.3,4,3,1,2,0,2,7,0,"https://fbref.com/en/players/4a987ffa/Adrian-Grbic"
"9728","Pierre-Yves Hamel_2022",2022,"Lorient","Ligue 1","Pierre-Yves Hamel","FRA","FW,MF","27",1994,0.3,0,0,0,0,0,0,1,0,1,0,0,0,2,2,0,0,"https://fbref.com/en/players/a99da9ec/Pierre-Yves-Hamel"
"9729","Jérôme Hergault_2022",2022,"Lorient","Ligue 1","Jérôme Hergault","FRA","DF","35",1986,3.9,3,1,1,2,0,2,5,40,3,4,1,3,4,7,7,0,"https://fbref.com/en/players/a84f9a4b/Jerome-Hergault"
"9730","Bonke Innocent_2022",2022,"Lorient","Ligue 1","Bonke Innocent","NGA","MF","25",1996,9.7,27,16,10,16,1,11,26,42.3,15,11,3,8,16,43,14,0,"https://fbref.com/en/players/546bb36e/Bonke-Innocent"
"9731","Moritz Jenz_2022",2022,"Lorient","Ligue 1","Moritz Jenz","GER","DF","22",1999,15.3,26,12,18,6,2,11,24,45.8,13,19,11,8,28,54,55,0,"https://fbref.com/en/players/ee644761/Moritz-Jenz"
"9732","Ibrahima Koné_2022",2022,"Lorient","Ligue 1","Ibrahima Koné","MLI","FW","22",1999,8.1,7,4,0,3,4,2,3,66.7,1,8,3,5,1,8,3,0,"https://fbref.com/en/players/04bb2b06/Ibrahima-Kone"
"9733","Julien Laporte_2022",2022,"Lorient","Ligue 1","Julien Laporte","FRA","DF","27",1993,32.1,63,45,35,26,2,32,64,50,32,37,22,15,54,117,174,0,"https://fbref.com/en/players/f066022d/Julien-Laporte"
"9734","Armand Lauriente_2022",2022,"Lorient","Ligue 1","Armand Lauriente","FRA","FW,MF","22",1998,27.5,33,18,9,16,8,11,30,36.7,19,27,2,25,15,48,3,0,"https://fbref.com/en/players/2d22cea7/Armand-Lauriente"
"9735","Théo Le Bris_2022",2022,"Lorient","Ligue 1","Théo Le Bris","FRA","MF","18",2002,0.7,2,1,1,1,0,1,2,50,1,2,0,2,0,2,1,0,"https://fbref.com/en/players/afe39ca8/Theo-Le-Bris"
"9736","Enzo Le Fée_2022",2022,"Lorient","Ligue 1","Enzo Le Fée","FRA","MF,FW","21",2000,24.4,70,44,25,36,9,41,90,45.6,49,25,1,24,29,99,18,0,"https://fbref.com/en/players/6f806d99/Enzo-Le-Fee"
"9737","Vincent Le Goff_2022",2022,"Lorient","Ligue 1","Vincent Le Goff","FRA","DF","31",1989,34,61,38,38,19,4,37,62,59.7,25,18,3,15,37,98,50,0,"https://fbref.com/en/players/2321ea6e/Vincent-Le-Goff"
"9738","Fabien Lemoine_2022",2022,"Lorient","Ligue 1","Fabien Lemoine","FRA","MF","34",1987,12.4,35,22,20,14,1,17,41,41.5,24,21,4,17,14,49,24,1,"https://fbref.com/en/players/54d51e22/Fabien-Lemoine"
"9739","Samuel Loric_2022",2022,"Lorient","Ligue 1","Samuel Loric","FRA","DF","21",2000,3,7,5,2,3,2,5,8,62.5,3,2,0,2,5,12,9,0,"https://fbref.com/en/players/9004f318/Samuel-Loric"
"9740","Houboulang Mendes_2022",2022,"Lorient","Ligue 1","Houboulang Mendes","FRA","DF","23",1998,35.8,58,28,37,18,3,40,57,70.2,17,41,21,20,41,99,128,4,"https://fbref.com/en/players/1545cf15/Houboulang-Mendes"
"9741","Terem Moffi_2022",2022,"Lorient","Ligue 1","Terem Moffi","NGA","FW","22",1999,30.1,17,10,3,12,2,9,32,28.1,23,11,2,9,4,21,22,0,"https://fbref.com/en/players/065dc209/Terem-Moffi"
"9742","Thomas Monconduit_2022",2022,"Lorient","Ligue 1","Thomas Monconduit","FRA","MF","30",1991,25,41,25,19,17,5,20,57,35.1,37,21,10,11,22,63,51,1,"https://fbref.com/en/players/84d94b91/Thomas-Monconduit"
"9743","Jérémy Morel_2022",2022,"Lorient","Ligue 1","Jérémy Morel","MAD","DF","37",1984,6.7,13,9,8,4,1,6,6,100,0,9,7,2,7,20,31,0,"https://fbref.com/en/players/e97150c0/Jeremy-Morel"
"9744","Baptiste Mouazan_2022",2022,"Lorient","Ligue 1","Baptiste Mouazan","FRA","MF","19",2001,1.1,4,3,2,2,0,1,3,33.3,2,3,0,3,1,5,1,0,"https://fbref.com/en/players/81ac108d/Baptiste-Mouazan"
"9745","Paul Nardi_2022",2022,"Lorient","Ligue 1","Paul Nardi","FRA","GK","27",1994,22,1,0,1,0,0,1,2,50,1,0,0,0,0,1,10,2,"https://fbref.com/en/players/2d70dbe5/Paul-Nardi"
"9746","Dango Ouattara_2022",2022,"Lorient","Ligue 1","Dango Ouattara","BFA","MF,FW","19",2002,9,21,15,9,11,1,11,23,47.8,12,10,1,9,14,35,15,1,"https://fbref.com/en/players/2f9e4435/Dango-Ouattara"
"9747","Léo Pétrot_2022",2022,"Lorient","Ligue 1","Léo Pétrot","FRA","DF","24",1997,20.2,31,17,23,8,0,21,29,72.4,8,33,17,16,22,53,86,0,"https://fbref.com/en/players/00638016/Leo-Petrot"
"9748","Sambou Soumano_2022",2022,"Lorient","Ligue 1","Sambou Soumano","SEN","FW,MF","20",2001,5,4,1,1,2,1,2,2,100,0,3,0,3,1,5,7,0,"https://fbref.com/en/players/7cc00776/Sambou-Soumano"
"9749","Houssem Aouar_2022",2022,"Lyon","Ligue 1","Houssem Aouar","ALG","MF,FW","23",1998,27.8,46,30,9,25,12,27,54,50,27,26,1,25,20,66,5,0,"https://fbref.com/en/players/a5db0bec/Houssem-Aouar"
"9750","Bradley Barcola_2022",2022,"Lyon","Ligue 1","Bradley Barcola","FRA","FW,MF","18",2002,2.9,7,4,2,3,2,1,8,12.5,7,7,1,6,2,9,1,0,"https://fbref.com/en/players/a0d55a09/Bradley-Barcola"
"9751","Jérôme Boateng_2022",2022,"Lyon","Ligue 1","Jérôme Boateng","GER","DF","32",1988,18,20,15,11,9,0,9,17,52.9,8,20,10,10,20,40,73,0,"https://fbref.com/en/players/2db2fd7b/Jerome-Boateng"
"9752","Maxence Caqueret_2022",2022,"Lyon","Ligue 1","Maxence Caqueret","FRA","MF","21",2000,25.9,73,40,29,36,8,30,80,37.5,50,38,10,28,43,116,26,2,"https://fbref.com/en/players/f81ef10d/Maxence-Caqueret"
"9753","Rayan Cherki_2022",2022,"Lyon","Ligue 1","Rayan Cherki","FRA","FW,MF","17",2003,4.9,6,2,1,3,2,4,9,44.4,5,2,0,2,1,7,0,0,"https://fbref.com/en/players/b34c63a5/Rayan-Cherki"
"9754","Maxwel Cornet_2022",2022,"Lyon","Ligue 1","Maxwel Cornet","CIV","DF","24",1996,0.7,3,1,1,0,2,3,4,75,1,0,0,0,1,4,1,0,"https://fbref.com/en/players/beb391dd/Maxwel-Cornet"
"9755","Damien Da Silva_2022",2022,"Lyon","Ligue 1","Damien Da Silva","FRA","DF","33",1988,12.5,13,9,7,5,1,5,9,55.6,4,15,10,5,22,35,53,1,"https://fbref.com/en/players/1ec7e1c5/Damien-Da-Silva"
"9756","Moussa Dembélé_2022",2022,"Lyon","Ligue 1","Moussa Dembélé","FRA","FW","25",1996,24.5,18,9,5,5,8,6,15,40,9,13,0,13,8,26,30,1,"https://fbref.com/en/players/e7986081/Moussa-Dembele"
"9757","Jason Denayer_2022",2022,"Lyon","Ligue 1","Jason Denayer","BEL","DF","26",1995,11.1,11,4,8,3,0,6,7,85.7,1,8,7,1,16,27,52,0,"https://fbref.com/en/players/47af88b8/Jason-Denayer"
"9758","Sinaly Diomande_2022",2022,"Lyon","Ligue 1","Sinaly Diomande","CIV","DF","20",2001,6.4,6,3,4,2,0,5,6,83.3,1,6,6,0,12,18,26,0,"https://fbref.com/en/players/6de23ab0/Sinaly-Diomande"
"9759","Leo Dubois_2022",2022,"Lyon","Ligue 1","Leo Dubois","FRA","DF","26",1994,19.4,43,27,22,14,7,27,46,58.7,19,27,3,24,22,65,35,1,"https://fbref.com/en/players/ff0ab48c/Leo-Dubois"
"9760","Romain Faivre_2022",2022,"Lyon","Ligue 1","Romain Faivre","FRA","FW,MF","23",1998,9.9,10,4,2,6,2,4,13,30.8,9,4,0,4,3,13,2,0,"https://fbref.com/en/players/745ca0a3/Romain-Faivre"
"9761","Bruno Guimarães_2022",2022,"Lyon","Ligue 1","Bruno Guimarães","BRA","MF","23",1997,18.2,50,31,20,25,5,23,59,39,36,21,4,17,21,71,11,1,"https://fbref.com/en/players/82518f62/Bruno-Guimaraes"
"9762","Malo Gusto_2022",2022,"Lyon","Ligue 1","Malo Gusto","FRA","DF","18",2003,20.9,55,35,29,21,5,24,40,60,16,21,6,15,33,88,41,1,"https://fbref.com/en/players/d56b9520/Malo-Gusto"
"9763","Henrique_2022",2022,"Lyon","Ligue 1","Henrique","BRA","DF","27",1994,12.3,13,7,10,1,2,5,16,31.3,11,13,1,12,22,35,14,0,"https://fbref.com/en/players/f28474a4/Henrique"
"9764","Tino Kadewere_2022",2022,"Lyon","Ligue 1","Tino Kadewere","ZIM","FW","25",1996,5.6,7,5,2,2,3,4,13,30.8,9,7,0,7,4,11,1,1,"https://fbref.com/en/players/7d08063d/Tino-Kadewere"
"9765","Habib Keita_2022",2022,"Lyon","Ligue 1","Habib Keita","MLI","MF,FW","19",2002,0.1,0,0,0,0,0,0,0,NA,0,0,0,0,0,0,0,0,"https://fbref.com/en/players/cc588cbe/Habib-Keita"
"9766","Anthony Lopes_2022",2022,"Lyon","Ligue 1","Anthony Lopes","POR","GK","30",1990,33.1,0,0,0,0,0,0,0,NA,0,0,0,0,3,3,12,3,"https://fbref.com/en/players/f00de885/Anthony-Lopes"
"9767","Castello Lukeba_2022",2022,"Lyon","Ligue 1","Castello Lukeba","FRA","DF","18",2002,23.3,34,19,27,7,0,15,23,65.2,8,18,9,9,38,72,64,2,"https://fbref.com/en/players/5b9512c5/Castello-Lukeba"
"9768","Marcelo_2022",2022,"Lyon","Ligue 1","Marcelo","BRA","DF","34",1987,2,4,3,0,4,0,4,6,66.7,2,3,2,1,4,8,10,0,"https://fbref.com/en/players/e3d0b0c4/Marcelo"
"9769","Thiago Mendes_2022",2022,"Lyon","Ligue 1","Thiago Mendes","BRA","MF,DF","29",1992,20.7,36,22,18,16,2,12,30,40,18,24,5,19,34,70,56,1,"https://fbref.com/en/players/c6e5d20f/Thiago-Mendes"
"9770","Tanguy Ndombele_2022",2022,"Lyon","Ligue 1","Tanguy Ndombele","FRA","MF","24",1996,7.8,25,14,5,17,3,12,19,63.2,7,8,3,5,3,28,6,2,"https://fbref.com/en/players/5cdddffa/Tanguy-Ndombele"
"9771","Emerson Palmieri_2022",2022,"Lyon","Ligue 1","Emerson Palmieri","ITA","DF","26",1994,25.2,46,25,16,22,8,22,34,64.7,12,23,8,15,27,73,66,0,"https://fbref.com/en/players/e0bc6fdc/Emerson-Palmieri"
"9772","Lucas Paquetá_2022",2022,"Lyon","Ligue 1","Lucas Paquetá","BRA","MF,FW","23",1997,30,68,38,24,26,18,17,51,33.3,34,43,5,38,9,77,22,0,"https://fbref.com/en/players/9b6f7fd5/Lucas-Paqueta"
"9773","Julian Pollersbeck_2022",2022,"Lyon","Ligue 1","Julian Pollersbeck","GER","GK","26",1994,4.8,0,0,0,0,0,0,0,NA,0,0,0,0,1,1,1,0,"https://fbref.com/en/players/d6f6ce93/Julian-Pollersbeck"
"9774","Jeff Reine-Adélaïde_2022",2022,"Lyon","Ligue 1","Jeff Reine-Adélaïde","FRA","MF,DF","23",1998,2.2,5,3,4,1,0,4,5,80,1,2,0,2,0,5,0,1,"https://fbref.com/en/players/d504b3e1/Jeff-Reine-Adelaide"
"9775","Xherdan Shaqiri_2022",2022,"Lyon","Ligue 1","Xherdan Shaqiri","SUI","FW,MF","29",1991,7.5,7,3,0,5,2,2,10,20,8,2,0,2,2,9,2,0,"https://fbref.com/en/players/6421ec64/Xherdan-Shaqiri"
"9776","Islam Slimani_2022",2022,"Lyon","Ligue 1","Islam Slimani","ALG","FW","33",1988,6.4,3,2,0,1,2,1,6,16.7,5,4,0,4,2,5,5,0,"https://fbref.com/en/players/ffec9769/Islam-Slimani"
"9777","Tetê_2022",2022,"Lyon","Ligue 1","Tetê","BRA","FW,MF","21",2000,6.5,10,5,4,5,1,3,13,23.1,10,4,0,4,3,13,1,0,"https://fbref.com/en/players/7120a04d/Tete"
"9778","Karl Toko Ekambi_2022",2022,"Lyon","Ligue 1","Karl Toko Ekambi","CMR","FW","28",1992,25.5,13,7,4,6,3,4,21,19,17,26,0,26,20,33,5,0,"https://fbref.com/en/players/5ceba7fc/Karl-Toko-Ekambi"
"9779","László Bénes_2022",2022,"M'Gladbach","Bundesliga","László Bénes","SVK","MF","23",1997,2.7,5,3,1,3,1,1,6,16.7,5,5,2,3,2,7,5,0,"https://fbref.com/en/players/fe888e39/Laszlo-Benes"
"9780","Keanan Bennetts_2022",2022,"M'Gladbach","Bundesliga","Keanan Bennetts","ENG","FW,DF","22",1999,0.6,2,0,1,1,0,1,1,100,0,1,0,1,0,2,0,0,"https://fbref.com/en/players/f4c7c708/Keanan-Bennetts"
"9781","Ramy Bensebaini_2022",2022,"M'Gladbach","Bundesliga","Ramy Bensebaini","ALG","DF","26",1995,22.4,42,30,24,15,3,27,44,61.4,17,33,7,26,39,81,77,1,"https://fbref.com/en/players/378825c7/Ramy-Bensebaini"
"9782","Jordan Beyer_2022",2022,"M'Gladbach","Bundesliga","Jordan Beyer","GER","DF","21",2000,15.4,46,27,32,13,1,23,39,59,16,18,5,13,15,61,52,2,"https://fbref.com/en/players/9af1f9ff/Jordan-Beyer"
"9783","Nico Elvedi_2022",2022,"M'Gladbach","Bundesliga","Nico Elvedi","SUI","DF","24",1996,27,40,24,23,17,0,22,36,61.1,14,33,22,11,34,74,83,1,"https://fbref.com/en/players/48035304/Nico-Elvedi"
"9784","Breel Embolo_2022",2022,"M'Gladbach","Bundesliga","Breel Embolo","SUI","FW","24",1997,24.1,16,11,1,12,3,3,8,37.5,5,14,2,12,6,22,7,0,"https://fbref.com/en/players/0b4f388a/Breel-Embolo"
"9785","Marvin Friedrich_2022",2022,"M'Gladbach","Bundesliga","Marvin Friedrich","GER","DF","25",1995,6.7,14,8,10,4,0,9,11,81.8,2,5,3,2,5,19,26,0,"https://fbref.com/en/players/b77f44a4/Marvin-Friedrich"
"9786","Matthias Ginter_2022",2022,"M'Gladbach","Bundesliga","Matthias Ginter","GER","DF","27",1994,26.2,36,22,20,13,3,27,40,67.5,13,21,10,11,33,69,76,0,"https://fbref.com/en/players/f521b80a/Matthias-Ginter"
"9787","Patrick Herrmann_2022",2022,"M'Gladbach","Bundesliga","Patrick Herrmann","GER","DF,FW","30",1991,8.4,15,7,5,6,4,9,24,37.5,15,10,1,9,6,21,8,0,"https://fbref.com/en/players/dfb6490a/Patrick-Herrmann"
"9788","Jonas Hofmann_2022",2022,"M'Gladbach","Bundesliga","Jonas Hofmann","GER","MF,FW","29",1992,23.1,30,20,6,17,7,17,42,40.5,25,23,0,23,12,42,10,0,"https://fbref.com/en/players/2903a856/Jonas-Hofmann"
"9789","Tony Jantschke_2022",2022,"M'Gladbach","Bundesliga","Tony Jantschke","GER","DF","31",1990,2.5,6,5,2,4,0,3,6,50,3,3,2,1,5,11,8,0,"https://fbref.com/en/players/34b54da7/Tony-Jantschke"
"9790","Kouadio Koné_2022",2022,"M'Gladbach","Bundesliga","Kouadio Koné","FRA","MF","20",2001,24.3,60,37,29,28,3,25,42,59.5,17,27,4,23,34,94,12,0,"https://fbref.com/en/players/86574238/Kouadio-Kone"
"9791","Christoph Kramer_2022",2022,"M'Gladbach","Bundesliga","Christoph Kramer","GER","MF","30",1991,8.3,28,11,15,10,3,12,28,42.9,16,18,5,13,12,40,9,0,"https://fbref.com/en/players/496aeede/Christoph-Kramer"
"9792","Stefan Lainer_2022",2022,"M'Gladbach","Bundesliga","Stefan Lainer","AUT","DF","28",1992,16.3,19,11,9,7,3,12,28,42.9,16,24,5,19,14,33,31,0,"https://fbref.com/en/players/4aea5077/Stefan-Lainer"
"9793","Torben Müsel_2022",2022,"M'Gladbach","Bundesliga","Torben Müsel","GER","MF","22",1999,0.1,0,0,0,0,0,0,0,NA,0,0,0,0,0,0,0,0,"https://fbref.com/en/players/d01b9ad6/Torben-Musel"
"9794","Luca Netz_2022",2022,"M'Gladbach","Bundesliga","Luca Netz","GER","DF,FW","18",2003,15.5,24,11,12,10,2,11,40,27.5,29,24,4,20,13,37,33,1,"https://fbref.com/en/players/e79269bd/Luca-Netz"
"9795","Florian Neuhaus_2022",2022,"M'Gladbach","Bundesliga","Florian Neuhaus","GER","MF","24",1997,23.6,55,28,24,26,5,27,64,42.2,37,38,6,32,31,86,19,4,"https://fbref.com/en/players/36a59ba4/Florian-Neuhaus"
"9796","Connor Noß_2022",2022,"M'Gladbach","Bundesliga","Connor Noß","IRL","MF","20",2001,0.6,1,0,0,1,0,0,1,0,1,1,1,0,0,1,0,0,"https://fbref.com/en/players/ccc6d365/Connor-Noss"
"9797","Alassane Pléa_2022",2022,"M'Gladbach","Bundesliga","Alassane Pléa","FRA","MF,FW","28",1993,23,18,14,6,9,3,7,20,35,13,9,1,8,4,22,9,0,"https://fbref.com/en/players/bc6bd723/Alassane-Plea"
"9798","Joe Scally_2022",2022,"M'Gladbach","Bundesliga","Joe Scally","USA","DF","18",2002,21.2,40,30,21,14,5,17,41,41.5,24,27,4,23,22,62,38,0,"https://fbref.com/en/players/236f02cd/Joe-Scally"
"9799","Tobias Sippel_2022",2022,"M'Gladbach","Bundesliga","Tobias Sippel","GER","GK","33",1988,1,0,0,0,0,0,0,0,NA,0,0,0,0,0,0,0,0,"https://fbref.com/en/players/0d8a37c2/Tobias-Sippel"
"9800","Yann Sommer_2022",2022,"M'Gladbach","Bundesliga","Yann Sommer","SUI","GK","32",1988,33,0,0,0,0,0,0,2,0,2,0,0,0,3,3,8,3,"https://fbref.com/en/players/420c18a1/Yann-Sommer"
"9801","Lars Stindl_2022",2022,"M'Gladbach","Bundesliga","Lars Stindl","GER","MF,FW","32",1988,18.1,23,15,6,14,3,9,33,27.3,24,28,2,26,10,33,14,0,"https://fbref.com/en/players/7cd6badb/Lars-Stindl"
"9802","Marcus Thuram_2022",2022,"M'Gladbach","Bundesliga","Marcus Thuram","FRA","FW","23",1997,10.9,6,5,0,5,1,1,4,25,3,5,0,5,5,11,5,0,"https://fbref.com/en/players/6f8cd6d0/Marcus-Thuram"
"9803","Hannes Wolf_2022",2022,"M'Gladbach","Bundesliga","Hannes Wolf","AUT","FW,MF","22",1999,3.4,23,12,4,13,6,10,20,50,10,10,0,10,2,25,1,0,"https://fbref.com/en/players/be42a291/Hannes-Wolf"
"9804","Denis Zakaria_2022",2022,"M'Gladbach","Bundesliga","Denis Zakaria","SUI","MF,DF","24",1996,15.5,23,14,9,10,4,12,35,34.3,23,25,5,20,19,42,22,1,"https://fbref.com/en/players/384d58d9/Denis-Zakaria"
"9805","Leandro Barreiro Martins_2022",2022,"Mainz 05","Bundesliga","Leandro Barreiro Martins","LUX","MF","21",2000,19.9,63,32,23,27,13,29,50,58,21,23,6,17,32,95,23,0,"https://fbref.com/en/players/00242b75/Leandro-Barreiro-Martins"
"9806","Stefan Bell_2022",2022,"Mainz 05","Bundesliga","Stefan Bell","GER","DF","29",1991,31.8,54,23,37,16,1,30,63,47.6,33,26,15,11,41,95,112,1,"https://fbref.com/en/players/857a5abe/Stefan-Bell"
"9807","Jean-Paul Boëtius_2022",2022,"Mainz 05","Bundesliga","Jean-Paul Boëtius","NED","MF","27",1994,20,40,23,18,17,5,22,53,41.5,31,41,3,38,25,65,11,0,"https://fbref.com/en/players/635f2732/Jean-Paul-Boetius"
"9808","Daniel Brosinski_2022",2022,"Mainz 05","Bundesliga","Daniel Brosinski","GER","DF","33",1988,4.3,2,1,1,1,0,1,1,100,0,6,0,6,3,5,9,0,"https://fbref.com/en/players/a7813ac4/Daniel-Brosinski"
"9809","Delano Burgzorg_2022",2022,"Mainz 05","Bundesliga","Delano Burgzorg","NED","MF","22",1998,0.3,1,1,1,0,0,0,1,0,1,0,0,0,0,1,0,0,"https://fbref.com/en/players/05e2d5ea/Delano-Burgzorg"
"9810","Jonathan Burkardt_2022",2022,"Mainz 05","Bundesliga","Jonathan Burkardt","GER","FW,MF","21",2000,29,17,8,0,10,7,6,25,24,19,31,5,26,8,25,16,0,"https://fbref.com/en/players/05f99a4a/Jonathan-Burkardt"
"9811","Finn Dahmen_2022",2022,"Mainz 05","Bundesliga","Finn Dahmen","GER","GK","23",1998,2,0,0,0,0,0,0,0,NA,0,0,0,0,0,0,2,0,"https://fbref.com/en/players/dee3013b/Finn-Dahmen"
"9812","Stephan Fürstner_2022",2022,"Mainz 05","Bundesliga","Stephan Fürstner","GER","MF","33",1987,0.1,0,0,0,0,0,0,2,0,2,0,0,0,0,0,1,0,"https://fbref.com/en/players/18c2e247/Stephan-Furstner"
"9813","Alexander Hack_2022",2022,"Mainz 05","Bundesliga","Alexander Hack","GER","DF","27",1993,23,52,26,35,17,0,29,46,63,17,31,14,17,51,103,95,1,"https://fbref.com/en/players/a5ec3ede/Alexander-Hack"
"9814","Marcus Ingvartsen_2022",2022,"Mainz 05","Bundesliga","Marcus Ingvartsen","DEN","FW,MF","25",1996,7.6,3,2,2,0,1,3,9,33.3,6,6,0,6,6,9,7,1,"https://fbref.com/en/players/271b8617/Marcus-Ingvartsen"
"9815","Lee Jae-sung_2022",2022,"Mainz 05","Bundesliga","Lee Jae-sung","KOR","MF,FW","28",1992,16,30,12,8,14,8,6,27,22.2,21,20,2,18,18,48,18,0,"https://fbref.com/en/players/34b0387f/Lee-Jae-sung"
"9816","Luca Kilian_2022",2022,"Mainz 05","Bundesliga","Luca Kilian","GER","FW","21",1999,0,0,0,0,0,0,0,0,NA,0,0,0,0,0,0,0,0,"https://fbref.com/en/players/610aa1e9/Luca-Kilian"
"9817","Dominik Kohr_2022",2022,"Mainz 05","Bundesliga","Dominik Kohr","GER","MF","27",1994,17.9,40,20,18,19,3,16,42,38.1,26,21,2,19,35,75,22,0,"https://fbref.com/en/players/0fbecd11/Dominik-Kohr"
"9818","Anderson Lucoqui_2022",2022,"Mainz 05","Bundesliga","Anderson Lucoqui","ANG","DF","24",1997,8.3,22,10,11,6,5,11,22,50,11,15,3,12,11,33,10,0,"https://fbref.com/en/players/5569bf9a/Anderson-Lucoqui"
"9819","Aarón Martín_2022",2022,"Mainz 05","Bundesliga","Aarón Martín","ESP","DF","24",1997,25.5,54,33,32,18,4,24,55,43.6,31,24,4,20,20,74,35,0,"https://fbref.com/en/players/2f3e911a/Aaron-Martin"
"9820","Paul Nebel_2022",2022,"Mainz 05","Bundesliga","Paul Nebel","GER","MF,FW","18",2002,2.5,5,3,3,1,1,2,3,66.7,1,0,0,0,0,5,1,0,"https://fbref.com/en/players/1b6d8083/Paul-Nebel"
"9821","David Nemeth_2022",2022,"Mainz 05","Bundesliga","David Nemeth","AUT","DF","20",2001,3.5,3,2,2,1,0,1,3,33.3,2,5,1,4,6,9,11,1,"https://fbref.com/en/players/da76715c/David-Nemeth"
"9822","Moussa Niakhate_2022",2022,"Mainz 05","Bundesliga","Moussa Niakhate","SEN","DF","25",1996,28.5,40,23,25,13,2,20,33,60.6,13,37,11,26,50,90,69,1,"https://fbref.com/en/players/00242715/Moussa-Niakhate"
"9823","Karim Onisiwo_2022",2022,"Mainz 05","Bundesliga","Karim Onisiwo","AUT","FW","29",1992,26.2,18,10,4,6,8,7,22,31.8,15,27,2,25,7,25,8,0,"https://fbref.com/en/players/f26834c7/Karim-Onisiwo"
"9824","Matondo-Merveille Papela_2022",2022,"Mainz 05","Bundesliga","Matondo-Merveille Papela","GER","MF","20",2001,0.9,3,2,2,1,0,2,3,66.7,1,2,0,2,2,5,0,0,"https://fbref.com/en/players/b4b08774/Matondo-Merveille-Papela"
"9825","Romario Rösch_2022",2022,"Mainz 05","Bundesliga","Romario Rösch","GER","MF","22",1999,0,0,0,0,0,0,0,0,NA,0,0,0,0,0,0,0,0,"https://fbref.com/en/players/87ebfdb8/Romario-Rosch"
"9826","Jerry St. Juste_2022",2022,"Mainz 05","Bundesliga","Jerry St. Juste","NED","DF","24",1996,6.7,13,9,7,6,0,7,8,87.5,1,7,3,4,14,27,14,0,"https://fbref.com/en/players/90339309/Jerry-St-Juste"
"9827","Anton Stach_2022",2022,"Mainz 05","Bundesliga","Anton Stach","GER","MF","22",1998,20.7,28,19,14,13,1,15,38,39.5,23,24,5,19,51,79,25,0,"https://fbref.com/en/players/0f59a7bf/Anton-Stach"
"9828","Kevin Stöger_2022",2022,"Mainz 05","Bundesliga","Kevin Stöger","AUT","MF","27",1993,4.7,10,5,5,5,0,4,10,40,6,6,0,6,5,15,1,1,"https://fbref.com/en/players/e5649a78/Kevin-Stoger"
"9829","Ádám Szalai_2022",2022,"Mainz 05","Bundesliga","Ádám Szalai","HUN","FW","33",1987,2.9,3,2,0,2,1,0,2,0,2,2,0,2,0,3,0,0,"https://fbref.com/en/players/53e07d0b/Adam-Szalai"
"9830","Niklas Tauer_2022",2022,"Mainz 05","Bundesliga","Niklas Tauer","GER","DF,MF","20",2001,5.4,16,9,9,7,0,9,14,64.3,5,6,2,4,9,25,14,0,"https://fbref.com/en/players/27270af4/Niklas-Tauer"
"9831","Silvan Widmer_2022",2022,"Mainz 05","Bundesliga","Silvan Widmer","SUI","DF","28",1993,32.4,60,28,32,20,8,36,61,59,25,44,16,28,43,103,59,2,"https://fbref.com/en/players/f68b64fc/Silvan-Widmer"
"9832","Robin Zentner_2022",2022,"Mainz 05","Bundesliga","Robin Zentner","GER","GK","26",1994,32,2,2,2,0,0,2,2,100,0,0,0,0,2,4,21,1,"https://fbref.com/en/players/5c4bf6ba/Robin-Zentner"
"9833","Amath_2022",2022,"Mallorca","La Liga","Amath","SEN","FW,MF","25",1996,9.8,21,11,11,6,4,7,17,41.2,10,12,0,12,7,28,7,0,"https://fbref.com/en/players/f3b1d9a2/Amath"
"9834","Josep Antoni Gayá_2022",2022,"Mallorca","La Liga","Josep Antoni Gayá","ESP","DF","21",2000,0.6,0,0,0,0,0,0,0,NA,0,1,0,1,1,1,3,1,"https://fbref.com/en/players/4a5f2032/Josep-Antoni-Gaya"
"9835","Iddrisu Baba_2022",2022,"Mallorca","La Liga","Iddrisu Baba","GHA","MF","25",1996,21.5,57,30,31,23,3,25,43,58.1,18,19,5,14,24,81,34,1,"https://fbref.com/en/players/bfd381b3/Iddrisu-Baba"
"9836","Rodrigo Battaglia_2022",2022,"Mallorca","La Liga","Rodrigo Battaglia","ARG","MF","30",1991,13.1,32,16,13,19,0,15,30,50,15,21,10,11,10,42,36,0,"https://fbref.com/en/players/d637fc22/Rodrigo-Battaglia"
"9837","Jaume Costa_2022",2022,"Mallorca","La Liga","Jaume Costa","ESP","DF","33",1988,20.3,35,26,23,7,5,23,31,74.2,8,22,7,15,23,58,55,0,"https://fbref.com/en/players/808d48f3/Jaume-Costa"
"9838","Aleix Febas_2022",2022,"Mallorca","La Liga","Aleix Febas","ESP","MF","25",1996,1.3,4,1,0,4,0,2,4,50,2,0,0,0,0,4,0,0,"https://fbref.com/en/players/38126309/Aleix-Febas"
"9839","Iñigo Ruiz de Galarreta_2022",2022,"Mallorca","La Liga","Iñigo Ruiz de Galarreta","ESP","MF","27",1993,15.3,40,21,14,21,5,14,30,46.7,16,16,2,14,20,60,21,0,"https://fbref.com/en/players/91f7631f/Inigo-Ruiz-de-Galarreta"
"9840","Giovanni González_2022",2022,"Mallorca","La Liga","Giovanni González","URU","DF","26",1994,4.1,9,3,4,4,1,3,5,60,2,7,2,5,4,13,14,0,"https://fbref.com/en/players/1fc474ae/Giovanni-Gonzalez"
"9841","Dominik Greif_2022",2022,"Mallorca","La Liga","Dominik Greif","SVK","GK","24",1997,1,0,0,0,0,0,0,0,NA,0,0,0,0,0,0,0,0,"https://fbref.com/en/players/30061f53/Dominik-Greif"
"9842","Clément Grenier_2022",2022,"Mallorca","La Liga","Clément Grenier","FRA","MF","30",1991,0.7,0,0,0,0,0,0,0,NA,0,1,1,0,0,0,1,0,"https://fbref.com/en/players/8b298f56/Clement-Grenier"
"9843","Matthew Hoppe_2022",2022,"Mallorca","La Liga","Matthew Hoppe","USA","FW,MF","20",2001,1.5,1,0,0,0,1,0,3,0,3,0,0,0,0,1,0,0,"https://fbref.com/en/players/1bc432b7/Matthew-Hoppe"
"9844","Lago Junior_2022",2022,"Mallorca","La Liga","Lago Junior","CIV","FW,MF","30",1990,2,3,2,3,0,0,3,5,60,2,0,0,0,2,5,2,0,"https://fbref.com/en/players/360d70f8/Lago-Junior"
"9845","Lee Kangin_2022",2022,"Mallorca","La Liga","Lee Kangin","KOR","MF,FW","20",2001,15.7,13,6,2,9,2,5,29,17.2,24,11,1,10,5,18,7,0,"https://fbref.com/en/players/8455ad90/Lee-Kangin"
"9846","Takefusa Kubo_2022",2022,"Mallorca","La Liga","Takefusa Kubo","JPN","FW,MF","20",2001,17.8,31,19,12,14,5,10,24,41.7,14,24,3,21,8,39,4,0,"https://fbref.com/en/players/16aa3654/Takefusa-Kubo"
"9847","Javier Llabrés_2022",2022,"Mallorca","La Liga","Javier Llabrés","ESP","FW,MF","18",2002,1.5,2,1,0,1,1,1,2,50,1,1,0,1,0,2,0,0,"https://fbref.com/en/players/38b0cf42/Javier-Llabres"
"9848","Pablo Maffeo_2022",2022,"Mallorca","La Liga","Pablo Maffeo","ESP","DF","24",1997,32.7,84,47,48,28,8,38,69,55.1,31,30,13,17,46,130,74,0,"https://fbref.com/en/players/5db04597/Pablo-Maffeo"
"9849","Jordi Mboula_2022",2022,"Mallorca","La Liga","Jordi Mboula","ESP","FW","22",1999,4.8,8,2,3,3,2,5,9,55.6,4,7,1,6,3,11,3,0,"https://fbref.com/en/players/4887118d/Jordi-Mboula"
"9850","Vedat Muriqi_2022",2022,"Mallorca","La Liga","Vedat Muriqi","KVX","FW","27",1994,16,6,3,1,3,2,1,7,14.3,6,12,0,12,6,12,29,0,"https://fbref.com/en/players/0cadc46d/Vedat-Muriqi"
"9851","Fernando Niño_2022",2022,"Mallorca","La Liga","Fernando Niño","ESP","FW","20",2000,9.8,10,4,3,2,5,2,12,16.7,10,9,2,7,3,13,15,0,"https://fbref.com/en/players/81d5c497/Fernando-Nino"
"9852","Brian Oliván_2022",2022,"Mallorca","La Liga","Brian Oliván","ESP","DF","27",1994,24.3,33,20,22,9,2,12,23,52.2,11,17,7,10,28,61,63,0,"https://fbref.com/en/players/a3e4bf46/Brian-Olivan"
"9853","Abdón Prats_2022",2022,"Mallorca","La Liga","Abdón Prats","ESP","FW","28",1992,7.1,2,2,1,0,1,1,5,20,4,5,0,5,1,3,6,0,"https://fbref.com/en/players/d1b060e2/Abdon-Prats"
"9854","Antonio Raillo_2022",2022,"Mallorca","La Liga","Antonio Raillo","ESP","DF","29",1991,17,16,7,10,4,2,5,6,83.3,1,17,14,3,18,34,81,0,"https://fbref.com/en/players/b857bd29/Antonio-Raillo"
"9855","Manolo Reina_2022",2022,"Mallorca","La Liga","Manolo Reina","ESP","GK","36",1985,21,0,0,0,0,0,0,0,NA,0,0,0,0,1,1,6,2,"https://fbref.com/en/players/605eb473/Manolo-Reina"
"9856","Sergio Rico_2022",2022,"Mallorca","La Liga","Sergio Rico","ESP","GK","27",1993,14,0,0,0,0,0,0,0,NA,0,0,0,0,0,0,5,2,"https://fbref.com/en/players/5f0241b2/Sergio-Rico"
"9857","Ángel Rodríguez_2022",2022,"Mallorca","La Liga","Ángel Rodríguez","ESP","FW,MF","34",1987,17.2,15,9,6,7,2,4,21,19,17,15,1,14,3,18,13,0,"https://fbref.com/en/players/8cfc2f69/Angel-Rodriguez"
"9858","Dani Rodríguez_2022",2022,"Mallorca","La Liga","Dani Rodríguez","ESP","MF,FW","33",1988,31.5,53,31,20,24,9,15,46,32.6,31,28,3,25,20,73,27,0,"https://fbref.com/en/players/70f8e0bd/Dani-Rodriguez"
"9859","Leonardo Román_2022",2022,"Mallorca","La Liga","Leonardo Román","ESP","GK","21",2000,2,0,0,0,0,0,0,0,NA,0,0,0,0,0,0,2,0,"https://fbref.com/en/players/924ff27e/Leonardo-Roman"
"9860","Franco Russo_2022",2022,"Mallorca","La Liga","Franco Russo","ARG","DF","26",1994,16.3,19,10,10,9,0,13,31,41.9,18,14,9,5,27,46,73,1,"https://fbref.com/en/players/b75ac54b/Franco-Russo"
"9861","Antonio Sánchez_2022",2022,"Mallorca","La Liga","Antonio Sánchez","ESP","MF,FW","24",1997,18,53,24,29,17,7,19,49,38.8,30,32,2,30,32,85,32,1,"https://fbref.com/en/players/a254bbe0/Antonio-Sanchez"
"9862","Joan Sastre Vanrell_2022",2022,"Mallorca","La Liga","Joan Sastre Vanrell","ESP","DF","24",1997,2.9,6,3,5,0,1,3,4,75,1,3,0,3,2,8,10,0,"https://fbref.com/en/players/f9acf8bf/Joan-Sastre-Vanrell"
"9863","Aleksandar Sedlar_2022",2022,"Mallorca","La Liga","Aleksandar Sedlar","SRB","DF,MF","29",1991,4.5,5,3,4,1,0,3,5,60,2,4,4,0,5,10,19,0,"https://fbref.com/en/players/a35134ae/Aleksandar-Sedlar"
"9864","Salva Sevilla_2022",2022,"Mallorca","La Liga","Salva Sevilla","ESP","MF","37",1984,16.7,18,12,8,8,2,6,17,35.3,11,12,6,6,14,32,11,0,"https://fbref.com/en/players/75bd85ea/Salva-Sevilla"
"9865","Martin Valjent_2022",2022,"Mallorca","La Liga","Martin Valjent","SVK","DF","25",1995,35.3,31,19,18,12,1,13,24,54.2,11,34,26,8,31,62,173,1,"https://fbref.com/en/players/f2c6ac01/Martin-Valjent"
"9866","Nathan Aké_2022",2022,"Manchester City","Premier League","Nathan Aké","NED","DF","26",1995,10.3,16,9,7,8,1,6,8,75,2,7,5,2,8,24,23,0,"https://fbref.com/en/players/eaeca114/Nathan-Ake"
"9867","João Cancelo_2022",2022,"Manchester City","Premier League","João Cancelo","POR","DF","27",1994,35.9,83,54,33,35,15,46,91,50.5,45,25,3,22,59,142,45,1,"https://fbref.com/en/players/bd6351cd/Joao-Cancelo"
"9868","Kayky Chagas_2022",2022,"Manchester City","Premier League","Kayky Chagas","BRA","FW","18",2003,0.1,0,0,0,0,0,0,0,NA,0,0,0,0,0,0,0,0,"https://fbref.com/en/players/17734ea0/Kayky-Chagas"
"9869","Kevin De Bruyne_2022",2022,"Manchester City","Premier League","Kevin De Bruyne","BEL","MF","30",1991,24.5,32,16,4,15,13,12,37,32.4,25,32,2,30,6,38,16,0,"https://fbref.com/en/players/e46012d4/Kevin-De-Bruyne"
"9870","Liam Delap_2022",2022,"Manchester City","Premier League","Liam Delap","ENG","FW","18",2003,0.1,0,0,0,0,0,0,0,NA,0,0,0,0,0,0,0,0,"https://fbref.com/en/players/dd897ee7/Liam-Delap"
"9871","Rúben Dias_2022",2022,"Manchester City","Premier League","Rúben Dias","POR","DF","24",1997,26.7,26,19,11,12,3,8,15,53.3,7,19,13,6,23,49,66,0,"https://fbref.com/en/players/31c69ef1/Ruben-Dias"
"9872","Ederson_2022",2022,"Manchester City","Premier League","Ederson","BRA","GK","27",1993,37,2,1,2,0,0,0,2,0,2,0,0,0,0,2,12,0,"https://fbref.com/en/players/3bb7b8b4/Ederson"
"9873","CJ Egan-Riley_2022",2022,"Manchester City","Premier League","CJ Egan-Riley","ENG","DF","18",2003,0,1,1,1,0,0,1,1,100,0,0,0,0,0,1,0,0,"https://fbref.com/en/players/d313e8ff/CJ-Egan-Riley"
"9874","Fernandinho_2022",2022,"Manchester City","Premier League","Fernandinho","BRA","MF,DF","36",1985,10.7,21,10,7,10,4,9,27,33.3,18,8,2,6,8,29,13,1,"https://fbref.com/en/players/101da2b5/Fernandinho"
"9875","Phil Foden_2022",2022,"Manchester City","Premier League","Phil Foden","ENG","FW","21",2000,23.6,16,8,10,4,2,7,17,41.2,10,9,0,9,11,27,5,0,"https://fbref.com/en/players/ed1e53f3/Phil-Foden"
"9876","Jack Grealish_2022",2022,"Manchester City","Premier League","Jack Grealish","ENG","FW","25",1995,21.3,18,17,4,10,4,5,13,38.5,8,11,1,10,8,26,7,0,"https://fbref.com/en/players/b0b4fd3e/Jack-Grealish"
"9877","İlkay Gündoğan_2022",2022,"Manchester City","Premier League","İlkay Gündoğan","GER","MF","30",1990,20.6,23,9,10,12,1,12,31,38.7,19,11,1,10,15,38,10,0,"https://fbref.com/en/players/819b3158/Ilkay-Gundogan"
"9878","Gabriel Jesus_2022",2022,"Manchester City","Premier League","Gabriel Jesus","BRA","FW","24",1997,20.9,18,12,2,4,12,6,26,23.1,20,18,0,18,15,33,8,0,"https://fbref.com/en/players/b66315ae/Gabriel-Jesus"
"9879","Aymeric Laporte_2022",2022,"Manchester City","Premier League","Aymeric Laporte","ESP","DF","27",1994,31.4,33,15,22,10,1,14,20,70,6,15,10,5,20,53,64,2,"https://fbref.com/en/players/119b9a8e/Aymeric-Laporte"
"9880","Riyad Mahrez_2022",2022,"Manchester City","Premier League","Riyad Mahrez","ALG","FW","30",1991,16.6,11,3,5,4,2,5,19,26.3,14,15,1,14,6,17,6,0,"https://fbref.com/en/players/892d5bb1/Riyad-Mahrez"
"9881","James Mcatee_2022",2022,"Manchester City","Premier League","James Mcatee","ENG","MF,FW","18",2002,0.2,0,0,0,0,0,0,2,0,2,0,0,0,0,0,0,0,"https://fbref.com/en/players/96593e89/James-Mcatee"
"9882","Benjamin Mendy_2022",2022,"Manchester City","Premier League","Benjamin Mendy","FRA","DF","27",1994,0.9,2,2,1,1,0,2,6,33.3,4,0,0,0,0,2,0,0,"https://fbref.com/en/players/5271c8f1/Benjamin-Mendy"
"9883","Cole Palmer_2022",2022,"Manchester City","Premier League","Cole Palmer","ENG","FW,MF","19",2002,1.4,2,1,1,1,0,0,2,0,2,3,0,3,1,3,0,0,"https://fbref.com/en/players/dc7f8a28/Cole-Palmer"
"9884","Rodri_2022",2022,"Manchester City","Premier League","Rodri","ESP","MF","25",1996,32,72,43,24,38,10,32,59,54.2,27,28,5,23,28,100,45,0,"https://fbref.com/en/players/6434f10d/Rodri"
"9885","Bernardo Silva_2022",2022,"Manchester City","Premier League","Bernardo Silva","POR","MF,FW","26",1994,31.7,57,29,19,19,19,31,67,46.3,36,24,2,22,20,77,19,0,"https://fbref.com/en/players/3eb22ec9/Bernardo-Silva"
"9886","Zack Steffen_2022",2022,"Manchester City","Premier League","Zack Steffen","USA","GK","26",1995,1,0,0,0,0,0,0,0,NA,0,0,0,0,0,0,2,0,"https://fbref.com/en/players/42130443/Zack-Steffen"
"9887","Raheem Sterling_2022",2022,"Manchester City","Premier League","Raheem Sterling","ENG","FW","26",1994,23.6,23,10,3,11,9,10,23,43.5,13,12,0,12,12,35,3,0,"https://fbref.com/en/players/b400bde0/Raheem-Sterling"
"9888","John Stones_2022",2022,"Manchester City","Premier League","John Stones","ENG","DF","27",1994,12.4,5,3,3,2,0,2,3,66.7,1,3,3,0,11,16,27,1,"https://fbref.com/en/players/5eecec3d/John-Stones"
"9889","Ferrán Torres_2022",2022,"Manchester City","Premier League","Ferrán Torres","ESP","FW","21",2000,3.4,2,2,0,1,1,0,3,0,3,2,0,2,0,2,1,0,"https://fbref.com/en/players/9e1035f8/Ferran-Torres"
"9890","Kyle Walker_2022",2022,"Manchester City","Premier League","Kyle Walker","ENG","DF","31",1990,19.5,15,6,7,7,1,8,17,47.1,9,14,4,10,14,29,16,1,"https://fbref.com/en/players/86dd77d1/Kyle-Walker"
"9891","Oleksandr Zinchenko_2022",2022,"Manchester City","Premier League","Oleksandr Zinchenko","UKR","DF","24",1996,11.6,20,14,7,10,3,11,20,55,9,11,3,8,14,34,15,1,"https://fbref.com/en/players/51cf8561/Oleksandr-Zinchenko"
"9892","Eric Bailly_2022",2022,"Manchester Utd","Premier League","Eric Bailly","CIV","DF","27",1994,2.4,5,4,4,0,1,3,4,75,1,4,2,2,3,8,11,0,"https://fbref.com/en/players/a1232f4e/Eric-Bailly"
"9893","Donny van de Beek_2022",2022,"Manchester Utd","Premier League","Donny van de Beek","NED","MF","24",1997,0.8,6,4,4,1,1,1,2,50,1,5,1,4,2,8,1,0,"https://fbref.com/en/players/50dc94ce/Donny-van-de-Beek"
"9894","Edinson Cavani_2022",2022,"Manchester Utd","Premier League","Edinson Cavani","URU","FW","34",1987,8.5,4,1,0,3,1,2,8,25,6,6,0,6,2,6,8,0,"https://fbref.com/en/players/527f063d/Edinson-Cavani"
"9895","Diogo Dalot_2022",2022,"Manchester Utd","Premier League","Diogo Dalot","POR","DF","22",1999,20,55,41,35,12,8,31,57,54.4,26,24,13,11,29,84,59,0,"https://fbref.com/en/players/d9565625/Diogo-Dalot"
"9896","Anthony Elanga_2022",2022,"Manchester Utd","Premier League","Anthony Elanga","SWE","FW","19",2002,13.5,26,20,12,12,2,15,29,51.7,14,17,1,16,9,35,7,0,"https://fbref.com/en/players/2fba6108/Anthony-Elanga"
"9897","Bruno Fernandes_2022",2022,"Manchester Utd","Premier League","Bruno Fernandes","POR","MF","26",1994,34.6,54,28,26,22,6,26,91,28.6,65,36,0,36,17,71,42,2,"https://fbref.com/en/players/507c7bdf/Bruno-Fernandes"
"9898","Fred_2022",2022,"Manchester Utd","Premier League","Fred","BRA","MF","28",1993,22.5,63,27,32,24,7,22,79,27.8,57,38,11,27,32,95,24,0,"https://fbref.com/en/players/b853e0ad/Fred"
"9899","Alejandro Garnacho_2022",2022,"Manchester Utd","Premier League","Alejandro Garnacho","ARG","FW,MF","17",2004,0.1,0,0,0,0,0,0,1,0,1,0,0,0,0,0,0,0,"https://fbref.com/en/players/7aa8adfe/Alejandro-Garnacho"
"9900","David de Gea_2022",2022,"Manchester Utd","Premier League","David de Gea","ESP","GK","30",1990,38,0,0,0,0,0,0,0,NA,0,0,0,0,0,0,11,2,"https://fbref.com/en/players/7ba6d84e/David-de-Gea"
"9901","Mason Greenwood_2022",2022,"Manchester Utd","Premier League","Mason Greenwood","ENG","FW,MF","19",2001,14.1,15,9,9,1,5,3,9,33.3,6,5,0,5,1,16,6,0,"https://fbref.com/en/players/58eee997/Mason-Greenwood"
"9902","Daniel James_2022",2022,"Manchester Utd","Premier League","Daniel James","WAL","FW","23",1997,1.4,2,1,0,2,0,0,0,NA,0,2,0,2,0,2,1,0,"https://fbref.com/en/players/c931d9f9/Daniel-James"
"9903","Phil Jones_2022",2022,"Manchester Utd","Premier League","Phil Jones","ENG","DF","29",1992,1.8,5,5,3,1,1,2,3,66.7,1,4,4,0,3,8,8,0,"https://fbref.com/en/players/def899bd/Phil-Jones"
"9904","Victor Lindelöf_2022",2022,"Manchester Utd","Premier League","Victor Lindelöf","SWE","DF","27",1994,26.2,16,11,9,7,0,9,14,64.3,5,26,17,9,25,41,96,0,"https://fbref.com/en/players/f5deef4c/Victor-Lindelof"
"9905","Jesse Lingard_2022",2022,"Manchester Utd","Premier League","Jesse Lingard","ENG","FW,MF","28",1992,4.1,9,7,4,3,2,2,6,33.3,4,4,0,4,0,9,1,0,"https://fbref.com/en/players/810e3c74/Jesse-Lingard"
"9906","Harry Maguire_2022",2022,"Manchester Utd","Premier League","Harry Maguire","ENG","DF","28",1993,27.9,34,21,22,8,4,19,31,61.3,12,36,29,7,32,66,101,3,"https://fbref.com/en/players/d8931174/Harry-Maguire"
"9907","Anthony Martial_2022",2022,"Manchester Utd","Premier League","Anthony Martial","FRA","FW","25",1995,2.4,0,0,0,0,0,0,1,0,1,1,0,1,0,0,1,0,"https://fbref.com/en/players/8b788c01/Anthony-Martial"
"9908","Juan Mata_2022",2022,"Manchester Utd","Premier League","Juan Mata","ESP","MF","33",1988,2.6,6,4,2,3,1,3,5,60,2,1,0,1,1,7,1,0,"https://fbref.com/en/players/29733c72/Juan-Mata"
"9909","Nemanja Matić_2022",2022,"Manchester Utd","Premier League","Nemanja Matić","SRB","MF","32",1988,15.4,31,18,19,11,1,15,31,48.4,16,21,6,15,31,62,21,3,"https://fbref.com/en/players/eb7822d7/Nemanja-Matic"
"9910","Scott McTominay_2022",2022,"Manchester Utd","Premier League","Scott McTominay","SCO","MF","24",1996,26.5,65,33,32,24,9,30,61,49.2,31,45,10,35,31,96,60,1,"https://fbref.com/en/players/d93c2511/Scott-McTominay"
"9911","Hannibal Mejbri_2022",2022,"Manchester Utd","Premier League","Hannibal Mejbri","TUN","FW","18",2003,0.8,2,1,1,1,0,1,1,100,0,0,0,0,0,2,0,0,"https://fbref.com/en/players/ca22ccb0/Hannibal-Mejbri"
"9912","Paul Pogba_2022",2022,"Manchester Utd","Premier League","Paul Pogba","FRA","MF,FW","28",1993,15,13,9,5,7,1,6,28,21.4,22,11,0,11,13,26,16,0,"https://fbref.com/en/players/867239d3/Paul-Pogba"
"9913","Marcus Rashford_2022",2022,"Manchester Utd","Premier League","Marcus Rashford","ENG","FW,MF","23",1997,13.7,6,5,1,4,1,2,13,15.4,11,10,1,9,5,11,5,1,"https://fbref.com/en/players/a1d5bd30/Marcus-Rashford"
"9914","Cristiano Ronaldo_2022",2022,"Manchester Utd","Premier League","Cristiano Ronaldo","POR","FW","36",1985,27.3,8,6,1,5,2,2,6,33.3,4,8,0,8,2,10,29,0,"https://fbref.com/en/players/dea698d9/Cristiano-Ronaldo"
"9915","Jadon Sancho_2022",2022,"Manchester Utd","Premier League","Jadon Sancho","ENG","FW,MF","21",2000,21.1,14,8,9,4,1,8,22,36.4,14,19,0,19,15,29,5,3,"https://fbref.com/en/players/dbf053da/Jadon-Sancho"
"9916","Luke Shaw_2022",2022,"Manchester Utd","Premier League","Luke Shaw","ENG","DF","26",1995,17.8,21,13,9,9,3,12,21,57.1,9,22,11,11,9,30,22,2,"https://fbref.com/en/players/9c94165b/Luke-Shaw"
"9917","Shola Shoretire_2022",2022,"Manchester Utd","Premier League","Shola Shoretire","ENG","MF","17",2004,0.2,0,0,0,0,0,0,0,NA,0,0,0,0,0,0,0,0,"https://fbref.com/en/players/00f0482f/Shola-Shoretire"
"9918","Alex Telles_2022",2022,"Manchester Utd","Premier League","Alex Telles","BRA","DF","28",1992,18.4,48,27,35,9,4,27,43,62.8,16,17,4,13,26,74,45,0,"https://fbref.com/en/players/e73c9bb2/Alex-Telles"
"9919","Raphaël Varane_2022",2022,"Manchester Utd","Premier League","Raphaël Varane","FRA","DF","28",1993,20.3,28,19,21,6,1,10,22,45.5,12,18,9,9,18,46,82,1,"https://fbref.com/en/players/9f8e9423/Raphael-Varane"
"9920","Aaron Wan-Bissaka_2022",2022,"Manchester Utd","Premier League","Aaron Wan-Bissaka","ENG","DF","23",1997,19.9,49,36,25,18,6,14,20,70,6,24,14,10,34,83,41,2,"https://fbref.com/en/players/9e525177/Aaron-Wan-Bissaka"
"9921","Jordan Amavi_2022",2022,"Marseille","Ligue 1","Jordan Amavi","FRA","DF,FW","27",1994,1.4,6,5,3,1,2,5,10,50,5,1,0,1,1,7,3,0,"https://fbref.com/en/players/22721b88/Jordan-Amavi"
"9922","Cédric Bakambu_2022",2022,"Marseille","Ligue 1","Cédric Bakambu","COD","FW","30",1991,4,2,0,1,0,1,0,3,0,3,2,0,2,0,2,1,0,"https://fbref.com/en/players/0af4dcf0/Cedric-Bakambu"
"9923","Leonardo Balerdi_2022",2022,"Marseille","Ligue 1","Leonardo Balerdi","ARG","DF","22",1999,10.6,9,6,9,0,0,5,14,35.7,9,11,4,7,19,28,30,0,"https://fbref.com/en/players/7c3ed041/Leonardo-Balerdi"
"9924","Salim Ben Seghir_2022",2022,"Marseille","Ligue 1","Salim Ben Seghir","FRA","MF","18",2003,0,0,0,0,0,0,0,0,NA,0,0,0,0,0,0,0,0,"https://fbref.com/en/players/1f6298f2/Salim-Ben-Seghir"
"9925","Darío Benedetto_2022",2022,"Marseille","Ligue 1","Darío Benedetto","ARG","FW,MF","31",1990,0.6,0,0,0,0,0,0,0,NA,0,2,0,2,0,0,0,0,"https://fbref.com/en/players/bef0a7ac/Dario-Benedetto"
"9926","Duje Ćaleta-Car_2022",2022,"Marseille","Ligue 1","Duje Ćaleta-Car","CRO","DF","24",1996,22.9,21,8,15,6,0,11,14,78.6,3,11,7,4,24,45,55,2,"https://fbref.com/en/players/94f8d10c/Duje-Caleta-Car"
"9927","Konrad De La Fuente_2022",2022,"Marseille","Ligue 1","Konrad De La Fuente","USA","FW,MF","20",2001,8.7,11,7,8,2,1,7,11,63.6,4,5,0,5,2,13,4,0,"https://fbref.com/en/players/4b77bb89/Konrad-De-La-Fuente"
"9928","Bamba Dieng_2022",2022,"Marseille","Ligue 1","Bamba Dieng","SEN","FW","21",2000,10.8,17,11,5,5,7,4,14,28.6,10,7,0,7,5,22,8,0,"https://fbref.com/en/players/40774c6b/Bamba-Dieng"
"9929","Gerson_2022",2022,"Marseille","Ligue 1","Gerson","BRA","MF,FW","24",1997,28.3,42,17,16,20,6,8,35,22.9,27,26,4,22,16,58,16,2,"https://fbref.com/en/players/8827bf46/Gerson"
"9930","Álvaro González_2022",2022,"Marseille","Ligue 1","Álvaro González","ESP","DF","31",1990,5,1,1,1,0,0,1,1,100,0,0,0,0,1,2,9,0,"https://fbref.com/en/players/42dcf26d/Alvaro-Gonzalez"
"9931","Mattéo Guendouzi_2022",2022,"Marseille","Ligue 1","Mattéo Guendouzi","FRA","MF","22",1999,35,45,30,10,26,9,13,47,27.7,34,15,1,14,16,61,18,0,"https://fbref.com/en/players/5ea8ef20/Matteo-Guendouzi"
"9932","Pape Gueye_2022",2022,"Marseille","Ligue 1","Pape Gueye","SEN","MF","22",1999,17,38,19,15,22,1,16,31,51.6,15,15,3,12,24,62,16,0,"https://fbref.com/en/players/7155e3e1/Pape-Gueye"
"9933","Amine Harit_2022",2022,"Marseille","Ligue 1","Amine Harit","MAR","FW,MF","24",1997,12.9,18,11,9,9,0,9,17,52.9,8,10,0,10,4,22,2,0,"https://fbref.com/en/players/e7d59f4f/Amine-Harit"
"9934","Luis Henrique_2022",2022,"Marseille","Ligue 1","Luis Henrique","BRA","FW,MF","19",2001,7.8,4,3,2,1,1,2,5,40,3,2,0,2,5,9,1,0,"https://fbref.com/en/players/f36d5624/Luis-Henrique"
"9935","Boubacar Kamara_2022",2022,"Marseille","Ligue 1","Boubacar Kamara","FRA","MF,DF","21",1999,30.9,68,38,27,36,5,26,47,55.3,21,29,10,19,46,114,44,1,"https://fbref.com/en/players/cc77354e/Boubacar-Kamara"
"9936","Sead Kolašinac_2022",2022,"Marseille","Ligue 1","Sead Kolašinac","BIH","DF","28",1993,4.9,7,6,2,3,2,5,8,62.5,3,4,0,4,0,7,7,1,"https://fbref.com/en/players/3935e52e/Sead-Kolasinac"
"9937","Pol Lirola_2022",2022,"Marseille","Ligue 1","Pol Lirola","ESP","DF,FW","23",1997,19.7,28,16,15,9,4,13,28,46.4,15,15,0,15,13,41,22,0,"https://fbref.com/en/players/ff800ed8/Pol-Lirola"
"9938","Pau López_2022",2022,"Marseille","Ligue 1","Pau López","ESP","GK","26",1994,29,0,0,0,0,0,0,1,0,1,0,0,0,0,0,12,1,"https://fbref.com/en/players/20b9f052/Pau-Lopez"
"9939","Steve Mandanda_2022",2022,"Marseille","Ligue 1","Steve Mandanda","FRA","GK","36",1985,9,0,0,0,0,0,0,1,0,1,1,0,1,1,1,4,1,"https://fbref.com/en/players/1d2d5cc8/Steve-Mandanda"
"9940","Arkadiusz Milik_2022",2022,"Marseille","Ligue 1","Arkadiusz Milik","POL","FW","27",1994,15.7,9,2,0,5,4,4,18,22.2,14,9,1,8,3,12,10,1,"https://fbref.com/en/players/85613cf0/Arkadiusz-Milik"
"9941","Dimitri Payet_2022",2022,"Marseille","Ligue 1","Dimitri Payet","FRA","FW,MF","34",1987,28.8,16,8,4,10,2,7,31,22.6,24,9,0,9,9,25,3,0,"https://fbref.com/en/players/58ae47b2/Dimitri-Payet"
"9942","Luan Peres Petroni_2022",2022,"Marseille","Ligue 1","Luan Peres Petroni","BRA","DF","27",1994,29.8,65,35,33,25,7,36,52,69.2,16,26,12,14,43,108,64,1,"https://fbref.com/en/players/a5549ec1/Luan-Peres-Petroni"
"9943","Nemanja Radonjić_2022",2022,"Marseille","Ligue 1","Nemanja Radonjić","SRB","FW","25",1996,0.2,0,0,0,0,0,0,0,NA,0,0,0,0,0,0,0,0,"https://fbref.com/en/players/0630eb63/Nemanja-Radonjic"
"9944","Valentin Rongier_2022",2022,"Marseille","Ligue 1","Valentin Rongier","FRA","MF,DF","26",1994,24.4,77,51,36,36,5,28,60,46.7,32,26,5,21,33,110,14,0,"https://fbref.com/en/players/ed45c4a5/Valentin-Rongier"
"9945","William Saliba_2022",2022,"Marseille","Ligue 1","William Saliba","FRA","DF","20",2001,36,54,32,36,16,2,27,35,77.1,8,24,16,8,48,102,85,0,"https://fbref.com/en/players/972aeb2a/William-Saliba"
"9946","Oussama Targhalline_2022",2022,"Marseille","Ligue 1","Oussama Targhalline","MAR","FW","19",2002,0.1,0,0,0,0,0,0,0,NA,0,0,0,0,0,0,0,0,"https://fbref.com/en/players/abd56820/Oussama-Targhalline"
"9947","Cengiz Ünder_2022",2022,"Marseille","Ligue 1","Cengiz Ünder","TUR","FW,MF","24",1997,24.4,18,13,5,6,7,5,18,27.8,13,13,2,11,14,32,9,0,"https://fbref.com/en/players/1880614f/Cengiz-Under"
"9948","Sofiane Alakouch_2022",2022,"Metz","Ligue 1","Sofiane Alakouch","MAR","DF,MF","23",1998,1.8,7,4,3,4,0,2,5,40,3,4,0,4,1,8,4,0,"https://fbref.com/en/players/5314e067/Sofiane-Alakouch"
"9949","Ibrahim Amadou_2022",2022,"Metz","Ligue 1","Ibrahim Amadou","FRA","DF,MF","28",1993,9,16,8,10,6,0,8,15,53.3,7,4,2,2,14,30,26,0,"https://fbref.com/en/players/9260926b/Ibrahim-Amadou"
"9950","Amine Bassi_2022",2022,"Metz","Ligue 1","Amine Bassi","FRA","MF,FW","23",1997,2,6,3,2,3,1,1,3,33.3,2,5,0,5,0,6,0,0,"https://fbref.com/en/players/ced1d98f/Amine-Bassi"
"9951","Farid Boulaya_2022",2022,"Metz","Ligue 1","Farid Boulaya","ALG","MF,FW","28",1993,17,18,10,7,9,2,14,38,36.8,24,8,2,6,12,30,5,0,"https://fbref.com/en/players/a0791826/Farid-Boulaya"
"9952","Dylan Bronn_2022",2022,"Metz","Ligue 1","Dylan Bronn","TUN","DF","26",1995,28.3,47,29,33,13,1,20,31,64.5,11,32,19,13,40,87,78,1,"https://fbref.com/en/players/edd81e2a/Dylan-Bronn"
"9953","Marc-Aurèle Caillard_2022",2022,"Metz","Ligue 1","Marc-Aurèle Caillard","FRA","GK","27",1994,17.1,0,0,0,0,0,0,2,0,2,0,0,0,2,2,9,1,"https://fbref.com/en/players/5ee6e943/Marc-Aurele-Caillard"
"9954","Fali Candé_2022",2022,"Metz","Ligue 1","Fali Candé","GNB","DF","23",1998,10.8,30,18,13,15,2,13,31,41.9,18,11,2,9,6,36,21,0,"https://fbref.com/en/players/3cc4bb19/Fali-Cande"
"9955","Fabien Centonze_2022",2022,"Metz","Ligue 1","Fabien Centonze","FRA","DF","25",1996,17.6,33,21,22,9,2,13,32,40.6,19,37,8,29,32,65,51,0,"https://fbref.com/en/players/3c6bbbab/Fabien-Centonze"
"9956","Thomas Delaine_2022",2022,"Metz","Ligue 1","Thomas Delaine","FRA","DF","29",1992,25.7,48,35,34,12,2,22,42,52.4,20,20,7,13,27,75,31,0,"https://fbref.com/en/players/8332db56/Thomas-Delaine"
"9957","Mamadou Fofana_2022",2022,"Metz","Ligue 1","Mamadou Fofana","MLI","DF","23",1998,0.4,1,1,0,1,0,1,2,50,1,2,1,1,1,2,2,0,"https://fbref.com/en/players/4c4ffacc/Mamadou-Fofana"
"9958","Vagner Gonçalves_2022",2022,"Metz","Ligue 1","Vagner Gonçalves","CPV","FW","25",1996,1,2,1,0,2,0,1,1,100,0,0,0,0,1,3,0,0,"https://fbref.com/en/players/743fd71f/Vagner-Goncalves"
"9959","Lamine Gueye_2022",2022,"Metz","Ligue 1","Lamine Gueye","SEN","FW,MF","23",1998,6.2,5,5,1,1,3,3,7,42.9,4,4,0,4,6,11,1,0,"https://fbref.com/en/players/9d5dcc23/Lamine-Gueye"
"9960","Jemerson_2022",2022,"Metz","Ligue 1","Jemerson","BRA","DF","28",1992,13.4,37,25,30,7,0,18,26,69.2,8,23,8,15,25,62,33,1,"https://fbref.com/en/players/7cab69b5/Jemerson"
"9961","Lenny Joseph_2022",2022,"Metz","Ligue 1","Lenny Joseph","FRA","FW,MF","20",2000,1.7,2,1,1,1,0,0,0,NA,0,3,0,3,0,2,0,0,"https://fbref.com/en/players/d1828392/Lenny-Joseph"
"9962","Jean-Armel Kana-Biyik_2022",2022,"Metz","Ligue 1","Jean-Armel Kana-Biyik","CMR","DF","32",1989,7.4,10,6,8,2,0,4,9,44.4,5,11,4,7,16,26,22,1,"https://fbref.com/en/players/76a4233b/Jean-Armel-Kana-Biyik"
"9963","Boubakar Kouyaté_2022",2022,"Metz","Ligue 1","Boubakar Kouyaté","MLI","DF","24",1997,29.6,84,50,56,28,0,48,77,62.3,29,63,33,30,79,163,217,3,"https://fbref.com/en/players/562a4799/Boubakar-Kouyate"
"9964","Lenny Lacroix_2022",2022,"Metz","Ligue 1","Lenny Lacroix","FRA","DF","18",2003,2.2,9,7,8,1,0,5,8,62.5,3,5,1,4,10,19,5,0,"https://fbref.com/en/players/5413ef36/Lenny-Lacroix"
"9965","Didier Lamkel Zé_2022",2022,"Metz","Ligue 1","Didier Lamkel Zé","CMR","FW","24",1996,6.7,3,1,1,0,2,1,3,33.3,2,3,1,2,1,4,7,0,"https://fbref.com/en/players/b229aa13/Didier-Lamkel-Ze"
"9966","Louis Mafouta_2022",2022,"Metz","Ligue 1","Louis Mafouta","CTA","FW","27",1994,5.8,0,0,0,0,0,0,5,0,5,1,0,1,0,0,4,0,"https://fbref.com/en/players/bec3d251/Louis-Mafouta"
"9967","Habib Maïga_2022",2022,"Metz","Ligue 1","Habib Maïga","CIV","MF","25",1996,14.1,47,28,29,13,5,24,48,50,24,20,7,13,14,61,18,0,"https://fbref.com/en/players/e768de1f/Habib-Maiga"
"9968","Pape Matar Sarr_2022",2022,"Metz","Ligue 1","Pape Matar Sarr","SEN","MF","18",2002,23.7,45,26,21,23,1,18,39,46.2,21,33,3,30,29,74,22,0,"https://fbref.com/en/players/feb5d972/Pape-Matar-Sarr"
"9969","Amadou Mbengue_2022",2022,"Metz","Ligue 1","Amadou Mbengue","SEN","DF,MF","19",2002,6.8,19,10,10,9,0,11,22,50,11,7,2,5,10,29,19,0,"https://fbref.com/en/players/14d2670e/Amadou-Mbengue"
"9970","Georges Mikautadze_2022",2022,"Metz","Ligue 1","Georges Mikautadze","GEO","FW","20",2000,0,0,0,0,0,0,0,0,NA,0,0,0,0,0,0,0,0,"https://fbref.com/en/players/4788cb6b/Georges-Mikautadze"
"9971","William Mikelbrencis_2022",2022,"Metz","Ligue 1","William Mikelbrencis","FRA","DF","17",2004,6.8,11,5,6,4,1,6,9,66.7,3,6,3,3,5,16,9,0,"https://fbref.com/en/players/14df1d7f/William-Mikelbrencis"
"9972","Kévin N'Doram_2022",2022,"Metz","Ligue 1","Kévin N'Doram","FRA","MF","25",1996,13.7,10,8,3,5,2,3,20,15,17,24,5,19,19,29,21,0,"https://fbref.com/en/players/e50623a0/Kevin-NDoram"
"9973","Papa Ndiaga Yade_2022",2022,"Metz","Ligue 1","Papa Ndiaga Yade","SEN","DF,FW","21",2000,7.7,15,10,8,7,0,8,18,44.4,10,4,1,3,10,25,9,0,"https://fbref.com/en/players/87e9c7cd/Papa-Ndiaga-Yade"
"9974","Opa Nguette_2022",2022,"Metz","Ligue 1","Opa Nguette","SEN","FW,MF","27",1994,11.6,21,14,9,6,6,5,14,35.7,9,13,3,10,2,23,9,0,"https://fbref.com/en/players/75a63397/Opa-Nguette"
"9975","Sikou Niakaté_2022",2022,"Metz","Ligue 1","Sikou Niakaté","FRA","DF","22",1999,7.3,8,7,8,0,0,4,11,36.4,7,5,3,2,27,35,34,0,"https://fbref.com/en/players/8eef18aa/Sikou-Niakate"
"9976","Ibrahima Niane_2022",2022,"Metz","Ligue 1","Ibrahima Niane","SEN","FW","22",1999,17.6,1,1,0,1,0,0,5,0,5,6,1,5,3,4,16,0,"https://fbref.com/en/players/46faabfa/Ibrahima-Niane"
"9977","Alexandre Oukidja_2022",2022,"Metz","Ligue 1","Alexandre Oukidja","ALG","GK","33",1988,20.8,0,0,0,0,0,0,1,0,1,1,0,1,1,1,17,2,"https://fbref.com/en/players/ae7d0ecd/Alexandre-Oukidja"
"9978","Vincent Pajot_2022",2022,"Metz","Ligue 1","Vincent Pajot","FRA","MF","30",1990,25.7,86,56,35,47,4,20,46,43.5,26,33,6,27,51,137,38,0,"https://fbref.com/en/players/f86ca403/Vincent-Pajot"
"9979","Nicolas de Préville_2022",2022,"Metz","Ligue 1","Nicolas de Préville","FRA","FW,MF","30",1991,21.9,17,8,7,8,2,3,19,15.8,16,12,4,8,5,22,11,0,"https://fbref.com/en/players/b0547a87/Nicolas-de-Preville"
"9980","Warren Tchimbembé_2022",2022,"Metz","Ligue 1","Warren Tchimbembé","CGO","MF","23",1998,2.3,1,1,0,1,0,0,1,0,1,2,1,1,2,3,2,0,"https://fbref.com/en/players/93b8f9f4/Warren-Tchimbembe"
"9981","Cheikh Tidiane Sabaly_2022",2022,"Metz","Ligue 1","Cheikh Tidiane Sabaly","SEN","FW,MF","22",1999,1.7,6,3,1,4,1,2,2,100,0,1,0,1,0,6,1,0,"https://fbref.com/en/players/9ddf7fae/Cheikh-Tidiane-Sabaly"
"9982","Boubacar Traoré_2022",2022,"Metz","Ligue 1","Boubacar Traoré","MLI","MF","19",2001,19.2,43,26,18,23,2,10,39,25.6,29,29,5,24,25,68,11,1,"https://fbref.com/en/players/999ceb5f/Boubacar-Traore"
"9983","Matthieu Udol_2022",2022,"Metz","Ligue 1","Matthieu Udol","FRA","DF","25",1996,11.2,23,14,11,10,2,12,18,66.7,6,20,7,13,31,54,29,1,"https://fbref.com/en/players/cc41f558/Matthieu-Udol"
"9984","Tiemoué Bakayoko_2022",2022,"Milan","Serie A","Tiemoué Bakayoko","FRA","MF","26",1994,5.6,19,13,9,7,3,5,16,31.3,11,8,1,7,9,28,10,2,"https://fbref.com/en/players/59bf127b/Tiemoue-Bakayoko"
"9985","Fodé Ballo-Touré_2022",2022,"Milan","Serie A","Fodé Ballo-Touré","SEN","DF","24",1997,5,18,14,5,13,0,4,9,44.4,5,6,2,4,3,21,5,0,"https://fbref.com/en/players/f449640d/Fode-Ballo-Toure"
"9986","Ismaël Bennacer_2022",2022,"Milan","Serie A","Ismaël Bennacer","ALG","MF","23",1997,16.9,44,30,22,15,7,21,50,42,29,20,4,16,25,69,15,0,"https://fbref.com/en/players/db092d3b/Ismael-Bennacer"
"9987","Davide Calabria_2022",2022,"Milan","Serie A","Davide Calabria","ITA","DF","24",1996,23.5,62,37,31,23,8,37,72,51.4,35,25,5,20,23,85,40,1,"https://fbref.com/en/players/2146785a/Davide-Calabria"
"9988","Samu Castillejo_2022",2022,"Milan","Serie A","Samu Castillejo","ESP","FW,MF","26",1995,1.4,4,2,0,2,2,1,8,12.5,7,4,1,3,2,6,1,0,"https://fbref.com/en/players/130a7a3f/Samu-Castillejo"
"9989","Andrea Conti_2022",2022,"Milan","Serie A","Andrea Conti","ITA","DF","27",1994,0.1,0,0,0,0,0,0,0,NA,0,0,0,0,0,0,0,0,"https://fbref.com/en/players/8fef5412/Andrea-Conti"
"9990","Brahim Díaz_2022",2022,"Milan","Serie A","Brahim Díaz","ESP","MF","21",1999,20.6,23,17,3,11,9,8,22,36.4,14,11,0,11,8,31,4,0,"https://fbref.com/en/players/407feb71/Brahim-Diaz"
"9991","Alessandro Florenzi_2022",2022,"Milan","Serie A","Alessandro Florenzi","ITA","DF,FW","30",1991,12.8,28,14,14,7,7,14,32,43.8,18,9,2,7,27,55,10,1,"https://fbref.com/en/players/e288d4b3/Alessandro-Florenzi"
"9992","Matteo Gabbia_2022",2022,"Milan","Serie A","Matteo Gabbia","ITA","DF","21",1999,6,4,3,1,3,0,0,4,0,4,2,2,0,8,12,12,0,"https://fbref.com/en/players/c235e803/Matteo-Gabbia"
"9993","Olivier Giroud_2022",2022,"Milan","Serie A","Olivier Giroud","FRA","FW","34",1986,21,15,11,4,6,5,3,17,17.6,14,13,4,9,3,18,19,0,"https://fbref.com/en/players/16ceb862/Olivier-Giroud"
"9994","Theo Hernández_2022",2022,"Milan","Serie A","Theo Hernández","FRA","DF","23",1997,30.1,53,35,34,14,5,29,40,72.5,11,16,3,13,23,76,29,3,"https://fbref.com/en/players/d4c9725f/Theo-Hernandez"
"9995","Zlatan Ibrahimović_2022",2022,"Milan","Serie A","Zlatan Ibrahimović","SWE","FW","39",1981,11.3,0,0,0,0,0,0,2,0,2,2,1,1,3,3,9,0,"https://fbref.com/en/players/4cde5509/Zlatan-Ibrahimovic"
"9996","Pierre Kalulu_2022",2022,"Milan","Serie A","Pierre Kalulu","FRA","DF","21",2000,21.6,61,36,36,21,4,17,22,77.3,5,36,15,21,26,87,54,0,"https://fbref.com/en/players/85f7d1be/Pierre-Kalulu"
"9997","Franck Kessié_2022",2022,"Milan","Serie A","Franck Kessié","CIV","MF","24",1996,25.6,41,23,12,24,5,17,26,65.4,9,39,10,29,23,64,22,0,"https://fbref.com/en/players/05e19d6a/Franck-Kessie"
"9998","Simon Kjær_2022",2022,"Milan","Serie A","Simon Kjær","DEN","DF","32",1989,8.9,20,12,9,8,3,6,12,50,6,17,13,4,9,29,39,0,"https://fbref.com/en/players/8b8a56ce/Simon-Kjaer"
"9999","Rade Krunić_2022",2022,"Milan","Serie A","Rade Krunić","BIH","MF,FW","27",1993,15.7,33,18,16,14,3,15,31,48.4,16,19,2,17,16,49,17,0,"https://fbref.com/en/players/817c6964/Rade-Krunic"
"10000","Rafael Leão_2022",2022,"Milan","Serie A","Rafael Leão","POR","FW","22",1999,28.9,17,7,3,9,5,10,20,50,10,12,1,11,12,29,8,0,"https://fbref.com/en/players/20730eae/Rafael-Leao"
"10001","Mike Maignan_2022",2022,"Milan","Serie A","Mike Maignan","FRA","GK","26",1995,32,2,1,2,0,0,2,2,100,0,0,0,0,1,3,4,2,"https://fbref.com/en/players/fcb38f57/Mike-Maignan"
"10002","Daniel Maldini_2022",2022,"Milan","Serie A","Daniel Maldini","ITA","MF","19",2001,1.6,8,3,4,3,1,2,6,33.3,4,4,0,4,1,9,0,0,"https://fbref.com/en/players/801831fe/Daniel-Maldini"
"10003","Junior Messias_2022",2022,"Milan","Serie A","Junior Messias","BRA","FW,MF","30",1991,15.9,34,18,11,14,9,15,34,44.1,19,11,1,10,17,51,17,0,"https://fbref.com/en/players/f49c4ae9/Junior-Messias"
"10004","Pietro Pellegri_2022",2022,"Milan","Serie A","Pietro Pellegri","ITA","FW","20",2001,1.5,2,2,0,1,1,0,1,0,1,0,0,0,0,2,1,0,"https://fbref.com/en/players/a44d3a3c/Pietro-Pellegri"
"10005","Ante Rebić_2022",2022,"Milan","Serie A","Ante Rebić","CRO","FW","27",1993,9.9,14,8,3,6,5,7,20,35,13,14,0,14,3,17,3,1,"https://fbref.com/en/players/536cebe5/Ante-Rebic"
"10006","Alessio Romagnoli_2022",2022,"Milan","Serie A","Alessio Romagnoli","ITA","DF","26",1995,15.7,24,14,14,10,0,14,18,77.8,4,21,12,9,19,43,45,0,"https://fbref.com/en/players/3ead85f9/Alessio-Romagnoli"
"10007","Alexis Saelemaekers_2022",2022,"Milan","Serie A","Alexis Saelemaekers","BEL","FW","22",1999,20.7,43,22,12,17,14,15,51,29.4,36,19,0,19,15,58,8,0,"https://fbref.com/en/players/ee251371/Alexis-Saelemaekers"
"10008","Luca Stanga_2022",2022,"Milan","Serie A","Luca Stanga","ITA","DF","19",2002,0,1,0,0,1,0,0,0,NA,0,0,0,0,0,1,0,0,"https://fbref.com/en/players/2967bcd0/Luca-Stanga"
"10009","Ciprian Tătărușanu_2022",2022,"Milan","Serie A","Ciprian Tătărușanu","ROU","GK","35",1986,6,0,0,0,0,0,0,1,0,1,0,0,0,0,0,2,1,"https://fbref.com/en/players/b056e3da/Ciprian-Tatarusanu"
"10010","Fikayo Tomori_2022",2022,"Milan","Serie A","Fikayo Tomori","ENG","DF","23",1997,30.2,73,44,36,34,3,18,26,69.2,8,37,23,14,45,118,84,1,"https://fbref.com/en/players/7edfbb8a/Fikayo-Tomori"
"10011","Sandro Tonali_2022",2022,"Milan","Serie A","Sandro Tonali","ITA","MF","21",2000,28.9,54,37,23,25,6,21,41,51.2,20,26,8,18,34,88,19,0,"https://fbref.com/en/players/0db169ae/Sandro-Tonali"
"10012","Ruben Aguilar_2022",2022,"Monaco","Ligue 1","Ruben Aguilar","FRA","DF","28",1993,23.8,78,53,39,32,7,43,68,63.2,25,19,4,15,44,122,57,0,"https://fbref.com/en/players/3dd738a1/Ruben-Aguilar"
"10013","Maghnes Akliouche_2022",2022,"Monaco","Ligue 1","Maghnes Akliouche","FRA","MF,FW","19",2002,0.6,2,0,0,2,0,0,1,0,1,2,0,2,0,2,0,0,"https://fbref.com/en/players/b625b241/Maghnes-Akliouche"
"10014","Benoît Badiashile_2022",2022,"Monaco","Ligue 1","Benoît Badiashile","FRA","DF","20",2001,20.4,36,19,21,15,0,14,23,60.9,9,18,12,6,28,64,68,1,"https://fbref.com/en/players/06df8256/Benoit-Badiashile"
"10015","Wissam Ben Yedder_2022",2022,"Monaco","Ligue 1","Wissam Ben Yedder","FRA","FW","30",1990,28.1,18,8,1,11,6,6,15,40,9,12,1,11,0,18,1,0,"https://fbref.com/en/players/942b4f90/Wissam-Ben-Yedder"
"10016","Myron Boadu_2022",2022,"Monaco","Ligue 1","Myron Boadu","NED","FW","20",2001,10.7,9,7,2,3,4,1,5,20,4,6,0,6,2,11,1,0,"https://fbref.com/en/players/5b479568/Myron-Boadu"
"10017","Krépin Diatta_2022",2022,"Monaco","Ligue 1","Krépin Diatta","SEN","MF,DF","22",1999,3.2,3,2,1,0,2,1,3,33.3,2,2,0,2,1,4,0,0,"https://fbref.com/en/players/8104e41e/Krepin-Diatta"
"10018","Sofiane Diop_2022",2022,"Monaco","Ligue 1","Sofiane Diop","FRA","MF,FW","21",2000,21.6,38,20,12,19,7,15,47,31.9,32,10,0,10,23,61,4,0,"https://fbref.com/en/players/19053e31/Sofiane-Diop"
"10019","Axel Disasi_2022",2022,"Monaco","Ligue 1","Axel Disasi","FRA","DF","23",1998,30.2,42,27,20,21,1,23,39,59,16,40,30,10,26,68,75,0,"https://fbref.com/en/players/ad82197c/Axel-Disasi"
"10020","Cesc Fàbregas_2022",2022,"Monaco","Ligue 1","Cesc Fàbregas","ESP","MF","34",1987,0.4,1,0,0,1,0,1,1,100,0,0,0,0,1,2,0,0,"https://fbref.com/en/players/33508c78/Cesc-Fabregas"
"10021","Youssouf Fofana_2022",2022,"Monaco","Ligue 1","Youssouf Fofana","FRA","MF","22",1999,24.3,69,43,19,41,9,29,56,51.8,27,29,7,22,32,101,22,2,"https://fbref.com/en/players/822d51d7/Youssouf-Fofana"
"10022","Aleksandr Golovin_2022",2022,"Monaco","Ligue 1","Aleksandr Golovin","RUS","FW,MF","25",1996,16.7,40,22,10,18,12,18,41,43.9,23,26,1,25,12,52,8,0,"https://fbref.com/en/players/3708e9fa/Aleksandr-Golovin"
"10023","Wilson Isidor_2022",2022,"Monaco","Ligue 1","Wilson Isidor","FRA","FW,MF","20",2000,0.6,0,0,0,0,0,0,4,0,4,1,0,1,0,0,0,0,"https://fbref.com/en/players/a671316d/Wilson-Isidor"
"10024","Ismail Jakobs_2022",2022,"Monaco","Ligue 1","Ismail Jakobs","SEN","DF,FW","21",1999,13.4,32,16,14,15,3,16,35,45.7,19,16,1,15,17,49,31,0,"https://fbref.com/en/players/a0415710/Ismail-Jakobs"
"10025","Félix Lemaréchal_2022",2022,"Monaco","Ligue 1","Félix Lemaréchal","CIV","MF","17",2003,0.1,0,0,0,0,0,0,1,0,1,0,0,0,0,0,0,0,"https://fbref.com/en/players/8ca9415f/Felix-Lemarechal"
"10026","Jean Lucas_2022",2022,"Monaco","Ligue 1","Jean Lucas","BRA","MF","23",1998,16.1,43,25,14,24,5,17,40,42.5,23,15,5,10,13,56,4,1,"https://fbref.com/en/players/a99138af/Jean-Lucas"
"10027","Guillermo Maripán_2022",2022,"Monaco","Ligue 1","Guillermo Maripán","CHI","DF","27",1994,20.4,36,24,27,9,0,20,40,50,20,21,14,7,25,61,66,1,"https://fbref.com/en/players/d9764034/Guillermo-Maripan"
"10028","Gelson Martins_2022",2022,"Monaco","Ligue 1","Gelson Martins","POR","MF,FW","26",1995,21.2,42,27,10,26,6,21,59,35.6,38,26,1,25,17,59,4,0,"https://fbref.com/en/players/3ef0fa48/Gelson-Martins"
"10029","Eliot Matazo_2022",2022,"Monaco","Ligue 1","Eliot Matazo","BEL","MF","19",2002,8.8,8,7,4,4,0,2,11,18.2,9,11,3,8,13,21,9,0,"https://fbref.com/en/players/15944afd/Eliot-Matazo"
"10030","Chrislain Matsima_2022",2022,"Monaco","Ligue 1","Chrislain Matsima","FRA","DF","19",2002,1.5,3,2,1,2,0,2,7,28.6,5,3,3,0,1,4,6,1,"https://fbref.com/en/players/cf1ef7ec/Chrislain-Matsima"
"10031","Alexander Nübel_2022",2022,"Monaco","Ligue 1","Alexander Nübel","GER","GK","24",1996,38,0,0,0,0,0,0,1,0,1,0,0,0,0,0,11,1,"https://fbref.com/en/players/afb0c500/Alexander-Nubel"
"10032","Strahinja Pavlović_2022",2022,"Monaco","Ligue 1","Strahinja Pavlović","SRB","DF","20",2001,5,23,16,8,13,2,8,12,66.7,4,5,3,2,9,32,15,0,"https://fbref.com/en/players/25146df0/Strahinja-Pavlovic"
"10033","Tiago Ribeiro_2022",2022,"Monaco","Ligue 1","Tiago Ribeiro","POR","FW","19",2002,0,0,0,0,0,0,0,0,NA,0,0,0,0,0,0,0,0,"https://fbref.com/en/players/507d7569/Tiago-Ribeiro"
"10034","Djibril Sidibé_2022",2022,"Monaco","Ligue 1","Djibril Sidibé","FRA","DF","29",1992,10.5,24,13,13,8,3,9,24,37.5,15,10,1,9,16,40,13,0,"https://fbref.com/en/players/4c5b714f/Djibril-Sidibe"
"10035","Caio Henrique Oliveira Silva_2022",2022,"Monaco","Ligue 1","Caio Henrique Oliveira Silva","BRA","DF","24",1997,29.6,53,30,31,18,4,28,59,47.5,31,30,6,24,27,80,37,3,"https://fbref.com/en/players/30af8b93/Caio-Henrique-Oliveira-Silva"
"10036","Aurélien Tchouaméni_2022",2022,"Monaco","Ligue 1","Aurélien Tchouaméni","FRA","MF","21",2000,32.5,86,45,33,49,4,29,55,52.7,26,39,7,32,101,187,34,0,"https://fbref.com/en/players/4f255115/Aurelien-Tchouameni"
"10037","Vanderson_2022",2022,"Monaco","Ligue 1","Vanderson","BRA","FW,DF","20",2001,12.4,35,19,10,19,6,15,23,65.2,8,17,4,13,13,48,12,0,"https://fbref.com/en/players/ee45fd85/Vanderson"
"10038","Kevin Volland_2022",2022,"Monaco","Ligue 1","Kevin Volland","GER","MF,FW","29",1992,27.1,24,10,2,18,4,6,31,19.4,25,20,0,20,3,27,9,0,"https://fbref.com/en/players/64f69877/Kevin-Volland"
"10039","Dimitry Bertaud_2022",2022,"Montpellier","Ligue 1","Dimitry Bertaud","FRA","GK","23",1998,9.3,0,0,0,0,0,0,1,0,1,0,0,0,0,0,5,1,"https://fbref.com/en/players/380a15e2/Dimitry-Bertaud"
"10040","Rémy Cabella_2022",2022,"Montpellier","Ligue 1","Rémy Cabella","FRA","MF,FW","31",1990,3.5,15,7,4,8,3,5,15,33.3,10,7,0,7,5,20,1,0,"https://fbref.com/en/players/148e136f/Remy-Cabella"
"10041","Joris Chotard_2022",2022,"Montpellier","Ligue 1","Joris Chotard","FRA","MF","19",2001,32.6,59,30,33,23,3,36,78,46.2,42,27,15,12,42,101,56,0,"https://fbref.com/en/players/7909ffa4/Joris-Chotard"
"10042","Nicolas Cozza_2022",2022,"Montpellier","Ligue 1","Nicolas Cozza","FRA","DF","22",1999,30.8,80,47,50,23,7,35,65,53.8,30,35,19,16,38,118,82,1,"https://fbref.com/en/players/8f325097/Nicolas-Cozza"
"10043","Sacha Delaye_2022",2022,"Montpellier","Ligue 1","Sacha Delaye","FRA","MF,FW","19",2002,2.9,8,6,3,2,3,2,8,25,6,1,0,1,1,9,1,1,"https://fbref.com/en/players/e4448c8c/Sacha-Delaye"
"10044","Andy Delort_2022",2022,"Montpellier","Ligue 1","Andy Delort","ALG","FW","29",1991,3,2,0,0,1,1,0,1,0,1,1,0,1,0,2,4,0,"https://fbref.com/en/players/d33c706e/Andy-Delort"
"10045","Maxime Estève_2022",2022,"Montpellier","Ligue 1","Maxime Estève","FRA","DF","19",2002,20.6,27,18,22,4,1,15,27,55.6,12,31,24,7,22,49,69,1,"https://fbref.com/en/players/1a066e69/Maxime-Esteve"
"10046","Jordan Ferri_2022",2022,"Montpellier","Ligue 1","Jordan Ferri","FRA","MF","29",1992,32.3,55,35,28,23,4,29,87,33.3,58,21,5,16,30,85,35,0,"https://fbref.com/en/players/375622c5/Jordan-Ferri"
"10047","Valère Germain_2022",2022,"Montpellier","Ligue 1","Valère Germain","FRA","FW","31",1990,21.9,23,14,6,11,6,8,31,25.8,23,13,1,12,9,32,27,0,"https://fbref.com/en/players/ea0ff634/Valere-Germain"
"10048","Nicholas Gioacchini_2022",2022,"Montpellier","Ligue 1","Nicholas Gioacchini","USA","FW,MF","21",2000,5.5,7,5,3,2,2,4,10,40,6,8,0,8,4,11,5,0,"https://fbref.com/en/players/79ab7593/Nicholas-Gioacchini"
"10049","Yanis Guermouche_2022",2022,"Montpellier","Ligue 1","Yanis Guermouche","FRA","MF,FW","20",2001,0.1,2,1,0,1,1,1,1,100,0,0,0,0,0,2,0,0,"https://fbref.com/en/players/642f9f79/Yanis-Guermouche"
"10050","Gaëtan Laborde_2022",2022,"Montpellier","Ligue 1","Gaëtan Laborde","FRA","FW","27",1994,3.8,2,2,1,1,0,2,4,50,2,3,0,3,5,7,5,0,"https://fbref.com/en/players/7cdda3bf/Gaetan-Laborde"
"10051","Léo Leroy_2022",2022,"Montpellier","Ligue 1","Léo Leroy","FRA","MF","21",2000,7,31,21,17,11,3,12,34,35.3,22,20,4,16,8,39,8,0,"https://fbref.com/en/players/fcc84a07/Leo-Leroy"
"10052","Béni Makouana_2022",2022,"Montpellier","Ligue 1","Béni Makouana","CGO","FW,MF","18",2002,3.6,2,2,0,0,2,0,1,0,1,1,0,1,3,5,2,0,"https://fbref.com/en/players/654f49ca/Beni-Makouana"
"10053","Stephy Mavididi_2022",2022,"Montpellier","Ligue 1","Stephy Mavididi","ENG","FW,MF","23",1998,25.5,24,13,11,7,6,14,39,35.9,25,23,2,21,8,32,11,0,"https://fbref.com/en/players/30144daa/Stephy-Mavididi"
"10054","Pedro Mendes_2022",2022,"Montpellier","Ligue 1","Pedro Mendes","POR","DF","30",1990,0.2,1,1,1,0,0,0,0,NA,0,1,1,0,0,1,2,0,"https://fbref.com/en/players/6690ef25/Pedro-Mendes"
"10055","Florent Mollet_2022",2022,"Montpellier","Ligue 1","Florent Mollet","FRA","FW,MF","29",1991,29.2,31,22,14,12,5,14,57,24.6,43,27,4,23,24,55,13,0,"https://fbref.com/en/players/7e82a78f/Florent-Mollet"
"10056","Jonas Omlin_2022",2022,"Montpellier","Ligue 1","Jonas Omlin","SUI","GK","27",1994,28.7,2,1,2,0,0,2,3,66.7,1,0,0,0,0,2,12,3,"https://fbref.com/en/players/c631f952/Jonas-Omlin"
"10057","Ambroise Oyongo_2022",2022,"Montpellier","Ligue 1","Ambroise Oyongo","CMR","DF","30",1991,7.3,13,4,7,4,2,9,15,60,6,5,1,4,6,19,17,0,"https://fbref.com/en/players/e3e05edf/Ambroise-Oyongo"
"10058","Mihailo Ristić_2022",2022,"Montpellier","Ligue 1","Mihailo Ristić","SRB","DF","25",1995,20,44,32,26,16,2,25,43,58.1,18,16,6,10,17,61,48,0,"https://fbref.com/en/players/ea0aa7e0/Mihailo-Ristic"
"10059","Mamadou Sakho_2022",2022,"Montpellier","Ligue 1","Mamadou Sakho","FRA","DF","31",1990,28.6,34,22,26,8,0,16,26,61.5,10,41,34,7,41,75,134,4,"https://fbref.com/en/players/87935cf3/Mamadou-Sakho"
"10060","Junior Sambia_2022",2022,"Montpellier","Ligue 1","Junior Sambia","FRA","DF,FW","24",1996,17,22,13,12,7,3,13,22,59.1,9,22,3,19,21,43,31,0,"https://fbref.com/en/players/24eb7ed6/Junior-Sambia"
"10061","Téji Savanier_2022",2022,"Montpellier","Ligue 1","Téji Savanier","FRA","MF","29",1991,26.8,46,27,18,19,9,21,59,35.6,38,23,1,22,25,71,12,1,"https://fbref.com/en/players/6bde367b/Teji-Savanier"
"10062","Arnaud Souquet_2022",2022,"Montpellier","Ligue 1","Arnaud Souquet","FRA","DF","29",1992,25.9,56,35,30,17,9,32,65,49.2,33,21,7,14,34,90,60,1,"https://fbref.com/en/players/4e0afc5d/Arnaud-Souquet"
"10063","Thuler_2022",2022,"Montpellier","Ligue 1","Thuler","BRA","DF","22",1999,9.5,21,12,17,4,0,8,15,53.3,7,9,7,2,9,30,30,0,"https://fbref.com/en/players/db23d9fc/Thuler"
"10064","Elye Wahi_2022",2022,"Montpellier","Ligue 1","Elye Wahi","FRA","FW","18",2003,19.8,18,10,9,6,3,6,16,37.5,10,7,0,7,4,22,4,0,"https://fbref.com/en/players/0d7b6576/Elye-Wahi"
"10065","Mohamed Achi_2022",2022,"Nantes","Ligue 1","Mohamed Achi","FRA","MF","19",2002,0.1,0,0,0,0,0,0,0,NA,0,0,0,0,0,0,0,0,"https://fbref.com/en/players/1e93fc5d/Mohamed-Achi"
"10066","Dennis Appiah_2022",2022,"Nantes","Ligue 1","Dennis Appiah","FRA","DF","29",1992,23.3,55,34,35,18,2,28,48,58.3,20,30,13,17,27,82,74,0,"https://fbref.com/en/players/feb5d3ab/Dennis-Appiah"
"10067","Jean-Kévin Augustin_2022",2022,"Nantes","Ligue 1","Jean-Kévin Augustin","FRA","FW,MF","24",1997,0.9,1,0,0,0,1,0,3,0,3,1,0,1,0,1,0,0,"https://fbref.com/en/players/97bfa797/Jean-Kevin-Augustin"
"10068","Ludovic Blas_2022",2022,"Nantes","Ligue 1","Ludovic Blas","FRA","MF,FW","23",1997,32.9,33,18,7,20,6,15,44,34.1,29,33,3,30,31,64,6,1,"https://fbref.com/en/players/6191093d/Ludovic-Blas"
"10069","Osman Bukari_2022",2022,"Nantes","Ligue 1","Osman Bukari","GHA","FW,MF","22",1998,11.2,18,8,7,6,5,8,22,36.4,14,8,0,8,8,26,1,0,"https://fbref.com/en/players/eab85789/Osman-Bukari"
"10070","Jean-Charles Castelletto_2022",2022,"Nantes","Ligue 1","Jean-Charles Castelletto","CMR","DF","26",1995,27.9,45,24,27,17,1,25,35,71.4,10,38,27,11,30,75,73,0,"https://fbref.com/en/players/e0f3a1f6/Jean-Charles-Castelletto"
"10071","Pedro Chirivella_2022",2022,"Nantes","Ligue 1","Pedro Chirivella","ESP","MF","24",1997,29.3,49,31,14,26,9,25,70,35.7,45,23,2,21,37,86,11,0,"https://fbref.com/en/players/68a26d51/Pedro-Chirivella"
"10072","Marcus Coco_2022",2022,"Nantes","Ligue 1","Marcus Coco","FRA","MF,FW","25",1996,10.3,34,14,17,11,6,8,18,44.4,10,11,1,10,10,44,15,0,"https://fbref.com/en/players/3010aefb/Marcus-Coco"
"10073","Sébastien Corchia_2022",2022,"Nantes","Ligue 1","Sébastien Corchia","FRA","DF","30",1990,14.7,33,20,17,11,5,24,42,57.1,18,24,3,21,13,46,36,0,"https://fbref.com/en/players/0e7ccfc4/Sebastien-Corchia"
"10074","Kalifa Coulibaly_2022",2022,"Nantes","Ligue 1","Kalifa Coulibaly","MLI","FW","29",1991,9.4,5,1,1,1,3,0,4,0,4,2,2,0,0,5,11,0,"https://fbref.com/en/players/9980269a/Kalifa-Coulibaly"
"10075","Wylan Cyprien_2022",2022,"Nantes","Ligue 1","Wylan Cyprien","FRA","MF","26",1995,16.6,33,17,12,18,3,13,32,40.6,19,16,6,10,10,43,14,2,"https://fbref.com/en/players/3e092724/Wylan-Cyprien"
"10076","Lohann Doucet_2022",2022,"Nantes","Ligue 1","Lohann Doucet","FRA","MF,DF","18",2002,0.1,0,0,0,0,0,0,0,NA,0,0,0,0,1,1,0,0,"https://fbref.com/en/players/dff0c299/Lohann-Doucet"
"10077","Renaud Emond_2022",2022,"Nantes","Ligue 1","Renaud Emond","BEL","FW,MF","29",1991,2.1,1,0,0,1,0,0,4,0,4,2,1,1,0,1,1,0,"https://fbref.com/en/players/5c9ac7f0/Renaud-Emond"
"10078","Fábio_2022",2022,"Nantes","Ligue 1","Fábio","BRA","DF","31",1990,18.5,61,40,31,23,7,36,74,48.6,38,29,7,22,35,96,31,1,"https://fbref.com/en/players/bc7b4580/Fabio"
"10079","Willem Geubbels_2022",2022,"Nantes","Ligue 1","Willem Geubbels","FRA","FW,MF","19",2001,6,8,5,4,2,2,5,12,41.7,7,5,0,5,6,14,5,0,"https://fbref.com/en/players/9836e892/Willem-Geubbels"
"10080","Andrei Girotto_2022",2022,"Nantes","Ligue 1","Andrei Girotto","BRA","DF,MF","29",1992,35,85,52,49,32,4,52,103,50.5,51,67,33,34,69,154,143,0,"https://fbref.com/en/players/3befc2b6/Andrei-Girotto"
"10081","Randal Kolo Muani_2022",2022,"Nantes","Ligue 1","Randal Kolo Muani","FRA","FW,MF","22",1998,32.8,28,14,7,10,11,10,25,40,15,14,3,11,6,34,31,0,"https://fbref.com/en/players/c0b3669f/Randal-Kolo-Muani"
"10082","Alban Lafont_2022",2022,"Nantes","Ligue 1","Alban Lafont","FRA","GK","22",1999,38,3,3,3,0,0,3,8,37.5,5,1,0,1,1,4,25,2,"https://fbref.com/en/players/4e7db402/Alban-Lafont"
"10083","Yannis M'Bemba_2022",2022,"Nantes","Ligue 1","Yannis M'Bemba","FRA","DF,FW","20",2001,0.1,0,0,0,0,0,0,0,NA,0,0,0,0,0,0,1,0,"https://fbref.com/en/players/080de72a/Yannis-MBemba"
"10084","Quentin Merlin_2022",2022,"Nantes","Ligue 1","Quentin Merlin","FRA","DF,MF","19",2002,21.4,45,28,19,20,6,26,49,53.1,23,25,4,21,27,72,29,2,"https://fbref.com/en/players/0bfca6a1/Quentin-Merlin"
"10085","Samuel Moutoussamy_2022",2022,"Nantes","Ligue 1","Samuel Moutoussamy","COD","MF","24",1996,16.8,48,32,20,20,8,23,62,37.1,39,14,2,12,17,65,16,0,"https://fbref.com/en/players/af0c835b/Samuel-Moutoussamy"
"10086","Nicolas Pallois_2022",2022,"Nantes","Ligue 1","Nicolas Pallois","FRA","DF","33",1987,27.2,51,33,40,11,0,34,59,57.6,25,40,19,21,53,104,116,1,"https://fbref.com/en/players/779847d6/Nicolas-Pallois"
"10087","Roli Pereira de Sa_2022",2022,"Nantes","Ligue 1","Roli Pereira de Sa","FRA","MF","24",1996,6.4,12,4,3,5,4,3,20,15,17,6,0,6,6,18,3,0,"https://fbref.com/en/players/60f58477/Roli-Pereira-de-Sa"
"10088","Moses Simon_2022",2022,"Nantes","Ligue 1","Moses Simon","NGA","FW,MF","26",1995,25.9,17,11,6,5,6,11,23,47.8,12,14,3,11,12,29,5,0,"https://fbref.com/en/players/5f3eaaf5/Moses-Simon"
"10089","Abdoulaye Sylla_2022",2022,"Nantes","Ligue 1","Abdoulaye Sylla","GUI","DF","21",2000,1.7,4,4,2,1,1,2,4,50,2,5,3,2,1,5,3,0,"https://fbref.com/en/players/2aeb43f1/Abdoulaye-Sylla"
"10090","Charles Traore_2022",2022,"Nantes","Ligue 1","Charles Traore","MLI","DF","29",1992,8,16,12,10,4,2,2,13,15.4,11,11,4,7,15,31,30,0,"https://fbref.com/en/players/de488e56/Charles-Traore"
"10091","Diego Demme_2022",2022,"Napoli","Serie A","Diego Demme","GER","MF","29",1991,7.7,21,12,4,13,4,10,21,47.6,11,11,2,9,9,30,2,0,"https://fbref.com/en/players/dc3fa3b5/Diego-Demme"
"10092","Giovanni Di Lorenzo_2022",2022,"Napoli","Serie A","Giovanni Di Lorenzo","ITA","DF","27",1993,31.9,58,36,30,20,8,33,58,56.9,25,28,10,18,38,96,46,1,"https://fbref.com/en/players/230a2fac/Giovanni-Di-Lorenzo"
"10093","Elif Elmas_2022",2022,"Napoli","Serie A","Elif Elmas","MKD","FW,MF","21",1999,18,25,15,10,10,5,12,28,42.9,16,13,2,11,8,33,17,0,"https://fbref.com/en/players/cf007308/Elif-Elmas"
"10094","Gianluca Gaetano_2022",2022,"Napoli","Serie A","Gianluca Gaetano","ITA","MF","21",2000,0.2,1,1,1,0,0,1,2,50,1,0,0,0,2,3,0,0,"https://fbref.com/en/players/3b387cc7/Gianluca-Gaetano"
"10095","Faouzi Ghoulam_2022",2022,"Napoli","Serie A","Faouzi Ghoulam","ALG","DF","30",1991,3.7,3,1,1,2,0,0,3,0,3,2,1,1,3,6,10,0,"https://fbref.com/en/players/c5adc293/Faouzi-Ghoulam"
"10096","Lorenzo Insigne_2022",2022,"Napoli","Serie A","Lorenzo Insigne","ITA","FW","30",1991,25.4,23,14,8,12,3,8,44,18.2,36,30,1,29,20,43,3,1,"https://fbref.com/en/players/2f557579/Lorenzo-Insigne"
"10097","Juan Jesus_2022",2022,"Napoli","Serie A","Juan Jesus","BRA","DF","30",1991,14.2,25,17,14,11,0,12,18,66.7,6,21,16,5,9,34,34,0,"https://fbref.com/en/players/79083382/Juan-Jesus"
"10098","Kalidou Koulibaly_2022",2022,"Napoli","Serie A","Kalidou Koulibaly","SEN","DF","30",1991,26.7,39,23,31,6,2,25,38,65.8,13,41,25,16,29,68,90,1,"https://fbref.com/en/players/da974c7b/Kalidou-Koulibaly"
"10099","Stanislav Lobotka_2022",2022,"Napoli","Serie A","Stanislav Lobotka","SVK","MF","26",1994,18.7,39,24,16,20,3,14,36,38.9,22,9,1,8,12,51,13,1,"https://fbref.com/en/players/e1cbb531/Stanislav-Lobotka"
"10100","Hirving Lozano_2022",2022,"Napoli","Serie A","Hirving Lozano","MEX","FW","26",1995,17.9,28,20,12,11,5,8,30,26.7,22,24,0,24,9,37,9,0,"https://fbref.com/en/players/a69e4806/Hirving-Lozano"
"10101","Kévin Malcuit_2022",2022,"Napoli","Serie A","Kévin Malcuit","MAR","DF,MF","30",1991,3.2,4,2,4,0,0,2,2,100,0,3,0,3,8,12,6,0,"https://fbref.com/en/players/d6a889ea/Kevin-Malcuit"
"10102","Kostas Manolas_2022",2022,"Napoli","Serie A","Kostas Manolas","GRE","DF","30",1991,3.5,2,2,1,1,0,2,3,66.7,1,2,1,1,4,6,10,1,"https://fbref.com/en/players/c707411f/Kostas-Manolas"
"10103","Davide Marfella_2022",2022,"Napoli","Serie A","Davide Marfella","ITA","GK","21",1999,0.1,0,0,0,0,0,0,0,NA,0,0,0,0,0,0,0,0,"https://fbref.com/en/players/880fcdbb/Davide-Marfella"
"10104","Alex Meret_2022",2022,"Napoli","Serie A","Alex Meret","ITA","GK","24",1997,6.9,0,0,0,0,0,0,0,NA,0,0,0,0,0,0,3,1,"https://fbref.com/en/players/9413b19f/Alex-Meret"
"10105","Dries Mertens_2022",2022,"Napoli","Serie A","Dries Mertens","BEL","FW,MF","34",1987,15.4,16,7,1,11,4,3,16,18.8,13,8,2,6,9,25,2,0,"https://fbref.com/en/players/89b2c8a9/Dries-Mertens"
"10106","Victor Osimhen_2022",2022,"Napoli","Serie A","Victor Osimhen","NGA","FW","22",1998,22,10,5,1,2,7,2,6,33.3,4,16,3,13,3,13,17,0,"https://fbref.com/en/players/8c90fd7a/Victor-Osimhen"
"10107","David Ospina_2022",2022,"Napoli","Serie A","David Ospina","COL","GK","32",1988,31,0,0,0,0,0,0,0,NA,0,0,0,0,1,1,11,1,"https://fbref.com/en/players/82b1198a/David-Ospina"
"10108","Adam Ounas_2022",2022,"Napoli","Serie A","Adam Ounas","ALG","MF,FW","24",1996,3.6,6,1,0,3,3,3,7,42.9,4,3,0,3,2,8,3,0,"https://fbref.com/en/players/ed90babd/Adam-Ounas"
"10109","Andrea Petagna_2022",2022,"Napoli","Serie A","Andrea Petagna","ITA","FW","26",1995,6.5,3,3,0,3,0,1,4,25,3,1,0,1,0,3,5,0,"https://fbref.com/en/players/03f946ed/Andrea-Petagna"
"10110","Matteo Politano_2022",2022,"Napoli","Serie A","Matteo Politano","ITA","FW","27",1993,18.3,24,12,8,11,5,15,54,27.8,39,11,2,9,13,37,5,0,"https://fbref.com/en/players/5e861944/Matteo-Politano"
"10111","Amir Rrahmani_2022",2022,"Napoli","Serie A","Amir Rrahmani","KVX","DF","27",1994,32.5,21,11,15,5,1,15,19,78.9,4,36,25,11,19,40,89,0,"https://fbref.com/en/players/4b3e1a38/Amir-Rrahmani"
"10112","Mário Rui_2022",2022,"Napoli","Serie A","Mário Rui","POR","DF","30",1991,33.2,68,43,32,28,8,39,84,46.4,45,31,7,24,40,108,50,0,"https://fbref.com/en/players/0b5a292a/Mario-Rui"
"10113","Fabián Ruiz Peña_2022",2022,"Napoli","Serie A","Fabián Ruiz Peña","ESP","MF","25",1996,26.5,55,33,22,29,4,29,67,43.3,38,34,1,33,22,77,32,0,"https://fbref.com/en/players/c0c7ff58/Fabian-Ruiz-Pena"
"10114","Axel Tuanzebe_2022",2022,"Napoli","Serie A","Axel Tuanzebe","ENG","DF","23",1997,0.1,0,0,0,0,0,0,0,NA,0,1,1,0,0,0,0,0,"https://fbref.com/en/players/2baec6ce/Axel-Tuanzebe"
"10115","Andre-Frank Zambo Anguissa_2022",2022,"Napoli","Serie A","Andre-Frank Zambo Anguissa","CMR","MF","25",1995,21.4,50,26,24,17,9,25,51,49,26,31,5,26,24,74,33,1,"https://fbref.com/en/players/6bb2c084/Andre-Frank-Zambo-Anguissa"
"10116","Alessandro Zanoli_2022",2022,"Napoli","Serie A","Alessandro Zanoli","ITA","DF","20",2000,5.1,10,7,6,3,1,3,5,60,2,2,1,1,4,14,16,0,"https://fbref.com/en/players/3b12b11f/Alessandro-Zanoli"
"10117","Piotr Zieliński_2022",2022,"Napoli","Serie A","Piotr Zieliński","POL","MF","27",1994,23.2,19,12,5,9,5,6,21,28.6,15,13,2,11,8,27,4,0,"https://fbref.com/en/players/a5296e55/Piotr-Zielinski"
"10118","Miguel Almirón_2022",2022,"Newcastle Utd","Premier League","Miguel Almirón","PAR","MF,FW","27",1994,19.1,47,29,23,17,7,11,44,25,33,14,1,13,20,67,13,0,"https://fbref.com/en/players/862a1c15/Miguel-Almiron"
"10119","Dan Burn_2022",2022,"Newcastle Utd","Premier League","Dan Burn","ENG","DF","29",1992,16,16,11,11,4,1,7,11,63.6,4,22,14,8,20,36,101,0,"https://fbref.com/en/players/b2d31e83/Dan-Burn"
"10120","Ciaran Clark_2022",2022,"Newcastle Utd","Premier League","Ciaran Clark","IRL","DF","31",1989,11.3,13,10,4,7,2,9,14,64.3,5,14,11,3,13,26,43,1,"https://fbref.com/en/players/2b91cf8e/Ciaran-Clark"
"10121","Karl Darlow_2022",2022,"Newcastle Utd","Premier League","Karl Darlow","ENG","GK","30",1990,8,0,0,0,0,0,0,0,NA,0,0,0,0,0,0,5,1,"https://fbref.com/en/players/cde3309f/Karl-Darlow"
"10122","Martin Dúbravka_2022",2022,"Newcastle Utd","Premier League","Martin Dúbravka","SVK","GK","32",1989,26,1,1,1,0,0,0,1,0,1,0,0,0,0,1,8,2,"https://fbref.com/en/players/3a949a25/Martin-Dubravka"
"10123","Paul Dummett_2022",2022,"Newcastle Utd","Premier League","Paul Dummett","WAL","DF","29",1991,2.2,7,3,3,4,0,5,8,62.5,3,5,0,5,3,10,5,0,"https://fbref.com/en/players/3fe6bd8c/Paul-Dummett"
"10124","Federico Fernández_2022",2022,"Newcastle Utd","Premier League","Federico Fernández","ARG","DF","32",1989,5.8,3,0,3,0,0,2,5,40,3,10,10,0,4,7,28,0,"https://fbref.com/en/players/f25b010f/Federico-Fernandez"
"10125","Ryan Fraser_2022",2022,"Newcastle Utd","Premier League","Ryan Fraser","SCO","FW,MF","27",1994,16.3,10,3,5,3,2,5,13,38.5,8,11,1,10,11,21,11,0,"https://fbref.com/en/players/d56543a0/Ryan-Fraser"
"10126","Dwight Gayle_2022",2022,"Newcastle Utd","Premier League","Dwight Gayle","ENG","FW,DF","30",1990,0.4,1,0,0,1,0,0,1,0,1,0,0,0,1,2,0,0,"https://fbref.com/en/players/e58a03c6/Dwight-Gayle"
"10127","Bruno Guimarães_2022",2022,"Newcastle Utd","Premier League","Bruno Guimarães","BRA","MF","23",1997,11.5,44,23,18,22,4,21,38,55.3,17,25,6,19,9,53,13,0,"https://fbref.com/en/players/82518f62/Bruno-Guimaraes"
"10128","Isaac Hayden_2022",2022,"Newcastle Utd","Premier League","Isaac Hayden","ENG","MF,DF","26",1995,11.1,28,14,11,14,3,12,29,41.4,17,17,8,9,14,42,24,0,"https://fbref.com/en/players/c951a6df/Isaac-Hayden"
"10129","Jeff Hendrick_2022",2022,"Newcastle Utd","Premier League","Jeff Hendrick","IRL","MF","29",1992,0.8,1,1,0,1,0,1,1,100,0,0,0,0,0,1,1,0,"https://fbref.com/en/players/989d5705/Jeff-Hendrick"
"10130","Joelinton_2022",2022,"Newcastle Utd","Premier League","Joelinton","BRA","MF,FW","24",1996,28.4,72,38,30,33,9,26,61,42.6,35,46,11,35,34,106,50,2,"https://fbref.com/en/players/c17bfb65/Joelinton"
"10131","Emil Krafth_2022",2022,"Newcastle Utd","Premier League","Emil Krafth","SWE","DF","26",1994,18.2,37,16,25,11,1,27,36,75,9,16,10,6,25,62,56,0,"https://fbref.com/en/players/77cf6852/Emil-Krafth"
"10132","Jamaal Lascelles_2022",2022,"Newcastle Utd","Premier League","Jamaal Lascelles","ENG","DF","27",1993,22.9,15,7,9,5,1,4,12,33.3,8,38,28,10,22,37,121,1,"https://fbref.com/en/players/450ab6fc/Jamaal-Lascelles"
"10133","Jamal Lewis_2022",2022,"Newcastle Utd","Premier League","Jamal Lewis","NIR","DF","23",1998,2.9,8,6,6,1,1,3,4,75,1,3,2,1,3,11,8,0,"https://fbref.com/en/players/efb9215a/Jamal-Lewis"
"10134","Sean Longstaff_2022",2022,"Newcastle Utd","Premier League","Sean Longstaff","ENG","MF","23",1997,16.3,54,34,18,31,5,24,65,36.9,41,18,6,12,9,63,18,0,"https://fbref.com/en/players/a2b105e0/Sean-Longstaff"
"10135","Javier Manquillo_2022",2022,"Newcastle Utd","Premier League","Javier Manquillo","ESP","DF","27",1994,14,39,29,28,10,1,21,36,58.3,15,15,6,9,10,49,32,0,"https://fbref.com/en/players/758dd7f0/Javier-Manquillo"
"10136","Jacob Murphy_2022",2022,"Newcastle Utd","Premier League","Jacob Murphy","ENG","FW,DF","26",1995,16.4,49,26,34,11,4,26,41,63.4,15,20,2,18,23,72,17,0,"https://fbref.com/en/players/de112b84/Jacob-Murphy"
"10137","Matt Ritchie_2022",2022,"Newcastle Utd","Premier League","Matt Ritchie","SCO","DF","31",1989,14.9,22,15,10,10,2,10,27,37,17,10,2,8,13,35,26,0,"https://fbref.com/en/players/71ef519e/Matt-Ritchie"
"10138","Allan Saint-Maximin_2022",2022,"Newcastle Utd","Premier League","Allan Saint-Maximin","FRA","FW,MF","24",1997,31.2,13,8,6,4,3,3,17,17.6,14,13,2,11,11,24,3,0,"https://fbref.com/en/players/2b16cb1a/Allan-Saint-Maximin"
"10139","Fabian Schär_2022",2022,"Newcastle Utd","Premier League","Fabian Schär","SUI","DF","29",1991,24,16,11,11,3,2,8,16,50,8,27,18,9,32,48,95,2,"https://fbref.com/en/players/c8aa95da/Fabian-Schar"
"10140","Jonjo Shelvey_2022",2022,"Newcastle Utd","Premier League","Jonjo Shelvey","ENG","MF","29",1992,22,30,17,12,18,0,14,34,41.2,20,22,7,15,22,52,20,2,"https://fbref.com/en/players/3727dd3c/Jonjo-Shelvey"
"10141","Matt Targett_2022",2022,"Newcastle Utd","Premier League","Matt Targett","ENG","DF","25",1995,16,41,26,26,14,1,24,37,64.9,13,15,4,11,25,66,39,1,"https://fbref.com/en/players/e514ab62/Matt-Targett"
"10142","Kieran Trippier_2022",2022,"Newcastle Utd","Premier League","Kieran Trippier","ENG","DF","30",1990,4.8,17,10,8,8,1,10,16,62.5,6,10,3,7,10,27,10,0,"https://fbref.com/en/players/21512407/Kieran-Trippier"
"10143","Joe Willock_2022",2022,"Newcastle Utd","Premier League","Joe Willock","ENG","MF","21",1999,22.6,64,37,30,28,6,29,68,42.6,39,37,6,31,21,85,10,1,"https://fbref.com/en/players/a3b03921/Joe-Willock"
"10144","Callum Wilson_2022",2022,"Newcastle Utd","Premier League","Callum Wilson","ENG","FW","29",1992,15.4,9,8,1,5,3,1,4,25,3,7,2,5,3,12,10,0,"https://fbref.com/en/players/c596fcb0/Callum-Wilson"
"10145","Chris Wood_2022",2022,"Newcastle Utd","Premier League","Chris Wood","NZL","FW","29",1991,14.7,2,0,1,1,0,1,2,50,1,5,2,3,2,4,9,0,"https://fbref.com/en/players/4e9a0555/Chris-Wood"
"10146","Freddie Woodman_2022",2022,"Newcastle Utd","Premier League","Freddie Woodman","ENG","GK","24",1997,4,0,0,0,0,0,0,0,NA,0,0,0,0,0,0,0,1,"https://fbref.com/en/players/19e50035/Freddie-Woodman"
"10147","Jordan Amavi_2022",2022,"Nice","Ligue 1","Jordan Amavi","FRA","DF","27",1994,4.6,16,10,8,7,1,10,17,58.8,7,3,1,2,15,31,7,0,"https://fbref.com/en/players/22721b88/Jordan-Amavi"
"10148","Youcef Atal_2022",2022,"Nice","Ligue 1","Youcef Atal","ALG","DF","25",1996,12.7,29,19,17,10,2,14,25,56,11,13,2,11,32,61,21,0,"https://fbref.com/en/players/6a827d8e/Youcef-Atal"
"10149","Danilo Barbosa_2022",2022,"Nice","Ligue 1","Danilo Barbosa","BRA","DF","25",1996,1,0,0,0,0,0,0,0,NA,0,1,1,0,2,2,10,0,"https://fbref.com/en/players/0557ff4f/Danilo-Barbosa"
"10150","Melvin Bard_2022",2022,"Nice","Ligue 1","Melvin Bard","FRA","DF","20",2000,28.8,59,37,38,17,4,41,63,65.1,22,33,10,23,51,110,56,0,"https://fbref.com/en/players/1ddbc7ca/Melvin-Bard"
"10151","Walter Benítez_2022",2022,"Nice","Ligue 1","Walter Benítez","ARG","GK","28",1993,37,0,0,0,0,0,0,2,0,2,1,0,1,0,0,12,2,"https://fbref.com/en/players/8a2248b4/Walter-Benitez"
"10152","Hicham Boudaoui_2022",2022,"Nice","Ligue 1","Hicham Boudaoui","ALG","MF","21",1999,18,31,18,15,10,6,13,36,36.1,23,17,4,13,18,49,15,0,"https://fbref.com/en/players/f9d5908e/Hicham-Boudaoui"
"10153","Bilal Brahimi_2022",2022,"Nice","Ligue 1","Bilal Brahimi","ALG","MF","21",2000,4.2,1,1,0,1,0,0,2,0,2,1,0,1,2,3,1,0,"https://fbref.com/en/players/02bcaf8e/Bilal-Brahimi"
"10154","Marcin Bułka_2022",2022,"Nice","Ligue 1","Marcin Bułka","POL","GK","21",1999,1,0,0,0,0,0,0,0,NA,0,0,0,0,0,0,0,0,"https://fbref.com/en/players/db87a2c4/Marcin-Bulka"
"10155","Alexis Claude-Maurice_2022",2022,"Nice","Ligue 1","Alexis Claude-Maurice","FRA","MF","23",1998,2.3,2,0,1,0,1,1,4,25,3,7,0,7,3,5,1,0,"https://fbref.com/en/players/741418c3/Alexis-Claude-Maurice"
"10156","Lucas Da Cunha_2022",2022,"Nice","Ligue 1","Lucas Da Cunha","FRA","MF","20",2001,4.4,13,7,2,7,4,6,11,54.5,5,2,0,2,1,14,2,0,"https://fbref.com/en/players/007faf7a/Lucas-Da-Cunha"
"10157","Flavius Daniliuc_2022",2022,"Nice","Ligue 1","Flavius Daniliuc","AUT","DF","20",2001,14.4,46,31,26,17,3,34,43,79.1,9,13,7,6,14,60,34,1,"https://fbref.com/en/players/7ef972c3/Flavius-Daniliuc"
"10158","Dante_2022",2022,"Nice","Ligue 1","Dante","BRA","DF","37",1983,31.9,42,29,30,12,0,23,33,69.7,10,43,27,16,49,91,96,1,"https://fbref.com/en/players/fd2bc67d/Dante"
"10159","Andy Delort_2022",2022,"Nice","Ligue 1","Andy Delort","ALG","FW","29",1991,27.2,15,9,3,5,7,7,12,58.3,5,13,4,9,9,24,14,0,"https://fbref.com/en/players/d33c706e/Andy-Delort"
"10160","Kasper Dolberg_2022",2022,"Nice","Ligue 1","Kasper Dolberg","DEN","FW","23",1997,16.6,9,4,4,3,2,3,9,33.3,6,15,1,14,6,15,17,0,"https://fbref.com/en/players/cc83b74d/Kasper-Dolberg"
"10161","Amine Gouiri_2022",2022,"Nice","Ligue 1","Amine Gouiri","FRA","FW,MF","21",2000,30.6,22,13,2,13,7,10,32,31.3,22,22,5,17,11,33,17,1,"https://fbref.com/en/players/aad56ca3/Amine-Gouiri"
"10162","Evann Guessand_2022",2022,"Nice","Ligue 1","Evann Guessand","FRA","FW","20",2001,4.9,9,8,2,5,2,3,8,37.5,5,4,0,4,0,9,1,0,"https://fbref.com/en/players/b73f17f8/Evann-Guessand"
"10163","Hassane Kamara_2022",2022,"Nice","Ligue 1","Hassane Kamara","CIV","MF,DF","27",1994,6,13,10,4,6,3,5,8,62.5,3,10,2,8,9,22,4,0,"https://fbref.com/en/players/19a12bed/Hassane-Kamara"
"10164","Justin Kluivert_2022",2022,"Nice","Ligue 1","Justin Kluivert","NED","MF","22",1999,20.8,19,9,6,12,1,5,21,23.8,16,13,1,12,14,33,6,0,"https://fbref.com/en/players/4c3a6744/Justin-Kluivert"
"10165","Mario Lemina_2022",2022,"Nice","Ligue 1","Mario Lemina","GAB","MF","27",1993,21.9,62,35,25,33,4,28,38,73.7,10,32,9,23,48,110,37,0,"https://fbref.com/en/players/2b471f99/Mario-Lemina"
"10166","Jordan Lotomba_2022",2022,"Nice","Ligue 1","Jordan Lotomba","SUI","DF","22",1998,19.8,33,17,21,9,3,16,30,53.3,14,17,4,13,12,45,28,0,"https://fbref.com/en/players/fc4cf6a7/Jordan-Lotomba"
"10167","Myziane Maolida_2022",2022,"Nice","Ligue 1","Myziane Maolida","FRA","MF","22",1999,0.4,1,0,0,1,0,0,0,NA,0,1,0,1,0,1,0,0,"https://fbref.com/en/players/706a60e1/Myziane-Maolida"
"10168","Dan Ndoye_2022",2022,"Nice","Ligue 1","Dan Ndoye","SUI","FW,MF","20",2000,2.3,0,0,0,0,0,0,2,0,2,4,0,4,0,0,0,0,"https://fbref.com/en/players/8e697a8f/Dan-Ndoye"
"10169","Pablo Rosario_2022",2022,"Nice","Ligue 1","Pablo Rosario","NED","MF","24",1997,30.3,59,37,18,32,9,26,66,39.4,40,33,7,26,38,97,43,0,"https://fbref.com/en/players/1a6b7ea4/Pablo-Rosario"
"10170","Morgan Schneiderlin_2022",2022,"Nice","Ligue 1","Morgan Schneiderlin","FRA","MF","31",1989,7.2,21,12,9,11,1,6,13,46.2,7,8,2,6,20,41,18,0,"https://fbref.com/en/players/51b41c5c/Morgan-Schneiderlin"
"10171","Calvin Stengs_2022",2022,"Nice","Ligue 1","Calvin Stengs","NED","MF","22",1998,11.9,16,7,6,9,1,7,20,35,13,10,0,10,8,24,6,0,"https://fbref.com/en/players/8f7e6783/Calvin-Stengs"
"10172","Khéphren Thuram_2022",2022,"Nice","Ligue 1","Khéphren Thuram","FRA","MF","20",2001,21.1,33,19,11,18,4,17,35,48.6,18,31,11,20,28,61,19,0,"https://fbref.com/en/players/7d9397f8/Khephren-Thuram"
"10173","Jean-Clair Todibo_2022",2022,"Nice","Ligue 1","Jean-Clair Todibo","FRA","DF","21",1999,34.6,59,37,43,15,1,39,60,65,21,45,21,24,51,110,130,2,"https://fbref.com/en/players/88f130ed/Jean-Clair-Todibo"
"10174","Max Aarons_2022",2022,"Norwich City","Premier League","Max Aarons","ENG","DF","21",2000,32,64,44,49,15,0,37,55,67.3,18,39,19,20,28,92,96,1,"https://fbref.com/en/players/774cf58b/Max-Aarons"
"10175","Sam Byram_2022",2022,"Norwich City","Premier League","Sam Byram","ENG","DF","27",1993,11.4,24,15,17,6,1,19,27,70.4,8,21,11,10,22,46,48,0,"https://fbref.com/en/players/1bf811d4/Sam-Byram"
"10176","Todd Cantwell_2022",2022,"Norwich City","Premier League","Todd Cantwell","ENG","FW,MF","23",1998,4.9,15,13,8,6,1,6,17,35.3,11,2,0,2,3,18,2,0,"https://fbref.com/en/players/f63d8a4b/Todd-Cantwell"
"10177","Kieran Dowell_2022",2022,"Norwich City","Premier League","Kieran Dowell","ENG","FW,MF","23",1997,10.1,18,7,8,7,3,9,32,28.1,23,10,1,9,7,25,4,0,"https://fbref.com/en/players/2f6ec02a/Kieran-Dowell"
"10178","Dimitris Giannoulis_2022",2022,"Norwich City","Premier League","Dimitris Giannoulis","GRE","DF","25",1995,13,36,21,17,17,2,24,36,66.7,12,22,6,16,19,55,41,1,"https://fbref.com/en/players/112c495e/Dimitris-Giannoulis"
"10179","Ben Gibson_2022",2022,"Norwich City","Premier League","Ben Gibson","ENG","DF","28",1993,27.7,23,16,17,6,0,7,12,58.3,5,36,30,6,27,50,139,2,"https://fbref.com/en/players/bcfb0142/Ben-Gibson"
"10180","Billy Gilmour_2022",2022,"Norwich City","Premier League","Billy Gilmour","SCO","MF","20",2001,20.6,41,21,16,21,4,14,52,26.9,38,21,4,17,17,58,29,0,"https://fbref.com/en/players/df10e27c/Billy-Gilmour"
"10181","Angus Gunn_2022",2022,"Norwich City","Premier League","Angus Gunn","SCO","GK","25",1996,9,0,0,0,0,0,0,0,NA,0,0,0,0,0,0,11,0,"https://fbref.com/en/players/e082af5b/Angus-Gunn"
"10182","Grant Hanley_2022",2022,"Norwich City","Premier League","Grant Hanley","SCO","DF","29",1991,32.2,44,25,28,14,2,18,35,51.4,17,56,45,11,56,100,176,2,"https://fbref.com/en/players/e9254eec/Grant-Hanley"
"10183","Adam Idah_2022",2022,"Norwich City","Premier League","Adam Idah","IRL","FW,MF","20",2001,6.9,9,6,2,5,2,2,3,66.7,1,4,2,2,3,12,7,0,"https://fbref.com/en/players/291e3ec3/Adam-Idah"
"10184","Ozan Kabak_2022",2022,"Norwich City","Premier League","Ozan Kabak","TUR","DF","21",2000,10.2,10,5,4,6,0,5,9,55.6,4,19,11,8,16,26,26,0,"https://fbref.com/en/players/2d61d13a/Ozan-Kabak"
"10185","Tim Krul_2022",2022,"Norwich City","Premier League","Tim Krul","NED","GK","33",1988,29,1,1,1,0,0,1,4,25,3,0,0,0,0,1,10,4,"https://fbref.com/en/players/f23f9d20/Tim-Krul"
"10186","Pierre Lees-Melou_2022",2022,"Norwich City","Premier League","Pierre Lees-Melou","FRA","MF","28",1993,25.2,58,36,23,29,6,25,92,27.2,67,37,11,26,25,83,23,0,"https://fbref.com/en/players/f5044e54/Pierre-Lees-Melou"
"10187","Kenny McLean_2022",2022,"Norwich City","Premier League","Kenny McLean","SCO","MF","29",1992,30.1,42,22,18,20,4,17,59,28.8,42,29,7,22,34,76,54,0,"https://fbref.com/en/players/471f16b3/Kenny-McLean"
"10188","Bali Mumba_2022",2022,"Norwich City","Premier League","Bali Mumba","ENG","DF","19",2001,0.5,1,1,1,0,0,0,0,NA,0,0,0,0,0,1,5,0,"https://fbref.com/en/players/2d760d7b/Bali-Mumba"
"10189","Mathias Normann_2022",2022,"Norwich City","Premier League","Mathias Normann","NOR","MF","25",1996,18.3,34,21,19,14,1,17,46,37,29,17,8,9,19,53,43,1,"https://fbref.com/en/players/8996350d/Mathias-Normann"
"10190","Andrew Omobamidele_2022",2022,"Norwich City","Premier League","Andrew Omobamidele","IRL","DF","19",2002,4.2,8,6,5,3,0,5,11,45.5,6,8,8,0,5,13,13,0,"https://fbref.com/en/players/c393a6c4/Andrew-Omobamidele"
"10191","Teemu Pukki_2022",2022,"Norwich City","Premier League","Teemu Pukki","FIN","FW","31",1990,36.1,23,11,2,14,7,6,29,20.7,23,21,1,20,4,27,3,0,"https://fbref.com/en/players/0745b37d/Teemu-Pukki"
"10192","Przemysław Płacheta_2022",2022,"Norwich City","Premier League","Przemysław Płacheta","POL","FW,MF","23",1998,5.6,4,3,3,1,0,2,7,28.6,5,3,1,2,2,6,5,1,"https://fbref.com/en/players/3c33f9d9/Przemyslaw-Placheta"
"10193","Milot Rashica_2022",2022,"Norwich City","Premier League","Milot Rashica","KVX","FW,MF","25",1996,24.8,31,19,12,12,7,11,30,36.7,19,22,3,19,15,46,23,0,"https://fbref.com/en/players/6c6a3300/Milot-Rashica"
"10194","Jon Rowe_2022",2022,"Norwich City","Premier League","Jon Rowe","ENG","FW,MF","18",2003,2.5,3,2,2,1,0,2,3,66.7,1,7,0,7,3,6,1,0,"https://fbref.com/en/players/8c12f884/Jon-Rowe"
"10195","Lukas Rupp_2022",2022,"Norwich City","Premier League","Lukas Rupp","GER","MF","30",1991,8.5,9,4,5,3,1,4,15,26.7,11,11,1,10,9,18,7,0,"https://fbref.com/en/players/3faa1780/Lukas-Rupp"
"10196","Josh Sargent_2022",2022,"Norwich City","Premier League","Josh Sargent","USA","FW,MF","21",2000,17.5,26,14,15,7,4,14,39,35.9,25,29,2,27,11,37,18,2,"https://fbref.com/en/players/a8d4428b/Josh-Sargent"
"10197","Tony Springett_2022",2022,"Norwich City","Premier League","Tony Springett","ENG","MF,FW","18",2002,1.6,2,1,1,1,0,1,4,25,3,0,0,0,0,2,2,0,"https://fbref.com/en/players/35be8087/Tony-Springett"
"10198","Jakob Sørensen_2022",2022,"Norwich City","Premier League","Jakob Sørensen","DEN","MF,DF","23",1998,6.7,22,11,6,14,2,10,20,50,10,7,3,4,10,32,19,0,"https://fbref.com/en/players/953c30b0/Jakob-Sorensen"
"10199","Christos Tzolis_2022",2022,"Norwich City","Premier League","Christos Tzolis","GRE","FW,MF","19",2002,3.7,5,3,3,1,1,2,9,22.2,7,3,0,3,1,6,1,0,"https://fbref.com/en/players/9f333379/Christos-Tzolis"
"10200","Brandon Williams_2022",2022,"Norwich City","Premier League","Brandon Williams","ENG","DF","20",2000,23.6,55,37,35,18,2,36,64,56.3,28,26,6,20,44,99,50,0,"https://fbref.com/en/players/5e74d6c8/Brandon-Williams"
"10201","Christoph Zimmermann_2022",2022,"Norwich City","Premier League","Christoph Zimmermann","GER","DF","28",1993,1.7,6,3,5,1,0,3,4,75,1,0,0,0,1,7,4,0,"https://fbref.com/en/players/2d5f03bf/Christoph-Zimmermann"
"10202","José Ángel_2022",2022,"Osasuna","La Liga","José Ángel","ESP","DF","31",1989,12,20,13,9,9,2,9,14,64.3,5,6,1,5,10,30,21,0,"https://fbref.com/en/players/3024e383/Jose-Angel"
"10203","Jesús Areso_2022",2022,"Osasuna","La Liga","Jesús Areso","ESP","DF","22",1999,2.1,3,3,2,1,0,0,2,0,2,0,0,0,0,3,2,1,"https://fbref.com/en/players/94e01ec6/Jesus-Areso"
"10204","Ezequiel Ávila_2022",2022,"Osasuna","La Liga","Ezequiel Ávila","ARG","FW,MF","27",1994,20.8,17,7,6,7,4,7,21,33.3,14,14,2,12,13,30,15,1,"https://fbref.com/en/players/253a06b9/Ezequiel-Avila"
"10205","Barbero_2022",2022,"Osasuna","La Liga","Barbero","ESP","FW,MF","22",1998,0.2,0,0,0,0,0,0,0,NA,0,0,0,0,0,0,1,0,"https://fbref.com/en/players/981c1863/Barbero"
"10206","Kike Barja_2022",2022,"Osasuna","La Liga","Kike Barja","ESP","MF,FW","24",1997,9.6,15,11,4,7,4,8,22,36.4,14,10,1,9,9,24,4,0,"https://fbref.com/en/players/aad53e64/Kike-Barja"
"10207","Iker Benito_2022",2022,"Osasuna","La Liga","Iker Benito","ESP","FW,MF","18",2002,1.3,2,1,1,0,1,0,1,0,1,2,0,2,0,2,2,0,"https://fbref.com/en/players/50cbc806/Iker-Benito"
"10208","Darko Brašanac_2022",2022,"Osasuna","La Liga","Darko Brašanac","SRB","MF","29",1992,26.7,35,22,19,14,2,14,40,35,26,25,8,17,25,60,15,0,"https://fbref.com/en/players/4accb7e0/Darko-Brasanac"
"10209","Ante Budimir_2022",2022,"Osasuna","La Liga","Ante Budimir","CRO","FW","30",1991,19.3,24,10,3,15,6,6,19,31.6,13,22,4,18,3,27,16,0,"https://fbref.com/en/players/8f3565b3/Ante-Budimir"
"10210","Juan Cruz Armada_2022",2022,"Osasuna","La Liga","Juan Cruz Armada","ESP","DF","29",1992,21.5,28,21,15,12,1,8,16,50,8,15,12,3,16,44,58,1,"https://fbref.com/en/players/a56da3ba/Juan-Cruz-Armada"
"10211","Unai Dufur_2022",2022,"Osasuna","La Liga","Unai Dufur","ESP","DF","22",1999,1,0,0,0,0,0,0,0,NA,0,1,0,1,4,4,4,0,"https://fbref.com/en/players/c261b5dd/Unai-Dufur"
"10212","David García_2022",2022,"Osasuna","La Liga","David García","ESP","DF","27",1994,34.5,28,14,15,11,2,12,22,54.5,10,27,21,6,52,80,168,0,"https://fbref.com/en/players/3e42f707/David-Garcia"
"10213","Rubén García_2022",2022,"Osasuna","La Liga","Rubén García","ESP","MF,FW","28",1993,26.4,43,26,12,23,8,16,49,32.7,33,31,4,27,24,67,16,0,"https://fbref.com/en/players/5c96b017/Ruben-Garcia"
"10214","Unai García_2022",2022,"Osasuna","La Liga","Unai García","ESP","DF","29",1992,15.6,21,12,14,6,1,14,17,82.4,3,19,11,8,22,43,78,0,"https://fbref.com/en/players/4a633cfe/Unai-Garcia"
"10215","Jaume Grau_2022",2022,"Osasuna","La Liga","Jaume Grau","ESP","MF","24",1997,0,1,1,1,0,0,0,1,0,1,0,0,0,0,1,0,0,"https://fbref.com/en/players/fc3d2006/Jaume-Grau"
"10216","Aridane Hernández_2022",2022,"Osasuna","La Liga","Aridane Hernández","ESP","DF","32",1989,12.9,12,9,10,2,0,3,13,23.1,10,11,9,2,20,32,71,0,"https://fbref.com/en/players/132ac341/Aridane-Hernandez"
"10217","Sergio Herrera_2022",2022,"Osasuna","La Liga","Sergio Herrera","ESP","GK","28",1993,36,3,2,3,0,0,3,6,50,3,1,0,1,1,4,18,0,"https://fbref.com/en/players/a4995f48/Sergio-Herrera"
"10218","Robert Ibáñez_2022",2022,"Osasuna","La Liga","Robert Ibáñez","ESP","MF,FW","28",1993,1,3,3,2,0,1,1,2,50,1,1,0,1,1,4,1,0,"https://fbref.com/en/players/c7429db3/Robert-Ibanez"
"10219","Kike_2022",2022,"Osasuna","La Liga","Kike","ESP","FW","31",1989,20.7,11,7,3,4,4,3,23,13,20,10,1,9,3,14,12,0,"https://fbref.com/en/players/e897d8ba/Kike"
"10220","Javi Martínez_2022",2022,"Osasuna","La Liga","Javi Martínez","ESP","MF,FW","21",1999,9.8,21,14,8,11,2,10,29,34.5,19,6,0,6,9,30,10,0,"https://fbref.com/en/players/3672b352/Javi-Martinez"
"10221","Jon Moncayola_2022",2022,"Osasuna","La Liga","Jon Moncayola","ESP","MF","23",1998,32.4,40,20,18,18,4,17,44,38.6,27,26,9,17,20,60,43,0,"https://fbref.com/en/players/9939e168/Jon-Moncayola"
"10222","Javier Ontiveros_2022",2022,"Osasuna","La Liga","Javier Ontiveros","ESP","FW,MF","23",1997,0.4,0,0,0,0,0,0,2,0,2,0,0,0,1,1,0,1,"https://fbref.com/en/players/a83d8b0c/Javier-Ontiveros"
"10223","Iñigo Pérez_2022",2022,"Osasuna","La Liga","Iñigo Pérez","ESP","MF","33",1988,3.8,3,2,2,1,0,2,4,50,2,1,0,1,0,3,3,0,"https://fbref.com/en/players/bc61cc65/Inigo-Perez"
"10224","Juan Pérez_2022",2022,"Osasuna","La Liga","Juan Pérez","ESP","GK","25",1996,2,0,0,0,0,0,0,1,0,1,0,0,0,0,0,1,1,"https://fbref.com/en/players/8f29e08b/Juan-Perez"
"10225","Jonás Ramalho_2022",2022,"Osasuna","La Liga","Jonás Ramalho","ESP","DF","28",1993,2.7,4,2,2,2,0,2,3,66.7,1,4,1,3,3,7,9,0,"https://fbref.com/en/players/be3a0121/Jonas-Ramalho"
"10226","Manu Sánchez_2022",2022,"Osasuna","La Liga","Manu Sánchez","ESP","DF","20",2000,25.1,72,34,41,22,9,43,79,54.4,36,28,3,25,18,90,43,0,"https://fbref.com/en/players/ffacd3d5/Manu-Sanchez"
"10227","Oier Sanjurjo_2022",2022,"Osasuna","La Liga","Oier Sanjurjo","ESP","MF","35",1986,8.4,10,6,3,7,0,2,19,10.5,17,8,3,5,1,11,9,0,"https://fbref.com/en/players/466824fb/Oier-Sanjurjo"
"10228","Roberto Torres_2022",2022,"Osasuna","La Liga","Roberto Torres","ESP","MF,FW","32",1989,9,7,4,3,1,3,3,15,20,12,8,0,8,8,15,4,0,"https://fbref.com/en/players/d733aa38/Roberto-Torres"
"10229","Lucas Torró_2022",2022,"Osasuna","La Liga","Lucas Torró","ESP","MF","27",1994,30.3,71,40,25,38,8,29,57,50.9,28,32,11,21,47,118,55,0,"https://fbref.com/en/players/0e4fef6e/Lucas-Torro"
"10230","Nacho Vidal_2022",2022,"Osasuna","La Liga","Nacho Vidal","ESP","DF","26",1995,32.2,83,47,49,25,9,39,77,50.6,38,32,14,18,58,141,79,0,"https://fbref.com/en/players/3a9c4b7b/Nacho-Vidal"
"10231","Juan Bernat_2022",2022,"Paris S-G","Ligue 1","Juan Bernat","ESP","DF,MF","28",1993,10.6,24,14,10,10,4,13,18,72.2,5,8,0,8,8,32,16,0,"https://fbref.com/en/players/433dc9a2/Juan-Bernat"
"10232","Nathan Bitu Mazala_2022",2022,"Paris S-G","Ligue 1","Nathan Bitu Mazala","FRA","DF","18",2002,0.1,0,0,0,0,0,0,0,NA,0,1,0,1,0,0,0,0,"https://fbref.com/en/players/0f697e02/Nathan-Bitu-Mazala"
"10233","El Chadaille Bitshiabu_2022",2022,"Paris S-G","Ligue 1","El Chadaille Bitshiabu","FRA","DF","16",2005,0.1,0,0,0,0,0,0,0,NA,0,0,0,0,0,0,2,0,"https://fbref.com/en/players/2180c761/El-Chadaille-Bitshiabu"
"10234","Colin Dagba_2022",2022,"Paris S-G","Ligue 1","Colin Dagba","FRA","DF","22",1998,1.8,4,2,2,2,0,3,6,50,3,4,2,2,2,6,1,0,"https://fbref.com/en/players/29c02c9f/Colin-Dagba"
"10235","Ángel Di María_2022",2022,"Paris S-G","Ligue 1","Ángel Di María","ARG","FW","33",1988,18.3,29,18,6,13,10,14,37,37.8,23,17,0,17,6,35,3,0,"https://fbref.com/en/players/19cda00b/Angel-Di-Maria"
"10236","Abdou Diallo_2022",2022,"Paris S-G","Ligue 1","Abdou Diallo","SEN","DF","25",1996,9.7,22,14,10,9,3,8,14,57.1,6,6,2,4,10,32,19,1,"https://fbref.com/en/players/fc62f087/Abdou-Diallo"
"10237","Junior Dina Ebimbe_2022",2022,"Paris S-G","Ligue 1","Junior Dina Ebimbe","FRA","MF","20",2000,3.5,9,4,3,4,2,2,3,66.7,1,5,3,2,2,11,1,0,"https://fbref.com/en/players/95bb6ddc/Junior-Dina-Ebimbe"
"10238","Gianluigi Donnarumma_2022",2022,"Paris S-G","Ligue 1","Gianluigi Donnarumma","ITA","GK","22",1999,17,0,0,0,0,0,0,0,NA,0,0,0,0,0,0,9,2,"https://fbref.com/en/players/08f5afaa/Gianluigi-Donnarumma"
"10239","Julian Draxler_2022",2022,"Paris S-G","Ligue 1","Julian Draxler","GER","FW,MF","27",1993,6.1,3,2,0,3,0,0,4,0,4,3,0,3,5,8,3,0,"https://fbref.com/en/players/1a992676/Julian-Draxler"
"10240","Idrissa Gana Gueye_2022",2022,"Paris S-G","Ligue 1","Idrissa Gana Gueye","SEN","MF","31",1989,18.2,60,36,24,24,12,18,44,40.9,26,23,4,19,24,84,13,0,"https://fbref.com/en/players/72c812f3/Idrissa-Gana-Gueye"
"10241","Djeidi Gassama_2022",2022,"Paris S-G","Ligue 1","Djeidi Gassama","FRA","FW","17",2003,0,0,0,0,0,0,0,0,NA,0,1,1,0,0,0,0,0,"https://fbref.com/en/players/bbdb2789/Djeidi-Gassama"
"10242","Ismaël Gharbi_2022",2022,"Paris S-G","Ligue 1","Ismaël Gharbi","ESP","FW","17",2004,0,0,0,0,0,0,0,0,NA,0,0,0,0,0,0,0,0,"https://fbref.com/en/players/5b3cfa12/Ismael-Gharbi"
"10243","Achraf Hakimi_2022",2022,"Paris S-G","Ligue 1","Achraf Hakimi","MAR","DF","22",1998,27.5,74,51,38,27,9,40,72,55.6,32,26,5,21,28,102,23,2,"https://fbref.com/en/players/e42d61c7/Achraf-Hakimi"
"10244","Ander Herrera_2022",2022,"Paris S-G","Ligue 1","Ander Herrera","ESP","MF","31",1989,12.1,29,17,7,16,6,14,39,35.9,25,22,8,14,14,43,8,0,"https://fbref.com/en/players/436a9dd0/Ander-Herrera"
"10245","Mauro Icardi_2022",2022,"Paris S-G","Ligue 1","Mauro Icardi","ARG","FW","28",1993,11.4,5,3,1,3,1,3,7,42.9,4,3,0,3,5,10,12,0,"https://fbref.com/en/players/43b78598/Mauro-Icardi"
"10246","Arnaud Kalimuendo_2022",2022,"Paris S-G","Ligue 1","Arnaud Kalimuendo","FRA","FW","19",2002,0.1,0,0,0,0,0,0,0,NA,0,0,0,0,0,0,0,0,"https://fbref.com/en/players/bf4c41f9/Arnaud-Kalimuendo"
"10247","Thilo Kehrer_2022",2022,"Paris S-G","Ligue 1","Thilo Kehrer","GER","DF","24",1996,16.8,21,14,9,11,1,9,21,42.9,12,19,11,8,24,45,29,0,"https://fbref.com/en/players/51dbeea9/Thilo-Kehrer"
"10248","Presnel Kimpembe_2022",2022,"Paris S-G","Ligue 1","Presnel Kimpembe","FRA","DF","25",1995,28.6,34,19,18,15,1,14,23,60.9,9,20,14,6,38,72,73,1,"https://fbref.com/en/players/aef6e670/Presnel-Kimpembe"
"10249","Alexandre Letellier_2022",2022,"Paris S-G","Ligue 1","Alexandre Letellier","FRA","GK","30",1990,0.1,0,0,0,0,0,0,0,NA,0,0,0,0,0,0,0,0,"https://fbref.com/en/players/96fcd380/Alexandre-Letellier"
"10250","Marquinhos_2022",2022,"Paris S-G","Ligue 1","Marquinhos","BRA","DF","27",1994,31.8,37,14,25,11,1,20,35,57.1,15,35,19,16,16,53,102,0,"https://fbref.com/en/players/d5f2f82b/Marquinhos"
"10251","Kylian Mbappé_2022",2022,"Paris S-G","Ligue 1","Kylian Mbappé","FRA","FW","22",1998,33.6,11,8,1,4,6,7,13,53.8,6,6,0,6,5,16,13,0,"https://fbref.com/en/players/42fd9c7f/Kylian-Mbappe"
"10252","Nuno Mendes_2022",2022,"Paris S-G","Ligue 1","Nuno Mendes","POR","DF","19",2002,18.4,48,29,23,18,7,25,47,53.2,22,27,5,22,21,69,17,1,"https://fbref.com/en/players/f20e4cc9/Nuno-Mendes"
"10253","Lionel Messi_2022",2022,"Paris S-G","Ligue 1","Lionel Messi","ARG","FW,MF","34",1987,23.9,10,3,1,5,4,3,13,23.1,10,5,0,5,4,14,0,0,"https://fbref.com/en/players/d70ce98e/Lionel-Messi"
"10254","Edouard Michut_2022",2022,"Paris S-G","Ligue 1","Edouard Michut","FRA","MF","18",2003,0.8,0,0,0,0,0,0,2,0,2,2,0,2,1,1,2,0,"https://fbref.com/en/players/fe6c1add/Edouard-Michut"
"10255","Keylor Navas_2022",2022,"Paris S-G","Ligue 1","Keylor Navas","CRC","GK","34",1986,20.6,0,0,0,0,0,0,0,NA,0,0,0,0,0,0,5,1,"https://fbref.com/en/players/ecada4fc/Keylor-Navas"
"10256","Neymar_2022",2022,"Paris S-G","Ligue 1","Neymar","BRA","FW,MF","29",1992,20.6,29,19,5,12,12,12,36,33.3,24,9,1,8,4,33,2,1,"https://fbref.com/en/players/69384e5d/Neymar"
"10257","Leandro Paredes_2022",2022,"Paris S-G","Ligue 1","Leandro Paredes","ARG","MF","27",1994,9.3,23,13,9,11,3,12,24,50,12,10,6,4,10,33,5,2,"https://fbref.com/en/players/dff153a4/Leandro-Paredes"
"10258","Danilo Pereira_2022",2022,"Paris S-G","Ligue 1","Danilo Pereira","POR","MF","29",1991,22.6,33,17,10,20,3,14,28,50,14,19,10,9,37,70,29,1,"https://fbref.com/en/players/8fd9996f/Danilo-Pereira"
"10259","Rafinha_2022",2022,"Paris S-G","Ligue 1","Rafinha","BRA","FW,MF","28",1993,2.4,14,8,3,9,2,7,11,63.6,4,3,0,3,4,18,0,0,"https://fbref.com/en/players/0c2ac3cb/Rafinha"
"10260","Sergio Ramos_2022",2022,"Paris S-G","Ligue 1","Sergio Ramos","ESP","DF","35",1986,8.9,12,5,6,6,0,8,15,53.3,7,4,2,2,8,20,27,0,"https://fbref.com/en/players/08511d65/Sergio-Ramos"
"10261","Sergio Rico_2022",2022,"Paris S-G","Ligue 1","Sergio Rico","ESP","GK","27",1993,0.3,0,0,0,0,0,0,0,NA,0,0,0,0,0,0,1,0,"https://fbref.com/en/players/5f0241b2/Sergio-Rico"
"10262","Pablo Sarabia_2022",2022,"Paris S-G","Ligue 1","Pablo Sarabia","ESP","FW","29",1992,0.2,0,0,0,0,0,0,1,0,1,0,0,0,0,0,0,0,"https://fbref.com/en/players/9744ff80/Pablo-Sarabia"
"10263","Xavi Simons_2022",2022,"Paris S-G","Ligue 1","Xavi Simons","NED","MF,FW","18",2003,1.5,1,1,0,1,0,1,2,50,1,3,0,3,0,1,0,0,"https://fbref.com/en/players/da4d670f/Xavi-Simons"
"10264","Marco Verratti_2022",2022,"Paris S-G","Ligue 1","Marco Verratti","ITA","MF","28",1992,21.5,60,40,16,30,14,32,64,50,32,36,10,26,18,78,14,2,"https://fbref.com/en/players/1467af0d/Marco-Verratti"
"10265","Georginio Wijnaldum_2022",2022,"Paris S-G","Ligue 1","Georginio Wijnaldum","NED","MF","30",1990,18.4,15,9,2,12,1,11,19,57.9,8,13,3,10,9,24,7,0,"https://fbref.com/en/players/eb58eef0/Georginio-Wijnaldum"
"10266","Sekou Yansané_2022",2022,"Paris S-G","Ligue 1","Sekou Yansané","GUI","FW","18",2003,0.2,0,0,0,0,0,0,1,0,1,0,0,0,0,0,1,0,"https://fbref.com/en/players/bce37ac0/Sekou-Yansane"
"10267","Tyler Adams_2022",2022,"RB Leipzig","Bundesliga","Tyler Adams","USA","MF","22",1999,15,23,7,5,16,2,7,25,28,18,24,1,23,16,39,19,2,"https://fbref.com/en/players/2b09d998/Tyler-Adams"
"10268","Angeliño_2022",2022,"RB Leipzig","Bundesliga","Angeliño","ESP","DF","24",1997,25.5,28,21,14,13,1,14,30,46.7,16,24,3,21,29,57,40,0,"https://fbref.com/en/players/30941e96/Angelino"
"10269","Solomon Bonnah_2022",2022,"RB Leipzig","Bundesliga","Solomon Bonnah","NED","DF","17",2003,0.1,0,0,0,0,0,0,0,NA,0,1,0,1,1,1,0,0,"https://fbref.com/en/players/dd7b6eb8/Solomon-Bonnah"
"10270","Brian Brobbey_2022",2022,"RB Leipzig","Bundesliga","Brian Brobbey","NED","FW,MF","19",2002,1.5,1,0,0,1,0,1,1,100,0,1,0,1,0,1,0,0,"https://fbref.com/en/players/4c184730/Brian-Brobbey"
"10271","Emil Forsberg_2022",2022,"RB Leipzig","Bundesliga","Emil Forsberg","SWE","MF","29",1991,19,21,12,2,11,8,7,22,31.8,15,18,0,18,2,23,2,1,"https://fbref.com/en/players/9a2e0ccc/Emil-Forsberg"
"10272","Péter Gulácsi_2022",2022,"RB Leipzig","Bundesliga","Péter Gulácsi","HUN","GK","31",1990,33,0,0,0,0,0,0,0,NA,0,0,0,0,1,1,15,1,"https://fbref.com/en/players/bcb2ccd8/Peter-Gulacsi"
"10273","Joško Gvardiol_2022",2022,"RB Leipzig","Bundesliga","Joško Gvardiol","CRO","DF","19",2002,26.8,47,31,28,17,2,22,39,56.4,17,30,11,19,51,98,62,2,"https://fbref.com/en/players/5ad50391/Josko-Gvardiol"
"10274","Amadou Haidara_2022",2022,"RB Leipzig","Bundesliga","Amadou Haidara","MLI","MF","23",1998,14.7,30,14,11,19,0,17,37,45.9,20,22,6,16,16,46,8,1,"https://fbref.com/en/players/92432bc6/Amadou-Haidara"
"10275","Marcel Halstenberg_2022",2022,"RB Leipzig","Bundesliga","Marcel Halstenberg","GER","DF","29",1991,5.6,10,7,6,4,0,6,11,54.5,5,6,0,6,7,17,11,0,"https://fbref.com/en/players/8ff2354e/Marcel-Halstenberg"
"10276","Hwang Hee-chan_2022",2022,"RB Leipzig","Bundesliga","Hwang Hee-chan","KOR","FW","25",1996,0.5,0,0,0,0,0,0,0,NA,0,0,0,0,1,1,0,0,"https://fbref.com/en/players/169fd162/Hwang-Hee-chan"
"10277","Benjamin Henrichs_2022",2022,"RB Leipzig","Bundesliga","Benjamin Henrichs","GER","DF","24",1997,12.7,30,21,18,6,6,12,22,54.5,10,16,1,15,19,49,14,0,"https://fbref.com/en/players/0a89e877/Benjamin-Henrichs"
"10278","Kevin Kampl_2022",2022,"RB Leipzig","Bundesliga","Kevin Kampl","SVN","MF","30",1990,21.1,41,19,16,20,5,10,42,23.8,32,24,5,19,24,65,17,0,"https://fbref.com/en/players/b825a650/Kevin-Kampl"
"10279","Lukas Klostermann_2022",2022,"RB Leipzig","Bundesliga","Lukas Klostermann","GER","DF","25",1996,18.3,29,16,11,15,3,13,19,68.4,6,16,3,13,26,55,58,0,"https://fbref.com/en/players/ca8033cb/Lukas-Klostermann"
"10280","Konrad Laimer_2022",2022,"RB Leipzig","Bundesliga","Konrad Laimer","AUT","MF","24",1997,13.8,38,24,11,22,5,24,53,45.3,29,29,3,26,4,42,9,0,"https://fbref.com/en/players/c1b7847c/Konrad-Laimer"
"10281","Josep Martinez_2022",2022,"RB Leipzig","Bundesliga","Josep Martinez","ESP","GK","23",1998,1,0,0,0,0,0,0,0,NA,0,0,0,0,0,0,0,0,"https://fbref.com/en/players/11d8aff0/Josep-Martinez"
"10282","Ilaix Moriba_2022",2022,"RB Leipzig","Bundesliga","Ilaix Moriba","GUI","MF","18",2003,0.4,0,0,0,0,0,0,4,0,4,2,0,2,1,1,0,0,"https://fbref.com/en/players/f4c69aa6/Ilaix-Moriba"
"10283","Nordi Mukiele_2022",2022,"RB Leipzig","Bundesliga","Nordi Mukiele","FRA","DF,FW","23",1997,20.5,35,22,23,9,3,14,27,51.9,13,31,5,26,31,66,44,2,"https://fbref.com/en/players/ac73ec79/Nordi-Mukiele"
"10284","Christopher Nkunku_2022",2022,"RB Leipzig","Bundesliga","Christopher Nkunku","FRA","FW,MF","23",1997,30.3,23,10,10,11,2,9,35,25.7,26,23,2,21,15,38,15,0,"https://fbref.com/en/players/7c56da38/Christopher-Nkunku"
"10285","Hugo Novoa_2022",2022,"RB Leipzig","Bundesliga","Hugo Novoa","ESP","MF,FW","18",2003,1.5,4,4,2,0,2,2,7,28.6,5,2,0,2,1,5,0,0,"https://fbref.com/en/players/5458f670/Hugo-Novoa"
"10286","Dani Olmo_2022",2022,"RB Leipzig","Bundesliga","Dani Olmo","ESP","MF,FW","23",1998,8.3,14,6,5,7,2,5,18,27.8,13,5,1,4,4,18,1,0,"https://fbref.com/en/players/ae44e8e2/Dani-Olmo"
"10287","Willi Orban_2022",2022,"RB Leipzig","Bundesliga","Willi Orban","HUN","DF","28",1992,29.4,32,22,20,11,1,13,25,52,12,40,24,16,44,76,123,2,"https://fbref.com/en/players/20030c06/Willi-Orban"
"10288","Yussuf Poulsen_2022",2022,"RB Leipzig","Bundesliga","Yussuf Poulsen","DEN","FW,MF","27",1994,12,13,4,3,6,4,3,13,23.1,10,13,0,13,3,16,9,0,"https://fbref.com/en/players/d2416c2e/Yussuf-Poulsen"
"10289","Sidney Raebiger_2022",2022,"RB Leipzig","Bundesliga","Sidney Raebiger","GER","MF","16",2005,0,0,0,0,0,0,0,0,NA,0,0,0,0,0,0,0,0,"https://fbref.com/en/players/a8090a41/Sidney-Raebiger"
"10290","Marcel Sabitzer_2022",2022,"RB Leipzig","Bundesliga","Marcel Sabitzer","AUT","MF,FW","27",1994,0.5,2,1,1,1,0,1,1,100,0,0,0,0,1,3,0,0,"https://fbref.com/en/players/e280527c/Marcel-Sabitzer"
"10291","André Silva_2022",2022,"RB Leipzig","Bundesliga","André Silva","POR","FW","25",1995,23.1,13,9,2,3,8,4,13,30.8,9,20,2,18,2,15,15,0,"https://fbref.com/en/players/3effaa34/Andre-Silva"
"10292","Mohamed Simakan_2022",2022,"RB Leipzig","Bundesliga","Mohamed Simakan","FRA","DF","21",2000,22.3,48,27,25,21,2,27,41,65.9,14,22,11,11,40,88,46,1,"https://fbref.com/en/players/fcb27134/Mohamed-Simakan"
"10293","Dominik Szoboszlai_2022",2022,"RB Leipzig","Bundesliga","Dominik Szoboszlai","HUN","MF,FW","20",2000,17.1,17,12,5,9,3,8,27,29.6,19,30,3,27,10,27,15,0,"https://fbref.com/en/players/934e1968/Dominik-Szoboszlai"
"10294","Philipp Tschauner_2022",2022,"RB Leipzig","Bundesliga","Philipp Tschauner","GER","GK","35",1985,0,0,0,0,0,0,0,0,NA,0,0,0,0,0,0,0,0,"https://fbref.com/en/players/73e2f6eb/Philipp-Tschauner"
"10295","Joscha Wosz_2022",2022,"RB Leipzig","Bundesliga","Joscha Wosz","GER","DF","19",2002,0.1,0,0,0,0,0,0,0,NA,0,0,0,0,0,0,0,0,"https://fbref.com/en/players/80c9e555/Joscha-Wosz"
"10296","Álvaro Aguirre_2022",2022,"Rayo Vallecano","La Liga","Álvaro Aguirre","ESP","FW","21",2000,0.1,0,0,0,0,0,0,0,NA,0,0,0,0,0,0,0,0,"https://fbref.com/en/players/93b054dc/Alvaro-Aguirre"
"10297","Alejandro Asensio_2022",2022,"Rayo Vallecano","La Liga","Alejandro Asensio","ESP","FW","20",2000,0.1,0,0,0,0,0,0,0,NA,0,0,0,0,0,0,0,0,"https://fbref.com/en/players/b4c23f36/Alejandro-Asensio"
"10298","Iván Balliu_2022",2022,"Rayo Vallecano","La Liga","Iván Balliu","ALB","DF","29",1992,35,45,22,25,11,9,19,31,61.3,12,24,5,19,39,84,64,0,"https://fbref.com/en/players/cee88597/Ivan-Balliu"
"10299","Bebé_2022",2022,"Rayo Vallecano","La Liga","Bebé","CPV","FW","31",1990,9.6,6,5,1,3,2,4,16,25,12,18,0,18,3,9,6,0,"https://fbref.com/en/players/d8712bf9/Bebe"
"10300","Catena_2022",2022,"Rayo Vallecano","La Liga","Catena","ESP","DF","26",1994,36,39,23,24,15,0,25,42,59.5,17,26,19,7,30,69,168,3,"https://fbref.com/en/players/274ab13c/Catena"
"10301","Pathé Ciss_2022",2022,"Rayo Vallecano","La Liga","Pathé Ciss","SEN","MF","27",1994,12.2,31,15,20,8,3,12,26,46.2,14,16,6,10,30,61,27,0,"https://fbref.com/en/players/9a0408b6/Pathe-Ciss"
"10302","Santi Comesaña_2022",2022,"Rayo Vallecano","La Liga","Santi Comesaña","ESP","MF","24",1996,29.8,87,56,45,33,9,40,104,38.5,64,46,6,40,33,120,30,0,"https://fbref.com/en/players/5ae499d0/Santi-Comesana"
"10303","Stole Dimitrievski_2022",2022,"Rayo Vallecano","La Liga","Stole Dimitrievski","MKD","GK","27",1993,30.8,0,0,0,0,0,0,0,NA,0,0,0,0,1,1,14,3,"https://fbref.com/en/players/fc70e345/Stole-Dimitrievski"
"10304","Radamel Falcao_2022",2022,"Rayo Vallecano","La Liga","Radamel Falcao","COL","FW","35",1986,9.3,2,1,0,1,1,1,4,25,3,4,1,3,2,4,11,0,"https://fbref.com/en/players/66116290/Radamel-Falcao"
"10305","Álvaro García_2022",2022,"Rayo Vallecano","La Liga","Álvaro García","ESP","FW,MF","28",1992,33.3,42,23,15,18,9,8,35,22.9,27,27,3,24,42,84,24,0,"https://fbref.com/en/players/90bbd822/Alvaro-Garcia"
"10306","Fran Garcia_2022",2022,"Rayo Vallecano","La Liga","Fran Garcia","ESP","DF","21",1999,33.6,60,35,44,12,4,39,73,53.4,34,34,8,26,45,105,53,0,"https://fbref.com/en/players/7226539b/Fran-Garcia"
"10307","Sergi Guardiola_2022",2022,"Rayo Vallecano","La Liga","Sergi Guardiola","ESP","FW","30",1991,19,10,9,3,5,2,1,21,4.8,20,14,2,12,4,14,17,0,"https://fbref.com/en/players/32974271/Sergi-Guardiola"
"10308","Mario Hernández_2022",2022,"Rayo Vallecano","La Liga","Mario Hernández","ESP","DF,FW","22",1999,4.4,10,4,7,3,0,5,9,55.6,4,1,0,1,4,14,7,0,"https://fbref.com/en/players/90162357/Mario-Hernandez"
"10309","Unai López_2022",2022,"Rayo Vallecano","La Liga","Unai López","ESP","MF","25",1995,12.9,19,9,6,10,3,10,33,30.3,23,7,0,7,10,29,8,1,"https://fbref.com/en/players/88050721/Unai-Lopez"
"10310","Nikola Maraš_2022",2022,"Rayo Vallecano","La Liga","Nikola Maraš","SRB","DF","25",1995,11.6,13,9,12,1,0,9,15,60,6,17,13,4,15,28,51,0,"https://fbref.com/en/players/b9d0446f/Nikola-Maras"
"10311","Andrés Martín_2022",2022,"Rayo Vallecano","La Liga","Andrés Martín","ESP","FW,MF","22",1999,2.1,0,0,0,0,0,0,1,0,1,1,0,1,0,0,0,0,"https://fbref.com/en/players/2ae30661/Andres-Martin"
"10312","Martín Merquelanz_2022",2022,"Rayo Vallecano","La Liga","Martín Merquelanz","ESP","FW,MF","26",1995,1.9,2,1,2,0,0,2,6,33.3,4,2,0,2,0,2,1,0,"https://fbref.com/en/players/ddd5348b/Martin-Merquelanz"
"10313","Randy Ntekja_2022",2022,"Rayo Vallecano","La Liga","Randy Ntekja","FRA","FW,MF","23",1997,16.2,24,13,9,11,4,8,19,42.1,11,21,1,20,8,32,12,0,"https://fbref.com/en/players/a6103274/Randy-Ntekja"
"10314","Isaac Palazón Camacho_2022",2022,"Rayo Vallecano","La Liga","Isaac Palazón Camacho","ESP","FW,MF","26",1994,25.4,42,28,20,19,3,18,59,30.5,41,31,3,28,13,55,22,0,"https://fbref.com/en/players/49dbab27/Isaac-Palazon-Camacho"
"10315","José Pozo_2022",2022,"Rayo Vallecano","La Liga","José Pozo","ESP","MF,DF","25",1996,0.8,2,2,0,2,0,2,3,66.7,1,1,0,1,0,2,1,0,"https://fbref.com/en/players/fc8b614b/Jose-Pozo"
"10316","Yacine Qasmi_2022",2022,"Rayo Vallecano","La Liga","Yacine Qasmi","MAR","FW","30",1991,0,0,0,0,0,0,0,0,NA,0,0,0,0,0,0,0,0,"https://fbref.com/en/players/3b3cbebb/Yacine-Qasmi"
"10317","Kévin Rodrigues_2022",2022,"Rayo Vallecano","La Liga","Kévin Rodrigues","POR","DF,FW","27",1994,4.8,15,11,8,7,0,6,10,60,4,10,1,9,7,22,6,0,"https://fbref.com/en/players/f1bed920/Kevin-Rodrigues"
"10318","Esteban Saveljich_2022",2022,"Rayo Vallecano","La Liga","Esteban Saveljich","MNE","DF","30",1991,18.9,18,11,11,7,0,9,15,60,6,20,12,8,16,34,69,0,"https://fbref.com/en/players/79f2a5f5/Esteban-Saveljich"
"10319","Mario Suárez_2022",2022,"Rayo Vallecano","La Liga","Mario Suárez","ESP","DF","34",1987,7.9,9,4,7,2,0,3,9,33.3,6,6,4,2,7,16,37,1,"https://fbref.com/en/players/7106f0a0/Mario-Suarez"
"10320","Mamadou Sylla_2022",2022,"Rayo Vallecano","La Liga","Mamadou Sylla","SEN","FW","27",1994,2.8,1,1,1,0,0,0,1,0,1,2,0,2,4,5,3,0,"https://fbref.com/en/players/e5ec95f8/Mamadou-Sylla"
"10321","Óscar Trejo_2022",2022,"Rayo Vallecano","La Liga","Óscar Trejo","ARG","MF","33",1988,22.3,42,24,14,18,10,15,50,30,35,26,1,25,13,55,11,0,"https://fbref.com/en/players/fc647b34/Oscar-Trejo"
"10322","Óscar Valentín_2022",2022,"Rayo Vallecano","La Liga","Óscar Valentín","ESP","MF","26",1994,28.5,102,53,46,51,5,44,105,41.9,61,56,10,46,39,141,43,0,"https://fbref.com/en/players/592f3158/Oscar-Valentin"
"10323","Luca Zidane_2022",2022,"Rayo Vallecano","La Liga","Luca Zidane","FRA","GK","23",1998,7.2,0,0,0,0,0,0,1,0,1,0,0,0,0,0,1,1,"https://fbref.com/en/players/c818c4d9/Luca-Zidane"
"10324","David Alaba_2022",2022,"Real Madrid","La Liga","David Alaba","AUT","DF","29",1992,29.4,23,13,15,6,2,9,19,47.4,10,26,15,11,22,45,70,1,"https://fbref.com/en/players/05439de2/David-Alaba"
"10325","Marco Asensio_2022",2022,"Real Madrid","La Liga","Marco Asensio","ESP","FW,MF","25",1996,19.2,12,8,6,4,2,4,18,22.2,14,8,1,7,12,24,6,1,"https://fbref.com/en/players/45af8a54/Marco-Asensio"
"10326","Gareth Bale_2022",2022,"Real Madrid","La Liga","Gareth Bale","WAL","FW","32",1989,3.1,2,1,1,0,1,1,4,25,3,2,0,2,2,4,1,0,"https://fbref.com/en/players/a58bb1e1/Gareth-Bale"
"10327","Karim Benzema_2022",2022,"Real Madrid","La Liga","Karim Benzema","FRA","FW","33",1987,28.8,11,9,5,3,3,2,9,22.2,7,10,0,10,4,15,13,0,"https://fbref.com/en/players/70d74ece/Karim-Benzema"
"10328","Blanco_2022",2022,"Real Madrid","La Liga","Blanco","ESP","MF","21",2000,0.3,2,0,1,1,0,0,0,NA,0,1,1,0,1,3,0,0,"https://fbref.com/en/players/506daeac/Blanco"
"10329","Eduardo Camavinga_2022",2022,"Real Madrid","La Liga","Eduardo Camavinga","FRA","MF","18",2002,13.7,52,35,22,20,10,20,38,52.6,18,20,2,18,17,69,14,1,"https://fbref.com/en/players/7b9c2d84/Eduardo-Camavinga"
"10330","Dani Carvajal_2022",2022,"Real Madrid","La Liga","Dani Carvajal","ESP","DF","29",1992,17.2,43,28,21,15,7,15,26,57.7,11,22,8,14,20,63,38,2,"https://fbref.com/en/players/4958bfb2/Dani-Carvajal"
"10331","Casemiro_2022",2022,"Real Madrid","La Liga","Casemiro","BRA","MF","29",1992,28.5,79,51,45,30,4,30,67,44.8,37,65,19,46,38,117,65,3,"https://fbref.com/en/players/4d224fe8/Casemiro"
"10332","Dani Ceballos_2022",2022,"Real Madrid","La Liga","Dani Ceballos","ESP","MF","24",1996,3.1,7,5,4,3,0,1,5,20,4,8,2,6,4,11,2,0,"https://fbref.com/en/players/c0617e2b/Dani-Ceballos"
"10333","Thibaut Courtois_2022",2022,"Real Madrid","La Liga","Thibaut Courtois","BEL","GK","29",1992,36,1,0,1,0,0,1,2,50,1,0,0,0,0,1,9,1,"https://fbref.com/en/players/1840e36d/Thibaut-Courtois"
"10334","Mario Gila_2022",2022,"Real Madrid","La Liga","Mario Gila","ESP","DF","20",2000,0.3,1,0,1,0,0,0,1,0,1,0,0,0,1,2,1,0,"https://fbref.com/en/players/9c435456/Mario-Gila"
"10335","Peter González_2022",2022,"Real Madrid","La Liga","Peter González","DOM","MF,DF","19",2002,0.3,0,0,0,0,0,0,0,NA,0,0,0,0,1,1,0,0,"https://fbref.com/en/players/1ccd3dae/Peter-Gonzalez"
"10336","Miguel Gutiérrez_2022",2022,"Real Madrid","La Liga","Miguel Gutiérrez","ESP","DF","20",2001,2.9,7,5,5,0,2,3,5,60,2,0,0,0,2,9,2,0,"https://fbref.com/en/players/7e98cff1/Miguel-Gutierrez"
"10337","Eden Hazard_2022",2022,"Real Madrid","La Liga","Eden Hazard","BEL","FW,MF","30",1991,8,6,3,3,2,1,3,7,42.9,4,3,0,3,2,8,0,0,"https://fbref.com/en/players/a39bb753/Eden-Hazard"
"10338","Isco_2022",2022,"Real Madrid","La Liga","Isco","ESP","MF,FW","29",1992,3.7,9,5,4,4,1,5,12,41.7,7,1,0,1,2,11,1,0,"https://fbref.com/en/players/a0b4bb3e/Isco"
"10339","Luka Jović_2022",2022,"Real Madrid","La Liga","Luka Jović","SRB","FW","23",1997,4.1,1,1,0,1,0,0,1,0,1,3,0,3,1,2,4,0,"https://fbref.com/en/players/4d8cd038/Luka-Jovic"
"10340","Vinicius Júnior_2022",2022,"Real Madrid","La Liga","Vinicius Júnior","BRA","FW","21",2000,29.9,46,24,23,19,4,15,50,30,35,25,0,25,6,52,6,0,"https://fbref.com/en/players/7111d552/Vinicius-Junior"
"10341","Toni Kroos_2022",2022,"Real Madrid","La Liga","Toni Kroos","GER","MF","31",1990,23.4,34,26,13,17,4,14,36,38.9,22,16,3,13,12,46,13,1,"https://fbref.com/en/players/6ce1f46f/Toni-Kroos"
"10342","Latasa_2022",2022,"Real Madrid","La Liga","Latasa","ESP","FW","20",2001,0.1,0,0,0,0,0,0,0,NA,0,0,0,0,0,0,0,0,"https://fbref.com/en/players/2bea832e/Latasa"
"10343","Andriy Lunin_2022",2022,"Real Madrid","La Liga","Andriy Lunin","UKR","GK","22",1999,2,0,0,0,0,0,0,0,NA,0,0,0,0,0,0,2,0,"https://fbref.com/en/players/3061e1ec/Andriy-Lunin"
"10344","Marcelo_2022",2022,"Real Madrid","La Liga","Marcelo","BRA","DF","33",1988,5.8,8,4,2,3,3,5,10,50,5,7,2,5,1,9,11,0,"https://fbref.com/en/players/603116a7/Marcelo"
"10345","Mariano_2022",2022,"Real Madrid","La Liga","Mariano","DOM","FW","27",1993,3.8,2,0,2,0,0,0,0,NA,0,2,0,2,1,3,3,0,"https://fbref.com/en/players/5c4dc0ff/Mariano"
"10346","Ferland Mendy_2022",2022,"Real Madrid","La Liga","Ferland Mendy","FRA","DF","26",1995,19.3,24,14,11,10,3,8,14,57.1,6,8,2,6,18,42,27,3,"https://fbref.com/en/players/3cefcaef/Ferland-Mendy"
"10347","Éder Militão_2022",2022,"Real Madrid","La Liga","Éder Militão","BRA","DF","23",1998,33.7,50,32,30,12,8,20,39,51.3,19,42,20,22,52,102,107,3,"https://fbref.com/en/players/2784f898/Eder-Militao"
"10348","Luka Modrić_2022",2022,"Real Madrid","La Liga","Luka Modrić","CRO","MF","35",1985,22.6,18,10,8,7,3,6,27,22.2,21,10,4,6,20,38,9,0,"https://fbref.com/en/players/6025fab1/Luka-Modric"
"10349","Nacho_2022",2022,"Real Madrid","La Liga","Nacho","ESP","DF","31",1990,17.3,18,14,9,9,0,12,22,54.5,10,22,15,7,34,52,50,0,"https://fbref.com/en/players/2946f9a1/Nacho"
"10350","Rodrygo_2022",2022,"Real Madrid","La Liga","Rodrygo","BRA","FW","20",2001,16.9,18,14,7,4,7,3,18,16.7,15,21,0,21,11,29,3,0,"https://fbref.com/en/players/8f5e92a6/Rodrygo"
"10351","Sergio Santos_2022",2022,"Real Madrid","La Liga","Sergio Santos","ESP","DF","20",2001,0.1,0,0,0,0,0,0,0,NA,0,0,0,0,0,0,0,0,"https://fbref.com/en/players/cf59e05f/Sergio-Santos"
"10352","Jesús Vallejo_2022",2022,"Real Madrid","La Liga","Jesús Vallejo","ESP","DF","24",1997,3.8,7,5,7,0,0,5,6,83.3,1,9,8,1,6,13,16,0,"https://fbref.com/en/players/c2111b45/Jesus-Vallejo"
"10353","Federico Valverde_2022",2022,"Real Madrid","La Liga","Federico Valverde","URU","MF","23",1998,20.4,36,16,11,16,9,12,31,38.7,19,23,5,18,24,60,12,0,"https://fbref.com/en/players/0959c2a2/Federico-Valverde"
"10354","Lucas Vázquez_2022",2022,"Real Madrid","La Liga","Lucas Vázquez","ESP","DF","30",1991,20.4,43,22,24,9,10,17,35,48.6,18,25,7,18,20,63,41,1,"https://fbref.com/en/players/fd51b456/Lucas-Vazquez"
"10355","Ander Barrenetxea_2022",2022,"Real Sociedad","La Liga","Ander Barrenetxea","ESP","FW,MF","19",2001,6.1,15,10,9,6,0,8,18,44.4,10,7,0,7,2,17,2,0,"https://fbref.com/en/players/200e89e1/Ander-Barrenetxea"
"10356","Jon Bautista_2022",2022,"Real Sociedad","La Liga","Jon Bautista","ESP","MF","26",1995,0.5,3,0,0,3,0,0,1,0,1,1,0,1,1,4,1,0,"https://fbref.com/en/players/debc6b55/Jon-Bautista"
"10357","Cristo_2022",2022,"Real Sociedad","La Liga","Cristo","ESP","DF","21",2000,0.2,0,0,0,0,0,0,0,NA,0,0,0,0,0,0,0,0,"https://fbref.com/en/players/ad81ba78/Cristo"
"10358","Naïs Djouahra_2022",2022,"Real Sociedad","La Liga","Naïs Djouahra","FRA","FW,MF","21",1999,2.4,7,3,2,2,3,4,8,50,4,3,0,3,2,9,2,0,"https://fbref.com/en/players/3594a357/Nais-Djouahra"
"10359","Aritz Elustondo_2022",2022,"Real Sociedad","La Liga","Aritz Elustondo","ESP","DF","27",1994,23.4,21,14,16,5,0,10,20,50,10,19,13,6,29,50,86,0,"https://fbref.com/en/players/f7dc2ae5/Aritz-Elustondo"
"10360","Andoni Gorosabel_2022",2022,"Real Sociedad","La Liga","Andoni Gorosabel","ESP","DF","24",1996,25.4,47,31,32,9,6,25,47,53.2,22,16,3,13,18,65,49,0,"https://fbref.com/en/players/6f5f82c0/Andoni-Gorosabel"
"10361","Ander Guevara_2022",2022,"Real Sociedad","La Liga","Ander Guevara","ESP","MF","24",1997,9.6,18,13,6,10,2,10,17,58.8,7,12,6,6,12,30,8,0,"https://fbref.com/en/players/8e48dc61/Ander-Guevara"
"10362","Jon Guridi_2022",2022,"Real Sociedad","La Liga","Jon Guridi","ESP","MF","26",1995,2.3,5,3,2,3,0,1,4,25,3,3,1,2,3,8,4,0,"https://fbref.com/en/players/4c0a6a48/Jon-Guridi"
"10363","Asier Illarramendi_2022",2022,"Real Sociedad","La Liga","Asier Illarramendi","ESP","MF","31",1990,4.2,9,5,5,3,1,1,10,10,9,5,1,4,4,13,12,0,"https://fbref.com/en/players/5ce0b5ba/Asier-Illarramendi"
"10364","Alexander Isak_2022",2022,"Real Sociedad","La Liga","Alexander Isak","SWE","FW","21",1999,23.8,7,4,1,3,3,2,12,16.7,10,14,2,12,3,10,10,0,"https://fbref.com/en/players/8e92be30/Alexander-Isak"
"10365","Adnan Januzaj_2022",2022,"Real Sociedad","La Liga","Adnan Januzaj","BEL","FW,MF","26",1995,18.1,17,11,5,8,4,9,24,37.5,15,15,3,12,12,29,15,0,"https://fbref.com/en/players/4737cebe/Adnan-Januzaj"
"10366","Robin Le Normand_2022",2022,"Real Sociedad","La Liga","Robin Le Normand","ESP","DF","24",1996,37,49,32,36,8,5,28,36,77.8,8,34,22,12,48,97,125,0,"https://fbref.com/en/players/9a64e67e/Robin-Le-Normand"
"10367","Julen Lobete_2022",2022,"Real Sociedad","La Liga","Julen Lobete","ESP","FW,MF","20",2000,3.2,4,3,3,0,1,1,2,50,1,6,1,5,1,5,1,0,"https://fbref.com/en/players/a952a529/Julen-Lobete"
"10368","Ander Martin_2022",2022,"Real Sociedad","La Liga","Ander Martin","ESP","FW,MF","20",2000,1,1,0,0,1,0,1,1,100,0,0,0,0,3,4,1,0,"https://fbref.com/en/players/e1e75690/Ander-Martin"
"10369","Mikel Merino_2022",2022,"Real Sociedad","La Liga","Mikel Merino","ESP","MF","25",1996,32.1,71,38,21,40,10,26,67,38.8,41,50,10,40,21,92,56,2,"https://fbref.com/en/players/d080ed5e/Mikel-Merino"
"10370","Aihen Muñoz_2022",2022,"Real Sociedad","La Liga","Aihen Muñoz","ESP","DF","23",1997,14.9,28,17,14,13,1,18,29,62.1,11,11,1,10,17,45,34,0,"https://fbref.com/en/players/228b0d9d/Aihen-Munoz"
"10371","Roberto Navarro_2022",2022,"Real Sociedad","La Liga","Roberto Navarro","ESP","MF,FW","19",2002,2.2,5,3,1,1,3,3,5,60,2,2,0,2,2,7,2,0,"https://fbref.com/en/players/c997b942/Roberto-Navarro"
"10372","Mikel Oyarzabal_2022",2022,"Real Sociedad","La Liga","Mikel Oyarzabal","ESP","FW,MF","24",1997,18.6,18,10,7,7,4,7,21,33.3,14,18,2,16,10,28,16,1,"https://fbref.com/en/players/8c3c640c/Mikel-Oyarzabal"
"10373","Jon Pacheco_2022",2022,"Real Sociedad","La Liga","Jon Pacheco","ESP","DF","20",2001,4.2,6,4,4,2,0,3,3,100,0,6,4,2,6,12,18,0,"https://fbref.com/en/players/44150beb/Jon-Pacheco"
"10374","Portu_2022",2022,"Real Sociedad","La Liga","Portu","ESP","FW,MF","29",1992,17.7,16,7,2,6,8,3,19,15.8,16,21,3,18,7,23,8,0,"https://fbref.com/en/players/1bda5842/Portu"
"10375","Rafinha_2022",2022,"Real Sociedad","La Liga","Rafinha","BRA","MF","28",1993,11.7,43,27,17,20,6,16,28,57.1,12,21,2,19,12,55,4,0,"https://fbref.com/en/players/0c2ac3cb/Rafinha"
"10376","Álex Remiro_2022",2022,"Real Sociedad","La Liga","Álex Remiro","ESP","GK","26",1995,35,0,0,0,0,0,0,0,NA,0,0,0,0,1,1,24,2,"https://fbref.com/en/players/374ee424/Alex-Remiro"
"10377","Diego Rico_2022",2022,"Real Sociedad","La Liga","Diego Rico","ESP","DF","28",1993,18.3,41,20,19,17,5,22,45,48.9,23,29,4,25,30,71,54,0,"https://fbref.com/en/players/d9ba39fc/Diego-Rico"
"10378","Mathew Ryan_2022",2022,"Real Sociedad","La Liga","Mathew Ryan","AUS","GK","29",1992,3,0,0,0,0,0,0,0,NA,0,0,0,0,0,0,2,0,"https://fbref.com/en/players/4535e4bb/Mathew-Ryan"
"10379","David Silva_2022",2022,"Real Sociedad","La Liga","David Silva","ESP","MF","35",1986,19.1,28,17,10,11,7,3,20,15,17,13,3,10,7,35,12,0,"https://fbref.com/en/players/e2716bd0/David-Silva"
"10380","Alex Sola_2022",2022,"Real Sociedad","La Liga","Alex Sola","ESP","DF,FW","22",1999,0.5,1,1,1,0,0,1,3,33.3,2,1,0,1,2,3,3,0,"https://fbref.com/en/players/5fa714d5/Alex-Sola"
"10381","Alexander Sørloth_2022",2022,"Real Sociedad","La Liga","Alexander Sørloth","NOR","FW","25",1995,19.6,20,7,4,10,6,7,17,41.2,10,14,1,13,4,24,15,0,"https://fbref.com/en/players/e92cd3f7/Alexander-Sorloth"
"10382","Beñat Turrientes_2022",2022,"Real Sociedad","La Liga","Beñat Turrientes","ESP","MF","19",2002,2.3,0,0,0,0,0,0,4,0,4,1,0,1,2,2,2,0,"https://fbref.com/en/players/068f4dec/Benat-Turrientes"
"10383","Germán Valera_2022",2022,"Real Sociedad","La Liga","Germán Valera","ESP","FW","19",2002,0.6,3,2,3,0,0,1,1,100,0,0,0,0,0,3,1,0,"https://fbref.com/en/players/84f55b4a/German-Valera"
"10384","Joseba Zaldúa_2022",2022,"Real Sociedad","La Liga","Joseba Zaldúa","ESP","DF","29",1992,13,31,22,20,8,3,16,22,72.7,6,14,4,10,13,44,35,0,"https://fbref.com/en/players/5ca20b7a/Joseba-Zaldua"
"10385","Igor Zubeldia_2022",2022,"Real Sociedad","La Liga","Igor Zubeldia","ESP","DF","24",1997,18.3,20,10,12,8,0,12,18,66.7,6,16,6,10,27,47,53,0,"https://fbref.com/en/players/5c7845f6/Igor-Zubeldia"
"10386","Martín Zubimendi_2022",2022,"Real Sociedad","La Liga","Martín Zubimendi","ESP","MF","22",1999,28.8,52,25,19,30,3,22,44,50,22,30,13,17,49,101,48,1,"https://fbref.com/en/players/3ee0dd59/Martin-Zubimendi"
"10387","Yunis Abdelhamid_2022",2022,"Reims","Ligue 1","Yunis Abdelhamid","MAR","DF","33",1987,33.1,48,27,34,14,0,16,32,50,16,50,25,25,68,116,104,0,"https://fbref.com/en/players/32c2d95f/Yunis-Abdelhamid"
"10388","Martin Adeline_2022",2022,"Reims","Ligue 1","Martin Adeline","FRA","MF,FW","17",2003,3.9,15,11,5,8,2,8,16,50,8,0,0,0,11,26,6,0,"https://fbref.com/en/players/7587446d/Martin-Adeline"
"10389","Mitchell van Bergen_2022",2022,"Reims","Ligue 1","Mitchell van Bergen","NED","FW,MF","21",1999,10.9,8,5,7,0,1,6,15,40,9,9,0,9,4,12,7,0,"https://fbref.com/en/players/0b2c9aec/Mitchell-van-Bergen"
"10390","Valon Berisha_2022",2022,"Reims","Ligue 1","Valon Berisha","KVX","MF,FW","28",1993,5.1,10,7,2,5,3,2,10,20,8,9,0,9,4,14,3,0,"https://fbref.com/en/players/d5575935/Valon-Berisha"
"10391","El Bilal Touré_2022",2022,"Reims","Ligue 1","El Bilal Touré","MLI","FW","19",2001,13.3,13,6,4,6,3,2,7,28.6,5,10,3,7,6,19,19,0,"https://fbref.com/en/players/47c609d5/El-Bilal-Toure"
"10392","Maxime Busi_2022",2022,"Reims","Ligue 1","Maxime Busi","BEL","DF","21",1999,14.4,26,15,20,5,1,19,36,52.8,17,19,5,14,17,43,28,0,"https://fbref.com/en/players/7b082ec2/Maxime-Busi"
"10393","Mathieu Cafaro_2022",2022,"Reims","Ligue 1","Mathieu Cafaro","FRA","MF,FW","24",1997,2.1,4,2,3,1,0,0,7,0,7,2,0,2,3,7,1,0,"https://fbref.com/en/players/2a657da0/Mathieu-Cafaro"
"10394","Jens Cajuste_2022",2022,"Reims","Ligue 1","Jens Cajuste","SWE","MF,FW","21",1999,4,10,6,6,2,2,6,17,35.3,11,7,2,5,5,15,6,0,"https://fbref.com/en/players/928a4a61/Jens-Cajuste"
"10395","Moreto Cassamã_2022",2022,"Reims","Ligue 1","Moreto Cassamã","GNB","MF","23",1998,8.9,12,6,7,4,1,3,19,15.8,16,10,5,5,9,21,5,0,"https://fbref.com/en/players/f54d2149/Moreto-Cassama"
"10396","Xavier Chavalerin_2022",2022,"Reims","Ligue 1","Xavier Chavalerin","FRA","MF","30",1991,2.4,4,4,2,1,1,1,3,33.3,2,2,0,2,5,9,2,1,"https://fbref.com/en/players/279ddf6a/Xavier-Chavalerin"
"10397","Ibrahim Diakité_2022",2022,"Reims","Ligue 1","Ibrahim Diakité","GUI","MF","17",2003,0,0,0,0,0,0,0,1,0,1,0,0,0,0,0,0,0,"https://fbref.com/en/players/d8c19a60/Ibrahim-Diakite"
"10398","Anastasios Donis_2022",2022,"Reims","Ligue 1","Anastasios Donis","GRE","FW,MF","24",1996,4.1,8,7,4,2,2,2,6,33.3,4,3,0,3,0,8,1,0,"https://fbref.com/en/players/0f26fd24/Anastasios-Donis"
"10399","Fodé Doucouré_2022",2022,"Reims","Ligue 1","Fodé Doucouré","MLI","DF,FW","20",2001,1.7,12,9,9,3,0,9,11,81.8,2,1,0,1,4,16,6,0,"https://fbref.com/en/players/1bfe34dc/Fode-Doucoure"
"10400","Kamory Doumbia_2022",2022,"Reims","Ligue 1","Kamory Doumbia","MLI","MF,FW","18",2003,3.9,8,2,2,5,1,5,13,38.5,8,9,3,6,3,11,3,0,"https://fbref.com/en/players/9226aa22/Kamory-Doumbia"
"10401","Moussa Doumbia_2022",2022,"Reims","Ligue 1","Moussa Doumbia","MLI","FW","26",1994,1,0,0,0,0,0,0,1,0,1,0,0,0,0,0,0,0,"https://fbref.com/en/players/6481421d/Moussa-Doumbia"
"10402","Hugo Ekitike_2022",2022,"Reims","Ligue 1","Hugo Ekitike","FRA","FW","19",2002,14.1,18,10,8,6,4,4,11,36.4,7,9,2,7,6,24,15,0,"https://fbref.com/en/players/5b92d896/Hugo-Ekitike"
"10403","Wout Faes_2022",2022,"Reims","Ligue 1","Wout Faes","BEL","DF","23",1998,37,40,24,30,9,1,25,33,75.8,8,47,37,10,53,93,169,2,"https://fbref.com/en/players/9c221d14/Wout-Faes"
"10404","Alexis Flips_2022",2022,"Reims","Ligue 1","Alexis Flips","FRA","MF,DF","21",2000,11.7,37,21,21,9,7,22,45,48.9,23,21,0,21,24,61,17,0,"https://fbref.com/en/players/caef7840/Alexis-Flips"
"10405","Thomas Foket_2022",2022,"Reims","Ligue 1","Thomas Foket","BEL","DF,FW","26",1994,24.8,28,19,12,13,3,18,40,45,22,26,4,22,33,61,35,0,"https://fbref.com/en/players/90eb507d/Thomas-Foket"
"10406","Andrew Gravillon_2022",2022,"Reims","Ligue 1","Andrew Gravillon","GLP","DF","23",1998,23.7,32,24,19,13,0,17,27,63,10,25,15,10,33,65,83,1,"https://fbref.com/en/players/49136c42/Andrew-Gravillon"
"10407","Fraser Hornby_2022",2022,"Reims","Ligue 1","Fraser Hornby","SCO","FW,MF","21",1999,3.9,3,1,1,2,0,0,2,0,2,3,0,3,4,7,5,0,"https://fbref.com/en/players/29aee77c/Fraser-Hornby"
"10408","Ilan Kebbal_2022",2022,"Reims","Ligue 1","Ilan Kebbal","ALG","MF,FW","23",1998,19.7,31,15,13,10,8,12,44,27.3,32,16,0,16,13,44,3,0,"https://fbref.com/en/players/37d04e90/Ilan-Kebbal"
"10409","Samuel Koeberlé_2022",2022,"Reims","Ligue 1","Samuel Koeberlé","FRA","FW","16",2004,0,0,0,0,0,0,0,0,NA,0,0,0,0,0,0,0,0,"https://fbref.com/en/players/6751b938/Samuel-Koeberle"
"10410","Philippe Koffi_2022",2022,"Reims","Ligue 1","Philippe Koffi","CIV","FW","19",2002,4.2,4,0,0,3,1,0,2,0,2,2,1,1,3,7,3,0,"https://fbref.com/en/players/9f1c2822/Philippe-Koffi"
"10411","Ghislain Konan_2022",2022,"Reims","Ligue 1","Ghislain Konan","CIV","DF","25",1995,26.9,35,19,19,15,1,16,30,53.3,14,35,8,27,28,63,45,0,"https://fbref.com/en/players/6b2c894b/Ghislain-Konan"
"10412","Banzouzi Locko_2022",2022,"Reims","Ligue 1","Banzouzi Locko","FRA","MF,DF","19",2002,11.2,28,19,13,11,4,14,24,58.3,10,20,8,12,14,42,15,0,"https://fbref.com/en/players/40221fa7/Banzouzi-Locko"
"10413","Dion Lopy_2022",2022,"Reims","Ligue 1","Dion Lopy","SEN","MF","19",2002,18.2,53,29,22,24,7,21,53,39.6,32,20,4,16,22,75,17,0,"https://fbref.com/en/players/64c14d49/Dion-Lopy"
"10414","Azor Matusiwa_2022",2022,"Reims","Ligue 1","Azor Matusiwa","NED","MF","23",1998,27.4,58,32,28,26,4,26,55,47.3,29,49,19,30,62,120,43,0,"https://fbref.com/en/players/a17a94d6/Azor-Matusiwa"
"10415","Moustapha Mbow_2022",2022,"Reims","Ligue 1","Moustapha Mbow","SEN","DF","21",2000,1,6,6,3,2,1,3,3,100,0,0,0,0,1,7,6,0,"https://fbref.com/en/players/3f3a2cba/Moustapha-Mbow"
"10416","Nathanael Mbuku_2022",2022,"Reims","Ligue 1","Nathanael Mbuku","FRA","FW,MF","19",2002,15.8,14,13,4,7,3,2,8,25,6,14,0,14,11,25,4,0,"https://fbref.com/en/players/46750e9c/Nathanael-Mbuku"
"10417","Marshall Munetsi_2022",2022,"Reims","Ligue 1","Marshall Munetsi","ZIM","MF,DF","25",1996,20.9,34,17,21,11,2,17,39,43.6,22,39,13,26,43,77,72,2,"https://fbref.com/en/players/2acf0cd7/Marshall-Munetsi"
"10418","Predrag Rajković_2022",2022,"Reims","Ligue 1","Predrag Rajković","SRB","GK","25",1995,38,2,2,2,0,0,2,3,66.7,1,1,0,1,1,3,21,1,"https://fbref.com/en/players/58ad9383/Predrag-Rajkovic"
"10419","Kaj Sierhuis_2022",2022,"Reims","Ligue 1","Kaj Sierhuis","NED","FW","23",1998,0.9,1,1,1,0,0,1,3,33.3,2,0,0,0,0,1,1,0,"https://fbref.com/en/players/9c2b1f11/Kaj-Sierhuis"
"10420","Sambou Sissoko_2022",2022,"Reims","Ligue 1","Sambou Sissoko","FRA","MF,DF","22",1999,2,12,6,6,4,2,6,8,75,2,2,0,2,2,14,7,0,"https://fbref.com/en/players/e4bb1f08/Sambou-Sissoko"
"10421","Arber Zeneli_2022",2022,"Reims","Ligue 1","Arber Zeneli","KVX","FW","26",1995,4.5,1,0,0,0,1,1,5,20,4,0,0,0,1,2,1,0,"https://fbref.com/en/players/095e4199/Arber-Zeneli"
"10422","Matthis Abline_2022",2022,"Rennes","Ligue 1","Matthis Abline","FRA","FW","18",2003,1.1,0,0,0,0,0,0,0,NA,0,2,0,2,0,0,1,0,"https://fbref.com/en/players/0e46fa2f/Matthis-Abline"
"10423","Nayef Aguerd_2022",2022,"Rennes","Ligue 1","Nayef Aguerd","MAR","DF","25",1996,30.4,27,18,16,11,0,14,24,58.3,10,24,14,10,24,51,127,1,"https://fbref.com/en/players/288e1e13/Nayef-Aguerd"
"10424","Doğan Alemdar_2022",2022,"Rennes","Ligue 1","Doğan Alemdar","TUR","GK","18",2002,12,0,0,0,0,0,0,0,NA,0,0,0,0,0,0,9,1,"https://fbref.com/en/players/9e17ccff/Dogan-Alemdar"
"10425","Lorenz Assignon_2022",2022,"Rennes","Ligue 1","Lorenz Assignon","TOG","DF","21",2000,6.8,15,10,11,3,1,5,9,55.6,4,3,1,2,11,26,19,0,"https://fbref.com/en/players/b026bbf6/Lorenz-Assignon"
"10426","Loïc Bade_2022",2022,"Rennes","Ligue 1","Loïc Bade","FRA","DF","21",2000,10.9,6,5,4,2,0,3,5,60,2,12,10,2,12,18,48,0,"https://fbref.com/en/players/114bbdee/Loic-Bade"
"10427","Jeanöel Belocian_2022",2022,"Rennes","Ligue 1","Jeanöel Belocian","FRA","DF","16",2005,0.1,0,0,0,0,0,0,0,NA,0,0,0,0,0,0,0,0,"https://fbref.com/en/players/c678ddd7/Jeanoel-Belocian"
"10428","Benjamin Bourigeaud_2022",2022,"Rennes","Ligue 1","Benjamin Bourigeaud","FRA","FW,MF","27",1994,35.5,46,24,16,18,12,24,67,35.8,43,33,3,30,30,76,44,0,"https://fbref.com/en/players/20e73fac/Benjamin-Bourigeaud"
"10429","Eduardo Camavinga_2022",2022,"Rennes","Ligue 1","Eduardo Camavinga","FRA","MF","18",2002,1.6,4,1,2,1,1,2,5,40,3,1,1,0,1,5,3,0,"https://fbref.com/en/players/7b9c2d84/Eduardo-Camavinga"
"10430","Romain Del Castillo_2022",2022,"Rennes","Ligue 1","Romain Del Castillo","FRA","MF,FW","25",1996,0.3,2,1,0,1,1,2,2,100,0,0,0,0,1,3,0,0,"https://fbref.com/en/players/0be95d34/Romain-Del-Castillo"
"10431","Andy Diouf_2022",2022,"Rennes","Ligue 1","Andy Diouf","FRA","MF","18",2003,0.2,1,1,1,0,0,1,1,100,0,1,0,1,0,1,0,0,"https://fbref.com/en/players/9b5237b1/Andy-Diouf"
"10432","Jeremy Doku_2022",2022,"Rennes","Ligue 1","Jeremy Doku","BEL","FW,MF","19",2002,5.2,10,5,3,5,2,3,6,50,3,4,0,4,3,13,0,0,"https://fbref.com/en/players/fffea3e5/Jeremy-Doku"
"10433","Alfred Gomis_2022",2022,"Rennes","Ligue 1","Alfred Gomis","SEN","GK","27",1993,25,1,0,1,0,0,1,2,50,1,0,0,0,1,2,8,2,"https://fbref.com/en/players/cecbce23/Alfred-Gomis"
"10434","Sehrou Guirassy_2022",2022,"Rennes","Ligue 1","Sehrou Guirassy","GUI","FW","25",1996,11.3,4,2,1,2,1,1,7,14.3,6,4,0,4,1,5,8,0,"https://fbref.com/en/players/923f4dda/Sehrou-Guirassy"
"10435","Gaëtan Laborde_2022",2022,"Rennes","Ligue 1","Gaëtan Laborde","FRA","FW","27",1994,30.3,19,7,5,8,6,3,22,13.6,19,29,3,26,8,27,16,0,"https://fbref.com/en/players/7cdda3bf/Gaetan-Laborde"
"10436","Lovro Majer_2022",2022,"Rennes","Ligue 1","Lovro Majer","CRO","MF,FW","23",1998,20.4,32,21,9,14,9,11,42,26.2,31,26,2,24,11,43,9,0,"https://fbref.com/en/players/fc46aab1/Lovro-Majer"
"10437","Jonas Martin_2022",2022,"Rennes","Ligue 1","Jonas Martin","FRA","MF","31",1990,23.4,35,20,12,21,2,19,53,35.8,34,17,3,14,22,57,28,1,"https://fbref.com/en/players/468fdbad/Jonas-Martin"
"10438","Birger Meling_2022",2022,"Rennes","Ligue 1","Birger Meling","NOR","DF","26",1994,20.3,43,27,25,11,7,23,31,74.2,8,23,7,16,22,65,40,0,"https://fbref.com/en/players/70c52749/Birger-Meling"
"10439","Warmed Omari_2022",2022,"Rennes","Ligue 1","Warmed Omari","FRA","DF","21",2000,31.1,33,17,22,10,1,15,23,65.2,8,20,13,7,31,64,94,5,"https://fbref.com/en/players/4534a352/Warmed-Omari"
"10440","Romain Salin_2022",2022,"Rennes","Ligue 1","Romain Salin","FRA","GK","37",1984,1,0,0,0,0,0,0,0,NA,0,0,0,0,0,0,0,0,"https://fbref.com/en/players/74733221/Romain-Salin"
"10441","Baptiste Santamaria_2022",2022,"Rennes","Ligue 1","Baptiste Santamaria","FRA","MF,DF","26",1995,28,52,27,15,31,6,24,44,54.5,20,33,12,21,33,85,42,0,"https://fbref.com/en/players/5e22e2a4/Baptiste-Santamaria"
"10442","Kamaldeen Sulemana_2022",2022,"Rennes","Ligue 1","Kamaldeen Sulemana","GHA","MF,FW","19",2002,11.3,23,12,7,9,7,10,17,58.8,7,10,1,9,4,27,5,0,"https://fbref.com/en/players/a62f8bf1/Kamaldeen-Sulemana"
"10443","Flavien Tait_2022",2022,"Rennes","Ligue 1","Flavien Tait","FRA","MF","28",1993,23.6,28,19,13,9,6,13,40,32.5,27,15,4,11,19,47,13,1,"https://fbref.com/en/players/a0f9b535/Flavien-Tait"
"10444","Loum Tchaouna_2022",2022,"Rennes","Ligue 1","Loum Tchaouna","FRA","FW,MF","17",2003,1,3,1,1,2,0,1,5,20,4,0,0,0,2,5,0,0,"https://fbref.com/en/players/a3c8b4d3/Loum-Tchaouna"
"10445","Mathys Tel_2022",2022,"Rennes","Ligue 1","Mathys Tel","FRA","FW,MF","16",2005,0.6,2,1,1,1,0,0,0,NA,0,0,0,0,1,3,2,0,"https://fbref.com/en/players/829aa60c/Mathys-Tel"
"10446","Martin Terrier_2022",2022,"Rennes","Ligue 1","Martin Terrier","FRA","FW,MF","24",1997,30.9,55,33,22,16,17,25,43,58.1,18,29,3,26,18,73,17,0,"https://fbref.com/en/players/5148dcc5/Martin-Terrier"
"10447","Hamari Traoré_2022",2022,"Rennes","Ligue 1","Hamari Traoré","MLI","DF","29",1992,32.1,63,36,25,26,12,41,59,69.5,18,29,8,21,37,100,81,1,"https://fbref.com/en/players/a4b1028a/Hamari-Traore"
"10448","Adrien Truffert_2022",2022,"Rennes","Ligue 1","Adrien Truffert","FRA","DF","19",2001,18.2,29,21,17,9,3,11,24,45.8,13,25,5,20,19,48,30,0,"https://fbref.com/en/players/5d0e0a1f/Adrien-Truffert"
"10449","Chimuanya Ugochukwu_2022",2022,"Rennes","Ligue 1","Chimuanya Ugochukwu","FRA","MF","17",2004,4.5,13,9,5,5,3,9,19,47.4,10,7,2,5,4,17,2,0,"https://fbref.com/en/players/1df4a109/Chimuanya-Ugochukwu"
"10450","Tammy Abraham_2022",2022,"Roma","Serie A","Tammy Abraham","ENG","FW","23",1997,34.3,27,13,7,14,6,9,22,40.9,13,17,3,14,5,32,27,0,"https://fbref.com/en/players/f586779e/Tammy-Abraham"
"10451","Felix Afena-Gyan_2022",2022,"Roma","Serie A","Felix Afena-Gyan","GHA","FW,MF","18",2003,7.4,10,3,1,6,3,4,7,57.1,3,4,0,4,3,13,0,0,"https://fbref.com/en/players/0154d290/Felix-Afena-Gyan"
"10452","Edoardo Bove_2022",2022,"Roma","Serie A","Edoardo Bove","ITA","MF,DF","19",2002,0.8,1,1,1,0,0,0,2,0,2,1,0,1,1,2,0,0,"https://fbref.com/en/players/ae94a6c5/Edoardo-Bove"
"10453","Riccardo Calafiori_2022",2022,"Roma","Serie A","Riccardo Calafiori","ITA","DF","19",2002,1.9,5,4,2,2,1,1,5,20,4,3,0,3,3,8,1,0,"https://fbref.com/en/players/aded8e6f/Riccardo-Calafiori"
"10454","Bryan Cristante_2022",2022,"Roma","Serie A","Bryan Cristante","ITA","MF","26",1995,29.8,79,39,31,39,9,37,69,53.6,32,31,5,26,40,119,45,0,"https://fbref.com/en/players/16657b95/Bryan-Cristante"
"10455","Ebrima Darboe_2022",2022,"Roma","Serie A","Ebrima Darboe","GAM","MF","20",2001,0.7,1,1,0,1,0,0,0,NA,0,0,0,0,1,2,0,1,"https://fbref.com/en/players/cf043a33/Ebrima-Darboe"
"10456","Amadou Diawara_2022",2022,"Roma","Serie A","Amadou Diawara","GUI","MF","24",1997,1.9,7,2,5,2,0,1,3,33.3,2,2,0,2,0,7,1,0,"https://fbref.com/en/players/bf309d24/Amadou-Diawara"
"10457","Roger Ibanez_2022",2022,"Roma","Serie A","Roger Ibanez","BRA","DF","22",1998,32.1,54,32,31,19,4,26,43,60.5,17,26,7,19,62,116,104,2,"https://fbref.com/en/players/82efe6fa/Roger-Ibanez"
"10458","Rick Karsdorp_2022",2022,"Roma","Serie A","Rick Karsdorp","NED","DF,FW","26",1995,32,53,38,33,13,7,28,50,56,22,22,5,17,34,87,26,1,"https://fbref.com/en/players/9f84febe/Rick-Karsdorp"
"10459","Dimitrios Keramitsis_2022",2022,"Roma","Serie A","Dimitrios Keramitsis","GRE","MF","17",2004,0,0,0,0,0,0,0,0,NA,0,0,0,0,0,0,0,0,"https://fbref.com/en/players/6f30a1d5/Dimitrios-Keramitsis"
"10460","Marash Kumbulla_2022",2022,"Roma","Serie A","Marash Kumbulla","ALB","DF","21",2000,11.4,21,13,13,7,1,8,15,53.3,7,17,8,9,16,37,26,0,"https://fbref.com/en/players/a40819d9/Marash-Kumbulla"
"10461","Ainsley Maitland-Niles_2022",2022,"Roma","Serie A","Ainsley Maitland-Niles","ENG","DF","23",1997,5.4,8,6,5,0,3,5,14,35.7,9,7,0,7,6,14,7,0,"https://fbref.com/en/players/e3a5814e/Ainsley-Maitland-Niles"
"10462","Gianluca Mancini_2022",2022,"Roma","Serie A","Gianluca Mancini","ITA","DF","25",1996,32,41,25,22,18,1,18,33,54.5,15,38,19,19,39,80,69,0,"https://fbref.com/en/players/5aa53281/Gianluca-Mancini"
"10463","Borja Mayoral_2022",2022,"Roma","Serie A","Borja Mayoral","ESP","FW,DF","24",1997,1.1,0,0,0,0,0,0,0,NA,0,0,0,0,0,0,0,0,"https://fbref.com/en/players/64e8ed6d/Borja-Mayoral"
"10464","Henrikh Mkhitaryan_2022",2022,"Roma","Serie A","Henrikh Mkhitaryan","ARM","MF,FW","32",1989,27.7,45,29,11,27,7,17,52,32.7,35,33,2,31,22,67,33,0,"https://fbref.com/en/players/dd0daf32/Henrikh-Mkhitaryan"
"10465","Sérgio Oliveira_2022",2022,"Roma","Serie A","Sérgio Oliveira","POR","MF","29",1992,9.9,27,14,11,14,2,15,30,50,15,13,0,13,10,37,7,0,"https://fbref.com/en/players/947e036f/Sergio-Oliveira"
"10466","Rui Patrício_2022",2022,"Roma","Serie A","Rui Patrício","POR","GK","33",1988,38,0,0,0,0,0,0,0,NA,0,1,0,1,0,0,10,3,"https://fbref.com/en/players/79b0d6a0/Rui-Patricio"
"10467","Lorenzo Pellegrini_2022",2022,"Roma","Serie A","Lorenzo Pellegrini","ITA","MF","25",1996,25.4,35,14,10,17,8,16,60,26.7,44,29,1,28,27,62,20,0,"https://fbref.com/en/players/4a5a45c7/Lorenzo-Pellegrini"
"10468","Carles Pérez_2022",2022,"Roma","Serie A","Carles Pérez","ESP","MF,FW","23",1998,6.2,8,3,3,1,4,3,12,25,9,10,0,10,2,10,2,0,"https://fbref.com/en/players/a8f21b9f/Carles-Perez"
"10469","Bryan Reynolds_2022",2022,"Roma","Serie A","Bryan Reynolds","USA","DF","20",2001,0,0,0,0,0,0,0,1,0,1,0,0,0,0,0,1,0,"https://fbref.com/en/players/2306bf5c/Bryan-Reynolds"
"10470","Stephan El Shaarawy_2022",2022,"Roma","Serie A","Stephan El Shaarawy","ITA","FW,DF","28",1992,11.7,13,8,4,9,0,4,6,66.7,2,10,2,8,11,24,8,0,"https://fbref.com/en/players/d3aaad90/Stephan-El-Shaarawy"
"10471","Eldor Shomurodov_2022",2022,"Roma","Serie A","Eldor Shomurodov","UZB","FW,MF","26",1995,8.7,5,4,0,4,1,1,10,10,9,8,0,8,2,7,5,0,"https://fbref.com/en/players/57469b2d/Eldor-Shomurodov"
"10472","Chris Smalling_2022",2022,"Roma","Serie A","Chris Smalling","ENG","DF","31",1989,23.2,36,23,28,8,0,18,25,72,7,32,24,8,26,62,92,1,"https://fbref.com/en/players/b6964eb6/Chris-Smalling"
"10473","Leonardo Spinazzola_2022",2022,"Roma","Serie A","Leonardo Spinazzola","ITA","DF","28",1993,1.4,0,0,0,0,0,0,1,0,1,4,1,3,0,0,3,0,"https://fbref.com/en/players/3626daea/Leonardo-Spinazzola"
"10474","Jordan Veretout_2022",2022,"Roma","Serie A","Jordan Veretout","FRA","MF","28",1993,25.8,34,25,20,12,2,15,39,38.5,24,12,1,11,27,61,22,1,"https://fbref.com/en/players/4a56052c/Jordan-Veretout"
"10475","Matías Viña_2022",2022,"Roma","Serie A","Matías Viña","URU","DF,FW","23",1997,17.4,46,30,27,14,5,29,59,49.2,30,26,3,23,25,71,33,0,"https://fbref.com/en/players/08eb3b58/Matias-Vina"
"10476","Cristian Volpato_2022",2022,"Roma","Serie A","Cristian Volpato","ITA","FW,MF","17",2003,0.4,1,1,0,0,1,1,1,100,0,0,0,0,0,1,0,0,"https://fbref.com/en/players/72f87f25/Cristian-Volpato"
"10477","Nicola Zalewski_2022",2022,"Roma","Serie A","Nicola Zalewski","POL","DF","19",2002,8.8,32,19,17,11,4,21,35,60,14,18,1,17,16,48,4,0,"https://fbref.com/en/players/45191c29/Nicola-Zalewski"
"10478","Nicolò Zaniolo_2022",2022,"Roma","Serie A","Nicolò Zaniolo","ITA","FW,MF","22",1999,21.9,24,15,0,15,9,6,28,21.4,22,19,0,19,7,31,6,0,"https://fbref.com/en/players/9907b1c8/Nicolo-Zaniolo"
"10479","Charles Abi_2022",2022,"Saint-Étienne","Ligue 1","Charles Abi","FRA","FW","21",2000,0.5,0,0,0,0,0,0,1,0,1,2,0,2,0,0,0,0,"https://fbref.com/en/players/469d3d84/Charles-Abi"
"10480","Adil Aouchiche_2022",2022,"Saint-Étienne","Ligue 1","Adil Aouchiche","FRA","MF,FW","19",2002,12,13,6,5,5,3,5,33,15.2,28,18,1,17,17,30,4,0,"https://fbref.com/en/players/b94b8be1/Adil-Aouchiche"
"10481","Stefan Bajic_2022",2022,"Saint-Étienne","Ligue 1","Stefan Bajic","FRA","GK","19",2001,5.7,0,0,0,0,0,0,0,NA,0,0,0,0,0,0,4,0,"https://fbref.com/en/players/be13e5a8/Stefan-Bajic"
"10482","Abdoulaye Bakayoko_2022",2022,"Saint-Étienne","Ligue 1","Abdoulaye Bakayoko","FRA","DF","18",2002,3.4,15,9,13,2,0,8,12,66.7,4,5,4,1,12,27,15,0,"https://fbref.com/en/players/ee95585f/Abdoulaye-Bakayoko"
"10483","Paul Bernardoni_2022",2022,"Saint-Étienne","Ligue 1","Paul Bernardoni","FRA","GK","24",1997,19,0,0,0,0,0,0,0,NA,0,0,0,0,0,0,14,2,"https://fbref.com/en/players/28dabd43/Paul-Bernardoni"
"10484","Denis Bouanga_2022",2022,"Saint-Étienne","Ligue 1","Denis Bouanga","GAB","FW,MF","26",1994,27.1,46,25,14,13,19,22,63,34.9,41,30,0,30,8,54,34,1,"https://fbref.com/en/players/0b0cbe5b/Denis-Bouanga"
"10485","Ryad Boudebouz_2022",2022,"Saint-Étienne","Ligue 1","Ryad Boudebouz","ALG","MF,FW","31",1990,25,27,15,11,12,4,12,29,41.4,17,17,2,15,10,37,5,0,"https://fbref.com/en/players/1001ae82/Ryad-Boudebouz"
"10486","Lucas Calodat_2022",2022,"Saint-Étienne","Ligue 1","Lucas Calodat","FRA","DF","19",2002,0,0,0,0,0,0,0,0,NA,0,0,0,0,0,0,0,0,"https://fbref.com/en/players/7a72e960/Lucas-Calodat"
"10487","Mahdi Camara_2022",2022,"Saint-Étienne","Ligue 1","Mahdi Camara","FRA","MF,DF","23",1998,34.1,101,57,39,50,12,39,70,55.7,31,44,8,36,57,158,35,1,"https://fbref.com/en/players/8577e60a/Mahdi-Camara"
"10488","Enzo Crivelli_2022",2022,"Saint-Étienne","Ligue 1","Enzo Crivelli","FRA","FW,MF","26",1995,1.1,1,0,0,0,1,0,0,NA,0,0,0,0,0,1,1,0,"https://fbref.com/en/players/06f33dc8/Enzo-Crivelli"
"10489","Elhadji Dieye_2022",2022,"Saint-Étienne","Ligue 1","Elhadji Dieye","SEN","FW,MF","19",2002,0.4,3,2,2,1,0,0,1,0,1,2,0,2,1,4,0,0,"https://fbref.com/en/players/6a04bb7c/Elhadji-Dieye"
"10490","Assane Dioussé_2022",2022,"Saint-Étienne","Ligue 1","Assane Dioussé","SEN","MF","23",1997,0.3,1,1,1,0,0,1,1,100,0,0,0,0,0,1,0,0,"https://fbref.com/en/players/7f622eef/Assane-Diousse"
"10491","Bryan Djile Nokoué_2022",2022,"Saint-Étienne","Ligue 1","Bryan Djile Nokoué","CMR","DF,MF","19",2002,0.6,3,3,1,2,0,2,2,100,0,1,0,1,1,4,2,0,"https://fbref.com/en/players/75186a6a/Bryan-Djile-Nokoue"
"10492","Lamine Ghezali_2022",2022,"Saint-Étienne","Ligue 1","Lamine Ghezali","FRA","DF","22",1999,0,0,0,0,0,0,0,0,NA,0,1,0,1,0,0,0,0,"https://fbref.com/en/players/ce84946a/Lamine-Ghezali"
"10493","Lucas Gourna-Douath_2022",2022,"Saint-Étienne","Ligue 1","Lucas Gourna-Douath","FRA","MF","17",2003,20,45,26,22,18,5,21,36,58.3,15,22,3,19,13,58,9,2,"https://fbref.com/en/players/3cd7820a/Lucas-Gourna-Douath"
"10494","Etienne Green_2022",2022,"Saint-Étienne","Ligue 1","Etienne Green","ENG","GK","21",2000,13.3,1,1,1,0,0,0,0,NA,0,0,0,0,1,2,9,0,"https://fbref.com/en/players/667b65da/Etienne-Green"
"10495","Romain Hamouma_2022",2022,"Saint-Étienne","Ligue 1","Romain Hamouma","FRA","FW,MF","34",1987,9.8,10,7,1,5,4,2,13,15.4,11,8,0,8,4,14,1,0,"https://fbref.com/en/players/0b4d8274/Romain-Hamouma"
"10496","Juan Ignacio Ramírez_2022",2022,"Saint-Étienne","Ligue 1","Juan Ignacio Ramírez","URU","FW","24",1997,1.4,2,1,0,1,1,0,0,NA,0,0,0,0,0,2,0,0,"https://fbref.com/en/players/ad513a6b/Juan-Ignacio-Ramirez"
"10497","Wahbi Khazri_2022",2022,"Saint-Étienne","Ligue 1","Wahbi Khazri","TUN","FW,MF","30",1991,24.7,33,18,7,17,9,9,34,26.5,25,21,0,21,12,45,7,0,"https://fbref.com/en/players/2677a1de/Wahbi-Khazri"
"10498","Timothée Kolodziejczak_2022",2022,"Saint-Étienne","Ligue 1","Timothée Kolodziejczak","FRA","DF","29",1991,28.5,43,24,22,14,7,20,36,55.6,16,29,7,22,60,103,72,1,"https://fbref.com/en/players/ab096c6f/Timothee-Kolodziejczak"
"10499","Jean-Philippe Krasso_2022",2022,"Saint-Étienne","Ligue 1","Jean-Philippe Krasso","CIV","FW","24",1997,5,7,5,0,5,2,2,10,20,8,7,1,6,0,7,1,0,"https://fbref.com/en/players/037f2523/Jean-Philippe-Krasso"
"10500","Yanis Lhery_2022",2022,"Saint-Étienne","Ligue 1","Yanis Lhery","FRA","FW,MF","18",2003,0.8,0,0,0,0,0,0,0,NA,0,4,0,4,0,0,0,0,"https://fbref.com/en/players/cc972842/Yanis-Lhery"
"10501","Yvann Macon_2022",2022,"Saint-Étienne","Ligue 1","Yvann Macon","FRA","DF","22",1998,17,41,22,24,14,3,16,42,38.1,26,18,4,14,18,59,27,0,"https://fbref.com/en/players/0bb6e193/Yvann-Macon"
"10502","Eliaquim Mangala_2022",2022,"Saint-Étienne","Ligue 1","Eliaquim Mangala","FRA","DF","30",1991,13.1,17,12,12,5,0,8,12,66.7,4,11,8,3,17,34,61,1,"https://fbref.com/en/players/f520049f/Eliaquim-Mangala"
"10503","Aimen Moueffek_2022",2022,"Saint-Étienne","Ligue 1","Aimen Moueffek","FRA","MF","20",2001,4.8,7,4,2,3,2,2,8,25,6,3,0,3,2,9,4,0,"https://fbref.com/en/players/2591b066/Aimen-Moueffek"
"10504","Harold Moukoudi_2022",2022,"Saint-Étienne","Ligue 1","Harold Moukoudi","CMR","DF","23",1997,18.5,25,12,17,8,0,14,25,56,11,27,14,13,35,60,48,0,"https://fbref.com/en/players/5f26e0c5/Harold-Moukoudi"
"10505","Mickael Nade_2022",2022,"Saint-Étienne","Ligue 1","Mickael Nade","FRA","DF","22",1999,28.5,57,35,37,18,2,23,38,60.5,15,29,15,14,60,117,84,0,"https://fbref.com/en/players/a6b6fa6e/Mickael-Nade"
"10506","Yvan Neyou_2022",2022,"Saint-Étienne","Ligue 1","Yvan Neyou","CMR","MF","24",1997,10.4,29,13,14,12,3,9,27,33.3,18,8,3,5,23,52,13,0,"https://fbref.com/en/players/0ad37003/Yvan-Neyou"
"10507","Arnaud Nordin_2022",2022,"Saint-Étienne","Ligue 1","Arnaud Nordin","FRA","FW,MF","23",1998,20.8,21,11,8,8,5,8,22,36.4,14,19,0,19,6,27,8,0,"https://fbref.com/en/players/7b9a9e25/Arnaud-Nordin"
"10508","Maxence Rivera_2022",2022,"Saint-Étienne","Ligue 1","Maxence Rivera","FRA","FW","19",2002,0.1,0,0,0,0,0,0,0,NA,0,0,0,0,0,0,0,0,"https://fbref.com/en/players/46a7b605/Maxence-Rivera"
"10509","Mathys Saban_2022",2022,"Saint-Étienne","Ligue 1","Mathys Saban","FRA","FW,MF","19",2002,0.8,4,2,2,2,0,1,1,100,0,1,0,1,0,4,0,0,"https://fbref.com/en/players/7d9f3d69/Mathys-Saban"
"10510","Falaye Sacko_2022",2022,"Saint-Étienne","Ligue 1","Falaye Sacko","MLI","DF","26",1995,7.4,15,10,14,1,0,13,16,81.3,3,11,7,4,4,19,18,2,"https://fbref.com/en/players/6388e356/Falaye-Sacko"
"10511","Bakary Sako_2022",2022,"Saint-Étienne","Ligue 1","Bakary Sako","MLI","FW,MF","33",1988,1.7,0,0,0,0,0,0,1,0,1,3,1,2,0,0,0,0,"https://fbref.com/en/players/381d7d54/Bakary-Sako"
"10512","Gabriel Silva_2022",2022,"Saint-Étienne","Ligue 1","Gabriel Silva","BRA","DF,MF","30",1991,7.9,12,7,7,2,3,9,13,69.2,4,9,3,6,18,30,13,0,"https://fbref.com/en/players/4914ed4a/Gabriel-Silva"
"10513","Nelson Sissoko_2022",2022,"Saint-Étienne","Ligue 1","Nelson Sissoko","FRA","DF","24",1997,0.5,2,0,2,0,0,1,1,100,0,0,0,0,0,2,2,0,"https://fbref.com/en/players/12bd0579/Nelson-Sissoko"
"10514","Saidou Sow_2022",2022,"Saint-Étienne","Ligue 1","Saidou Sow","GUI","DF","19",2002,11,28,17,21,6,1,16,21,76.2,5,15,5,10,23,51,34,0,"https://fbref.com/en/players/f6b94e8d/Saidou-Sow"
"10515","Sada Thioub_2022",2022,"Saint-Étienne","Ligue 1","Sada Thioub","SEN","DF,MF","26",1995,10.6,13,8,5,8,0,6,14,42.9,8,9,0,9,10,23,8,0,"https://fbref.com/en/players/f4bc42b1/Sada-Thioub"
"10516","Miguel Trauco_2022",2022,"Saint-Étienne","Ligue 1","Miguel Trauco","PER","DF,MF","28",1992,12.4,25,18,16,8,1,12,22,54.5,10,13,4,9,23,48,17,0,"https://fbref.com/en/players/e4b72e34/Miguel-Trauco"
"10517","Zaydou Youssouf_2022",2022,"Saint-Étienne","Ligue 1","Zaydou Youssouf","FRA","MF","22",1999,17.3,48,26,21,25,2,14,34,41.2,20,11,3,8,17,65,13,0,"https://fbref.com/en/players/e2f9bb5f/Zaydou-Youssouf"
"10518","Ramzi Aya_2022",2022,"Salernitana","Serie A","Ramzi Aya","ITA","DF","30",1990,1.5,1,1,1,0,0,1,1,100,0,0,0,0,0,1,4,0,"https://fbref.com/en/players/6a1f66a7/Ramzi-Aya"
"10519","Vid Belec_2022",2022,"Salernitana","Serie A","Vid Belec","SVN","GK","31",1990,21.5,0,0,0,0,0,0,0,NA,0,0,0,0,0,0,9,1,"https://fbref.com/en/players/4f8ce0e1/Vid-Belec"
"10520","Luka Bogdan_2022",2022,"Salernitana","Serie A","Luka Bogdan","CRO","DF","25",1996,4.4,6,3,6,0,0,4,8,50,4,3,2,1,6,12,21,0,"https://fbref.com/en/players/cb678320/Luka-Bogdan"
"10521","Emil Bohinen_2022",2022,"Salernitana","Serie A","Emil Bohinen","NOR","MF","22",1999,7.8,15,9,4,9,2,10,20,50,10,17,3,14,12,27,14,0,"https://fbref.com/en/players/c83c203f/Emil-Bohinen"
"10522","Federico Bonazzoli_2022",2022,"Salernitana","Serie A","Federico Bonazzoli","ITA","FW,MF","24",1997,20.7,24,12,9,8,7,6,25,24,19,17,1,16,6,30,7,0,"https://fbref.com/en/players/bf57eaab/Federico-Bonazzoli"
"10523","Leonardo Capezzi_2022",2022,"Salernitana","Serie A","Leonardo Capezzi","ITA","MF","26",1995,1.9,3,1,0,3,0,1,4,25,3,8,4,4,0,3,2,0,"https://fbref.com/en/players/07ea0ef2/Leonardo-Capezzi"
"10524","Lassana Coulibaly_2022",2022,"Salernitana","Serie A","Lassana Coulibaly","MLI","MF","25",1996,25.9,58,32,29,26,3,24,62,38.7,38,40,13,27,22,80,27,0,"https://fbref.com/en/players/85a44ecc/Lassana-Coulibaly"
"10525","Mamadou Coulibaly_2022",2022,"Salernitana","Serie A","Mamadou Coulibaly","SEN","MF","22",1999,9,15,12,8,5,2,7,20,35,13,9,0,9,11,26,9,0,"https://fbref.com/en/players/c976160c/Mamadou-Coulibaly"
"10526","Filippo Delli Carri_2022",2022,"Salernitana","Serie A","Filippo Delli Carri","ITA","DF","22",1999,3.7,6,4,4,2,0,5,14,35.7,9,6,2,4,4,10,14,0,"https://fbref.com/en/players/d2e8fd9b/Filippo-Delli-Carri"
"10527","Francesco Di Tacchio_2022",2022,"Salernitana","Serie A","Francesco Di Tacchio","ITA","MF","31",1990,13.9,17,7,5,10,2,9,25,36,16,16,8,8,22,39,25,0,"https://fbref.com/en/players/b5c3ff9f/Francesco-Di-Tacchio"
"10528","Radu Drăgușin_2022",2022,"Salernitana","Serie A","Radu Drăgușin","ROU","DF","19",2002,5.4,5,4,2,3,0,4,10,40,6,7,3,4,13,18,17,0,"https://fbref.com/en/players/620922ed/Radu-Dragusin"
"10529","Éderson_2022",2022,"Salernitana","Serie A","Éderson","BRA","MF","22",1999,12.7,29,18,11,14,4,14,26,53.8,12,11,2,9,19,48,8,0,"https://fbref.com/en/players/a9202def/Ederson"
"10530","Federico Fazio_2022",2022,"Salernitana","Serie A","Federico Fazio","ARG","DF","34",1987,15.9,17,11,10,6,1,9,12,75,3,21,16,5,27,44,67,1,"https://fbref.com/en/players/4e358a2d/Federico-Fazio"
"10531","Vincenzo Fiorillo_2022",2022,"Salernitana","Serie A","Vincenzo Fiorillo","ITA","GK","31",1990,1,0,0,0,0,0,0,0,NA,0,0,0,0,0,0,1,0,"https://fbref.com/en/players/a2565f79/Vincenzo-Fiorillo"
"10532","Riccardo Gagliolo_2022",2022,"Salernitana","Serie A","Riccardo Gagliolo","SWE","DF","31",1990,12.6,23,12,16,4,3,16,27,59.3,11,15,8,7,28,51,52,0,"https://fbref.com/en/players/173061c0/Riccardo-Gagliolo"
"10533","Cedric Gondo_2022",2022,"Salernitana","Serie A","Cedric Gondo","CIV","FW","24",1996,7.8,5,2,2,2,1,2,5,40,3,2,0,2,3,8,2,0,"https://fbref.com/en/players/ff37d2ef/Cedric-Gondo"
"10534","Norbert Gyömbér_2022",2022,"Salernitana","Serie A","Norbert Gyömbér","SVK","DF","29",1992,28.5,53,32,40,11,2,33,50,66,17,38,24,14,44,97,126,1,"https://fbref.com/en/players/0be276c6/Norbert-Gyomber"
"10535","Paweł Jaroszyński_2022",2022,"Salernitana","Serie A","Paweł Jaroszyński","POL","DF","26",1994,5.7,10,5,7,3,0,5,7,71.4,2,4,0,4,10,20,19,0,"https://fbref.com/en/players/958a601f/Pawel-Jaroszynski"
"10536","Grigoris Kastanos_2022",2022,"Salernitana","Serie A","Grigoris Kastanos","CYP","MF,FW","23",1998,15,30,19,9,19,2,7,23,30.4,16,21,5,16,22,52,8,0,"https://fbref.com/en/players/2a82aa85/Grigoris-Kastanos"
"10537","Wajdi Kechrida_2022",2022,"Salernitana","Serie A","Wajdi Kechrida","TUN","DF,MF","25",1995,10.6,9,6,6,3,0,8,13,61.5,5,10,2,8,8,17,15,0,"https://fbref.com/en/players/11962fe7/Wajdi-Kechrida"
"10538","Julian Kristoffersen_2022",2022,"Salernitana","Serie A","Julian Kristoffersen","NOR","FW","24",1997,0.1,0,0,0,0,0,0,0,NA,0,0,0,0,0,0,0,0,"https://fbref.com/en/players/b804c280/Julian-Kristoffersen"
"10539","Pasquale Mazzocchi_2022",2022,"Salernitana","Serie A","Pasquale Mazzocchi","ITA","DF","26",1995,14.1,28,19,15,11,2,14,34,41.2,20,5,0,5,11,39,31,0,"https://fbref.com/en/players/eb0ec070/Pasquale-Mazzocchi"
"10540","Mikael_2022",2022,"Salernitana","Serie A","Mikael","BRA","FW,MF","22",1999,1,1,1,0,1,0,0,0,NA,0,0,0,0,0,1,1,0,"https://fbref.com/en/players/33502726/Mikael"
"10541","Andrei Motoc_2022",2022,"Salernitana","Serie A","Andrei Motoc","ROU","DF","19",2002,1,1,1,0,1,0,0,0,NA,0,2,2,0,2,3,1,0,"https://fbref.com/en/players/b64073a0/Andrei-Motoc"
"10542","Lys Mousset_2022",2022,"Salernitana","Serie A","Lys Mousset","FRA","MF,FW","25",1996,1.8,1,0,0,1,0,0,0,NA,0,2,0,2,0,1,0,0,"https://fbref.com/en/players/d9cfca3d/Lys-Mousset"
"10543","Simeon Nwankwo_2022",2022,"Salernitana","Serie A","Simeon Nwankwo","NGA","FW","29",1992,9.4,5,5,0,4,1,4,10,40,6,8,3,5,3,8,10,0,"https://fbref.com/en/players/80dbbd10/Simeon-Nwankwo"
"10544","Joel Obi_2022",2022,"Salernitana","Serie A","Joel Obi","NGA","MF,DF","30",1991,12.7,23,14,5,14,4,5,12,41.7,7,17,6,11,10,33,7,0,"https://fbref.com/en/players/614c38fb/Joel-Obi"
"10545","Diego Perotti_2022",2022,"Salernitana","Serie A","Diego Perotti","ARG","MF,FW","33",1988,3.2,11,5,7,1,3,4,13,30.8,9,1,0,1,2,13,6,0,"https://fbref.com/en/players/a40d5a0c/Diego-Perotti"
"10546","Mario Perrone_2022",2022,"Salernitana","Serie A","Mario Perrone","ITA","DF","18",2003,0.2,0,0,0,0,0,0,0,NA,0,0,0,0,0,0,0,0,"https://fbref.com/en/players/6cd33e2a/Mario-Perrone"
"10547","Ivan Radovanović_2022",2022,"Salernitana","Serie A","Ivan Radovanović","SRB","DF,MF","32",1988,11.7,11,7,8,3,0,7,19,36.8,12,14,7,7,7,18,29,0,"https://fbref.com/en/players/023937a9/Ivan-Radovanovic"
"10548","Luca Ranieri_2022",2022,"Salernitana","Serie A","Luca Ranieri","ITA","DF","22",1999,23.4,38,21,23,11,4,19,33,57.6,14,18,8,10,22,60,67,0,"https://fbref.com/en/players/8c63fae5/Luca-Ranieri"
"10549","Franck Ribéry_2022",2022,"Salernitana","Serie A","Franck Ribéry","FRA","MF,FW","38",1983,15.8,17,10,6,6,5,8,13,61.5,5,12,0,12,3,20,1,0,"https://fbref.com/en/players/f61c7c4e/Franck-Ribery"
"10550","Matteo Ruggeri_2022",2022,"Salernitana","Serie A","Matteo Ruggeri","ITA","DF","19",2002,7.5,8,4,5,2,1,7,10,70,3,6,1,5,2,10,25,0,"https://fbref.com/en/players/ae9898c5/Matteo-Ruggeri"
"10551","Alessandro Russo_2022",2022,"Salernitana","Serie A","Alessandro Russo","ITA","MF","17",2003,0.3,1,0,1,0,0,0,1,0,1,0,0,0,0,1,1,0,"https://fbref.com/en/players/7152082d/Alessandro-Russo"
"10552","Andrea Schiavone_2022",2022,"Salernitana","Serie A","Andrea Schiavone","ITA","MF","28",1993,6.3,14,8,5,9,0,10,23,43.5,13,13,3,10,8,22,12,0,"https://fbref.com/en/players/4b55eb4d/Andrea-Schiavone"
"10553","Luigi Sepe_2022",2022,"Salernitana","Serie A","Luigi Sepe","ITA","GK","30",1991,15.5,0,0,0,0,0,0,0,NA,0,0,0,0,1,1,3,0,"https://fbref.com/en/players/343f753a/Luigi-Sepe"
"10554","Stefan Strandberg_2022",2022,"Salernitana","Serie A","Stefan Strandberg","NOR","DF","31",1990,10.4,13,8,10,3,0,8,11,72.7,3,15,13,2,9,22,49,0,"https://fbref.com/en/players/6d5e62b0/Stefan-Strandberg"
"10555","Simone Verdi_2022",2022,"Salernitana","Serie A","Simone Verdi","ITA","FW,MF","29",1992,9.2,12,8,5,2,5,9,20,45,11,4,0,4,3,15,1,0,"https://fbref.com/en/players/0375723e/Simone-Verdi"
"10556","Edoardo Vergani_2022",2022,"Salernitana","Serie A","Edoardo Vergani","ITA","FW,MF","20",2001,1.1,2,2,2,0,0,0,0,NA,0,2,2,0,0,2,2,0,"https://fbref.com/en/players/2873973b/Edoardo-Vergani"
"10557","Freddie Veseli_2022",2022,"Salernitana","Serie A","Freddie Veseli","ALB","DF","28",1992,6.6,7,2,4,3,0,5,6,83.3,1,10,5,5,4,11,19,0,"https://fbref.com/en/players/d541e703/Freddie-Veseli"
"10558","Nadir Zortea_2022",2022,"Salernitana","Serie A","Nadir Zortea","ITA","DF,MF","22",1999,15.7,21,15,9,7,5,11,19,57.9,8,14,2,12,7,28,33,0,"https://fbref.com/en/players/82598b71/Nadir-Zortea"
"10559","Milan Đurić_2022",2022,"Salernitana","Serie A","Milan Đurić","BIH","FW","31",1990,24.1,1,1,0,1,0,1,3,33.3,2,6,1,5,2,3,32,0,"https://fbref.com/en/players/405f6586/Milan-Djuric"
"10560","Kristoffer Askildsen_2022",2022,"Sampdoria","Serie A","Kristoffer Askildsen","NOR","MF","20",2001,8.4,18,6,7,11,0,9,19,47.4,10,14,7,7,15,33,15,0,"https://fbref.com/en/players/a69cc629/Kristoffer-Askildsen"
"10561","Emil Audero_2022",2022,"Sampdoria","Serie A","Emil Audero","ITA","GK","24",1997,28.4,3,1,3,0,0,3,5,60,2,0,0,0,2,5,17,2,"https://fbref.com/en/players/649b01d8/Emil-Audero"
"10562","Tommaso Augello_2022",2022,"Sampdoria","Serie A","Tommaso Augello","ITA","DF","26",1994,26.6,36,20,22,8,6,17,29,58.6,12,19,4,15,29,65,68,1,"https://fbref.com/en/players/3cd3b384/Tommaso-Augello"
"10563","Bartosz Bereszyński_2022",2022,"Sampdoria","Serie A","Bartosz Bereszyński","POL","DF","29",1992,32.7,64,38,34,25,5,37,80,46.3,43,38,12,26,42,106,73,1,"https://fbref.com/en/players/61b3978f/Bartosz-Bereszynski"
"10564","Antonio Candreva_2022",2022,"Sampdoria","Serie A","Antonio Candreva","ITA","MF,FW","34",1987,34.7,27,16,9,11,7,19,55,34.5,36,23,2,21,33,60,19,0,"https://fbref.com/en/players/356c9002/Antonio-Candreva"
"10565","Francesco Caputo_2022",2022,"Sampdoria","Serie A","Francesco Caputo","ITA","FW","33",1987,31,5,2,1,3,1,1,6,16.7,5,5,0,5,2,7,10,0,"https://fbref.com/en/players/5bd72174/Francesco-Caputo"
"10566","Julian Chabot_2022",2022,"Sampdoria","Serie A","Julian Chabot","GER","DF","23",1998,5.4,12,10,8,4,0,8,10,80,2,7,4,3,9,21,28,1,"https://fbref.com/en/players/ae7058f9/Julian-Chabot"
"10567","Riccardo Ciervo_2022",2022,"Sampdoria","Serie A","Riccardo Ciervo","ITA","MF,DF","19",2002,2.5,8,3,4,3,1,2,6,33.3,4,1,0,1,2,10,2,0,"https://fbref.com/en/players/da77b60b/Riccardo-Ciervo"
"10568","Omar Colley_2022",2022,"Sampdoria","Serie A","Omar Colley","GAM","DF","28",1992,30.5,47,36,32,14,1,22,32,68.8,10,31,19,12,80,127,135,2,"https://fbref.com/en/players/8b95acda/Omar-Colley"
"10569","Andrea Conti_2022",2022,"Sampdoria","Serie A","Andrea Conti","ITA","DF,MF","27",1994,2.6,4,2,2,1,1,3,6,50,3,4,0,4,7,11,4,0,"https://fbref.com/en/players/8fef5412/Andrea-Conti"
"10570","Mikkel Damsgaard_2022",2022,"Sampdoria","Serie A","Mikkel Damsgaard","DEN","MF,FW","21",2000,6.4,27,13,12,11,4,20,36,55.6,16,16,1,15,7,34,7,0,"https://fbref.com/en/players/215f3907/Mikkel-Damsgaard"
"10571","Fabio Depaoli_2022",2022,"Sampdoria","Serie A","Fabio Depaoli","ITA","MF,DF","24",1997,1.2,3,1,1,2,0,0,2,0,2,2,1,1,1,4,2,0,"https://fbref.com/en/players/d97f2e8d/Fabio-Depaoli"
"10572","Radu Drăgușin_2022",2022,"Sampdoria","Serie A","Radu Drăgușin","ROU","DF","19",2002,6.9,4,3,2,2,0,2,6,33.3,4,8,4,4,10,14,33,0,"https://fbref.com/en/players/620922ed/Radu-Dragusin"
"10573","Albin Ekdal_2022",2022,"Sampdoria","Serie A","Albin Ekdal","SWE","MF","32",1989,18.2,43,28,17,21,5,26,56,46.4,30,27,7,20,29,72,25,0,"https://fbref.com/en/players/f503ea63/Albin-Ekdal"
"10574","Wladimiro Falcone_2022",2022,"Sampdoria","Serie A","Wladimiro Falcone","ITA","GK","26",1995,9.5,0,0,0,0,0,0,0,NA,0,0,0,0,1,1,5,0,"https://fbref.com/en/players/9f5a610b/Wladimiro-Falcone"
"10575","Alex Ferrari_2022",2022,"Sampdoria","Serie A","Alex Ferrari","ITA","DF","27",1994,18.3,40,22,28,9,3,19,33,57.6,14,31,22,9,39,79,63,1,"https://fbref.com/en/players/d0dbca9f/Alex-Ferrari"
"10576","Manolo Gabbiadini_2022",2022,"Sampdoria","Serie A","Manolo Gabbiadini","ITA","FW,MF","29",1991,12.7,6,4,3,2,1,1,7,14.3,6,5,2,3,3,9,10,0,"https://fbref.com/en/players/8f866fe8/Manolo-Gabbiadini"
"10577","Sebastian Giovinco_2022",2022,"Sampdoria","Serie A","Sebastian Giovinco","ITA","MF","34",1987,0.4,0,0,0,0,0,0,1,0,1,0,0,0,0,0,0,0,"https://fbref.com/en/players/2b7c18ae/Sebastian-Giovinco"
"10578","Giangiacomo Magnani_2022",2022,"Sampdoria","Serie A","Giangiacomo Magnani","ITA","DF","25",1995,2.7,4,2,4,0,0,1,1,100,0,2,2,0,7,11,12,0,"https://fbref.com/en/players/cce9f582/Giangiacomo-Magnani"
"10579","Nicola Murru_2022",2022,"Sampdoria","Serie A","Nicola Murru","ITA","DF","26",1994,10.9,22,17,10,11,1,8,13,61.5,5,17,3,14,7,29,20,1,"https://fbref.com/en/players/d183e9d6/Nicola-Murru"
"10580","Fabio Quagliarella_2022",2022,"Sampdoria","Serie A","Fabio Quagliarella","ITA","FW","38",1983,18.5,6,2,2,2,2,2,15,13.3,13,14,1,13,3,9,12,0,"https://fbref.com/en/players/ee4f2f3b/Fabio-Quagliarella"
"10581","Nicola Ravaglia_2022",2022,"Sampdoria","Serie A","Nicola Ravaglia","ITA","GK","32",1988,0.1,0,0,0,0,0,0,0,NA,0,0,0,0,0,0,0,0,"https://fbref.com/en/players/d7a35008/Nicola-Ravaglia"
"10582","Tomás Rincón_2022",2022,"Sampdoria","Serie A","Tomás Rincón","VEN","MF","33",1988,13,22,13,9,10,3,13,34,38.2,21,15,2,13,18,40,11,0,"https://fbref.com/en/players/f1cfc209/Tomas-Rincon"
"10583","Abdelhamid Sabiri_2022",2022,"Sampdoria","Serie A","Abdelhamid Sabiri","MAR","MF,FW","24",1996,9.9,34,18,10,15,9,7,25,28,18,10,2,8,7,41,3,0,"https://fbref.com/en/players/4830e0af/Abdelhamid-Sabiri"
"10584","Stefano Sensi_2022",2022,"Sampdoria","Serie A","Stefano Sensi","ITA","MF,FW","25",1995,8.4,18,9,10,6,2,10,23,43.5,13,2,0,2,6,24,4,0,"https://fbref.com/en/players/b70bde8f/Stefano-Sensi"
"10585","Adrien Silva_2022",2022,"Sampdoria","Serie A","Adrien Silva","POR","MF","32",1989,12,24,12,14,5,5,9,33,27.3,24,15,5,10,23,47,23,0,"https://fbref.com/en/players/d6f88a1d/Adrien-Silva"
"10586","Vladyslav Supriaha_2022",2022,"Sampdoria","Serie A","Vladyslav Supriaha","UKR","FW","21",2000,0.2,0,0,0,0,0,0,1,0,1,0,0,0,0,0,0,0,"https://fbref.com/en/players/73affbb6/Vladyslav-Supriaha"
"10587","Morten Thorsby_2022",2022,"Sampdoria","Serie A","Morten Thorsby","NOR","MF","25",1996,32.7,46,26,15,23,8,28,56,50,28,37,12,25,25,71,39,0,"https://fbref.com/en/players/d1b49282/Morten-Thorsby"
"10588","Ernesto Torregrossa_2022",2022,"Sampdoria","Serie A","Ernesto Torregrossa","VEN","FW","29",1992,1.3,2,1,1,0,1,1,2,50,1,0,0,0,0,2,1,0,"https://fbref.com/en/players/bf39bdec/Ernesto-Torregrossa"
"10589","Simone Trimboli_2022",2022,"Sampdoria","Serie A","Simone Trimboli","ITA","MF","19",2002,0.7,2,1,2,0,0,2,2,100,0,0,0,0,2,4,0,0,"https://fbref.com/en/players/f5f21026/Simone-Trimboli"
"10590","Valerio Verre_2022",2022,"Sampdoria","Serie A","Valerio Verre","ITA","MF,FW","27",1994,4.7,7,5,1,4,2,4,9,44.4,5,7,0,7,0,7,5,0,"https://fbref.com/en/players/33ecf462/Valerio-Verre"
"10591","Ronaldo Vieira_2022",2022,"Sampdoria","Serie A","Ronaldo Vieira","GNB","MF","23",1998,5.5,NA,6,NA,NA,NA,NA,NA,NA,NA,NA,NA,NA,5,NA,NA,NA,"https://fbref.com/en/players/75e60d75/Ronaldo-Vieira"
"10592","Gerard Yepes_2022",2022,"Sampdoria","Serie A","Gerard Yepes","ESP","MF,DF","18",2002,0.2,1,0,0,1,0,1,1,100,0,1,0,1,0,1,0,0,"https://fbref.com/en/players/ee9040b4/Gerard-Yepes"
"10593","Maya Yoshida_2022",2022,"Sampdoria","Serie A","Maya Yoshida","JPN","DF","32",1988,20.3,17,10,8,9,0,8,15,53.3,7,27,20,7,28,45,72,1,"https://fbref.com/en/players/caffaf5a/Maya-Yoshida"
"10594","Kaan Ayhan_2022",2022,"Sassuolo","Serie A","Kaan Ayhan","TUR","DF","26",1994,15,20,12,14,6,0,7,15,46.7,8,20,14,6,13,33,57,0,"https://fbref.com/en/players/2200181e/Kaan-Ayhan"
"10595","Domenico Berardi_2022",2022,"Sassuolo","Serie A","Domenico Berardi","ITA","FW","26",1994,31.3,32,19,9,16,7,15,57,26.3,42,39,2,37,31,63,23,0,"https://fbref.com/en/players/53a0e358/Domenico-Berardi"
"10596","Jeremie Boga_2022",2022,"Sassuolo","Serie A","Jeremie Boga","CIV","FW,MF","24",1997,7.4,7,4,1,2,4,2,3,66.7,1,3,0,3,2,9,1,1,"https://fbref.com/en/players/fe012aca/Jeremie-Boga"
"10597","Francesco Caputo_2022",2022,"Sassuolo","Serie A","Francesco Caputo","ITA","FW","33",1987,1.7,0,0,0,0,0,0,0,NA,0,0,0,0,0,0,0,0,"https://fbref.com/en/players/5bd72174/Francesco-Caputo"
"10598","Emil Ceide_2022",2022,"Sassuolo","Serie A","Emil Ceide","NOR","FW,MF","19",2001,0.6,1,1,0,1,0,1,2,50,1,1,0,1,0,1,0,0,"https://fbref.com/en/players/98a84572/Emil-Ceide"
"10599","Vlad Chiricheș_2022",2022,"Sassuolo","Serie A","Vlad Chiricheș","ROU","DF","31",1989,25.6,28,15,19,9,0,10,21,47.6,11,34,21,13,41,69,71,4,"https://fbref.com/en/players/c316607a/Vlad-Chiriches"
"10600","Andrea Consigli_2022",2022,"Sassuolo","Serie A","Andrea Consigli","ITA","GK","34",1987,36.9,0,0,0,0,0,0,2,0,2,0,0,0,0,0,23,3,"https://fbref.com/en/players/8cabdc1e/Andrea-Consigli"
"10601","Grégoire Defrel_2022",2022,"Sassuolo","Serie A","Grégoire Defrel","MTQ","FW","30",1991,15.1,15,9,4,8,3,6,16,37.5,10,11,1,10,4,19,11,0,"https://fbref.com/en/players/854ee61a/Gregoire-Defrel"
"10602","Davide Frattesi_2022",2022,"Sassuolo","Serie A","Davide Frattesi","ITA","MF","21",1999,31.7,46,16,26,18,2,26,52,50,26,44,12,32,29,75,62,1,"https://fbref.com/en/players/2a7d27c1/Davide-Frattesi"
"10603","Edoardo Goldaniga_2022",2022,"Sassuolo","Serie A","Edoardo Goldaniga","ITA","DF,MF","27",1993,0,0,0,0,0,0,0,0,NA,0,0,0,0,0,0,0,0,"https://fbref.com/en/players/4b029b31/Edoardo-Goldaniga"
"10604","Abdou Harroui_2022",2022,"Sassuolo","Serie A","Abdou Harroui","NED","MF","23",1998,5,11,4,4,7,0,8,11,72.7,3,14,0,14,4,15,5,0,"https://fbref.com/en/players/65fd099c/Abdou-Harroui"
"10605","Matheus Henrique_2022",2022,"Sassuolo","Serie A","Matheus Henrique","BRA","MF","23",1997,12,10,3,6,3,1,6,24,25,18,14,2,12,7,17,12,1,"https://fbref.com/en/players/a2d9f138/Matheus-Henrique"
"10606","Hamed Junior Traorè_2022",2022,"Sassuolo","Serie A","Hamed Junior Traorè","CIV","FW,MF","21",2000,19.7,32,18,8,14,10,10,46,21.7,36,22,2,20,12,44,6,1,"https://fbref.com/en/players/570bb4b9/Hamed-Junior-Traore"
"10607","Giorgos Kyriakopoulos_2022",2022,"Sassuolo","Serie A","Giorgos Kyriakopoulos","GRE","DF,FW","25",1996,21.9,30,14,19,7,4,19,38,50,19,32,9,23,11,41,52,0,"https://fbref.com/en/players/0a483542/Giorgos-Kyriakopoulos"
"10608","Maxime Lopez_2022",2022,"Sassuolo","Serie A","Maxime Lopez","FRA","MF","23",1997,32.6,69,36,40,27,2,35,87,40.2,52,33,7,26,42,111,38,1,"https://fbref.com/en/players/20094685/Maxime-Lopez"
"10609","Francesco Magnanelli_2022",2022,"Sassuolo","Serie A","Francesco Magnanelli","ITA","MF","36",1984,3,5,4,4,1,0,1,9,11.1,8,3,1,2,1,6,3,0,"https://fbref.com/en/players/07767f42/Francesco-Magnanelli"
"10610","Gian Marco Ferrari_2022",2022,"Sassuolo","Serie A","Gian Marco Ferrari","ITA","DF","29",1992,34.7,16,11,10,6,0,10,23,43.5,13,37,27,10,43,59,114,2,"https://fbref.com/en/players/8650af85/Gian-Marco-Ferrari"
"10611","Mert Müldür_2022",2022,"Sassuolo","Serie A","Mert Müldür","TUR","DF","22",1999,22.7,52,35,43,7,2,27,49,55.1,22,25,6,19,24,76,44,1,"https://fbref.com/en/players/1295552e/Mert-Muldur"
"10612","Brian Oddei_2022",2022,"Sassuolo","Serie A","Brian Oddei","ITA","FW","18",2002,0.1,0,0,0,0,0,0,0,NA,0,0,0,0,0,0,0,0,"https://fbref.com/en/players/97e8ea97/Brian-Oddei"
"10613","Gianluca Pegolo_2022",2022,"Sassuolo","Serie A","Gianluca Pegolo","ITA","GK","40",1981,1,0,0,0,0,0,0,0,NA,0,0,0,0,0,0,0,1,"https://fbref.com/en/players/f058ed1f/Gianluca-Pegolo"
"10614","Federico Peluso_2022",2022,"Sassuolo","Serie A","Federico Peluso","ITA","DF","37",1984,0.1,1,1,0,1,0,1,1,100,0,0,0,0,0,1,0,0,"https://fbref.com/en/players/4f2908e5/Federico-Peluso"
"10615","Giacomo Raspadori_2022",2022,"Sassuolo","Serie A","Giacomo Raspadori","ITA","MF,FW","21",2000,30.4,29,18,5,15,9,11,38,28.9,27,29,3,26,9,38,11,0,"https://fbref.com/en/players/6e058f06/Giacomo-Raspadori"
"10616","Rogério_2022",2022,"Sassuolo","Serie A","Rogério","BRA","DF","23",1998,19.2,21,13,12,5,4,15,22,68.2,7,20,8,12,18,39,42,1,"https://fbref.com/en/players/10e7f486/Rogerio"
"10617","Ruan_2022",2022,"Sassuolo","Serie A","Ruan","BRA","DF","22",1999,2.4,7,4,7,0,0,3,4,75,1,6,5,1,2,9,24,1,"https://fbref.com/en/players/a378a02a/Ruan"
"10618","Luigi Samele_2022",2022,"Sassuolo","Serie A","Luigi Samele","ITA","FW","19",2002,0.1,0,0,0,0,0,0,0,NA,0,0,0,0,0,0,1,0,"https://fbref.com/en/players/548fea2f/Luigi-Samele"
"10619","Giacomo Satalino_2022",2022,"Sassuolo","Serie A","Giacomo Satalino","ITA","GK","22",1999,0.1,0,0,0,0,0,0,0,NA,0,0,0,0,0,0,0,0,"https://fbref.com/en/players/b1f0b916/Giacomo-Satalino"
"10620","Gianluca Scamacca_2022",2022,"Sassuolo","Serie A","Gianluca Scamacca","ITA","FW","22",1999,23.8,19,14,2,5,12,5,21,23.8,16,16,1,15,5,24,22,1,"https://fbref.com/en/players/8790f988/Gianluca-Scamacca"
"10621","Jeremy Toljan_2022",2022,"Sassuolo","Serie A","Jeremy Toljan","GER","DF","26",1994,15.5,18,10,12,4,2,13,20,65,7,12,5,7,12,30,41,0,"https://fbref.com/en/players/a96e5dc0/Jeremy-Toljan"
"10622","Filip Đuričić_2022",2022,"Sassuolo","Serie A","Filip Đuričić","SRB","MF,FW","29",1992,7.5,13,10,7,1,5,5,13,38.5,8,7,1,6,4,17,1,0,"https://fbref.com/en/players/eccbe56a/Filip-Djuricic"
"10623","Marcos Acuña_2022",2022,"Sevilla","La Liga","Marcos Acuña","ARG","DF","29",1991,25.1,50,29,27,14,9,30,46,65.2,16,22,5,17,14,64,25,1,"https://fbref.com/en/players/81442ecb/Marcos-Acuna"
"10624","Ludwig Augustinsson_2022",2022,"Sevilla","La Liga","Ludwig Augustinsson","SWE","DF,FW","27",1994,8.8,18,14,11,3,4,8,13,61.5,5,10,3,7,5,23,21,0,"https://fbref.com/en/players/9fec8860/Ludwig-Augustinsson"
"10625","Yassine Bounou_2022",2022,"Sevilla","La Liga","Yassine Bounou","MAR","GK","30",1991,31,0,0,0,0,0,0,0,NA,0,0,0,0,0,0,11,1,"https://fbref.com/en/players/f6798fc3/Yassine-Bounou"
"10626","Diego Carlos_2022",2022,"Sevilla","La Liga","Diego Carlos","BRA","DF","28",1993,32.9,35,24,20,13,2,16,24,66.7,8,48,33,15,24,59,120,5,"https://fbref.com/en/players/b4a014b1/Diego-Carlos"
"10627","Carmona_2022",2022,"Sevilla","La Liga","Carmona","ESP","DF","19",2002,0.3,0,0,0,0,0,0,0,NA,0,0,0,0,1,1,0,0,"https://fbref.com/en/players/2dce876a/Carmona"
"10628","Jesús Corona_2022",2022,"Sevilla","La Liga","Jesús Corona","MEX","FW,DF","28",1993,12.9,12,7,7,5,0,3,6,50,3,4,0,4,8,20,6,0,"https://fbref.com/en/players/fb938d24/Jesus-Corona"
"10629","Thomas Delaney_2022",2022,"Sevilla","La Liga","Thomas Delaney","DEN","MF","29",1991,17.2,41,24,17,21,3,16,30,53.3,14,19,10,9,13,54,35,0,"https://fbref.com/en/players/fe641c1a/Thomas-Delaney"
"10630","Javier Díaz_2022",2022,"Sevilla","La Liga","Javier Díaz","ESP","GK","24",1997,1,0,0,0,0,0,0,0,NA,0,0,0,0,0,0,0,0,"https://fbref.com/en/players/17a1299d/Javier-Diaz"
"10631","Marko Dmitrović_2022",2022,"Sevilla","La Liga","Marko Dmitrović","SRB","GK","29",1992,6,0,0,0,0,0,0,0,NA,0,0,0,0,0,0,3,1,"https://fbref.com/en/players/ac295d9e/Marko-Dmitrovic"
"10632","Youssef En-Nesyri_2022",2022,"Sevilla","La Liga","Youssef En-Nesyri","MAR","FW","24",1997,14.2,10,5,5,2,3,4,11,36.4,7,9,1,8,4,14,18,0,"https://fbref.com/en/players/04e17fd5/Youssef-En-Nesyri"
"10633","Fernando_2022",2022,"Sevilla","La Liga","Fernando","BRA","MF,DF","34",1987,20.6,24,17,14,9,1,12,33,36.4,21,21,13,8,29,53,32,2,"https://fbref.com/en/players/41f32541/Fernando"
"10634","Papu Gómez_2022",2022,"Sevilla","La Liga","Papu Gómez","ARG","FW,MF","33",1988,19.8,19,11,9,5,5,9,35,25.7,26,15,2,13,7,26,12,2,"https://fbref.com/en/players/6e4df551/Papu-Gomez"
"10635","Nemanja Gudelj_2022",2022,"Sevilla","La Liga","Nemanja Gudelj","SRB","DF,MF","29",1991,11.6,16,7,10,4,2,5,8,62.5,3,14,9,5,22,38,37,0,"https://fbref.com/en/players/0076ab7f/Nemanja-Gudelj"
"10636","Munir El Haddadi_2022",2022,"Sevilla","La Liga","Munir El Haddadi","MAR","FW,MF","25",1995,5.3,8,4,1,6,1,2,8,25,6,7,1,6,5,13,2,0,"https://fbref.com/en/players/8696bc90/Munir-El-Haddadi"
"10637","Oussama Idrissi_2022",2022,"Sevilla","La Liga","Oussama Idrissi","MAR","MF,FW","25",1996,1.4,1,0,0,1,0,0,1,0,1,1,0,1,1,2,1,0,"https://fbref.com/en/players/34caa4b3/Oussama-Idrissi"
"10638","Joan Jordán_2022",2022,"Sevilla","La Liga","Joan Jordán","ESP","MF","27",1994,27.9,61,30,22,31,8,28,65,43.1,37,27,6,21,30,91,18,1,"https://fbref.com/en/players/2a0c8ba4/Joan-Jordan"
"10639","Jules Koundé_2022",2022,"Sevilla","La Liga","Jules Koundé","FRA","DF","22",1998,30.4,40,17,27,10,3,18,28,64.3,10,33,18,15,21,61,101,2,"https://fbref.com/en/players/4d1666ff/Jules-Kounde"
"10640","Érik Lamela_2022",2022,"Sevilla","La Liga","Érik Lamela","ARG","FW,MF","29",1992,11.3,31,18,12,14,5,10,29,34.5,19,11,0,11,5,36,3,0,"https://fbref.com/en/players/abe66106/Erik-Lamela"
"10641","Luismi_2022",2022,"Sevilla","La Liga","Luismi","ESP","FW,MF","20",2001,0.1,0,0,0,0,0,0,0,NA,0,0,0,0,0,0,0,0,"https://fbref.com/en/players/acf5410c/Luismi"
"10642","Anthony Martial_2022",2022,"Sevilla","La Liga","Anthony Martial","FRA","FW,MF","25",1995,5.4,2,1,0,0,2,2,6,33.3,4,4,0,4,0,2,3,0,"https://fbref.com/en/players/8b788c01/Anthony-Martial"
"10643","Rafa Mir_2022",2022,"Sevilla","La Liga","Rafa Mir","ESP","FW","24",1997,20.1,4,3,1,1,2,0,11,0,11,4,3,1,0,4,17,0,"https://fbref.com/en/players/bbf5c11b/Rafa-Mir"
"10644","Gonzalo Montiel_2022",2022,"Sevilla","La Liga","Gonzalo Montiel","ARG","DF","24",1997,11.8,15,4,8,5,2,12,24,50,12,8,2,6,10,25,22,0,"https://fbref.com/en/players/374d5158/Gonzalo-Montiel"
"10645","Jesús Navas_2022",2022,"Sevilla","La Liga","Jesús Navas","ESP","DF","35",1985,19.8,18,13,11,5,2,9,17,52.9,8,15,2,13,17,35,26,1,"https://fbref.com/en/players/3f10bd22/Jesus-Navas"
"10646","Lucas Ocampos_2022",2022,"Sevilla","La Liga","Lucas Ocampos","ARG","FW","27",1994,23.6,45,24,23,18,4,23,55,41.8,32,35,1,34,9,54,24,1,"https://fbref.com/en/players/a08b974a/Lucas-Ocampos"
"10647","Pedro Ortiz_2022",2022,"Sevilla","La Liga","Pedro Ortiz","ESP","MF","20",2000,0.1,0,0,0,0,0,0,0,NA,0,0,0,0,0,0,1,0,"https://fbref.com/en/players/f9358b61/Pedro-Ortiz"
"10648","Ivan Rakitić_2022",2022,"Sevilla","La Liga","Ivan Rakitić","CRO","MF","33",1988,24.2,40,22,12,23,5,13,40,32.5,27,31,8,23,23,63,35,0,"https://fbref.com/en/players/89f951b5/Ivan-Rakitic"
"10649","Karim Rekik_2022",2022,"Sevilla","La Liga","Karim Rekik","NED","DF","26",1994,12.2,11,8,4,6,1,2,9,22.2,7,11,6,5,9,20,19,0,"https://fbref.com/en/players/3376a776/Karim-Rekik"
"10650","Óscar Rodríguez Arnaiz_2022",2022,"Sevilla","La Liga","Óscar Rodríguez Arnaiz","ESP","FW,MF","23",1998,4.6,4,3,1,3,0,2,3,66.7,1,2,0,2,5,9,7,1,"https://fbref.com/en/players/19709006/Oscar-Rodriguez-Arnaiz"
"10651","Iván Romero_2022",2022,"Sevilla","La Liga","Iván Romero","ESP","FW","20",2001,2,2,2,0,2,0,0,0,NA,0,1,0,1,2,4,0,0,"https://fbref.com/en/players/2fbe6af0/Ivan-Romero"
"10652","Juan Sánchez_2022",2022,"Sevilla","La Liga","Juan Sánchez","ESP","","17",2003,0.1,NA,0,NA,NA,NA,NA,NA,NA,NA,NA,NA,NA,0,NA,NA,NA,"https://fbref.com/en/players/ff4f78e1/Juan-Sanchez"
"10653","Valentino Scotta_2022",2022,"Sevilla","La Liga","Valentino Scotta","ESP","DF","19",2001,0,0,0,0,0,0,0,0,NA,0,0,0,0,0,0,0,0,"https://fbref.com/en/players/98529579/Valentino-Scotta"
"10654","Suso_2022",2022,"Sevilla","La Liga","Suso","ESP","FW","27",1993,4.3,4,3,1,3,0,3,13,23.1,10,4,0,4,0,4,0,0,"https://fbref.com/en/players/4e219ad2/Suso"
"10655","Óliver Torres_2022",2022,"Sevilla","La Liga","Óliver Torres","ESP","MF,FW","26",1994,11.2,22,12,8,7,7,8,25,32,17,10,1,9,6,28,4,0,"https://fbref.com/en/players/58a9a4d9/Oliver-Torres"
"10656","Che Adams_2022",2022,"Southampton","Premier League","Che Adams","SCO","FW","25",1996,22.7,13,6,5,5,3,2,16,12.5,14,18,2,16,8,21,18,0,"https://fbref.com/en/players/f2bf1b0f/Che-Adams"
"10657","Adam Armstrong_2022",2022,"Southampton","Premier League","Adam Armstrong","ENG","FW","24",1997,15.7,10,4,2,2,6,0,6,0,6,13,1,12,3,13,6,0,"https://fbref.com/en/players/68c720b5/Adam-Armstrong"
"10658","Stuart Armstrong_2022",2022,"Southampton","Premier League","Stuart Armstrong","SCO","MF","29",1992,16.4,27,19,15,6,6,9,23,39.1,14,10,1,9,8,35,15,0,"https://fbref.com/en/players/97333cf5/Stuart-Armstrong"
"10659","Jan Bednarek_2022",2022,"Southampton","Premier League","Jan Bednarek","POL","DF","25",1996,29.2,32,15,18,13,1,19,33,57.6,14,48,27,21,72,104,141,0,"https://fbref.com/en/players/4115ce4e/Jan-Bednarek"
"10660","Armando Broja_2022",2022,"Southampton","Premier League","Armando Broja","ALB","FW","19",2001,21.9,12,5,2,7,3,2,9,22.2,7,17,1,16,3,15,11,0,"https://fbref.com/en/players/97220da2/Armando-Broja"
"10661","Willy Caballero_2022",2022,"Southampton","Premier League","Willy Caballero","ARG","GK","39",1981,2,0,0,0,0,0,0,0,NA,0,0,0,0,0,0,2,1,"https://fbref.com/en/players/a179d516/Willy-Caballero"
"10662","Ibrahima Diallo_2022",2022,"Southampton","Premier League","Ibrahima Diallo","FRA","MF","22",1999,11.4,22,11,10,9,3,10,24,41.7,14,7,0,7,9,31,10,0,"https://fbref.com/en/players/11ff3d56/Ibrahima-Diallo"
"10663","Moussa Djenepo_2022",2022,"Southampton","Premier League","Moussa Djenepo","MLI","MF","23",1998,5.1,9,3,3,5,1,3,11,27.3,8,6,1,5,2,11,6,1,"https://fbref.com/en/players/254147d4/Moussa-Djenepo"
"10664","Mohamed Elyounoussi_2022",2022,"Southampton","Premier League","Mohamed Elyounoussi","NOR","MF,FW","26",1994,22.7,36,17,14,15,7,11,39,28.2,28,23,2,21,12,48,28,0,"https://fbref.com/en/players/68dc0dac/Mohamed-Elyounoussi"
"10665","Fraser Forster_2022",2022,"Southampton","Premier League","Fraser Forster","ENG","GK","33",1988,19,1,0,1,0,0,0,1,0,1,0,0,0,0,1,23,2,"https://fbref.com/en/players/c3e39f12/Fraser-Forster"
"10666","Valentino Livramento_2022",2022,"Southampton","Premier League","Valentino Livramento","ENG","DF","18",2002,24.5,54,28,30,18,6,27,45,60,18,23,9,14,47,101,50,1,"https://fbref.com/en/players/afed6722/Valentino-Livramento"
"10667","Shane Long_2022",2022,"Southampton","Premier League","Shane Long","IRL","FW","34",1987,3.4,9,5,2,4,3,1,1,100,0,4,0,4,0,9,2,0,"https://fbref.com/en/players/9f472354/Shane-Long"
"10668","Lyanco_2022",2022,"Southampton","Premier League","Lyanco","BRA","DF","24",1997,10.1,18,15,11,7,0,10,18,55.6,8,18,13,5,13,31,50,1,"https://fbref.com/en/players/b5bf1770/Lyanco"
"10669","Alex McCarthy_2022",2022,"Southampton","Premier League","Alex McCarthy","ENG","GK","31",1989,17,0,0,0,0,0,0,0,NA,0,0,0,0,0,0,4,0,"https://fbref.com/en/players/36c2ca73/Alex-McCarthy"
"10670","Romain Perraud_2022",2022,"Southampton","Premier League","Romain Perraud","FRA","DF","23",1997,18,34,22,18,14,2,16,29,55.2,13,24,6,18,17,51,42,0,"https://fbref.com/en/players/6dfd8f05/Romain-Perraud"
"10671","Nathan Redmond_2022",2022,"Southampton","Premier League","Nathan Redmond","ENG","MF,FW","27",1994,20.4,22,14,9,9,4,7,30,23.3,23,21,2,19,8,30,16,0,"https://fbref.com/en/players/ab651565/Nathan-Redmond"
"10672","Oriol Romeu_2022",2022,"Southampton","Premier League","Oriol Romeu","ESP","MF","29",1991,32.1,77,39,25,45,7,28,73,38.4,45,39,8,31,51,128,43,0,"https://fbref.com/en/players/4b511457/Oriol-Romeu"
"10673","Mohammed Salisu_2022",2022,"Southampton","Premier League","Mohammed Salisu","GHA","DF","22",1999,33,80,47,54,22,4,40,65,61.5,25,49,26,23,78,158,158,4,"https://fbref.com/en/players/0b33f6ad/Mohammed-Salisu"
"10674","William Smallbone_2022",2022,"Southampton","Premier League","William Smallbone","IRL","MF,FW","21",2000,1.5,4,4,2,2,0,1,3,33.3,2,4,0,4,2,6,0,0,"https://fbref.com/en/players/5e105217/William-Smallbone"
"10675","Jack Stephens_2022",2022,"Southampton","Premier League","Jack Stephens","ENG","DF","27",1994,9,19,12,13,5,1,6,16,37.5,10,12,7,5,19,38,42,0,"https://fbref.com/en/players/6adbc307/Jack-Stephens"
"10676","Nathan Tella_2022",2022,"Southampton","Premier League","Nathan Tella","ENG","MF,FW","22",1999,8.9,13,9,5,7,1,6,17,35.3,11,13,0,13,6,19,9,0,"https://fbref.com/en/players/f1e94cd6/Nathan-Tella"
"10677","Yan Valery_2022",2022,"Southampton","Premier League","Yan Valery","TUN","DF","22",1999,4.1,8,6,4,3,1,4,9,44.4,5,6,3,3,6,14,19,1,"https://fbref.com/en/players/531a4aa8/Yan-Valery"
"10678","Theo Walcott_2022",2022,"Southampton","Premier League","Theo Walcott","ENG","MF,FW","32",1989,4.2,4,2,2,0,2,1,5,20,4,3,0,3,5,9,2,0,"https://fbref.com/en/players/1ecb65be/Theo-Walcott"
"10679","Kyle Walker-Peters_2022",2022,"Southampton","Premier League","Kyle Walker-Peters","ENG","DF","24",1997,29.3,57,33,28,21,8,26,38,68.4,12,29,8,21,37,94,53,1,"https://fbref.com/en/players/984a5a64/Kyle-Walker-Peters"
"10680","James Ward-Prowse_2022",2022,"Southampton","Premier League","James Ward-Prowse","ENG","MF","26",1994,35.7,41,24,12,24,5,19,70,27.1,51,43,15,28,40,81,45,1,"https://fbref.com/en/players/3515d404/James-Ward-Prowse"
"10681","Kevin Agudelo_2022",2022,"Spezia","Serie A","Kevin Agudelo","COL","MF,FW","22",1998,13.7,44,26,13,26,5,7,20,35,13,22,0,22,8,52,6,0,"https://fbref.com/en/players/46fa7204/Kevin-Agudelo"
"10682","Kelvin Amian_2022",2022,"Spezia","Serie A","Kelvin Amian","FRA","DF","23",1998,29.4,66,42,43,18,5,30,41,73.2,11,39,21,18,32,98,75,0,"https://fbref.com/en/players/bcc81786/Kelvin-Amian"
"10683","Janis Antiste_2022",2022,"Spezia","Serie A","Janis Antiste","FRA","FW","18",2002,8.8,18,11,6,6,6,5,13,38.5,8,7,1,6,4,22,6,0,"https://fbref.com/en/players/38d9ce53/Janis-Antiste"
"10684","Simone Bastoni_2022",2022,"Spezia","Serie A","Simone Bastoni","ITA","MF,DF","24",1996,25.4,52,34,28,17,7,21,65,32.3,44,38,11,27,30,82,31,0,"https://fbref.com/en/players/1ac232b8/Simone-Bastoni"
"10685","Nicolò Bertola_2022",2022,"Spezia","Serie A","Nicolò Bertola","ITA","MF,DF","18",2003,0.4,3,2,3,0,0,3,4,75,1,0,0,0,3,6,1,0,"https://fbref.com/en/players/04b40c58/Nicolo-Bertola"
"10686","Mehdi Bourabia_2022",2022,"Spezia","Serie A","Mehdi Bourabia","MAR","MF","29",1991,3.1,5,1,2,3,0,3,11,27.3,8,7,6,1,3,8,10,0,"https://fbref.com/en/players/0d077b88/Mehdi-Bourabia"
"10687","Ebrima Colley_2022",2022,"Spezia","Serie A","Ebrima Colley","GAM","FW,MF","21",2000,4.4,6,1,3,2,1,1,7,14.3,6,8,0,8,3,9,2,0,"https://fbref.com/en/players/bf356094/Ebrima-Colley"
"10688","Martin Erlic_2022",2022,"Spezia","Serie A","Martin Erlic","CRO","DF","23",1998,28.6,28,16,18,10,0,10,18,55.6,8,54,39,15,28,56,122,1,"https://fbref.com/en/players/0fee6bda/Martin-Erlic"
"10689","Salvador Ferrer_2022",2022,"Spezia","Serie A","Salvador Ferrer","ESP","DF,MF","23",1998,16.6,32,18,15,9,8,12,25,48,13,24,12,12,18,50,46,0,"https://fbref.com/en/players/eb76987d/Salvador-Ferrer"
"10690","Emmanuel Gyasi_2022",2022,"Spezia","Serie A","Emmanuel Gyasi","GHA","FW,MF","27",1994,33.7,47,30,31,9,7,21,41,51.2,20,22,4,18,16,63,43,1,"https://fbref.com/en/players/f9758dae/Emmanuel-Gyasi"
"10691","Petko Hristov_2022",2022,"Spezia","Serie A","Petko Hristov","BUL","DF","22",1999,13.9,17,10,11,6,0,10,16,62.5,6,29,23,6,19,36,47,0,"https://fbref.com/en/players/d8800a46/Petko-Hristov"
"10692","Jakub Kiwior_2022",2022,"Spezia","Serie A","Jakub Kiwior","POL","MF","21",2000,21.8,50,27,25,19,6,26,57,45.6,31,38,15,23,40,90,53,0,"https://fbref.com/en/players/dc3e663e/Jakub-Kiwior"
"10693","Viktor Kovalenko_2022",2022,"Spezia","Serie A","Viktor Kovalenko","UKR","MF","25",1996,14.7,16,10,7,8,1,9,21,42.9,12,16,3,13,13,29,8,0,"https://fbref.com/en/players/9d60028d/Viktor-Kovalenko"
"10694","Giulio Maggiore_2022",2022,"Spezia","Serie A","Giulio Maggiore","ITA","MF","23",1998,31.3,58,32,20,32,6,31,77,40.3,46,30,5,25,29,87,33,0,"https://fbref.com/en/players/957e4c87/Giulio-Maggiore"
"10695","Rey Manaj_2022",2022,"Spezia","Serie A","Rey Manaj","ALB","FW","24",1997,19.6,19,12,3,11,5,6,26,23.1,20,16,0,16,4,23,13,0,"https://fbref.com/en/players/7703afb6/Rey-Manaj"
"10696","Samuel Mráz_2022",2022,"Spezia","Serie A","Samuel Mráz","SVK","FW","24",1997,0.6,0,0,0,0,0,0,0,NA,0,1,0,1,0,0,0,0,"https://fbref.com/en/players/be6c1ccc/Samuel-Mraz"
"10697","Aurélien Nguiamba_2022",2022,"Spezia","Serie A","Aurélien Nguiamba","FRA","MF","22",1999,0.6,3,2,1,2,0,2,3,66.7,1,2,1,1,0,3,1,0,"https://fbref.com/en/players/de135234/Aurelien-Nguiamba"
"10698","Dimitris Nikolaou_2022",2022,"Spezia","Serie A","Dimitris Nikolaou","GRE","DF","22",1998,36,39,26,29,7,3,22,34,64.7,12,48,24,24,49,88,132,1,"https://fbref.com/en/players/cf961d8d/Dimitris-Nikolaou"
"10699","M'Bala Nzola_2022",2022,"Spezia","Serie A","M'Bala Nzola","ANG","FW","24",1996,11.9,2,2,0,0,2,1,6,16.7,5,8,0,8,0,2,13,0,"https://fbref.com/en/players/a4948e67/MBala-Nzola"
"10700","Suf Podgoreanu_2022",2022,"Spezia","Serie A","Suf Podgoreanu","ISR","FW","19",2002,1.3,2,0,1,1,0,1,4,25,3,2,0,2,1,3,3,0,"https://fbref.com/en/players/d697a2d0/Suf-Podgoreanu"
"10701","Ivan Provedel_2022",2022,"Spezia","Serie A","Ivan Provedel","ITA","GK","27",1994,30.7,0,0,0,0,0,0,1,0,1,0,0,0,2,2,10,2,"https://fbref.com/en/players/277da414/Ivan-Provedel"
"10702","Arkadiusz Reca_2022",2022,"Spezia","Serie A","Arkadiusz Reca","POL","DF","26",1995,19.7,31,19,21,3,7,20,30,66.7,10,20,7,13,32,63,47,2,"https://fbref.com/en/players/6213fd82/Arkadiusz-Reca"
"10703","Jacopo Sala_2022",2022,"Spezia","Serie A","Jacopo Sala","ITA","MF","29",1991,9.8,22,11,10,10,2,13,30,43.3,17,6,0,6,14,36,11,0,"https://fbref.com/en/players/da5a981b/Jacopo-Sala"
"10704","Eddie Salcedo_2022",2022,"Spezia","Serie A","Eddie Salcedo","ITA","MF,FW","19",2001,4.8,1,1,0,0,1,0,1,0,1,2,1,1,0,1,7,1,"https://fbref.com/en/players/0489bb30/Eddie-Salcedo"
"10705","Aimar Sher_2022",2022,"Spezia","Serie A","Aimar Sher","SWE","MF","18",2002,0.5,2,1,1,1,0,0,1,0,1,1,0,1,3,5,1,0,"https://fbref.com/en/players/ef301f96/Aimar-Sher"
"10706","Dávid Strelec_2022",2022,"Spezia","Serie A","Dávid Strelec","SVK","FW,MF","20",2001,5.6,4,4,1,2,1,2,9,22.2,7,8,1,7,2,6,1,0,"https://fbref.com/en/players/2cb9486d/David-Strelec"
"10707","Daniele Verde_2022",2022,"Spezia","Serie A","Daniele Verde","ITA","FW,MF","25",1996,21.7,11,4,8,2,1,9,20,45,11,17,2,15,18,29,8,0,"https://fbref.com/en/players/d3298c99/Daniele-Verde"
"10708","Luca Vignali_2022",2022,"Spezia","Serie A","Luca Vignali","ITA","DF,MF","25",1996,0.9,1,1,0,1,0,0,3,0,3,0,0,0,1,2,1,0,"https://fbref.com/en/players/c1e8e74e/Luca-Vignali"
"10709","Jeroen Zoet_2022",2022,"Spezia","Serie A","Jeroen Zoet","NED","GK","30",1991,7,1,0,1,0,0,1,1,100,0,0,0,0,0,1,4,0,"https://fbref.com/en/players/cc1a0c57/Jeroen-Zoet"
"10710","Petar Zovko_2022",2022,"Spezia","Serie A","Petar Zovko","BIH","GK","19",2002,0.3,0,0,0,0,0,0,0,NA,0,0,0,0,0,0,1,0,"https://fbref.com/en/players/54f6afe3/Petar-Zovko"
"10711","Jean-Eudes Aholou_2022",2022,"Strasbourg","Ligue 1","Jean-Eudes Aholou","CIV","MF","27",1994,11.2,16,9,4,9,3,5,19,26.3,14,8,1,7,19,35,7,0,"https://fbref.com/en/players/48b28bfd/Jean-Eudes-Aholou"
"10712","Ludovic Ajorque_2022",2022,"Strasbourg","Ligue 1","Ludovic Ajorque","FRA","FW","27",1994,30.4,36,25,5,19,12,7,40,17.5,33,28,3,25,8,44,31,1,"https://fbref.com/en/players/462475ed/Ludovic-Ajorque"
"10713","Jean-Ricner Bellegarde_2022",2022,"Strasbourg","Ligue 1","Jean-Ricner Bellegarde","FRA","MF","23",1998,25.9,51,32,21,21,9,17,41,41.5,24,29,4,25,27,78,19,0,"https://fbref.com/en/players/10f0fdd3/Jean-Ricner-Bellegarde"
"10714","Anthony Caci_2022",2022,"Strasbourg","Ligue 1","Anthony Caci","FRA","DF","24",1997,26.6,65,34,35,24,6,33,55,60,22,22,3,19,33,98,49,1,"https://fbref.com/en/players/0118c54c/Anthony-Caci"
"10715","Mehdi Chahiri_2022",2022,"Strasbourg","Ligue 1","Mehdi Chahiri","MAR","DF","25",1996,0.2,1,1,1,0,0,1,1,100,0,0,0,0,0,1,0,0,"https://fbref.com/en/players/1787195f/Mehdi-Chahiri"
"10716","Habib Diallo_2022",2022,"Strasbourg","Ligue 1","Habib Diallo","SEN","FW","26",1995,17.1,9,5,0,8,1,0,8,0,8,13,4,9,4,13,11,0,"https://fbref.com/en/players/6605d143/Habib-Diallo"
"10717","Mouhamadou Diarra_2022",2022,"Strasbourg","Ligue 1","Mouhamadou Diarra","SEN","MF","17",2004,1.2,2,1,1,1,0,1,1,100,0,0,0,0,0,2,0,0,"https://fbref.com/en/players/6d0fe035/Mouhamadou-Diarra"
"10718","Alexander Djiku_2022",2022,"Strasbourg","Ligue 1","Alexander Djiku","GHA","DF","26",1994,29.9,50,37,33,13,4,18,35,51.4,17,30,13,17,61,111,90,2,"https://fbref.com/en/players/43e7a164/Alexander-Djiku"
"10719","Ismaël Doukouré_2022",2022,"Strasbourg","Ligue 1","Ismaël Doukouré","FRA","DF","18",2003,0.2,0,0,0,0,0,0,0,NA,0,0,0,0,0,0,1,0,"https://fbref.com/en/players/0512a60a/Ismael-Doukoure"
"10720","Karol Fila_2022",2022,"Strasbourg","Ligue 1","Karol Fila","POL","DF","23",1998,6.2,10,8,5,4,1,4,8,50,4,7,2,5,4,14,6,0,"https://fbref.com/en/players/50ac8941/Karol-Fila"
"10721","Kévin Gameiro_2022",2022,"Strasbourg","Ligue 1","Kévin Gameiro","FRA","FW","34",1987,26.5,19,10,5,9,5,6,18,33.3,12,22,1,21,6,25,1,0,"https://fbref.com/en/players/42276181/Kevin-Gameiro"
"10722","Frederic Guilbert_2022",2022,"Strasbourg","Ligue 1","Frederic Guilbert","FRA","DF","26",1994,28,69,39,33,24,12,32,62,51.6,30,37,11,26,55,124,39,0,"https://fbref.com/en/players/5d8d7454/Frederic-Guilbert"
"10723","Nordine Kandil_2022",2022,"Strasbourg","Ligue 1","Nordine Kandil","FRA","MF,FW","19",2001,1,2,1,2,0,0,1,1,100,0,1,1,0,0,2,0,0,"https://fbref.com/en/players/c5908bc4/Nordine-Kandil"
"10724","Eiji Kawashima_2022",2022,"Strasbourg","Ligue 1","Eiji Kawashima","JPN","GK","38",1983,1,0,0,0,0,0,0,0,NA,0,0,0,0,0,0,0,0,"https://fbref.com/en/players/a4527d33/Eiji-Kawashima"
"10725","Maxime Le Marchand_2022",2022,"Strasbourg","Ligue 1","Maxime Le Marchand","FRA","DF","31",1989,9.6,17,8,16,1,0,8,10,80,2,9,5,4,14,31,32,0,"https://fbref.com/en/players/321a71a7/Maxime-Le-Marchand"
"10726","Dimitri Liénard_2022",2022,"Strasbourg","Ligue 1","Dimitri Liénard","FRA","DF,MF","33",1988,22.7,71,43,40,21,10,46,77,59.7,31,12,0,12,21,92,28,0,"https://fbref.com/en/players/f7691f63/Dimitri-Lienard"
"10727","Abdul Majeed Waris_2022",2022,"Strasbourg","Ligue 1","Abdul Majeed Waris","GHA","FW,MF","29",1991,3.6,5,3,2,3,0,5,10,50,5,2,0,2,0,5,1,0,"https://fbref.com/en/players/46907171/Abdul-Majeed-Waris"
"10728","Dion Moise Sahi_2022",2022,"Strasbourg","Ligue 1","Dion Moise Sahi","CIV","FW,MF","19",2001,1.4,0,0,0,0,0,0,0,NA,0,1,0,1,1,1,1,0,"https://fbref.com/en/players/cdc4458b/Dion-Moise-Sahi"
"10729","Lebo Mothiba_2022",2022,"Strasbourg","Ligue 1","Lebo Mothiba","RSA","FW","25",1996,0,0,0,0,0,0,0,0,NA,0,0,0,0,0,0,0,0,"https://fbref.com/en/players/3eaf8817/Lebo-Mothiba"
"10730","Gerzino Nyamsi_2022",2022,"Strasbourg","Ligue 1","Gerzino Nyamsi","FRA","DF","24",1997,33.2,35,21,24,9,2,20,27,74.1,7,25,16,9,25,60,90,1,"https://fbref.com/en/players/6043997c/Gerzino-Nyamsi"
"10731","Lucas Perrin_2022",2022,"Strasbourg","Ligue 1","Lucas Perrin","FRA","DF","22",1998,27.8,43,32,24,17,2,26,45,57.8,19,28,11,17,42,85,67,0,"https://fbref.com/en/players/49070d66/Lucas-Perrin"
"10732","Sanjin Prcić_2022",2022,"Strasbourg","Ligue 1","Sanjin Prcić","BIH","MF","27",1993,24.3,47,28,14,27,6,14,29,48.3,15,18,3,15,47,94,19,0,"https://fbref.com/en/players/51c30111/Sanjin-Prcic"
"10733","Matz Sels_2022",2022,"Strasbourg","Ligue 1","Matz Sels","BEL","GK","29",1992,37,1,1,1,0,0,0,0,NA,0,0,0,0,1,2,22,0,"https://fbref.com/en/players/834b5c4c/Matz-Sels"
"10734","Mahame Siby_2022",2022,"Strasbourg","Ligue 1","Mahame Siby","MLI","DF","25",1996,0.2,0,0,0,0,0,0,0,NA,0,0,0,0,1,1,2,0,"https://fbref.com/en/players/6d075c67/Mahame-Siby"
"10735","Ibrahima Sissoko_2022",2022,"Strasbourg","Ligue 1","Ibrahima Sissoko","FRA","MF,DF","23",1997,25.6,47,23,18,20,9,19,46,41.3,27,32,11,21,35,82,31,0,"https://fbref.com/en/players/0f8418aa/Ibrahima-Sissoko"
"10736","Adrien Thomasson_2022",2022,"Strasbourg","Ligue 1","Adrien Thomasson","FRA","MF","27",1993,26.5,64,31,18,27,19,30,93,32.3,63,56,4,52,29,93,16,1,"https://fbref.com/en/players/c76b7567/Adrien-Thomasson"
"10737","Naouirou Ahamada_2022",2022,"Stuttgart","Bundesliga","Naouirou Ahamada","FRA","MF,DF","19",2002,0.7,1,0,1,0,0,1,3,33.3,2,0,0,0,0,1,0,0,"https://fbref.com/en/players/a6c58494/Naouirou-Ahamada"
"10738","Waldemar Anton_2022",2022,"Stuttgart","Bundesliga","Waldemar Anton","GER","DF","25",1996,28.8,40,26,22,15,3,19,32,59.4,13,27,16,11,32,72,116,1,"https://fbref.com/en/players/5e66fa06/Waldemar-Anton"
"10739","Fabian Bredlow_2022",2022,"Stuttgart","Bundesliga","Fabian Bredlow","GER","GK","26",1995,4,0,0,0,0,0,0,0,NA,0,0,0,0,0,0,1,0,"https://fbref.com/en/players/d28339cb/Fabian-Bredlow"
"10740","Tanguy Coulibaly_2022",2022,"Stuttgart","Bundesliga","Tanguy Coulibaly","FRA","FW,MF","20",2001,12,27,15,14,11,2,9,19,47.4,10,14,2,12,4,31,10,0,"https://fbref.com/en/players/05ba9d7c/Tanguy-Coulibaly"
"10741","Daniel Didavi_2022",2022,"Stuttgart","Bundesliga","Daniel Didavi","GER","MF,FW","31",1990,3.1,6,2,0,4,2,4,7,57.1,3,4,1,3,1,7,1,0,"https://fbref.com/en/players/d3096421/Daniel-Didavi"
"10742","Lilian Egloff_2022",2022,"Stuttgart","Bundesliga","Lilian Egloff","GER","MF,DF","18",2002,0.3,1,0,0,1,0,0,0,NA,0,1,0,1,0,1,0,0,"https://fbref.com/en/players/2f7fec15/Lilian-Egloff"
"10743","Wataru Endo_2022",2022,"Stuttgart","Bundesliga","Wataru Endo","JPN","MF","28",1993,32.2,73,41,34,34,5,31,72,43.1,41,43,12,31,30,103,64,0,"https://fbref.com/en/players/c149016b/Wataru-Endo"
"10744","Wahidullah Faghir_2022",2022,"Stuttgart","Bundesliga","Wahidullah Faghir","DEN","FW","18",2003,1.4,0,0,0,0,0,0,1,0,1,2,0,2,0,0,0,0,"https://fbref.com/en/players/93c9e7d9/Wahidullah-Faghir"
"10745","Ömer Faruk Beyaz_2022",2022,"Stuttgart","Bundesliga","Ömer Faruk Beyaz","TUR","DF,MF","17",2003,0.8,4,3,1,3,0,1,5,20,4,0,0,0,2,6,0,0,"https://fbref.com/en/players/8307b663/Omer-Faruk-Beyaz"
"10746","Philipp Förster_2022",2022,"Stuttgart","Bundesliga","Philipp Förster","GER","MF,FW","26",1995,10.7,20,13,4,12,4,11,26,42.3,15,12,1,11,3,23,2,0,"https://fbref.com/en/players/76fa965f/Philipp-Forster"
"10747","Chris Führich_2022",2022,"Stuttgart","Bundesliga","Chris Führich","GER","FW,MF","23",1998,19,28,16,10,10,8,18,39,46.2,21,31,2,29,8,36,9,0,"https://fbref.com/en/players/0cf778df/Chris-Fuhrich"
"10748","Hamadi Al Ghaddioui_2022",2022,"Stuttgart","Bundesliga","Hamadi Al Ghaddioui","MAR","FW","30",1990,5.5,5,4,2,1,2,0,4,0,4,3,1,2,0,5,4,0,"https://fbref.com/en/players/5723931e/Hamadi-Al-Ghaddioui"
"10749","Hiroki Ito_2022",2022,"Stuttgart","Bundesliga","Hiroki Ito","JPN","DF","22",1999,26.1,43,31,21,19,3,25,43,58.1,18,40,19,21,53,96,95,0,"https://fbref.com/en/players/204dded0/Hiroki-Ito"
"10750","Sasa Kalajdzic_2022",2022,"Stuttgart","Bundesliga","Sasa Kalajdzic","AUT","FW","24",1997,13.6,10,6,2,5,3,3,11,27.3,8,5,0,5,2,12,14,0,"https://fbref.com/en/players/15f24fe7/Sasa-Kalajdzic"
"10751","Atakan Karazor_2022",2022,"Stuttgart","Bundesliga","Atakan Karazor","GER","MF","24",1996,21.1,48,24,18,27,3,18,36,50,18,37,14,23,34,82,47,0,"https://fbref.com/en/players/5762be5c/Atakan-Karazor"
"10752","Silas Katompa_2022",2022,"Stuttgart","Bundesliga","Silas Katompa","COD","FW,MF","22",1998,3.1,5,4,4,0,1,3,7,42.9,4,5,0,5,2,7,1,0,"https://fbref.com/en/players/de4cac2d/Silas-Katompa"
"10753","Marc-Oliver Kempf_2022",2022,"Stuttgart","Bundesliga","Marc-Oliver Kempf","GER","DF","26",1995,9.3,13,8,7,4,2,3,10,30,7,16,14,2,16,29,26,2,"https://fbref.com/en/players/815c314f/Marc-Oliver-Kempf"
"10754","Philipp Klement_2022",2022,"Stuttgart","Bundesliga","Philipp Klement","GER","MF","28",1992,3.8,7,3,1,4,2,3,3,100,0,6,1,5,1,8,0,0,"https://fbref.com/en/players/0cddeaa7/Philipp-Klement"
"10755","Mateo Klimowicz_2022",2022,"Stuttgart","Bundesliga","Mateo Klimowicz","GER","MF,FW","21",2000,6.7,13,6,6,7,0,5,16,31.3,11,2,0,2,4,17,3,0,"https://fbref.com/en/players/2b7c56b4/Mateo-Klimowicz"
"10756","Matej Maglica_2022",2022,"Stuttgart","Bundesliga","Matej Maglica","CRO","MF","22",1998,0.1,0,0,0,0,0,0,1,0,1,0,0,0,0,0,0,0,"https://fbref.com/en/players/36cf2caf/Matej-Maglica"
"10757","Orel Mangala_2022",2022,"Stuttgart","Bundesliga","Orel Mangala","BEL","MF","23",1998,20.6,17,10,5,7,5,11,22,50,11,11,4,7,12,29,19,1,"https://fbref.com/en/players/a572e291/Orel-Mangala"
"10758","Omar Marmoush_2022",2022,"Stuttgart","Bundesliga","Omar Marmoush","EGY","FW","22",1999,17.5,26,17,6,14,6,4,20,20,16,9,1,8,7,33,6,0,"https://fbref.com/en/players/0e0102eb/Omar-Marmoush"
"10759","Roberto Massimo_2022",2022,"Stuttgart","Bundesliga","Roberto Massimo","GER","DF,FW","20",2000,9.7,14,5,6,7,1,4,16,25,12,9,0,9,3,17,6,0,"https://fbref.com/en/players/fc62fdf4/Roberto-Massimo"
"10760","Konstantinos Mavropanos_2022",2022,"Stuttgart","Bundesliga","Konstantinos Mavropanos","GRE","DF","23",1997,30.1,57,39,35,21,1,30,51,58.8,21,46,23,23,69,126,174,2,"https://fbref.com/en/players/00963611/Konstantinos-Mavropanos"
"10761","Enzo Millot_2022",2022,"Stuttgart","Bundesliga","Enzo Millot","FRA","MF","19",2002,0.6,2,0,0,2,0,0,1,0,1,0,0,0,1,3,1,0,"https://fbref.com/en/players/f76022e7/Enzo-Millot"
"10762","Clinton Mola_2022",2022,"Stuttgart","Bundesliga","Clinton Mola","ENG","DF","20",2001,1.3,3,1,2,1,0,2,4,50,2,5,5,0,3,6,2,0,"https://fbref.com/en/players/29ddfb9c/Clinton-Mola"
"10763","Florian Müller_2022",2022,"Stuttgart","Bundesliga","Florian Müller","GER","GK","23",1997,30,0,0,0,0,0,0,1,0,1,1,0,1,0,0,13,2,"https://fbref.com/en/players/cbac6ec9/Florian-Muller"
"10764","Nikolas Nartey_2022",2022,"Stuttgart","Bundesliga","Nikolas Nartey","DEN","MF,DF","21",2000,4.5,6,3,0,5,1,3,9,33.3,6,4,2,2,7,13,5,0,"https://fbref.com/en/players/30261ba1/Nikolas-Nartey"
"10765","Mohamed Sankoh_2022",2022,"Stuttgart","Bundesliga","Mohamed Sankoh","NED","FW","17",2003,0,0,0,0,0,0,0,0,NA,0,0,0,0,0,0,0,0,"https://fbref.com/en/players/be625686/Mohamed-Sankoh"
"10766","Borna Sosa_2022",2022,"Stuttgart","Bundesliga","Borna Sosa","CRO","DF,FW","23",1998,27.8,22,12,14,5,3,12,26,46.2,14,30,3,27,26,48,61,0,"https://fbref.com/en/players/af0d79a9/Borna-Sosa"
"10767","Pascal Stenzel_2022",2022,"Stuttgart","Bundesliga","Pascal Stenzel","GER","DF","25",1996,10,24,11,15,5,4,17,33,51.5,16,13,3,10,11,35,25,0,"https://fbref.com/en/players/99f7e9aa/Pascal-Stenzel"
"10768","Erik Thommy_2022",2022,"Stuttgart","Bundesliga","Erik Thommy","GER","FW,MF","26",1994,3,2,0,0,2,0,1,2,50,1,3,0,3,4,6,0,0,"https://fbref.com/en/players/df8e7b62/Erik-Thommy"
"10769","Alexis Tibidi_2022",2022,"Stuttgart","Bundesliga","Alexis Tibidi","FRA","MF,FW","17",2003,4.3,7,3,1,3,3,3,4,75,1,4,0,4,3,10,2,0,"https://fbref.com/en/players/ca6f4846/Alexis-Tibidi"
"10770","Tiago Tomás_2022",2022,"Stuttgart","Bundesliga","Tiago Tomás","POR","FW","19",2002,11.9,8,4,0,7,1,0,6,0,6,3,0,3,4,12,1,0,"https://fbref.com/en/players/b492126a/Tiago-Tomas"
"10771","Ola Aina_2022",2022,"Torino","Serie A","Ola Aina","NGA","DF","24",1996,16,27,19,11,10,6,15,23,65.2,8,17,3,14,28,55,30,0,"https://fbref.com/en/players/246d153b/Ola-Aina"
"10772","Cristian Ansaldi_2022",2022,"Torino","Serie A","Cristian Ansaldi","ARG","DF","34",1986,7.7,20,9,11,7,2,10,13,76.9,3,9,1,8,6,26,10,0,"https://fbref.com/en/players/bbafc0c4/Cristian-Ansaldi"
"10773","Daniele Baselli_2022",2022,"Torino","Serie A","Daniele Baselli","ITA","MF,FW","29",1992,1.7,3,3,2,0,1,2,6,33.3,4,0,0,0,1,4,2,0,"https://fbref.com/en/players/ea06dd97/Daniele-Baselli"
"10774","Andrea Belotti_2022",2022,"Torino","Serie A","Andrea Belotti","ITA","FW","27",1993,15.2,7,3,2,2,3,3,12,25,9,12,4,8,2,9,9,0,"https://fbref.com/en/players/d705ba44/Andrea-Belotti"
"10775","Etrit Berisha_2022",2022,"Torino","Serie A","Etrit Berisha","ALB","GK","32",1989,10,0,0,0,0,0,0,0,NA,0,0,0,0,0,0,4,0,"https://fbref.com/en/players/ee833569/Etrit-Berisha"
"10776","Josip Brekalo_2022",2022,"Torino","Serie A","Josip Brekalo","CRO","MF","23",1998,25.4,9,5,5,1,3,3,21,14.3,18,16,1,15,4,13,7,1,"https://fbref.com/en/players/d4a2533d/Josip-Brekalo"
"10777","Gleison Bremer_2022",2022,"Torino","Serie A","Gleison Bremer","BRA","DF","24",1997,32.1,49,24,27,22,0,18,28,64.3,10,54,23,31,105,154,137,0,"https://fbref.com/en/players/5fd5ed86/Gleison-Bremer"
"10778","Alessandro Buongiorno_2022",2022,"Torino","Serie A","Alessandro Buongiorno","ITA","DF","22",1999,13.1,20,9,9,8,3,9,13,69.2,4,12,6,6,31,51,44,0,"https://fbref.com/en/players/4ae67f27/Alessandro-Buongiorno"
"10779","Koffi Djidji_2022",2022,"Torino","Serie A","Koffi Djidji","CIV","DF","28",1992,19.3,48,29,21,23,4,14,18,77.8,4,20,9,11,34,82,60,0,"https://fbref.com/en/players/933d3b51/Koffi-Djidji"
"10780","Luca Gemello_2022",2022,"Torino","Serie A","Luca Gemello","ITA","GK","21",2000,1,0,0,0,0,0,0,0,NA,0,0,0,0,0,0,0,0,"https://fbref.com/en/players/53e494ec/Luca-Gemello"
"10781","Armando Izzo_2022",2022,"Torino","Serie A","Armando Izzo","ITA","DF","29",1992,5.8,16,9,14,2,0,9,11,81.8,2,5,4,1,17,33,21,0,"https://fbref.com/en/players/89976232/Armando-Izzo"
"10782","Ben Lhassine Kone_2022",2022,"Torino","Serie A","Ben Lhassine Kone","CIV","MF","21",2000,0.9,3,3,1,2,0,1,2,50,1,0,0,0,1,4,1,0,"https://fbref.com/en/players/7452c7a8/Ben-Lhassine-Kone"
"10783","Karol Linetty_2022",2022,"Torino","Serie A","Karol Linetty","POL","MF,FW","26",1995,10,14,8,3,4,7,6,18,33.3,12,8,0,8,3,17,2,0,"https://fbref.com/en/players/d023d70f/Karol-Linetty"
"10784","Saša Lukić_2022",2022,"Torino","Serie A","Saša Lukić","SRB","MF","24",1996,33.1,51,34,17,27,7,19,43,44.2,24,34,6,28,24,75,41,0,"https://fbref.com/en/players/c6e8cf1f/Sasa-Lukic"
"10785","Rolando Mandragora_2022",2022,"Torino","Serie A","Rolando Mandragora","ITA","MF","24",1997,14.7,21,10,3,16,2,12,21,57.1,9,18,4,14,10,31,13,0,"https://fbref.com/en/players/c7259b83/Rolando-Mandragora"
"10786","Vanja Milinković-Savić_2022",2022,"Torino","Serie A","Vanja Milinković-Savić","SRB","GK","24",1997,27,0,0,0,0,0,0,1,0,1,0,0,0,0,0,7,2,"https://fbref.com/en/players/9fa26bc2/Vanja-Milinkovic-Savic"
"10787","Pietro Pellegri_2022",2022,"Torino","Serie A","Pietro Pellegri","ITA","FW","20",2001,2.4,1,1,0,1,0,0,4,0,4,0,0,0,0,1,5,0,"https://fbref.com/en/players/a44d3a3c/Pietro-Pellegri"
"10788","Marko Pjaca_2022",2022,"Torino","Serie A","Marko Pjaca","CRO","MF","26",1995,12.8,7,4,1,4,2,3,8,37.5,5,10,2,8,4,11,2,0,"https://fbref.com/en/players/2c38b327/Marko-Pjaca"
"10789","Tommaso Pobega_2022",2022,"Torino","Serie A","Tommaso Pobega","ITA","MF","22",1999,24.9,48,30,17,20,11,21,40,52.5,19,32,3,29,25,73,38,0,"https://fbref.com/en/players/55a1cac2/Tommaso-Pobega"
"10790","Dennis Praet_2022",2022,"Torino","Serie A","Dennis Praet","BEL","MF","27",1994,17.1,19,10,6,8,5,8,22,36.4,14,12,1,11,3,22,4,0,"https://fbref.com/en/players/86695068/Dennis-Praet"
"10791","Samuele Ricci_2022",2022,"Torino","Serie A","Samuele Ricci","ITA","MF","19",2001,8,8,4,4,2,2,2,5,40,3,7,1,6,14,22,9,0,"https://fbref.com/en/players/9823be92/Samuele-Ricci"
"10792","Tomás Rincón_2022",2022,"Torino","Serie A","Tomás Rincón","VEN","MF","33",1988,1.8,2,2,2,0,0,0,3,0,3,3,1,2,2,4,4,0,"https://fbref.com/en/players/f1cfc209/Tomas-Rincon"
"10793","Ricardo Rodríguez_2022",2022,"Torino","Serie A","Ricardo Rodríguez","SUI","DF","28",1992,27.5,36,21,11,23,2,18,33,54.5,15,22,8,14,41,77,48,1,"https://fbref.com/en/players/7f78ad23/Ricardo-Rodriguez"
"10794","Antonio Sanabria_2022",2022,"Torino","Serie A","Antonio Sanabria","PAR","FW","25",1996,20,3,2,0,1,2,1,4,25,3,11,4,7,2,5,10,0,"https://fbref.com/en/players/0a447501/Antonio-Sanabria"
"10795","Demba Seck_2022",2022,"Torino","Serie A","Demba Seck","SEN","MF,FW","20",2001,1.6,2,1,0,2,0,0,0,NA,0,0,0,0,0,2,0,0,"https://fbref.com/en/players/16463a79/Demba-Seck"
"10796","Wilfried Singo_2022",2022,"Torino","Serie A","Wilfried Singo","CIV","DF","20",2000,29,55,35,24,24,7,24,34,70.6,10,26,6,20,23,78,47,0,"https://fbref.com/en/players/8b609c34/Wilfried-Singo"
"10797","Simone Verdi_2022",2022,"Torino","Serie A","Simone Verdi","ITA","MF,FW","29",1992,0.5,1,1,0,1,0,0,0,NA,0,0,0,0,0,1,0,0,"https://fbref.com/en/players/0375723e/Simone-Verdi"
"10798","Mërgim Vojvoda_2022",2022,"Torino","Serie A","Mërgim Vojvoda","KVX","DF","26",1995,22,38,23,23,11,4,20,36,55.6,16,27,8,19,20,58,51,0,"https://fbref.com/en/players/be2706c0/Mergim-Vojvoda"
"10799","Magnus Warming_2022",2022,"Torino","Serie A","Magnus Warming","DEN","MF,FW","21",2000,0.6,1,1,0,1,0,0,0,NA,0,2,0,2,0,1,0,0,"https://fbref.com/en/players/55e098cd/Magnus-Warming"
"10800","Simone Zaza_2022",2022,"Torino","Serie A","Simone Zaza","ITA","FW,DF","30",1991,1.4,2,2,1,1,0,1,1,100,0,3,0,3,0,2,3,0,"https://fbref.com/en/players/9592289a/Simone-Zaza"
"10801","David Zima_2022",2022,"Torino","Serie A","David Zima","CZE","DF","20",2000,14.6,20,12,8,11,1,9,20,45,11,15,13,2,23,43,42,0,"https://fbref.com/en/players/acf7e795/David-Zima"
"10802","Dele Alli_2022",2022,"Tottenham","Premier League","Dele Alli","ENG","MF","25",1996,7.3,14,8,10,3,1,5,17,29.4,12,22,5,17,6,20,16,0,"https://fbref.com/en/players/cea4ee8f/Dele-Alli"
"10803","Rodrigo Bentancur_2022",2022,"Tottenham","Premier League","Rodrigo Bentancur","URU","MF","24",1997,15.1,36,18,14,14,8,16,32,50,16,24,9,15,20,56,35,0,"https://fbref.com/en/players/3b8674e6/Rodrigo-Bentancur"
"10804","Steven Bergwijn_2022",2022,"Tottenham","Premier League","Steven Bergwijn","NED","FW,MF","23",1997,6.3,3,2,2,1,0,1,10,10,9,3,0,3,1,4,8,0,"https://fbref.com/en/players/a29b1131/Steven-Bergwijn"
"10805","Ben Davies_2022",2022,"Tottenham","Premier League","Ben Davies","WAL","DF","28",1993,28.2,36,21,20,12,4,13,26,50,13,32,19,13,30,66,75,1,"https://fbref.com/en/players/44781702/Ben-Davies"
"10806","Eric Dier_2022",2022,"Tottenham","Premier League","Eric Dier","ENG","DF","27",1994,34.1,15,9,6,8,1,7,14,50,7,37,32,5,27,42,142,1,"https://fbref.com/en/players/ac861941/Eric-Dier"
"10807","Matt Doherty_2022",2022,"Tottenham","Premier League","Matt Doherty","IRL","DF","29",1992,9.7,18,12,5,11,2,8,14,57.1,6,11,2,9,13,31,20,0,"https://fbref.com/en/players/d557d734/Matt-Doherty"
"10808","Emerson_2022",2022,"Tottenham","Premier League","Emerson","BRA","DF,MF","22",1999,25.4,72,47,50,16,6,36,67,53.7,31,25,2,23,22,94,92,1,"https://fbref.com/en/players/df8b52a5/Emerson"
"10809","Bryan Gil_2022",2022,"Tottenham","Premier League","Bryan Gil","ESP","FW,MF","20",2001,1,3,0,1,0,2,1,2,50,1,2,0,2,0,3,0,0,"https://fbref.com/en/players/7b5ab7f2/Bryan-Gil"
"10810","Son Heung-min_2022",2022,"Tottenham","Premier League","Son Heung-min","KOR","MF,FW","29",1992,33.4,15,6,5,7,3,5,23,21.7,18,27,6,21,13,28,8,0,"https://fbref.com/en/players/92e7e919/Son-Heung-min"
"10811","Pierre Højbjerg_2022",2022,"Tottenham","Premier League","Pierre Højbjerg","DEN","MF","25",1995,35.5,78,45,31,38,9,38,85,44.7,47,61,13,48,48,126,54,0,"https://fbref.com/en/players/8b04d6c1/Pierre-Hojbjerg"
"10812","Harry Kane_2022",2022,"Tottenham","Premier League","Harry Kane","ENG","FW","28",1993,35.9,15,5,2,10,3,7,18,38.9,11,26,8,18,3,18,39,0,"https://fbref.com/en/players/21a66f6a/Harry-Kane"
"10813","Dejan Kulusevski_2022",2022,"Tottenham","Premier League","Dejan Kulusevski","SWE","MF,FW","21",2000,14,19,13,7,10,2,5,23,21.7,18,14,0,14,13,32,3,0,"https://fbref.com/en/players/df3cda47/Dejan-Kulusevski"
"10814","Hugo Lloris_2022",2022,"Tottenham","Premier League","Hugo Lloris","FRA","GK","34",1986,38,1,1,1,0,0,1,2,50,1,0,0,0,1,2,24,3,"https://fbref.com/en/players/8f62b6ee/Hugo-Lloris"
"10815","Giovani Lo Celso_2022",2022,"Tottenham","Premier League","Giovani Lo Celso","ARG","MF,FW","25",1996,2.6,8,4,4,2,2,4,10,40,6,6,1,5,1,9,0,1,"https://fbref.com/en/players/d7553721/Giovani-Lo-Celso"
"10816","Lucas Moura_2022",2022,"Tottenham","Premier League","Lucas Moura","BRA","FW,MF","28",1992,19.7,25,10,7,14,4,8,35,22.9,27,19,0,19,18,43,19,0,"https://fbref.com/en/players/2b622f01/Lucas-Moura"
"10817","Tanguy Ndombele_2022",2022,"Tottenham","Premier League","Tanguy Ndombele","FRA","MF","24",1996,5.4,10,7,3,5,2,1,8,12.5,7,5,0,5,1,11,1,0,"https://fbref.com/en/players/5cdddffa/Tanguy-Ndombele"
"10818","Sergio Reguilón_2022",2022,"Tottenham","Premier League","Sergio Reguilón","ESP","DF,MF","24",1996,21.3,40,24,15,18,7,22,43,51.2,21,20,8,12,31,71,45,1,"https://fbref.com/en/players/3353737a/Sergio-Reguilon"
"10819","Joe Rodon_2022",2022,"Tottenham","Premier League","Joe Rodon","WAL","DF","23",1997,1,0,0,0,0,0,0,0,NA,0,2,1,1,0,0,7,0,"https://fbref.com/en/players/8d62d31a/Joe-Rodon"
"10820","Cristian Romero_2022",2022,"Tottenham","Premier League","Cristian Romero","ARG","DF","23",1998,20.5,62,39,39,21,2,22,34,64.7,12,46,21,25,33,95,74,1,"https://fbref.com/en/players/a3d94a58/Cristian-Romero"
"10821","Davinson Sánchez_2022",2022,"Tottenham","Premier League","Davinson Sánchez","COL","DF","25",1996,18.1,41,22,25,14,2,19,28,67.9,9,24,16,8,30,71,54,3,"https://fbref.com/en/players/da7b447d/Davinson-Sanchez"
"10822","Dane Scarlett_2022",2022,"Tottenham","Premier League","Dane Scarlett","ENG","MF","17",2004,0,0,0,0,0,0,0,0,NA,0,0,0,0,0,0,0,0,"https://fbref.com/en/players/21945a9e/Dane-Scarlett"
"10823","Ryan Sessegnon_2022",2022,"Tottenham","Premier League","Ryan Sessegnon","ENG","DF,MF","21",2000,11.6,25,19,14,7,4,11,22,50,11,18,3,15,7,32,26,0,"https://fbref.com/en/players/6aa3e78b/Ryan-Sessegnon"
"10824","Oliver Skipp_2022",2022,"Tottenham","Premier League","Oliver Skipp","ENG","MF","20",2000,15,33,19,14,18,1,15,31,48.4,16,19,7,12,12,45,10,1,"https://fbref.com/en/players/6250083a/Oliver-Skipp"
"10825","Japhet Tanganga_2022",2022,"Tottenham","Premier League","Japhet Tanganga","ENG","DF","22",1999,8.2,14,8,7,6,1,9,19,47.4,10,13,5,8,9,23,31,0,"https://fbref.com/en/players/e9971f2d/Japhet-Tanganga"
"10826","Harry Winks_2022",2022,"Tottenham","Premier League","Harry Winks","ENG","MF","25",1996,10.1,15,10,4,9,2,8,21,38.1,13,14,3,11,16,31,10,2,"https://fbref.com/en/players/2f7acede/Harry-Winks"
"10827","Karim Azamoum_2022",2022,"Troyes","Ligue 1","Karim Azamoum","FRA","DF","31",1990,4.3,6,5,4,2,0,3,5,60,2,4,2,2,1,7,10,0,"https://fbref.com/en/players/eaf71a5e/Karim-Azamoum"
"10828","Giulian Biancone_2022",2022,"Troyes","Ligue 1","Giulian Biancone","FRA","DF,MF","21",2000,25.5,70,42,44,22,4,40,69,58,29,23,8,15,53,123,71,1,"https://fbref.com/en/players/de40e38c/Giulian-Biancone"
"10829","Mamadou Camara_2022",2022,"Troyes","Ligue 1","Mamadou Camara","FRA","FW","20",2001,0.4,1,1,1,0,0,0,0,NA,0,0,0,0,0,1,0,0,"https://fbref.com/en/players/316e70c7/Mamadou-Camara"
"10830","Nassim Chadli_2022",2022,"Troyes","Ligue 1","Nassim Chadli","FRA","MF,DF","20",2001,1.1,5,3,3,0,2,2,4,50,2,1,0,1,0,5,0,0,"https://fbref.com/en/players/5c61496e/Nassim-Chadli"
"10831","Dylan Chambost_2022",2022,"Troyes","Ligue 1","Dylan Chambost","FRA","MF,FW","23",1997,8.4,16,11,6,9,1,4,25,16,21,9,2,7,8,24,4,0,"https://fbref.com/en/players/dbde4959/Dylan-Chambost"
"10832","Xavier Chavalerin_2022",2022,"Troyes","Ligue 1","Xavier Chavalerin","FRA","MF","30",1991,30.2,49,26,19,25,5,12,55,21.8,43,32,5,27,39,88,36,0,"https://fbref.com/en/players/279ddf6a/Xavier-Chavalerin"
"10833","Abdu Conté_2022",2022,"Troyes","Ligue 1","Abdu Conté","POR","DF","23",1998,15,22,12,16,5,1,12,24,50,12,12,2,10,4,26,10,0,"https://fbref.com/en/players/cfa49cc1/Abdu-Conte"
"10834","Tristan Dingomé_2022",2022,"Troyes","Ligue 1","Tristan Dingomé","CMR","MF,FW","30",1991,12,23,11,10,12,1,10,18,55.6,8,7,1,6,9,32,3,0,"https://fbref.com/en/players/92b56413/Tristan-Dingome"
"10835","Brandon Domingues_2022",2022,"Troyes","Ligue 1","Brandon Domingues","FRA","MF,FW","21",2000,2.6,6,2,2,4,0,2,3,66.7,1,3,0,3,3,9,0,0,"https://fbref.com/en/players/2a00c6c0/Brandon-Domingues"
"10836","Gauthier Gallon_2022",2022,"Troyes","Ligue 1","Gauthier Gallon","FRA","GK","28",1993,31,3,0,3,0,0,1,1,100,0,0,0,0,2,5,12,1,"https://fbref.com/en/players/db3164e1/Gauthier-Gallon"
"10837","Jimmy Giraudon_2022",2022,"Troyes","Ligue 1","Jimmy Giraudon","FRA","DF","29",1992,18,14,6,10,4,0,7,22,31.8,15,24,14,10,37,51,68,1,"https://fbref.com/en/players/6ba71da5/Jimmy-Giraudon"
"10838","Oualid El Hajjam_2022",2022,"Troyes","Ligue 1","Oualid El Hajjam","MAR","DF","30",1991,11.9,22,11,12,6,4,15,23,65.2,8,12,6,6,22,44,28,0,"https://fbref.com/en/players/9f29c204/Oualid-El-Hajjam"
"10839","Suk Hyun-jun_2022",2022,"Troyes","Ligue 1","Suk Hyun-jun","KOR","FW,MF","30",1991,1.7,0,0,0,0,0,0,0,NA,0,2,0,2,0,0,2,0,"https://fbref.com/en/players/7ffaf233/Suk-Hyun-jun"
"10840","Issa Kaboré_2022",2022,"Troyes","Ligue 1","Issa Kaboré","BFA","DF","20",2001,25,45,22,22,14,9,20,38,52.6,18,27,2,25,20,65,38,1,"https://fbref.com/en/players/c066d1a5/Issa-Kabore"
"10841","Youssouf Koné_2022",2022,"Troyes","Ligue 1","Youssouf Koné","MLI","DF","26",1995,10.9,30,18,21,8,1,19,30,63.3,11,8,3,5,10,40,25,0,"https://fbref.com/en/players/e6eadfb8/Youssouf-Kone"
"10842","Rominigue Kouamé_2022",2022,"Troyes","Ligue 1","Rominigue Kouamé","MLI","MF","24",1996,33,47,22,24,20,3,19,58,32.8,39,33,5,28,46,93,22,2,"https://fbref.com/en/players/86a2ba20/Rominigue-Kouame"
"10843","Mykola Kukharevych_2022",2022,"Troyes","Ligue 1","Mykola Kukharevych","UKR","FW","20",2001,0.2,0,0,0,0,0,0,0,NA,0,0,0,0,0,0,0,0,"https://fbref.com/en/players/8197a269/Mykola-Kukharevych"
"10844","Yasser Larouci_2022",2022,"Troyes","Ligue 1","Yasser Larouci","FRA","DF","20",2001,3.8,6,5,2,4,0,3,3,100,0,1,0,1,7,13,5,0,"https://fbref.com/en/players/0ed063d6/Yasser-Larouci"
"10845","Levi Lumeka_2022",2022,"Troyes","Ligue 1","Levi Lumeka","ENG","MF,FW","22",1998,0.7,0,0,0,0,0,0,2,0,2,0,0,0,0,0,2,0,"https://fbref.com/en/players/199ff86e/Levi-Lumeka"
"10846","Derek Mazou-Sacko_2022",2022,"Troyes","Ligue 1","Derek Mazou-Sacko","FRA","FW,DF","16",2004,0,1,0,0,0,1,1,1,100,0,0,0,0,0,1,1,0,"https://fbref.com/en/players/810edef9/Derek-Mazou-Sacko"
"10847","Lebo Mothiba_2022",2022,"Troyes","Ligue 1","Lebo Mothiba","RSA","FW,MF","25",1996,5.8,8,4,4,3,1,2,5,40,3,3,0,3,2,10,0,0,"https://fbref.com/en/players/3eaf8817/Lebo-Mothiba"
"10848","Jessy Moulin_2022",2022,"Troyes","Ligue 1","Jessy Moulin","FRA","GK","35",1986,7,0,0,0,0,0,0,0,NA,0,0,0,0,1,1,7,0,"https://fbref.com/en/players/28a65a2c/Jessy-Moulin"
"10849","Eric N'Jo_2022",2022,"Troyes","Ligue 1","Eric N'Jo","FRA","DF","17",2004,1.1,0,0,0,0,0,0,1,0,1,1,1,0,2,2,1,0,"https://fbref.com/en/players/b85e57bb/Eric-NJo"
"10850","Erik Palmer-Brown_2022",2022,"Troyes","Ligue 1","Erik Palmer-Brown","USA","DF","24",1997,19.3,37,22,29,8,0,20,26,76.9,6,26,18,8,34,71,87,1,"https://fbref.com/en/players/e5c1e0ca/Erik-Palmer-Brown"
"10851","Adil Rami_2022",2022,"Troyes","Ligue 1","Adil Rami","FRA","DF","35",1985,13,10,9,6,4,0,7,8,87.5,1,17,9,8,16,26,43,0,"https://fbref.com/en/players/8dbff17c/Adil-Rami"
"10852","Renaud Ripart_2022",2022,"Troyes","Ligue 1","Renaud Ripart","FRA","MF,FW","28",1993,21,38,21,18,15,5,18,50,36,32,21,1,20,19,57,21,1,"https://fbref.com/en/players/beae3a73/Renaud-Ripart"
"10853","Patrick Roberts_2022",2022,"Troyes","Ligue 1","Patrick Roberts","ENG","MF","24",1997,0.2,0,0,0,0,0,0,0,NA,0,0,0,0,0,0,0,0,"https://fbref.com/en/players/59d93937/Patrick-Roberts"
"10854","Gerson Rodrigues_2022",2022,"Troyes","Ligue 1","Gerson Rodrigues","LUX","FW,MF","26",1995,9.4,12,9,2,6,4,1,17,5.9,16,8,1,7,0,12,2,0,"https://fbref.com/en/players/3814b753/Gerson-Rodrigues"
"10855","Yoann Salmier_2022",2022,"Troyes","Ligue 1","Yoann Salmier","GUF","DF","28",1992,29.6,58,33,44,11,3,26,34,76.5,8,30,14,16,40,98,94,0,"https://fbref.com/en/players/c3725db2/Yoann-Salmier"
"10856","Mama Samba Baldé_2022",2022,"Troyes","Ligue 1","Mama Samba Baldé","GNB","MF,FW","25",1995,19.1,40,28,16,14,10,8,26,30.8,18,32,1,31,5,45,9,0,"https://fbref.com/en/players/fb14aa28/Mama-Samba-Balde"
"10857","Philippe Sandler_2022",2022,"Troyes","Ligue 1","Philippe Sandler","NED","DF","24",1997,0.8,0,0,0,0,0,0,0,NA,0,1,1,0,3,3,6,0,"https://fbref.com/en/players/60740e70/Philippe-Sandler"
"10858","Florian Tardieu_2022",2022,"Troyes","Ligue 1","Florian Tardieu","FRA","MF","29",1992,29.2,58,25,31,21,6,31,71,43.7,40,31,9,22,42,100,38,0,"https://fbref.com/en/players/ed39121c/Florian-Tardieu"
"10859","Yoann Touzghar_2022",2022,"Troyes","Ligue 1","Yoann Touzghar","TUN","FW","34",1986,16.2,5,2,1,3,1,1,3,33.3,2,3,1,2,3,8,8,0,"https://fbref.com/en/players/4e47507a/Yoann-Touzghar"
"10860","Ike Ugbo_2022",2022,"Troyes","Ligue 1","Ike Ugbo","CAN","FW","22",1998,9,3,1,0,1,2,0,1,0,1,4,1,3,2,5,1,0,"https://fbref.com/en/players/8a53d24b/Ike-Ugbo"
"10861","Tanguy Zoukrou_2022",2022,"Troyes","Ligue 1","Tanguy Zoukrou","FRA","DF","18",2003,0.9,1,0,1,0,0,1,2,50,1,0,0,0,0,1,2,0,"https://fbref.com/en/players/aefa3050/Tanguy-Zoukrou"
"10862","Tolgay Arslan_2022",2022,"Udinese","Serie A","Tolgay Arslan","GER","MF","30",1990,18.4,35,20,15,16,4,19,50,38,31,17,4,13,13,48,23,1,"https://fbref.com/en/players/963a328b/Tolgay-Arslan"
"10863","Rodrigo Becão_2022",2022,"Udinese","Serie A","Rodrigo Becão","BRA","DF","25",1996,34.8,81,46,49,30,2,34,60,56.7,26,45,20,25,42,123,89,3,"https://fbref.com/en/players/19e4eab9/Rodrigo-Becao"
"10864","Filip Benković_2022",2022,"Udinese","Serie A","Filip Benković","CRO","DF,FW","24",1997,0.1,0,0,0,0,0,0,0,NA,0,0,0,0,0,0,0,0,"https://fbref.com/en/players/305a3820/Filip-Benkovic"
"10865","Beto_2022",2022,"Udinese","Serie A","Beto","GNB","FW","23",1998,24.1,21,6,2,14,5,9,19,47.4,10,16,1,15,5,26,25,1,"https://fbref.com/en/players/ed5c0319/Beto"
"10866","Sebastien De Maio_2022",2022,"Udinese","Serie A","Sebastien De Maio","FRA","DF","34",1987,2,5,1,4,1,0,1,9,11.1,8,6,5,1,1,6,9,0,"https://fbref.com/en/players/952a03fe/Sebastien-De-Maio"
"10867","Gerard Deulofeu_2022",2022,"Udinese","Serie A","Gerard Deulofeu","ESP","FW,MF","27",1994,29.1,11,6,2,3,6,7,29,24.1,22,14,0,14,9,20,4,0,"https://fbref.com/en/players/39583cfd/Gerard-Deulofeu"
"10868","Fernando Forestieri_2022",2022,"Udinese","Serie A","Fernando Forestieri","ITA","FW,MF","31",1990,0.6,0,0,0,0,0,0,1,0,1,1,0,1,0,0,1,0,"https://fbref.com/en/players/d60c26fc/Fernando-Forestieri"
"10869","Mato Jajalo_2022",2022,"Udinese","Serie A","Mato Jajalo","BIH","MF","33",1988,7,24,14,14,7,3,11,23,47.8,12,7,0,7,11,35,5,0,"https://fbref.com/en/players/8c65eb5f/Mato-Jajalo"
"10870","Jean-Victor Makengo_2022",2022,"Udinese","Serie A","Jean-Victor Makengo","FRA","MF","23",1998,26.1,30,21,7,17,6,15,29,51.7,14,26,6,20,19,49,17,0,"https://fbref.com/en/players/22bfb57e/Jean-Victor-Makengo"
"10871","Pablo Marí_2022",2022,"Udinese","Serie A","Pablo Marí","ESP","DF","27",1993,14.9,16,8,8,6,2,8,16,50,8,18,12,6,21,37,72,0,"https://fbref.com/en/players/aa54ec6f/Pablo-Mari"
"10872","Nahuel Molina_2022",2022,"Udinese","Serie A","Nahuel Molina","ARG","DF","23",1998,29.3,41,24,17,21,3,16,48,33.3,32,24,3,21,22,63,44,2,"https://fbref.com/en/players/23610943/Nahuel-Molina"
"10873","Ilija Nestorovski_2022",2022,"Udinese","Serie A","Ilija Nestorovski","MKD","FW","31",1990,2.1,0,0,0,0,0,0,3,0,3,0,0,0,0,0,4,0,"https://fbref.com/en/players/b1236c63/Ilija-Nestorovski"
"10874","Bram Nuytinck_2022",2022,"Udinese","Serie A","Bram Nuytinck","NED","DF","31",1990,22.6,38,24,24,13,1,15,34,44.1,19,42,31,11,22,60,101,0,"https://fbref.com/en/players/e33f36d5/Bram-Nuytinck"
"10875","Stefano Okaka_2022",2022,"Udinese","Serie A","Stefano Okaka","ITA","FW","31",1989,0.2,0,0,0,0,0,0,0,NA,0,2,0,2,0,0,1,0,"https://fbref.com/en/players/601ef102/Stefano-Okaka"
"10876","Daniele Padelli_2022",2022,"Udinese","Serie A","Daniele Padelli","ITA","GK","35",1985,3,0,0,0,0,0,0,0,NA,0,0,0,0,0,0,2,1,"https://fbref.com/en/players/cf1c23d8/Daniele-Padelli"
"10877","Simone Pafundi_2022",2022,"Udinese","Serie A","Simone Pafundi","ITA","FW","15",2006,0.3,0,0,0,0,0,0,1,0,1,0,0,0,0,0,0,0,"https://fbref.com/en/players/8daee720/Simone-Pafundi"
"10878","Roberto Pereyra_2022",2022,"Udinese","Serie A","Roberto Pereyra","ARG","MF,FW","30",1991,19.9,18,12,7,6,5,7,23,30.4,16,26,5,21,12,30,11,0,"https://fbref.com/en/players/75f2c59f/Roberto-Pereyra"
"10879","Nehuén Pérez_2022",2022,"Udinese","Serie A","Nehuén Pérez","ARG","DF","21",2000,18.8,44,21,21,21,2,16,25,64,9,27,9,18,21,65,47,0,"https://fbref.com/en/players/f7c491f1/Nehuen-Perez"
"10880","Riccardo Pinzi_2022",2022,"Udinese","Serie A","Riccardo Pinzi","ITA","FW","17",2003,0,0,0,0,0,0,0,0,NA,0,0,0,0,0,0,0,0,"https://fbref.com/en/players/5dafcdce/Riccardo-Pinzi"
"10881","Ignacio Pussetto_2022",2022,"Udinese","Serie A","Ignacio Pussetto","ARG","FW,MF","25",1995,13.4,17,9,2,9,6,2,10,20,8,18,2,16,4,21,13,0,"https://fbref.com/en/players/62437b4f/Ignacio-Pussetto"
"10882","Lazar Samardzic_2022",2022,"Udinese","Serie A","Lazar Samardzic","SRB","MF,FW","19",2002,5.4,13,9,4,7,2,7,26,26.9,19,6,0,6,2,15,2,0,"https://fbref.com/en/players/217c93a1/Lazar-Samardzic"
"10883","Samir Santos_2022",2022,"Udinese","Serie A","Samir Santos","BRA","DF","26",1994,15.8,36,16,22,13,1,15,25,60,10,21,7,14,42,78,62,0,"https://fbref.com/en/players/92b4758e/Samir-Santos"
"10884","Marco Silvestri_2022",2022,"Udinese","Serie A","Marco Silvestri","ITA","GK","30",1991,35,0,0,0,0,0,0,1,0,1,0,0,0,1,1,11,1,"https://fbref.com/en/players/0d422df7/Marco-Silvestri"
"10885","Brandon Soppy_2022",2022,"Udinese","Serie A","Brandon Soppy","FRA","DF,MF","19",2002,8.6,20,9,8,10,2,11,16,68.8,5,10,2,8,5,25,9,1,"https://fbref.com/en/players/28f66c2e/Brandon-Soppy"
"10886","Jens Stryger Larsen_2022",2022,"Udinese","Serie A","Jens Stryger Larsen","DEN","DF","30",1991,7.6,5,2,3,1,1,2,3,66.7,1,2,0,2,4,9,17,0,"https://fbref.com/en/players/f91e81c9/Jens-Stryger-Larsen"
"10887","Isaac Success_2022",2022,"Udinese","Serie A","Isaac Success","NGA","FW,MF","25",1996,10.1,5,2,0,3,2,1,5,20,4,2,0,2,2,7,6,0,"https://fbref.com/en/players/f573a8bf/Isaac-Success"
"10888","Iyenoma Udogie_2022",2022,"Udinese","Serie A","Iyenoma Udogie","ITA","DF","18",2002,27.5,64,40,30,27,7,33,60,55,27,39,6,33,27,91,42,0,"https://fbref.com/en/players/7cd520e8/Iyenoma-Udogie"
"10889","Walace_2022",2022,"Udinese","Serie A","Walace","BRA","MF","26",1995,33,83,49,37,38,8,50,113,44.2,63,51,5,46,54,137,32,1,"https://fbref.com/en/players/26db8853/Walace"
"10890","Marvin Zeegelaar_2022",2022,"Udinese","Serie A","Marvin Zeegelaar","NED","DF","30",1990,7.1,15,11,6,8,1,5,14,35.7,9,12,4,8,12,27,22,1,"https://fbref.com/en/players/8abd0c03/Marvin-Zeegelaar"
"10891","Taiwo Awoniyi_2022",2022,"Union Berlin","Bundesliga","Taiwo Awoniyi","NGA","FW","23",1997,24.2,11,7,3,6,2,1,9,11.1,8,11,2,9,2,13,29,0,"https://fbref.com/en/players/e5478b87/Taiwo-Awoniyi"
"10892","Timo Baumgartl_2022",2022,"Union Berlin","Bundesliga","Timo Baumgartl","GER","DF","25",1996,24.1,59,28,34,21,4,31,47,66,16,27,11,16,37,96,58,0,"https://fbref.com/en/players/bd7d2e6d/Timo-Baumgartl"
"10893","Sheraldo Becker_2022",2022,"Union Berlin","Bundesliga","Sheraldo Becker","SUR","FW,MF","26",1995,19.5,9,6,3,4,2,6,18,33.3,12,11,0,11,2,11,4,0,"https://fbref.com/en/players/8eb55dbb/Sheraldo-Becker"
"10894","Kevin Behrens_2022",2022,"Union Berlin","Bundesliga","Kevin Behrens","GER","FW","30",1991,5.5,3,2,1,1,1,0,4,0,4,3,0,3,3,6,7,0,"https://fbref.com/en/players/30ae134d/Kevin-Behrens"
"10895","Keita Endo_2022",2022,"Union Berlin","Bundesliga","Keita Endo","JPN","MF","23",1997,0.6,1,1,1,0,0,0,0,NA,0,1,0,1,0,1,0,0,"https://fbref.com/en/players/1a83027b/Keita-Endo"
"10896","Marvin Friedrich_2022",2022,"Union Berlin","Bundesliga","Marvin Friedrich","GER","DF","25",1995,13,17,5,14,3,0,10,16,62.5,6,13,7,6,23,40,47,0,"https://fbref.com/en/players/b77f44a4/Marvin-Friedrich"
"10897","Niko Gießelmann_2022",2022,"Union Berlin","Bundesliga","Niko Gießelmann","GER","DF,FW","29",1991,23.1,24,17,10,11,3,15,38,39.5,23,26,4,22,18,42,29,1,"https://fbref.com/en/players/7242b495/Niko-Giesselmann"
"10898","Sebastian Griesbeck_2022",2022,"Union Berlin","Bundesliga","Sebastian Griesbeck","GER","MF","30",1990,0.1,1,1,0,1,0,1,1,100,0,0,0,0,0,1,0,0,"https://fbref.com/en/players/a8db7ebb/Sebastian-Griesbeck"
"10899","Genki Haraguchi_2022",2022,"Union Berlin","Bundesliga","Genki Haraguchi","JPN","MF","30",1991,19.5,37,20,12,22,3,15,48,31.3,33,25,3,22,26,63,15,0,"https://fbref.com/en/players/f24ea523/Genki-Haraguchi"
"10900","Dominique Heintz_2022",2022,"Union Berlin","Bundesliga","Dominique Heintz","GER","DF","27",1993,5.2,8,5,5,3,0,3,6,50,3,7,4,3,7,15,14,0,"https://fbref.com/en/players/699fb8db/Dominique-Heintz"
"10901","Marcus Ingvartsen_2022",2022,"Union Berlin","Bundesliga","Marcus Ingvartsen","DEN","MF","25",1996,1.4,0,0,0,0,0,0,2,0,2,0,0,0,2,2,1,0,"https://fbref.com/en/players/271b8617/Marcus-Ingvartsen"
"10902","Paul Jaeckel_2022",2022,"Union Berlin","Bundesliga","Paul Jaeckel","GER","DF","23",1998,22.7,51,29,27,24,0,29,51,56.9,22,34,10,24,57,108,81,0,"https://fbref.com/en/players/a93b6f4e/Paul-Jaeckel"
"10903","Rani Khedira_2022",2022,"Union Berlin","Bundesliga","Rani Khedira","GER","MF","27",1994,30.6,75,38,25,42,8,32,66,48.5,34,21,8,13,50,125,27,1,"https://fbref.com/en/players/59e4b92e/Rani-Khedira"
"10904","Robin Knoche_2022",2022,"Union Berlin","Bundesliga","Robin Knoche","GER","DF","29",1992,33,50,24,38,12,0,30,53,56.6,23,45,26,19,49,99,151,1,"https://fbref.com/en/players/6bd5cd5d/Robin-Knoche"
"10905","Max Kruse_2022",2022,"Union Berlin","Bundesliga","Max Kruse","GER","FW,MF","33",1988,14.1,4,1,0,3,1,2,16,12.5,14,12,0,12,3,7,2,0,"https://fbref.com/en/players/f9446dcd/Max-Kruse"
"10906","Andreas Luthe_2022",2022,"Union Berlin","Bundesliga","Andreas Luthe","GER","GK","34",1987,27,0,0,0,0,0,0,1,0,1,0,0,0,0,0,11,4,"https://fbref.com/en/players/7fe12375/Andreas-Luthe"
"10907","Sven Michel_2022",2022,"Union Berlin","Bundesliga","Sven Michel","GER","FW","31",1990,3.8,10,6,5,3,2,2,8,25,6,3,0,3,1,11,1,0,"https://fbref.com/en/players/1e274a0a/Sven-Michel"
"10908","Kevin Möhwald_2022",2022,"Union Berlin","Bundesliga","Kevin Möhwald","GER","MF","28",1993,3.9,7,1,3,3,1,1,7,14.3,6,3,0,3,3,10,6,0,"https://fbref.com/en/players/a5ce09f2/Kevin-Mohwald"
"10909","Bastian Oczipka_2022",2022,"Union Berlin","Bundesliga","Bastian Oczipka","GER","DF","32",1989,10.4,24,15,15,7,2,10,13,76.9,3,10,2,8,12,36,21,0,"https://fbref.com/en/players/d1661819/Bastian-Oczipka"
"10910","Levin Öztunalı_2022",2022,"Union Berlin","Bundesliga","Levin Öztunalı","GER","MF","25",1996,6.4,14,11,6,5,3,7,17,41.2,10,3,0,3,4,18,12,0,"https://fbref.com/en/players/66385c46/Levin-Oztunali"
"10911","Grischa Prömel_2022",2022,"Union Berlin","Bundesliga","Grischa Prömel","GER","MF","26",1995,26.9,36,22,14,17,5,22,52,42.3,30,18,3,15,23,59,22,0,"https://fbref.com/en/players/924f9191/Grischa-Promel"
"10912","Julian Ryerson_2022",2022,"Union Berlin","Bundesliga","Julian Ryerson","NOR","DF","23",1997,15.9,27,15,11,12,4,17,25,68,8,12,4,8,16,43,32,0,"https://fbref.com/en/players/009a4f60/Julian-Ryerson"
"10913","Frederik Rønnow_2022",2022,"Union Berlin","Bundesliga","Frederik Rønnow","DEN","GK","28",1992,7,0,0,0,0,0,0,0,NA,0,0,0,0,0,0,1,0,"https://fbref.com/en/players/a70b8345/Frederik-Ronnow"
"10914","András Schäfer_2022",2022,"Union Berlin","Bundesliga","András Schäfer","HUN","MF","22",1999,2.7,4,1,3,1,0,0,5,0,5,7,1,6,2,6,4,0,"https://fbref.com/en/players/049751d7/Andras-Schafer"
"10915","Cedric Teuchert_2022",2022,"Union Berlin","Bundesliga","Cedric Teuchert","GER","MF,FW","24",1997,1.2,3,2,3,0,0,2,6,33.3,4,1,0,1,0,3,0,0,"https://fbref.com/en/players/f956479d/Cedric-Teuchert"
"10916","Christopher Trimmel_2022",2022,"Union Berlin","Bundesliga","Christopher Trimmel","AUT","DF,FW","34",1987,22.1,49,30,25,19,5,26,45,57.8,19,20,3,17,34,83,75,0,"https://fbref.com/en/players/056d2d95/Christopher-Trimmel"
"10917","Anthony Ujah_2022",2022,"Union Berlin","Bundesliga","Anthony Ujah","NGA","FW,MF","30",1990,0.4,0,0,0,0,0,0,0,NA,0,0,0,0,0,0,0,0,"https://fbref.com/en/players/99be8fb5/Anthony-Ujah"
"10918","Andreas Voglsammer_2022",2022,"Union Berlin","Bundesliga","Andreas Voglsammer","GER","FW,MF","29",1992,9.8,14,9,8,3,3,6,14,42.9,8,9,2,7,2,16,7,0,"https://fbref.com/en/players/daa78200/Andreas-Voglsammer"
"10919","Omar Alderete_2022",2022,"Valencia","La Liga","Omar Alderete","PAR","DF","24",1996,26.7,53,34,34,17,2,34,53,64.2,19,30,18,12,35,88,153,0,"https://fbref.com/en/players/bb08bce9/Omar-Alderete"
"10920","Denis Cheryshev_2022",2022,"Valencia","La Liga","Denis Cheryshev","RUS","MF,FW","30",1990,6.3,14,5,6,1,7,6,15,40,9,9,1,8,9,23,9,0,"https://fbref.com/en/players/0ac94a23/Denis-Cheryshev"
"10921","Jasper Cillessen_2022",2022,"Valencia","La Liga","Jasper Cillessen","NED","GK","32",1989,16.2,0,0,0,0,0,0,1,0,1,0,0,0,1,1,6,0,"https://fbref.com/en/players/04ac8285/Jasper-Cillessen"
"10922","Eray Cömert_2022",2022,"Valencia","La Liga","Eray Cömert","SUI","DF","23",1998,4.5,5,3,4,1,0,3,6,50,3,3,2,1,2,7,6,0,"https://fbref.com/en/players/15937e17/Eray-Comert"
"10923","Thierry Correia_2022",2022,"Valencia","La Liga","Thierry Correia","POR","DF","22",1999,15.7,35,23,26,6,3,14,29,48.3,15,20,5,15,19,54,27,0,"https://fbref.com/en/players/c78b352d/Thierry-Correia"
"10924","Hélder Costa_2022",2022,"Valencia","La Liga","Hélder Costa","ANG","MF,FW","27",1994,12.4,27,16,11,9,7,14,41,34.1,27,12,1,11,3,30,9,0,"https://fbref.com/en/players/f13d02a6/Helder-Costa"
"10925","Mouctar Diakhaby_2022",2022,"Valencia","La Liga","Mouctar Diakhaby","GUI","DF","24",1996,21.6,35,24,18,15,2,13,23,56.5,10,29,17,12,30,65,87,3,"https://fbref.com/en/players/d2110326/Mouctar-Diakhaby"
"10926","Jaume Doménech_2022",2022,"Valencia","La Liga","Jaume Doménech","ESP","GK","30",1990,3.8,0,0,0,0,0,0,0,NA,0,0,0,0,0,0,3,1,"https://fbref.com/en/players/c9cb972b/Jaume-Domenech"
"10927","Mario Dominguez_2022",2022,"Valencia","La Liga","Mario Dominguez","ESP","FW","17",2004,0.3,0,0,0,0,0,0,0,NA,0,0,0,0,0,0,1,0,"https://fbref.com/en/players/d709cd5c/Mario-Dominguez"
"10928","Hugo Duro_2022",2022,"Valencia","La Liga","Hugo Duro","ESP","FW,MF","21",1999,20.4,25,19,11,13,1,15,38,39.5,23,24,2,22,4,29,20,1,"https://fbref.com/en/players/37e103f8/Hugo-Duro"
"10929","Dimitri Foulquier_2022",2022,"Valencia","La Liga","Dimitri Foulquier","FRA","DF","28",1993,26,36,17,17,15,4,21,34,61.8,13,19,3,16,29,65,49,0,"https://fbref.com/en/players/45e17712/Dimitri-Foulquier"
"10930","Bryan Gil_2022",2022,"Valencia","La Liga","Bryan Gil","ESP","MF,FW","20",2001,8.4,13,8,6,3,4,2,13,15.4,11,13,0,13,1,14,4,0,"https://fbref.com/en/players/7b5ab7f2/Bryan-Gil"
"10931","Maxi Gómez_2022",2022,"Valencia","La Liga","Maxi Gómez","URU","FW","24",1996,21.7,5,3,1,2,2,5,8,62.5,3,5,1,4,3,8,22,0,"https://fbref.com/en/players/4c2e9442/Maxi-Gomez"
"10932","Gonçalo Guedes_2022",2022,"Valencia","La Liga","Gonçalo Guedes","POR","FW,MF","24",1996,29,21,14,6,7,8,2,22,9.1,20,14,0,14,9,30,1,0,"https://fbref.com/en/players/e6bc67d7/Goncalo-Guedes"
"10933","Hugo Guillamón_2022",2022,"Valencia","La Liga","Hugo Guillamón","ESP","MF,DF","21",2000,26.2,43,27,20,16,7,18,44,40.9,26,26,10,16,30,73,53,1,"https://fbref.com/en/players/f7c12fbf/Hugo-Guillamon"
"10934","Jason_2022",2022,"Valencia","La Liga","Jason","ESP","MF,DF","27",1994,0.8,4,1,2,1,1,0,1,0,1,2,0,2,1,5,1,0,"https://fbref.com/en/players/9038c2a1/Jason"
"10935","Koba Koindredi_2022",2022,"Valencia","La Liga","Koba Koindredi","FRA","MF","19",2001,2,4,3,2,1,1,2,6,33.3,4,3,0,3,4,8,5,0,"https://fbref.com/en/players/3a58d075/Koba-Koindredi"
"10936","Toni Lato_2022",2022,"Valencia","La Liga","Toni Lato","ESP","DF","23",1997,6.6,17,12,12,3,2,9,16,56.3,7,6,0,6,8,25,14,0,"https://fbref.com/en/players/8e088e04/Toni-Lato"
"10937","Ruben Lendinez_2022",2022,"Valencia","La Liga","Ruben Lendinez","ESP","DF","18",2003,1.5,3,3,1,2,0,3,8,37.5,5,4,0,4,2,5,6,0,"https://fbref.com/en/players/755da865/Ruben-Lendinez"
"10938","José Luis Gayà_2022",2022,"Valencia","La Liga","José Luis Gayà","ESP","DF","26",1995,20.8,35,21,24,10,1,16,34,47.1,18,17,3,14,19,54,37,0,"https://fbref.com/en/players/b05e2dbd/Jose-Luis-Gaya"
"10939","Giorgi Mamardashvili_2022",2022,"Valencia","La Liga","Giorgi Mamardashvili","GEO","GK","20",2000,18,0,0,0,0,0,0,0,NA,0,0,0,0,0,0,6,1,"https://fbref.com/en/players/d4b73232/Giorgi-Mamardashvili"
"10940","Maranhão_2022",2022,"Valencia","La Liga","Maranhão","BRA","FW,MF","24",1996,10.8,15,11,4,6,5,5,16,31.3,11,15,0,15,7,22,13,0,"https://fbref.com/en/players/ae86d473/Maranhao"
"10941","Ilaix Moriba_2022",2022,"Valencia","La Liga","Ilaix Moriba","GUI","MF","18",2003,9.1,26,18,10,13,3,14,35,40,21,15,0,15,12,38,14,0,"https://fbref.com/en/players/f4c69aa6/Ilaix-Moriba"
"10942","Cristhian Mosquera_2022",2022,"Valencia","La Liga","Cristhian Mosquera","COL","DF","17",2004,2.4,4,2,3,0,1,3,6,50,3,1,0,1,3,7,1,1,"https://fbref.com/en/players/dc1ce4f5/Cristhian-Mosquera"
"10943","Yunus Musah_2022",2022,"Valencia","La Liga","Yunus Musah","USA","MF,FW","18",2002,14,23,13,8,8,7,6,20,30,14,19,1,18,14,37,11,0,"https://fbref.com/en/players/b51b1b9c/Yunus-Musah"
"10944","Gabriel Paulista_2022",2022,"Valencia","La Liga","Gabriel Paulista","BRA","DF","30",1990,17.7,21,12,16,5,0,14,20,70,6,18,12,6,39,60,88,0,"https://fbref.com/en/players/b7ca5c51/Gabriel-Paulista"
"10945","Cristiano Piccini_2022",2022,"Valencia","La Liga","Cristiano Piccini","ITA","DF","28",1992,3.6,14,8,9,5,0,5,7,71.4,2,3,2,1,1,15,11,0,"https://fbref.com/en/players/32c0491f/Cristiano-Piccini"
"10946","Uroš Račić_2022",2022,"Valencia","La Liga","Uroš Račić","SRB","MF","23",1998,13.4,32,18,9,19,4,12,33,36.4,21,16,6,10,16,48,21,0,"https://fbref.com/en/players/faed84db/Uros-Racic"
"10947","Jesús Santiago_2022",2022,"Valencia","La Liga","Jesús Santiago","ESP","MF","17",2004,0.9,2,2,1,1,0,0,2,0,2,1,0,1,0,2,1,0,"https://fbref.com/en/players/bc49fd34/Jesus-Santiago"
"10948","Rubén Sobrino_2022",2022,"Valencia","La Liga","Rubén Sobrino","ESP","MF","29",1992,0.2,1,1,1,0,0,1,1,100,0,1,0,1,2,3,0,0,"https://fbref.com/en/players/19b776e9/Ruben-Sobrino"
"10949","Carlos Soler_2022",2022,"Valencia","La Liga","Carlos Soler","ESP","MF","24",1997,27.5,29,19,10,15,4,11,37,29.7,26,19,4,15,14,43,28,0,"https://fbref.com/en/players/fed17f5a/Carlos-Soler"
"10950","Manu Vallejo_2022",2022,"Valencia","La Liga","Manu Vallejo","ESP","FW,MF","24",1997,1.1,2,1,1,1,0,0,1,0,1,0,0,0,0,2,1,0,"https://fbref.com/en/players/0bc4e720/Manu-Vallejo"
"10951","Jesus Vazquez_2022",2022,"Valencia","La Liga","Jesus Vazquez","ESP","DF","18",2003,9,24,13,10,8,6,10,22,45.5,12,16,3,13,9,33,19,0,"https://fbref.com/en/players/106c142c/Jesus-Vazquez"
"10952","Daniel Wass_2022",2022,"Valencia","La Liga","Daniel Wass","DEN","MF","32",1989,17.6,23,13,6,14,3,8,31,25.8,23,13,2,11,13,36,19,0,"https://fbref.com/en/players/d83bbc54/Daniel-Wass"
"10953","Ethan Ampadu_2022",2022,"Venezia","Serie A","Ethan Ampadu","WAL","MF,DF","20",2000,25.4,67,43,37,27,3,24,58,41.4,34,49,19,30,51,118,76,0,"https://fbref.com/en/players/10b9fa99/Ethan-Ampadu"
"10954","Mattia Aramu_2022",2022,"Venezia","Serie A","Mattia Aramu","ITA","MF,FW","26",1995,23.3,20,15,5,9,6,8,33,24.2,25,20,2,18,8,28,19,0,"https://fbref.com/en/players/0847b5a5/Mattia-Aramu"
"10955","Issa Bah_2022",2022,"Venezia","Serie A","Issa Bah","LUX","FW","19",2002,0.1,0,0,0,0,0,0,0,NA,0,0,0,0,0,0,0,0,"https://fbref.com/en/players/956a78ea/Issa-Bah"
"10956","Bjarki Bjarkason_2022",2022,"Venezia","Serie A","Bjarki Bjarkason","ISL","MF","21",2000,0,0,0,0,0,0,0,0,NA,0,0,0,0,0,0,0,0,"https://fbref.com/en/players/f1d25de7/Bjarki-Bjarkason"
"10957","Gianluca Busio_2022",2022,"Venezia","Serie A","Gianluca Busio","USA","MF","19",2002,21.7,53,28,27,20,6,28,63,44.4,35,45,13,32,21,74,30,1,"https://fbref.com/en/players/4a0b7f07/Gianluca-Busio"
"10958","Mattia Caldara_2022",2022,"Venezia","Serie A","Mattia Caldara","ITA","DF","27",1994,30,48,28,30,15,3,20,34,58.8,14,49,37,12,62,110,147,1,"https://fbref.com/en/players/ac7e640b/Mattia-Caldara"
"10959","Pietro Ceccaroni_2022",2022,"Venezia","Serie A","Pietro Ceccaroni","ITA","DF","25",1995,34.7,55,31,33,18,4,25,36,69.4,11,45,32,13,30,85,143,0,"https://fbref.com/en/players/4d1efb48/Pietro-Ceccaroni"
"10960","Domen Črnigoj_2022",2022,"Venezia","Serie A","Domen Črnigoj","SVN","MF","25",1995,20.9,21,13,7,11,3,11,29,37.9,18,27,8,19,24,45,42,0,"https://fbref.com/en/players/22cd43d2/Domen-Crnigoj"
"10961","Mickaël Cuisance_2022",2022,"Venezia","Serie A","Mickaël Cuisance","FRA","MF","21",1999,10.2,23,9,7,12,4,10,28,35.7,18,14,0,14,12,35,5,0,"https://fbref.com/en/players/5722eced/Mickael-Cuisance"
"10962","Jacopo Dezi_2022",2022,"Venezia","Serie A","Jacopo Dezi","ITA","MF","29",1992,0.2,0,0,0,0,0,0,1,0,1,0,0,0,1,1,0,0,"https://fbref.com/en/players/e921b9db/Jacopo-Dezi"
"10963","Francesco Di Mariano_2022",2022,"Venezia","Serie A","Francesco Di Mariano","ITA","FW","25",1996,0.7,1,1,0,1,0,0,0,NA,0,2,1,1,0,1,0,0,"https://fbref.com/en/players/35a2557c/Francesco-Di-Mariano"
"10964","Tyronne Ebuehi_2022",2022,"Venezia","Serie A","Tyronne Ebuehi","NGA","DF","25",1995,12.6,28,12,16,8,4,10,18,55.6,8,13,3,10,16,44,38,1,"https://fbref.com/en/players/6af30900/Tyronne-Ebuehi"
"10965","Luca Fiordilino_2022",2022,"Venezia","Serie A","Luca Fiordilino","ITA","MF","25",1996,7.3,21,13,11,6,4,13,27,48.1,14,14,4,10,11,32,12,0,"https://fbref.com/en/players/9bb1ad91/Luca-Fiordilino"
"10966","Francesco Forte_2022",2022,"Venezia","Serie A","Francesco Forte","ITA","FW","28",1993,4.7,3,2,0,2,1,2,5,40,3,1,0,1,0,3,2,0,"https://fbref.com/en/players/69e11a01/Francesco-Forte"
"10967","Nicolas Galazzi_2022",2022,"Venezia","Serie A","Nicolas Galazzi","ITA","MF","20",2000,0.2,2,1,1,0,1,0,1,0,1,0,0,0,0,2,0,0,"https://fbref.com/en/players/a796492f/Nicolas-Galazzi"
"10968","Ridgeciano Haps_2022",2022,"Venezia","Serie A","Ridgeciano Haps","SUR","DF","28",1993,22.8,36,20,26,4,6,11,21,52.4,10,34,12,22,29,65,57,1,"https://fbref.com/en/players/c8d7131c/Ridgeciano-Haps"
"10969","Thomas Henry_2022",2022,"Venezia","Serie A","Thomas Henry","FRA","FW","26",1994,23.5,9,4,2,3,4,5,13,38.5,8,11,5,6,2,11,25,0,"https://fbref.com/en/players/9ef42479/Thomas-Henry"
"10970","Daan Heymans_2022",2022,"Venezia","Serie A","Daan Heymans","BEL","MF,FW","22",1999,2.8,3,1,1,2,0,1,5,20,4,7,3,4,4,7,3,0,"https://fbref.com/en/players/6d70c771/Daan-Heymans"
"10971","Dennis Johnsen_2022",2022,"Venezia","Serie A","Dennis Johnsen","NOR","FW,MF","23",1998,16.1,14,10,8,4,2,6,18,33.3,12,14,1,13,5,19,3,0,"https://fbref.com/en/players/66784dee/Dennis-Johnsen"
"10972","Sofian Kiyine_2022",2022,"Venezia","Serie A","Sofian Kiyine","MAR","MF,FW","23",1997,13.8,24,14,9,11,4,12,32,37.5,20,15,1,14,10,34,9,0,"https://fbref.com/en/players/ce1806be/Sofian-Kiyine"
"10973","Patrick Leal_2022",2022,"Venezia","Serie A","Patrick Leal","USA","FW","18",2003,0,0,0,0,0,0,0,1,0,1,0,0,0,0,0,0,0,"https://fbref.com/en/players/d97ec0d1/Patrick-Leal"
"10974","Luca Lezzerini_2022",2022,"Venezia","Serie A","Luca Lezzerini","ITA","GK","26",1995,5.5,0,0,0,0,0,0,0,NA,0,1,0,1,0,0,0,0,"https://fbref.com/en/players/c9c32262/Luca-Lezzerini"
"10975","Niki Mäenpää_2022",2022,"Venezia","Serie A","Niki Mäenpää","FIN","GK","36",1985,16.5,0,0,0,0,0,0,0,NA,0,0,0,0,0,0,8,2,"https://fbref.com/en/players/14a96e1c/Niki-Maenpaa"
"10976","Aleš Matějů_2022",2022,"Venezia","Serie A","Aleš Matějů","CZE","DF","25",1996,8.1,16,12,10,5,1,13,29,44.8,16,10,6,4,9,25,15,0,"https://fbref.com/en/players/deb748c9/Ales-Mateju"
"10977","Pasquale Mazzocchi_2022",2022,"Venezia","Serie A","Pasquale Mazzocchi","ITA","DF","26",1995,13.8,18,8,11,4,3,10,26,38.5,16,11,8,3,21,39,31,1,"https://fbref.com/en/players/eb0ec070/Pasquale-Mazzocchi"
"10978","Hilmir Mikaelsson_2022",2022,"Venezia","Serie A","Hilmir Mikaelsson","ISL","FW","17",2004,0.2,2,0,0,1,1,0,0,NA,0,0,0,0,0,2,0,0,"https://fbref.com/en/players/5add9b29/Hilmir-Mikaelsson"
"10979","Marco Modolo_2022",2022,"Venezia","Serie A","Marco Modolo","ITA","DF","32",1989,4.4,6,3,4,2,0,2,5,40,3,6,6,0,4,10,26,0,"https://fbref.com/en/players/fdcdb521/Marco-Modolo"
"10980","Cristian Molinaro_2022",2022,"Venezia","Serie A","Cristian Molinaro","ITA","DF","38",1983,6.1,12,9,10,2,0,5,7,71.4,2,7,2,5,6,18,20,0,"https://fbref.com/en/players/1c8c5aed/Cristian-Molinaro"
"10981","Nani_2022",2022,"Venezia","Serie A","Nani","POR","MF,FW","34",1986,3.2,2,1,1,1,0,0,1,0,1,1,0,1,2,4,0,1,"https://fbref.com/en/players/15e9c7e6/Nani"
"10982","Jean-Pierre Nsame_2022",2022,"Venezia","Serie A","Jean-Pierre Nsame","CMR","FW","28",1993,2.7,1,1,0,0,1,0,0,NA,0,0,0,0,0,1,1,0,"https://fbref.com/en/players/12e6d21a/Jean-Pierre-Nsame"
"10983","David Okereke_2022",2022,"Venezia","Serie A","David Okereke","NGA","FW,MF","23",1997,22.8,16,10,4,9,3,3,20,15,17,19,3,16,10,26,20,0,"https://fbref.com/en/players/d125f22f/David-Okereke"
"10984","Dor Peretz_2022",2022,"Venezia","Serie A","Dor Peretz","ISR","MF","26",1995,6.5,27,18,8,16,3,13,25,52,12,8,4,4,8,35,11,0,"https://fbref.com/en/players/e2a302a8/Dor-Peretz"
"10985","Sergio Romero_2022",2022,"Venezia","Serie A","Sergio Romero","ARG","GK","34",1987,16,2,2,2,0,0,2,2,100,0,0,0,0,1,3,10,0,"https://fbref.com/en/players/1e26e376/Sergio-Romero"
"10986","David Schnegg_2022",2022,"Venezia","Serie A","David Schnegg","AUT","DF","22",1998,1.6,2,0,1,1,0,1,3,33.3,2,4,0,4,3,5,6,0,"https://fbref.com/en/players/1c341b14/David-Schnegg"
"10987","Arnór Sigurðsson_2022",2022,"Venezia","Serie A","Arnór Sigurðsson","ISL","FW,MF","22",1999,2,1,1,0,1,0,1,2,50,1,2,0,2,1,2,0,0,"https://fbref.com/en/players/f209b81e/Arnor-Sigurdsson"
"10988","Michael Svoboda_2022",2022,"Venezia","Serie A","Michael Svoboda","AUT","DF","22",1998,13.7,33,17,26,6,1,18,32,56.3,14,27,15,12,10,43,61,5,"https://fbref.com/en/players/8abd174d/Michael-Svoboda"
"10989","Tanner Tessmann_2022",2022,"Venezia","Serie A","Tanner Tessmann","USA","MF","19",2001,7.6,11,5,4,6,1,5,14,35.7,9,19,9,10,5,16,22,0,"https://fbref.com/en/players/ac277993/Tanner-Tessmann"
"10990","Maximilian Ullmann_2022",2022,"Venezia","Serie A","Maximilian Ullmann","AUT","DF","25",1996,2.7,0,0,0,0,0,0,1,0,1,4,0,4,2,2,7,0,"https://fbref.com/en/players/caaf2ed1/Maximilian-Ullmann"
"10991","Antonio Vacca_2022",2022,"Venezia","Serie A","Antonio Vacca","ITA","MF","31",1990,11.8,36,20,24,10,2,14,36,38.9,22,16,8,8,20,56,16,0,"https://fbref.com/en/players/444c89d9/Antonio-Vacca"
"10992","Raúl Albiol_2022",2022,"Villarreal","La Liga","Raúl Albiol","ESP","DF","35",1985,27.4,26,15,20,5,1,14,18,77.8,4,24,15,9,21,47,126,1,"https://fbref.com/en/players/4bd414c1/Raul-Albiol"
"10993","Paco Alcácer_2022",2022,"Villarreal","La Liga","Paco Alcácer","ESP","FW","27",1993,8.7,9,3,2,4,3,1,5,20,4,7,0,7,6,15,1,0,"https://fbref.com/en/players/a7a9d95a/Paco-Alcacer"
"10994","Sergio Asenjo_2022",2022,"Villarreal","La Liga","Sergio Asenjo","ESP","GK","32",1989,6,0,0,0,0,0,0,1,0,1,0,0,0,1,1,6,0,"https://fbref.com/en/players/9f0ea33f/Sergio-Asenjo"
"10995","Serge Aurier_2022",2022,"Villarreal","La Liga","Serge Aurier","CIV","DF","28",1992,11.2,14,9,11,2,1,4,7,57.1,3,14,7,7,11,25,25,0,"https://fbref.com/en/players/5c2b4f07/Serge-Aurier"
"10996","Étienne Capoue_2022",2022,"Villarreal","La Liga","Étienne Capoue","FRA","MF","33",1988,25.4,44,26,18,23,3,15,28,53.6,13,17,5,12,35,79,51,0,"https://fbref.com/en/players/5acc4a10/Etienne-Capoue"
"10997","Carlo_2022",2022,"Villarreal","La Liga","Carlo","ESP","MF","20",2001,0.1,0,0,0,0,0,0,0,NA,0,0,0,0,0,0,0,0,"https://fbref.com/en/players/8249ff06/Carlo"
"10998","Samuel Chukwueze_2022",2022,"Villarreal","La Liga","Samuel Chukwueze","NGA","MF,FW","22",1999,14.8,13,9,6,5,2,3,6,50,3,7,0,7,5,18,4,0,"https://fbref.com/en/players/b8a642fc/Samuel-Chukwueze"
"10999","Francis Coquelin_2022",2022,"Villarreal","La Liga","Francis Coquelin","FRA","MF","30",1991,9.2,26,17,9,11,6,11,20,55,9,15,5,10,19,45,11,0,"https://fbref.com/en/players/a6951bf8/Francis-Coquelin"
"11000","Arnaut Danjuma_2022",2022,"Villarreal","La Liga","Arnaut Danjuma","NED","FW","24",1997,16.4,7,6,3,0,4,2,4,50,2,5,0,5,2,9,3,0,"https://fbref.com/en/players/f08490a6/Arnaut-Danjuma"
"11001","Boulaye Dia_2022",2022,"Villarreal","La Liga","Boulaye Dia","SEN","FW","24",1996,14.1,8,6,3,4,1,2,5,40,3,6,1,5,5,13,4,0,"https://fbref.com/en/players/244bc2c8/Boulaye-Dia"
"11002","Pervis Estupiñán_2022",2022,"Villarreal","La Liga","Pervis Estupiñán","ECU","DF","23",1998,17.5,36,22,20,11,5,17,24,70.8,7,13,5,8,25,61,29,2,"https://fbref.com/en/players/d38fdf53/Pervis-Estupinan"
"11003","Juan Foyth_2022",2022,"Villarreal","La Liga","Juan Foyth","ARG","DF","23",1998,21.4,69,49,35,28,6,35,47,74.5,12,29,7,22,20,89,50,0,"https://fbref.com/en/players/6c7762c3/Juan-Foyth"
"11004","Mario Gaspar_2022",2022,"Villarreal","La Liga","Mario Gaspar","ESP","DF","30",1990,6.9,10,4,2,5,3,6,10,60,4,6,3,3,6,16,15,0,"https://fbref.com/en/players/fb5d47b3/Mario-Gaspar"
"11005","Moi Gómez_2022",2022,"Villarreal","La Liga","Moi Gómez","ESP","MF,FW","27",1994,14.3,15,7,8,3,4,5,17,29.4,12,5,0,5,6,21,6,0,"https://fbref.com/en/players/5a626448/Moi-Gomez"
"11006","Vicente Iborra_2022",2022,"Villarreal","La Liga","Vicente Iborra","ESP","MF","33",1988,11.5,19,10,9,7,3,12,24,50,12,11,5,6,11,30,27,1,"https://fbref.com/en/players/ad1ffcfd/Vicente-Iborra"
"11007","Nikita Iosifov_2022",2022,"Villarreal","La Liga","Nikita Iosifov","RUS","MF","20",2001,0,0,0,0,0,0,0,0,NA,0,0,0,0,0,0,0,0,"https://fbref.com/en/players/4c2fa917/Nikita-Iosifov"
"11008","Nicolas Jackson_2022",2022,"Villarreal","La Liga","Nicolas Jackson","SEN","FW,MF","20",2001,1.8,2,0,1,0,1,0,0,NA,0,0,0,0,1,3,1,0,"https://fbref.com/en/players/9c36ed83/Nicolas-Jackson"
"11009","Giovani Lo Celso_2022",2022,"Villarreal","La Liga","Giovani Lo Celso","ARG","FW,MF","25",1996,11,22,12,8,10,4,9,22,40.9,13,4,0,4,5,27,3,0,"https://fbref.com/en/players/d7553721/Giovani-Lo-Celso"
"11010","Aïssa Mandi_2022",2022,"Villarreal","La Liga","Aïssa Mandi","ALG","DF","29",1991,15.3,11,5,2,8,1,3,6,50,3,17,14,3,13,24,49,3,"https://fbref.com/en/players/fbd6378b/Aissa-Mandi"
"11011","Alberto Moreno_2022",2022,"Villarreal","La Liga","Alberto Moreno","ESP","MF,DF","29",1992,13.6,13,7,5,7,1,5,18,27.8,13,13,1,12,27,40,15,0,"https://fbref.com/en/players/11b9265b/Alberto-Moreno"
"11012","Gerard Moreno_2022",2022,"Villarreal","La Liga","Gerard Moreno","ESP","FW","29",1992,13.2,5,2,2,2,1,1,7,14.3,6,6,1,5,6,11,14,0,"https://fbref.com/en/players/81f0781e/Gerard-Moreno"
"11013","Daniel Parejo_2022",2022,"Villarreal","La Liga","Daniel Parejo","ESP","MF","32",1989,30,43,29,15,15,13,20,52,38.5,32,32,7,25,29,72,19,1,"https://fbref.com/en/players/7460ca0d/Daniel-Parejo"
"11014","Alfonso Pedraza_2022",2022,"Villarreal","La Liga","Alfonso Pedraza","ESP","DF","25",1996,18.9,34,16,17,12,5,10,28,35.7,18,12,3,9,31,65,32,0,"https://fbref.com/en/players/63f04c6c/Alfonso-Pedraza"
"11015","Rubén Peña_2022",2022,"Villarreal","La Liga","Rubén Peña","ESP","MF,FW","30",1991,1.5,2,0,1,1,0,2,6,33.3,4,1,0,1,5,7,2,0,"https://fbref.com/en/players/1f079188/Ruben-Pena"
"11016","Yeremi Pino_2022",2022,"Villarreal","La Liga","Yeremi Pino","ESP","MF,FW","18",2002,18.6,32,14,14,8,10,10,24,41.7,14,33,4,29,6,38,12,1,"https://fbref.com/en/players/540ec57b/Yeremi-Pino"
"11017","Dani Raba_2022",2022,"Villarreal","La Liga","Dani Raba","ESP","MF,FW","25",1995,1,1,0,0,1,0,1,2,50,1,2,0,2,0,1,2,0,"https://fbref.com/en/players/ea6a7ab4/Dani-Raba"
"11018","Gerónimo Rulli_2022",2022,"Villarreal","La Liga","Gerónimo Rulli","ARG","GK","29",1992,32,0,0,0,0,0,0,4,0,4,0,0,0,1,1,15,5,"https://fbref.com/en/players/625c144a/Geronimo-Rulli"
"11019","Pau Torres_2022",2022,"Villarreal","La Liga","Pau Torres","ESP","DF","24",1997,31.7,32,19,23,7,2,18,25,72,7,32,23,9,19,51,105,2,"https://fbref.com/en/players/532e1e4f/Pau-Torres"
"11020","Manu Trigueros_2022",2022,"Villarreal","La Liga","Manu Trigueros","ESP","MF,FW","29",1991,24.2,45,25,16,18,11,23,66,34.8,43,19,3,16,13,58,17,0,"https://fbref.com/en/players/963829d0/Manu-Trigueros"
"11021","Daniel Bachmann_2022",2022,"Watford","Premier League","Daniel Bachmann","AUT","GK","27",1994,12,0,0,0,0,0,0,0,NA,0,0,0,0,1,1,5,0,"https://fbref.com/en/players/1c0eea98/Daniel-Bachmann"
"11022","Craig Cathcart_2022",2022,"Watford","Premier League","Craig Cathcart","NIR","DF","32",1989,26.6,32,15,25,6,1,16,30,53.3,14,39,29,10,28,60,132,3,"https://fbref.com/en/players/89e4b358/Craig-Cathcart"
"11023","Tom Cleverley_2022",2022,"Watford","Premier League","Tom Cleverley","ENG","MF","31",1989,18,37,20,19,17,1,18,33,54.5,15,23,6,17,18,55,19,3,"https://fbref.com/en/players/6cdd8245/Tom-Cleverley"
"11024","Cucho_2022",2022,"Watford","Premier League","Cucho","COL","FW,MF","22",1999,12.7,13,5,5,5,3,5,27,18.5,22,13,1,12,5,18,9,0,"https://fbref.com/en/players/71b47ab9/Cucho"
"11025","Troy Deeney_2022",2022,"Watford","Premier League","Troy Deeney","ENG","FW","33",1988,0.3,0,0,0,0,0,0,1,0,1,0,0,0,0,0,2,0,"https://fbref.com/en/players/82e34b69/Troy-Deeney"
"11026","Emmanuel Dennis_2022",2022,"Watford","Premier League","Emmanuel Dennis","NGA","FW,MF","23",1997,28.7,51,35,20,22,9,17,52,32.7,35,36,2,34,15,66,13,0,"https://fbref.com/en/players/2c44a35d/Emmanuel-Dennis"
"11027","Oghenekaro Etebo_2022",2022,"Watford","Premier League","Oghenekaro Etebo","NGA","MF","25",1995,4.5,11,8,7,4,0,3,8,37.5,5,3,1,2,5,16,5,0,"https://fbref.com/en/players/b579e83d/Oghenekaro-Etebo"
"11028","Kiko Femenía_2022",2022,"Watford","Premier League","Kiko Femenía","ESP","DF","30",1991,23.8,35,22,23,10,2,21,37,56.8,16,24,8,16,37,72,51,0,"https://fbref.com/en/players/e5d01ecf/Kiko-Femenia"
"11029","Ashley Fletcher_2022",2022,"Watford","Premier League","Ashley Fletcher","ENG","FW","25",1995,0.3,2,1,1,1,0,1,1,100,0,1,1,0,0,2,0,0,"https://fbref.com/en/players/eeb6551f/Ashley-Fletcher"
"11030","Ben Foster_2022",2022,"Watford","Premier League","Ben Foster","ENG","GK","38",1983,26,0,0,0,0,0,0,3,0,3,0,0,0,0,0,9,4,"https://fbref.com/en/players/d0b3ceb9/Ben-Foster"
"11031","Dan Gosling_2022",2022,"Watford","Premier League","Dan Gosling","ENG","MF","31",1990,1.8,2,1,1,1,0,2,6,33.3,4,2,0,2,0,2,3,0,"https://fbref.com/en/players/7fec31a0/Dan-Gosling"
"11032","João Pedro_2022",2022,"Watford","Premier League","João Pedro","BRA","FW,MF","19",2001,18.3,20,14,7,8,5,6,23,26.1,17,23,3,20,15,35,17,0,"https://fbref.com/en/players/e8832875/Joao-Pedro"
"11033","Christian Kabasele_2022",2022,"Watford","Premier League","Christian Kabasele","BEL","DF","30",1991,13.3,11,5,10,1,0,7,10,70,3,20,16,4,14,25,67,1,"https://fbref.com/en/players/914ab9a1/Christian-Kabasele"
"11034","Samuel Kalu_2022",2022,"Watford","Premier League","Samuel Kalu","NGA","FW","23",1997,2.5,2,2,0,2,0,1,1,100,0,2,0,2,3,5,3,0,"https://fbref.com/en/players/b8d22478/Samuel-Kalu"
"11035","Hassane Kamara_2022",2022,"Watford","Premier League","Hassane Kamara","CIV","DF","27",1994,18,53,34,31,16,6,27,43,62.8,16,20,4,16,69,122,67,0,"https://fbref.com/en/players/19a12bed/Hassane-Kamara"
"11036","Edo Kayembe_2022",2022,"Watford","Premier League","Edo Kayembe","COD","MF","23",1998,8.9,21,13,11,9,1,8,16,50,8,6,1,5,9,30,13,0,"https://fbref.com/en/players/f99b71de/Edo-Kayembe"
"11037","Joshua King_2022",2022,"Watford","Premier League","Joshua King","NOR","FW","29",1992,25,19,15,7,6,6,4,17,23.5,13,15,4,11,8,27,31,0,"https://fbref.com/en/players/43458538/Joshua-King"
"11038","Juraj Kucka_2022",2022,"Watford","Premier League","Juraj Kucka","SVK","MF","34",1987,21.3,59,39,32,25,2,27,73,37,46,30,9,21,27,86,46,2,"https://fbref.com/en/players/5aaef9ef/Juraj-Kucka"
"11039","Imran Louza_2022",2022,"Watford","Premier League","Imran Louza","MAR","MF","22",1999,15.7,41,21,18,20,3,16,38,42.1,22,28,6,22,42,83,20,1,"https://fbref.com/en/players/e1df6989/Imran-Louza"
"11040","Adam Masina_2022",2022,"Watford","Premier League","Adam Masina","MAR","DF","27",1994,12,24,13,11,10,3,12,29,41.4,17,18,6,12,18,42,45,0,"https://fbref.com/en/players/de0f152c/Adam-Masina"
"11041","Jeremy Ngakia_2022",2022,"Watford","Premier League","Jeremy Ngakia","ENG","DF","20",2000,10,31,18,23,5,3,11,26,42.3,15,11,4,7,12,43,32,0,"https://fbref.com/en/players/3631ad41/Jeremy-Ngakia"
"11042","Nicolas Nkoulou_2022",2022,"Watford","Premier League","Nicolas Nkoulou","CMR","DF","31",1990,1.9,1,0,0,1,0,0,0,NA,0,2,1,1,2,3,8,0,"https://fbref.com/en/players/93cf32a8/Nicolas-Nkoulou"
"11043","Danny Rose_2022",2022,"Watford","Premier League","Danny Rose","ENG","DF","31",1990,7.7,16,10,11,4,1,10,24,41.7,14,8,5,3,14,30,11,1,"https://fbref.com/en/players/89d10e53/Danny-Rose"
"11044","Samir Santos_2022",2022,"Watford","Premier League","Samir Santos","BRA","DF","26",1994,18.6,24,11,18,6,0,8,19,42.1,11,21,11,10,43,67,85,3,"https://fbref.com/en/players/92b4758e/Samir-Santos"
"11045","Ismaila Sarr_2022",2022,"Watford","Premier League","Ismaila Sarr","SEN","FW,MF","23",1998,20.7,12,7,4,3,5,5,19,26.3,14,10,1,9,9,21,10,0,"https://fbref.com/en/players/bfdb33aa/Ismaila-Sarr"
"11046","Ken Sema_2022",2022,"Watford","Premier League","Ken Sema","SWE","MF,FW","27",1993,9.5,16,6,11,4,1,9,20,45,11,10,0,10,5,21,11,0,"https://fbref.com/en/players/1770bd68/Ken-Sema"
"11047","Francisco Sierralta_2022",2022,"Watford","Premier League","Francisco Sierralta","CHI","DF","24",1997,4.7,7,3,7,0,0,5,8,62.5,3,7,2,5,6,13,35,0,"https://fbref.com/en/players/0f933743/Francisco-Sierralta"
"11048","Moussa Sissoko_2022",2022,"Watford","Premier League","Moussa Sissoko","FRA","MF","31",1989,35.8,53,27,27,20,6,28,42,66.7,14,42,13,29,30,83,64,0,"https://fbref.com/en/players/2acd49b9/Moussa-Sissoko"
"11049","William Troost-Ekong_2022",2022,"Watford","Premier League","William Troost-Ekong","NGA","DF","27",1993,15.4,18,9,11,6,1,10,15,66.7,5,24,14,10,7,25,82,1,"https://fbref.com/en/players/7ed4921e/William-Troost-Ekong"
"11050","Ozan Tufan_2022",2022,"Watford","Premier League","Ozan Tufan","TUR","MF","26",1995,3.7,3,2,1,1,1,1,5,20,4,2,0,2,2,5,4,0,"https://fbref.com/en/players/17d45fb2/Ozan-Tufan"
"11051","Michail Antonio_2022",2022,"West Ham","Premier League","Michail Antonio","JAM","FW","31",1990,33,23,17,5,9,9,7,18,38.9,11,19,1,18,3,26,13,0,"https://fbref.com/en/players/ac05f970/Michail-Antonio"
"11052","Alphonse Areola_2022",2022,"West Ham","Premier League","Alphonse Areola","FRA","GK","28",1993,1,0,0,0,0,0,0,0,NA,0,0,0,0,0,0,1,0,"https://fbref.com/en/players/2f965a72/Alphonse-Areola"
"11053","Harrison Ashby_2022",2022,"West Ham","Premier League","Harrison Ashby","SCO","DF","19",2001,0.1,0,0,0,0,0,0,0,NA,0,1,0,1,1,1,1,0,"https://fbref.com/en/players/b391383a/Harrison-Ashby"
"11054","Saïd Benrahma_2022",2022,"West Ham","Premier League","Saïd Benrahma","ALG","FW,MF","25",1995,24.1,28,17,16,9,3,15,38,39.5,23,17,1,16,9,37,8,0,"https://fbref.com/en/players/5a04fd92/Said-Benrahma"
"11055","Jarrod Bowen_2022",2022,"West Ham","Premier League","Jarrod Bowen","ENG","FW","24",1996,33.1,36,20,20,11,5,17,44,38.6,27,29,2,27,21,57,14,0,"https://fbref.com/en/players/79c84d1c/Jarrod-Bowen"
"11056","Daniel Chesters_2022",2022,"West Ham","Premier League","Daniel Chesters","ENG","MF","19",2002,0,0,0,0,0,0,0,0,NA,0,0,0,0,0,0,0,0,"https://fbref.com/en/players/240c8ab6/Daniel-Chesters"
"11057","Vladimír Coufal_2022",2022,"West Ham","Premier League","Vladimír Coufal","CZE","DF","28",1992,24.5,45,25,24,14,7,18,36,50,18,31,9,22,22,67,64,1,"https://fbref.com/en/players/fdf3cb77/Vladimir-Coufal"
"11058","Aaron Cresswell_2022",2022,"West Ham","Premier League","Aaron Cresswell","ENG","DF","31",1989,30.3,28,18,18,6,4,13,25,52,12,31,18,13,35,63,66,0,"https://fbref.com/en/players/4f974391/Aaron-Cresswell"
"11059","Craig Dawson_2022",2022,"West Ham","Premier League","Craig Dawson","ENG","DF","31",1990,30.6,29,17,20,8,1,14,25,56,11,59,52,7,29,58,139,0,"https://fbref.com/en/players/3e9e06cb/Craig-Dawson"
"11060","Issa Diop_2022",2022,"West Ham","Premier League","Issa Diop","FRA","DF","24",1997,10.7,10,8,5,5,0,4,11,36.4,7,14,13,1,7,17,44,0,"https://fbref.com/en/players/a712ca2b/Issa-Diop"
"11061","Łukasz Fabiański_2022",2022,"West Ham","Premier League","Łukasz Fabiański","POL","GK","36",1985,37,0,0,0,0,0,0,0,NA,0,0,0,0,0,0,11,0,"https://fbref.com/en/players/9328b835/Lukasz-Fabianski"
"11062","Pablo Fornals_2022",2022,"West Ham","Premier League","Pablo Fornals","ESP","FW,MF","25",1996,31.1,54,28,21,21,12,22,84,26.2,62,49,2,47,27,81,16,1,"https://fbref.com/en/players/82927de4/Pablo-Fornals"
"11063","Ryan Fredericks_2022",2022,"West Ham","Premier League","Ryan Fredericks","ENG","DF","28",1992,3.4,2,2,2,0,0,0,1,0,1,2,1,1,4,6,6,0,"https://fbref.com/en/players/c067631c/Ryan-Fredericks"
"11064","Ben Johnson_2022",2022,"West Ham","Premier League","Ben Johnson","ENG","DF","21",2000,15.5,33,16,15,15,3,21,28,75,7,16,8,8,22,55,55,0,"https://fbref.com/en/players/9319781b/Ben-Johnson"
"11065","Alex Král_2022",2022,"West Ham","Premier League","Alex Král","CZE","MF","23",1998,0,0,0,0,0,0,0,0,NA,0,0,0,0,0,0,0,0,"https://fbref.com/en/players/e717705a/Alex-Kral"
"11066","Manuel Lanzini_2022",2022,"West Ham","Premier League","Manuel Lanzini","ARG","MF,FW","28",1993,19.8,28,15,10,11,7,10,35,28.6,25,16,0,16,19,47,10,0,"https://fbref.com/en/players/26f6dca8/Manuel-Lanzini"
"11067","Arthur Masuaku_2022",2022,"West Ham","Premier League","Arthur Masuaku","COD","DF,FW","27",1993,7.2,31,23,19,11,1,14,23,60.9,9,9,1,8,9,40,17,0,"https://fbref.com/en/players/57df7a11/Arthur-Masuaku"
"11068","Mark Noble_2022",2022,"West Ham","Premier League","Mark Noble","ENG","MF","34",1987,3.7,8,2,7,1,0,5,11,45.5,6,4,1,3,4,12,2,1,"https://fbref.com/en/players/ff527768/Mark-Noble"
"11069","Angelo Ogbonna_2022",2022,"West Ham","Premier League","Angelo Ogbonna","ITA","DF","33",1988,10.2,7,4,5,2,0,3,7,42.9,4,5,4,1,11,18,29,0,"https://fbref.com/en/players/74b2cd7e/Angelo-Ogbonna"
"11070","Sonny Perkins_2022",2022,"West Ham","Premier League","Sonny Perkins","ENG","FW","17",2004,0,NA,0,NA,NA,NA,NA,NA,NA,NA,NA,NA,NA,0,NA,NA,NA,"https://fbref.com/en/players/87f12e30/Sonny-Perkins"
"11071","Declan Rice_2022",2022,"West Ham","Premier League","Declan Rice","ENG","MF","22",1999,35.3,80,42,45,32,3,38,71,53.5,33,45,21,24,63,143,52,1,"https://fbref.com/en/players/1c7012b8/Declan-Rice"
"11072","Tomáš Souček_2022",2022,"West Ham","Premier League","Tomáš Souček","CZE","MF","26",1995,34,66,32,27,33,6,28,65,43.1,37,34,13,21,52,118,98,1,"https://fbref.com/en/players/6613c819/Tomas-Soucek"
"11073","Nikola Vlašić_2022",2022,"West Ham","Premier League","Nikola Vlašić","CRO","FW,MF","23",1997,6.2,11,7,4,6,1,5,20,25,15,4,0,4,2,13,1,0,"https://fbref.com/en/players/aa8e289e/Nikola-Vlasic"
"11074","Andriy Yarmolenko_2022",2022,"West Ham","Premier League","Andriy Yarmolenko","UKR","FW,MF","31",1989,3.5,4,2,2,2,0,2,8,25,6,4,2,2,0,4,2,0,"https://fbref.com/en/players/849c826a/Andriy-Yarmolenko"
"11075","Kurt Zouma_2022",2022,"West Ham","Premier League","Kurt Zouma","FRA","DF","26",1994,23.1,11,6,8,3,0,4,7,57.1,3,31,26,5,34,45,132,0,"https://fbref.com/en/players/ce4246f5/Kurt-Zouma"
"11076","Maximilian Arnold_2022",2022,"Wolfsburg","Bundesliga","Maximilian Arnold","GER","MF","27",1994,33.3,37,20,19,16,2,20,50,40,30,43,15,28,37,74,55,0,"https://fbref.com/en/players/86e119e0/Maximilian-Arnold"
"11077","Ridle Baku_2022",2022,"Wolfsburg","Bundesliga","Ridle Baku","GER","DF,FW","23",1998,27.2,62,37,30,24,8,25,65,38.5,40,43,1,42,21,83,52,1,"https://fbref.com/en/players/442b56fa/Ridle-Baku"
"11078","Bartosz Bialek_2022",2022,"Wolfsburg","Bundesliga","Bartosz Bialek","POL","FW,DF","19",2001,2,0,0,0,0,0,0,1,0,1,1,0,1,0,0,2,0,"https://fbref.com/en/players/763b8b37/Bartosz-Bialek"
"11079","Sebastiaan Bornauw_2022",2022,"Wolfsburg","Bundesliga","Sebastiaan Bornauw","BEL","DF","22",1999,22.3,30,19,23,5,2,16,25,64,9,29,8,21,42,72,97,1,"https://fbref.com/en/players/01834aa0/Sebastiaan-Bornauw"
"11080","Josip Brekalo_2022",2022,"Wolfsburg","Bundesliga","Josip Brekalo","CRO","FW","23",1998,0.2,0,0,0,0,0,0,0,NA,0,0,0,0,0,0,0,0,"https://fbref.com/en/players/d4a2533d/Josip-Brekalo"
"11081","John Brooks_2022",2022,"Wolfsburg","Bundesliga","John Brooks","USA","DF","28",1993,29.1,47,25,25,18,4,36,60,60,24,33,19,14,41,88,125,1,"https://fbref.com/en/players/e27da244/John-Brooks"
"11082","Koen Casteels_2022",2022,"Wolfsburg","Bundesliga","Koen Casteels","BEL","GK","29",1992,28,0,0,0,0,0,0,1,0,1,0,0,0,0,0,9,2,"https://fbref.com/en/players/db401046/Koen-Casteels"
"11083","Yannick Gerhardt_2022",2022,"Wolfsburg","Bundesliga","Yannick Gerhardt","GER","MF,DF","27",1994,17.5,42,20,18,17,7,22,36,61.1,14,24,1,23,25,67,25,1,"https://fbref.com/en/players/62ab9184/Yannick-Gerhardt"
"11084","Daniel Ginczek_2022",2022,"Wolfsburg","Bundesliga","Daniel Ginczek","GER","MF,FW","30",1991,0.1,0,0,0,0,0,0,0,NA,0,0,0,0,0,0,0,0,"https://fbref.com/en/players/e5f63987/Daniel-Ginczek"
"11085","Josuha Guilavogui_2022",2022,"Wolfsburg","Bundesliga","Josuha Guilavogui","FRA","MF,DF","30",1990,10.5,23,14,13,9,1,7,18,38.9,11,11,6,5,25,48,42,0,"https://fbref.com/en/players/e6c43eec/Josuha-Guilavogui"
"11086","Max Kruse_2022",2022,"Wolfsburg","Bundesliga","Max Kruse","GER","MF,FW","33",1988,12.5,9,3,4,4,1,5,12,41.7,7,2,0,2,3,12,4,0,"https://fbref.com/en/players/f9446dcd/Max-Kruse"
"11087","Maxence Lacroix_2022",2022,"Wolfsburg","Bundesliga","Maxence Lacroix","FRA","DF","21",2000,27.7,59,33,41,16,2,29,40,72.5,11,35,16,19,60,119,144,0,"https://fbref.com/en/players/277c49ed/Maxence-Lacroix"
"11088","Dodi Lukebakio_2022",2022,"Wolfsburg","Bundesliga","Dodi Lukebakio","BEL","FW,MF","23",1997,9.8,7,4,3,2,2,1,10,10,9,5,0,5,13,20,4,0,"https://fbref.com/en/players/0c61c77c/Dodi-Lukebakio"
"11089","Omar Marmoush_2022",2022,"Wolfsburg","Bundesliga","Omar Marmoush","EGY","FW","22",1999,0.3,0,0,0,0,0,0,0,NA,0,0,0,0,0,0,0,0,"https://fbref.com/en/players/0e0102eb/Omar-Marmoush"
"11090","Kevin Mbabu_2022",2022,"Wolfsburg","Bundesliga","Kevin Mbabu","SUI","DF","26",1995,15.5,31,20,21,5,5,12,23,52.2,11,25,8,17,35,66,35,0,"https://fbref.com/en/players/493924a7/Kevin-Mbabu"
"11091","Admir Mehmedi_2022",2022,"Wolfsburg","Bundesliga","Admir Mehmedi","SUI","DF","30",1991,0,0,0,0,0,0,0,0,NA,0,0,0,0,0,0,0,0,"https://fbref.com/en/players/b500b384/Admir-Mehmedi"
"11092","Felix Nmecha_2022",2022,"Wolfsburg","Bundesliga","Felix Nmecha","GER","MF,FW","20",2000,3.6,3,1,1,1,1,0,2,0,2,2,0,2,7,10,6,0,"https://fbref.com/en/players/091c86e2/Felix-Nmecha"
"11093","Lukas Nmecha_2022",2022,"Wolfsburg","Bundesliga","Lukas Nmecha","GER","FW,MF","22",1998,18.1,12,5,5,5,2,5,19,26.3,14,9,1,8,4,16,10,0,"https://fbref.com/en/players/0cc5f4a5/Lukas-Nmecha"
"11094","Paulo Otávio_2022",2022,"Wolfsburg","Bundesliga","Paulo Otávio","BRA","DF,MF","26",1994,4,14,10,7,4,3,8,15,53.3,7,11,6,5,4,18,9,0,"https://fbref.com/en/players/1cbe4984/Paulo-Otavio"
"11095","Kevin Paredes_2022",2022,"Wolfsburg","Bundesliga","Kevin Paredes","USA","FW,DF","18",2003,0.2,1,0,0,0,1,0,0,NA,0,1,0,1,0,1,0,0,"https://fbref.com/en/players/5c50fdbc/Kevin-Paredes"
"11096","Pavao Pervan_2022",2022,"Wolfsburg","Bundesliga","Pavao Pervan","AUT","GK","33",1987,6,0,0,0,0,0,0,0,NA,0,0,0,0,0,0,3,0,"https://fbref.com/en/players/c89e8aae/Pavao-Pervan"
"11097","Maximilian Philipp_2022",2022,"Wolfsburg","Bundesliga","Maximilian Philipp","GER","MF","27",1994,10.7,15,11,6,7,2,5,21,23.8,16,12,1,11,4,19,5,0,"https://fbref.com/en/players/061e8e23/Maximilian-Philipp"
"11098","Jérôme Roussillon_2022",2022,"Wolfsburg","Bundesliga","Jérôme Roussillon","FRA","DF","28",1993,19.7,14,9,8,6,0,10,16,62.5,6,24,5,19,14,28,34,2,"https://fbref.com/en/players/13203c45/Jerome-Roussillon"
"11099","Xaver Schlager_2022",2022,"Wolfsburg","Bundesliga","Xaver Schlager","AUT","MF","23",1997,11.6,43,20,20,20,3,20,49,40.8,29,25,2,23,9,52,14,0,"https://fbref.com/en/players/8f056768/Xaver-Schlager"
"11100","Renato Steffen_2022",2022,"Wolfsburg","Bundesliga","Renato Steffen","SUI","FW,MF","29",1991,10.7,20,16,10,10,0,9,16,56.3,7,7,0,7,13,33,14,0,"https://fbref.com/en/players/dd669209/Renato-Steffen"
"11101","Micky van de Ven_2022",2022,"Wolfsburg","Bundesliga","Micky van de Ven","NED","DF","20",2001,2.1,4,4,3,1,0,0,1,0,1,4,1,3,2,6,8,0,"https://fbref.com/en/players/8fe2a392/Micky-van-de-Ven"
"11102","Aster Vranckx_2022",2022,"Wolfsburg","Bundesliga","Aster Vranckx","BEL","MF","18",2002,12.7,34,13,14,16,4,14,26,53.8,12,19,7,12,13,47,16,0,"https://fbref.com/en/players/f86cd5df/Aster-Vranckx"
"11103","Luca Waldschmidt_2022",2022,"Wolfsburg","Bundesliga","Luca Waldschmidt","GER","MF,FW","25",1996,8,9,1,3,5,1,5,13,38.5,8,5,0,5,8,17,3,0,"https://fbref.com/en/players/e5a35ae9/Luca-Waldschmidt"
"11104","Wout Weghorst_2022",2022,"Wolfsburg","Bundesliga","Wout Weghorst","NED","FW","28",1992,17.3,13,7,3,3,7,7,17,41.2,10,10,3,7,2,15,11,1,"https://fbref.com/en/players/c4e87b8b/Wout-Weghorst"
"11105","Jonas Wind_2022",2022,"Wolfsburg","Bundesliga","Jonas Wind","DEN","FW,MF","22",1999,13.1,10,6,1,7,2,1,4,25,3,8,3,5,6,16,13,0,"https://fbref.com/en/players/2077ae86/Jonas-Wind"
"11106","Rayan Aït Nouri_2022",2022,"Wolves","Premier League","Rayan Aït Nouri","ALG","DF,MF","20",2001,20.3,64,36,46,15,3,22,44,50,22,24,2,22,22,86,39,1,"https://fbref.com/en/players/9b398aea/Rayan-Ait-Nouri"
"11107","Willy Boly_2022",2022,"Wolves","Premier League","Willy Boly","CIV","DF","30",1991,10,25,19,18,7,0,8,15,53.3,7,14,6,8,14,39,35,0,"https://fbref.com/en/players/a4ac4b8f/Willy-Boly"
"11108","Chem Campbell_2022",2022,"Wolves","Premier League","Chem Campbell","WAL","MF","18",2002,0.1,1,1,0,1,0,0,0,NA,0,0,0,0,0,1,0,0,"https://fbref.com/en/players/6f711f67/Chem-Campbell"
"11109","Jonny Castro_2022",2022,"Wolves","Premier League","Jonny Castro","ESP","DF","27",1994,11.4,25,15,13,11,1,11,20,55,9,14,3,11,13,38,11,0,"https://fbref.com/en/players/e28868f3/Jonny-Castro"
"11110","Chiquinho_2022",2022,"Wolves","Premier League","Chiquinho","POR","DF,FW","21",2000,2.3,9,6,4,5,0,4,5,80,1,5,0,5,2,11,1,0,"https://fbref.com/en/players/dc6c2f02/Chiquinho"
"11111","Conor Coady_2022",2022,"Wolves","Premier League","Conor Coady","ENG","DF","28",1993,37.3,31,14,23,7,1,16,28,57.1,12,46,40,6,28,59,140,0,"https://fbref.com/en/players/2928dca2/Conor-Coady"
"11112","Luke Cundle_2022",2022,"Wolves","Premier League","Luke Cundle","ENG","MF","19",2002,2,4,3,0,4,0,1,1,100,0,0,0,0,1,5,1,0,"https://fbref.com/en/players/cc3b8e78/Luke-Cundle"
"11113","Leander Dendoncker_2022",2022,"Wolves","Premier League","Leander Dendoncker","BEL","MF","26",1995,21.7,42,17,25,14,3,22,50,44,28,37,10,27,9,51,38,1,"https://fbref.com/en/players/5a7301ae/Leander-Dendoncker"
"11114","Morgan Gibbs-White_2022",2022,"Wolves","Premier League","Morgan Gibbs-White","ENG","DF,FW","21",2000,0.1,0,0,0,0,0,0,0,NA,0,1,0,1,0,0,0,0,"https://fbref.com/en/players/32f60ed8/Morgan-Gibbs-White"
"11115","Toti Gomes_2022",2022,"Wolves","Premier League","Toti Gomes","POR","DF","22",1999,4,11,7,10,1,0,7,9,77.8,2,6,3,3,8,19,15,0,"https://fbref.com/en/players/f0caab96/Toti-Gomes"
"11116","Hwang Hee-chan_2022",2022,"Wolves","Premier League","Hwang Hee-chan","KOR","FW,MF","25",1996,20.2,27,13,9,16,2,14,44,31.8,30,10,0,10,13,40,7,1,"https://fbref.com/en/players/169fd162/Hwang-Hee-chan"
"11117","Ki-Jana Hoever_2022",2022,"Wolves","Premier League","Ki-Jana Hoever","NED","DF,MF","19",2002,3.4,10,6,5,5,0,7,12,58.3,5,6,0,6,6,16,8,0,"https://fbref.com/en/players/9a71e978/Ki-Jana-Hoever"
"11118","Raúl Jiménez_2022",2022,"Wolves","Premier League","Raúl Jiménez","MEX","FW","30",1991,29.2,29,14,6,16,7,6,30,20,24,31,5,26,13,42,26,0,"https://fbref.com/en/players/b561db50/Raul-Jimenez"
"11119","Max Kilman_2022",2022,"Wolves","Premier League","Max Kilman","ENG","DF","24",1997,29.9,50,26,38,10,2,24,37,64.9,13,36,21,15,45,95,113,3,"https://fbref.com/en/players/d0f72bf1/Max-Kilman"
"11120","Fernando Marçal_2022",2022,"Wolves","Premier League","Fernando Marçal","BRA","MF,DF","32",1989,16.1,42,22,27,14,1,21,37,56.8,16,25,4,21,28,70,52,0,"https://fbref.com/en/players/9ae9eaea/Fernando-Marcal"
"11121","João Moutinho_2022",2022,"Wolves","Premier League","João Moutinho","POR","MF","34",1986,33,74,39,34,27,13,30,106,28.3,76,48,8,40,34,108,36,2,"https://fbref.com/en/players/f5a00fa4/Joao-Moutinho"
"11122","Pedro Neto_2022",2022,"Wolves","Premier League","Pedro Neto","POR","FW,MF","21",2000,5.2,4,4,2,0,2,0,9,0,9,0,0,0,6,10,1,0,"https://fbref.com/en/players/7ba2eaa9/Pedro-Neto"
"11123","Rúben Neves_2022",2022,"Wolves","Premier League","Rúben Neves","POR","MF","24",1997,29.6,68,37,23,41,4,24,87,27.6,63,39,5,34,41,109,49,3,"https://fbref.com/en/players/44bfb6c5/Ruben-Neves"
"11124","Daniel Podence_2022",2022,"Wolves","Premier League","Daniel Podence","POR","FW,MF","25",1995,16.5,18,11,10,5,3,4,17,23.5,13,8,1,7,10,28,1,0,"https://fbref.com/en/players/7fcc71d8/Daniel-Podence"
"11125","John Ruddy_2022",2022,"Wolves","Premier League","John Ruddy","ENG","GK","34",1986,1.5,0,0,0,0,0,0,0,NA,0,0,0,0,0,0,3,0,"https://fbref.com/en/players/da8b19e2/John-Ruddy"
"11126","José Sá_2022",2022,"Wolves","Premier League","José Sá","POR","GK","28",1993,36.5,2,1,2,0,0,2,4,50,2,0,0,0,2,4,19,5,"https://fbref.com/en/players/903b6e8b/Jose-Sa"
"11127","Romain Saïss_2022",2022,"Wolves","Premier League","Romain Saïss","MAR","DF","31",1990,30.1,40,27,28,11,1,19,33,57.6,14,41,21,20,58,98,158,2,"https://fbref.com/en/players/9fbbcf39/Romain-Saiss"
"11128","Nélson Semedo_2022",2022,"Wolves","Premier League","Nélson Semedo","POR","MF,DF","27",1993,23.7,58,39,39,17,2,25,49,51,24,23,4,19,21,79,64,1,"https://fbref.com/en/players/d04b94db/Nelson-Semedo"
"11129","Fábio Silva_2022",2022,"Wolves","Premier League","Fábio Silva","POR","FW","19",2002,6.4,3,2,0,2,1,0,8,0,8,2,0,2,1,4,1,0,"https://fbref.com/en/players/e7aa9d7c/Fabio-Silva"
"11130","Adama Traoré_2022",2022,"Wolves","Premier League","Adama Traoré","ESP","FW,MF","25",1996,11.9,8,3,6,0,2,3,7,42.9,4,4,1,3,2,10,1,0,"https://fbref.com/en/players/9a28eba4/Adama-Traore"
"11131","Francisco Trincão_2022",2022,"Wolves","Premier League","Francisco Trincão","POR","FW,MF","21",1999,14.8,28,15,9,13,6,3,19,15.8,16,17,1,16,12,40,1,1,"https://fbref.com/en/players/77e39b04/Francisco-Trincao"
"11132","Mickaël Alphonse_2023",2023,"Ajaccio","Ligue 1","Mickaël Alphonse","GLP","DF","33",1989,15.1,35,23,20,11,4,20,33,60.6,13,17,5,12,35,70,44,1,"https://fbref.com/en/players/0a63446f/Mickael-Alphonse"
"11133","Cédric Avinel_2023",2023,"Ajaccio","Ligue 1","Cédric Avinel","GLP","DF","35",1986,19.9,13,7,8,5,0,8,12,66.7,4,20,13,7,15,28,91,1,"https://fbref.com/en/players/a94d93be/Cedric-Avinel"
"11134","Mickaël Barreto_2023",2023,"Ajaccio","Ligue 1","Mickaël Barreto","FRA","MF","31",1991,14.7,32,20,12,17,3,8,45,17.8,37,17,0,17,18,50,11,0,"https://fbref.com/en/players/e3844ecb/Mickael-Barreto"
"11135","Cyrille Bayala_2023",2023,"Ajaccio","Ligue 1","Cyrille Bayala","BFA","MF","26",1996,22.3,53,37,16,20,17,23,47,48.9,24,20,3,17,25,78,21,0,"https://fbref.com/en/players/20e0dd86/Cyrille-Bayala"
"11136","Youcef Belaïli_2023",2023,"Ajaccio","Ligue 1","Youcef Belaïli","ALG","MF,FW","30",1992,12.8,18,10,3,9,6,8,20,40,12,10,1,9,5,23,4,0,"https://fbref.com/en/players/1a248246/Youcef-Belaili"
"11137","Kouamé Botué_2023",2023,"Ajaccio","Ligue 1","Kouamé Botué","BFA","FW,MF","19",2002,2.5,4,2,2,1,1,0,2,0,2,1,0,1,0,4,1,0,"https://fbref.com/en/players/65fcf987/Kouame-Botue"
"11138","Florian Chabrolle_2023",2023,"Ajaccio","Ligue 1","Florian Chabrolle","FRA","MF","24",1998,3.7,6,4,1,5,0,2,4,50,2,3,0,3,7,13,2,0,"https://fbref.com/en/players/5d9577aa/Florian-Chabrolle"
"11139","Ivane Chegra_2023",2023,"Ajaccio","Ligue 1","Ivane Chegra","FRA","MF,FW","18",2004,2.1,8,3,6,1,1,4,11,36.4,7,0,0,0,1,9,0,0,"https://fbref.com/en/players/1237c049/Ivane-Chegra"
"11140","Yanis Cimignani_2023",2023,"Ajaccio","Ligue 1","Yanis Cimignani","FRA","MF,DF","20",2002,3.1,11,5,3,7,1,4,5,80,1,5,1,4,2,13,2,0,"https://fbref.com/en/players/7495aba7/Yanis-Cimignani"
"11141","Mathieu Coutadeur_2023",2023,"Ajaccio","Ligue 1","Mathieu Coutadeur","FRA","MF","36",1986,21.6,23,13,13,10,0,8,28,28.6,20,19,3,16,19,42,21,0,"https://fbref.com/en/players/ef8ae23b/Mathieu-Coutadeur"
"11142","Ismael Diallo_2023",2023,"Ajaccio","Ligue 1","Ismael Diallo","CIV","DF","25",1997,24.2,46,33,35,9,2,35,63,55.6,28,26,12,14,30,76,46,1,"https://fbref.com/en/players/b3244eeb/Ismael-Diallo"
"11143","Moussa Djitte_2023",2023,"Ajaccio","Ligue 1","Moussa Djitte","SEN","FW","22",1999,1.5,1,0,0,0,1,1,2,50,1,0,0,0,0,1,1,0,"https://fbref.com/en/players/627b570a/Moussa-Djitte"
"11144","Oumar Gonzalez_2023",2023,"Ajaccio","Ligue 1","Oumar Gonzalez","CMR","DF","24",1998,28.6,51,28,34,13,4,23,37,62.2,14,32,11,21,52,103,82,0,"https://fbref.com/en/players/a9d4c241/Oumar-Gonzalez"
"11145","Ben Hamed Touré_2023",2023,"Ajaccio","Ligue 1","Ben Hamed Touré","CIV","FW","18",2003,2.3,4,4,2,2,0,1,5,20,4,2,0,2,1,5,4,0,"https://fbref.com/en/players/c7eebddf/Ben-Hamed-Toure"
"11146","Romain Hamouma_2023",2023,"Ajaccio","Ligue 1","Romain Hamouma","FRA","FW,MF","35",1987,12,8,3,3,3,2,3,6,50,3,8,0,8,2,10,2,0,"https://fbref.com/en/players/0b4d8274/Romain-Hamouma"
"11147","Mounaim El Idrissy_2023",2023,"Ajaccio","Ligue 1","Mounaim El Idrissy","FRA","FW","23",1999,27.7,32,19,5,20,7,10,36,27.8,26,22,0,22,13,45,20,0,"https://fbref.com/en/players/fb0ee44e/Mounaim-El-Idrissy"
"11148","Anthony Khelifa_2023",2023,"Ajaccio","Ligue 1","Anthony Khelifa","FRA","DF","16",2005,0.1,0,0,0,0,0,0,0,NA,0,0,0,0,0,0,0,0,"https://fbref.com/en/players/3670aa71/Anthony-Khelifa"
"11149","Youssouf Koné_2023",2023,"Ajaccio","Ligue 1","Youssouf Koné","MLI","DF","27",1995,10.2,28,19,24,4,0,18,25,72,7,9,2,7,12,40,32,1,"https://fbref.com/en/players/e6eadfb8/Youssouf-Kone"
"11150","Qazim Laçi_2023",2023,"Ajaccio","Ligue 1","Qazim Laçi","ALB","MF","26",1996,2.4,6,3,2,3,1,4,9,44.4,5,5,0,5,2,8,3,0,"https://fbref.com/en/players/eb0db257/Qazim-Laci"
"11151","Paolo Lebas_2023",2023,"Ajaccio","Ligue 1","Paolo Lebas","POR","MF","19",2003,0.6,0,0,0,0,0,0,0,NA,0,0,0,0,0,0,0,0,"https://fbref.com/en/players/5bf26efc/Paolo-Lebas"
"11152","Benjamin Leroy_2023",2023,"Ajaccio","Ligue 1","Benjamin Leroy","FRA","GK","33",1989,31.1,0,0,0,0,0,0,2,0,2,0,0,0,1,1,16,2,"https://fbref.com/en/players/1e7aea56/Benjamin-Leroy"
"11153","Ruan Levine_2023",2023,"Ajaccio","Ligue 1","Ruan Levine","BRA","MF,FW","23",1999,0.3,2,2,1,1,0,0,0,NA,0,1,0,1,2,4,0,0,"https://fbref.com/en/players/17e25e72/Ruan-Levine"
"11154","Thomas Mangani_2023",2023,"Ajaccio","Ligue 1","Thomas Mangani","FRA","MF","35",1987,14.8,32,17,14,15,3,18,47,38.3,29,22,3,19,24,56,22,1,"https://fbref.com/en/players/c801616a/Thomas-Mangani"
"11155","Vincent Marchetti_2023",2023,"Ajaccio","Ligue 1","Vincent Marchetti","FRA","MF","25",1997,27.2,55,26,29,19,7,25,68,36.8,43,23,3,20,19,74,31,0,"https://fbref.com/en/players/740f00ac/Vincent-Marchetti"
"11156","Fernand Mayembo_2023",2023,"Ajaccio","Ligue 1","Fernand Mayembo","CGO","DF","26",1996,7.9,8,5,6,2,0,4,9,44.4,5,2,0,2,11,19,36,0,"https://fbref.com/en/players/b20cc590/Fernand-Mayembo"
"11157","Bevic Moussiti-Oko_2023",2023,"Ajaccio","Ligue 1","Bevic Moussiti-Oko","CGO","FW","27",1995,7.8,3,1,1,1,1,1,2,50,1,5,3,2,2,5,8,0,"https://fbref.com/en/players/71d10572/Bevic-Moussiti-Oko"
"11158","Riad Nouri_2023",2023,"Ajaccio","Ligue 1","Riad Nouri","FRA","MF,FW","37",1985,18.8,21,12,7,10,4,12,29,41.4,17,8,1,7,15,36,11,0,"https://fbref.com/en/players/374fbf7d/Riad-Nouri"
"11159","Mehdi Puch Herrantz_2023",2023,"Ajaccio","Ligue 1","Mehdi Puch Herrantz","FRA","MF","18",2004,0.5,2,2,0,1,1,1,2,50,1,1,0,1,3,5,0,0,"https://fbref.com/en/players/7be7c08b/Mehdi-Puch-Herrantz"
"11160","Ghjuvanni Quilichini_2023",2023,"Ajaccio","Ligue 1","Ghjuvanni Quilichini","FRA","GK","19",2002,0.9,0,0,0,0,0,0,0,NA,0,0,0,0,0,0,1,0,"https://fbref.com/en/players/1b729a98/Ghjuvanni-Quilichini"
"11161","François-Joseph Sollacaro_2023",2023,"Ajaccio","Ligue 1","François-Joseph Sollacaro","FRA","GK","28",1994,6,0,0,0,0,0,0,0,NA,0,0,0,0,0,0,2,2,"https://fbref.com/en/players/f19f32b1/Francois-Joseph-Sollacaro"
"11162","Moussa Soumano_2023",2023,"Ajaccio","Ligue 1","Moussa Soumano","FRA","FW","17",2005,5.5,2,2,0,1,1,0,6,0,6,2,0,2,0,2,0,0,"https://fbref.com/en/players/86a49468/Moussa-Soumano"
"11163","Kevin Spadanuda_2023",2023,"Ajaccio","Ligue 1","Kevin Spadanuda","SUI","MF,FW","25",1997,11.8,29,18,15,9,5,12,33,36.4,21,18,0,18,11,40,5,0,"https://fbref.com/en/players/a45a5d95/Kevin-Spadanuda"
"11164","Tony Strata_2023",2023,"Ajaccio","Ligue 1","Tony Strata","FRA","MF,DF","17",2004,1.5,4,3,4,0,0,4,5,80,1,2,0,2,1,5,7,0,"https://fbref.com/en/players/4ca4f263/Tony-Strata"
"11165","Yoann Touzghar_2023",2023,"Ajaccio","Ligue 1","Yoann Touzghar","TUN","FW","35",1986,5,3,2,0,2,1,0,1,0,1,0,0,0,0,3,1,0,"https://fbref.com/en/players/4e47507a/Yoann-Touzghar"
"11166","Clément Vidal_2023",2023,"Ajaccio","Ligue 1","Clément Vidal","FRA","DF,MF","22",2000,21.1,25,15,14,11,0,18,38,47.4,20,27,16,11,27,52,73,1,"https://fbref.com/en/players/b2791a55/Clement-Vidal"
"11167","Mohamed Youssouf_2023",2023,"Ajaccio","Ligue 1","Mohamed Youssouf","COM","DF","34",1988,27.3,72,44,41,24,7,38,61,62.3,23,32,8,24,65,137,70,0,"https://fbref.com/en/players/1a85bcdb/Mohamed-Youssouf"
"11168","Sergio Akieme_2023",2023,"Almería","La Liga","Sergio Akieme","ESP","DF","24",1997,25.5,27,16,19,6,2,12,22,54.5,10,22,6,16,14,41,41,0,"https://fbref.com/en/players/06efa9dc/Sergio-Akieme"
"11169","Srđan Babić_2023",2023,"Almería","La Liga","Srđan Babić","SRB","DF","26",1996,33.3,28,18,20,8,0,15,32,46.9,17,34,22,12,29,57,124,1,"https://fbref.com/en/players/075fe5a3/Srdjan-Babic"
"11170","Léo Baptistão_2023",2023,"Almería","La Liga","Léo Baptistão","BRA","FW,MF","29",1992,19.2,32,20,13,16,3,13,33,39.4,20,17,2,15,19,51,12,0,"https://fbref.com/en/players/35f6db55/Leo-Baptistao"
"11171","El Bilal Touré_2023",2023,"Almería","La Liga","El Bilal Touré","MLI","FW","20",2001,14,4,3,2,1,1,0,3,0,3,6,1,5,1,5,23,0,"https://fbref.com/en/players/47c609d5/El-Bilal-Toure"
"11172","Juan Brandáriz_2023",2023,"Almería","La Liga","Juan Brandáriz","ESP","DF","23",1999,16.5,29,16,18,9,2,14,23,60.9,9,20,7,13,15,44,53,0,"https://fbref.com/en/players/2475cf9b/Juan-Brandariz"
"11173","José Carlos Lazo_2023",2023,"Almería","La Liga","José Carlos Lazo","ESP","MF,FW","26",1996,0.2,0,0,0,0,0,0,0,NA,0,0,0,0,0,0,0,0,"https://fbref.com/en/players/5b93209a/Jose-Carlos-Lazo"
"11174","Álex Centelles_2023",2023,"Almería","La Liga","Álex Centelles","ESP","DF","24",1997,12.5,22,14,16,3,3,16,22,72.7,6,13,2,11,11,33,40,0,"https://fbref.com/en/players/ae852b7d/Alex-Centelles"
"11175","Samu Costa_2023",2023,"Almería","La Liga","Samu Costa","POR","MF","21",2000,22.1,61,31,35,20,6,29,61,47.5,32,29,7,22,37,98,64,4,"https://fbref.com/en/players/76c2a023/Samu-Costa"
"11176","Curro_2023",2023,"Almería","La Liga","Curro","ESP","MF","26",1996,0.5,2,0,1,1,0,1,2,50,1,0,0,0,0,2,0,0,"https://fbref.com/en/players/f9a225f5/Curro"
"11177","Íñigo Eguaras_2023",2023,"Almería","La Liga","Íñigo Eguaras","ESP","MF","30",1992,10.7,11,8,4,6,1,5,18,27.8,13,9,3,6,6,17,15,0,"https://fbref.com/en/players/3e93f8cf/Inigo-Eguaras"
"11178","Rodrigo Ely_2023",2023,"Almería","La Liga","Rodrigo Ely","BRA","DF","28",1993,35.1,30,21,26,4,0,18,25,72,7,46,33,13,31,61,203,1,"https://fbref.com/en/players/fd47b4f2/Rodrigo-Ely"
"11179","Adri Embarba_2023",2023,"Almería","La Liga","Adri Embarba","ESP","FW,MF","30",1992,16.4,50,27,21,26,3,22,46,47.8,24,23,0,23,9,59,9,0,"https://fbref.com/en/players/db8f0eba/Adri-Embarba"
"11180","Fernando_2023",2023,"Almería","La Liga","Fernando","ESP","GK","32",1990,36.5,0,0,0,0,0,0,2,0,2,2,0,2,1,1,20,3,"https://fbref.com/en/players/dabb2827/Fernando"
"11181","Luis Javier Suárez_2023",2023,"Almería","La Liga","Luis Javier Suárez","COL","FW","24",1997,16.6,17,11,5,6,6,6,26,23.1,20,13,3,10,3,20,10,0,"https://fbref.com/en/players/eeba07f8/Luis-Javier-Suarez"
"11182","Kaiky_2023",2023,"Almería","La Liga","Kaiky","BRA","DF","18",2004,6.5,5,5,5,0,0,3,7,42.9,4,18,10,8,11,16,28,0,"https://fbref.com/en/players/55634fb8/Kaiky"
"11183","César de la Hoz_2023",2023,"Almería","La Liga","César de la Hoz","ESP","MF","30",1992,18.6,37,20,17,18,2,19,37,51.4,18,26,6,20,13,50,37,0,"https://fbref.com/en/players/60abea75/Cesar-de-la-Hoz"
"11184","Lázaro_2023",2023,"Almería","La Liga","Lázaro","BRA","FW,MF","20",2002,8,4,3,3,0,1,3,15,20,12,16,1,15,2,6,1,0,"https://fbref.com/en/players/86ff856b/Lazaro"
"11185","Diego Mariño_2023",2023,"Almería","La Liga","Diego Mariño","ESP","GK","32",1990,0.5,0,0,0,0,0,0,0,NA,0,0,0,0,0,0,0,0,"https://fbref.com/en/players/d9235a45/Diego-Marino"
"11186","Gonzalo Melero_2023",2023,"Almería","La Liga","Gonzalo Melero","ESP","MF","28",1994,20.6,32,16,9,18,5,11,39,28.2,28,23,2,21,7,39,19,1,"https://fbref.com/en/players/3902e91b/Gonzalo-Melero"
"11187","Houboulang Mendes_2023",2023,"Almería","La Liga","Houboulang Mendes","FRA","DF","24",1998,9.8,19,11,16,3,0,11,27,40.7,16,12,2,10,7,26,23,1,"https://fbref.com/en/players/1545cf15/Houboulang-Mendes"
"11188","Marko Milovanović_2023",2023,"Almería","La Liga","Marko Milovanović","SRB","FW","18",2003,0.2,0,0,0,0,0,0,0,NA,0,0,0,0,0,0,0,0,"https://fbref.com/en/players/1fda2b14/Marko-Milovanovic"
"11189","Fernando Pacheco_2023",2023,"Almería","La Liga","Fernando Pacheco","ESP","GK","30",1992,1,0,0,0,0,0,0,0,NA,0,0,0,0,0,0,1,0,"https://fbref.com/en/players/97852360/Fernando-Pacheco"
"11190","Francisco Portillo_2023",2023,"Almería","La Liga","Francisco Portillo","ESP","MF,FW","32",1990,8,13,6,4,5,4,3,16,18.8,13,7,1,6,7,20,8,0,"https://fbref.com/en/players/8e010ff4/Francisco-Portillo"
"11191","Alejandro Pozo Pozo_2023",2023,"Almería","La Liga","Alejandro Pozo Pozo","ESP","DF","23",1999,20.9,37,19,17,17,3,27,53,50.9,26,30,5,25,26,63,45,1,"https://fbref.com/en/players/3c16d927/Alejandro-Pozo-Pozo"
"11192","Arnau Puigmal_2023",2023,"Almería","La Liga","Arnau Puigmal","ESP","MF,FW","21",2001,8.5,22,14,10,7,5,12,17,70.6,5,7,0,7,11,33,6,0,"https://fbref.com/en/players/39352da2/Arnau-Puigmal"
"11193","Largie Ramazani_2023",2023,"Almería","La Liga","Largie Ramazani","BEL","FW,MF","21",2001,15.6,15,9,6,3,6,8,27,29.6,19,11,0,11,15,30,10,0,"https://fbref.com/en/players/cc9256ef/Largie-Ramazani"
"11194","Lucas Robertone_2023",2023,"Almería","La Liga","Lucas Robertone","ARG","MF","25",1997,31.6,50,28,20,21,9,28,64,43.8,36,45,7,38,46,96,46,1,"https://fbref.com/en/players/a8981944/Lucas-Robertone"
"11195","Umar Sadiq_2023",2023,"Almería","La Liga","Umar Sadiq","NGA","FW","25",1997,2.7,0,0,0,0,0,0,1,0,1,2,0,2,0,0,3,0,"https://fbref.com/en/players/686cbe7d/Umar-Sadiq"
"11196","Dyego Sousa_2023",2023,"Almería","La Liga","Dyego Sousa","POR","FW","32",1989,5.9,10,6,5,4,1,4,5,80,1,4,2,2,1,11,14,0,"https://fbref.com/en/players/e4738e91/Dyego-Sousa"
"11197","Himad Abdelli_2023",2023,"Angers","Ligue 1","Himad Abdelli","ALG","MF,FW","22",1999,23.7,64,38,22,32,10,31,67,46.3,36,30,1,29,28,92,15,0,"https://fbref.com/en/players/7978cbf0/Himad-Abdelli"
"11198","Ibrahim Amadou_2023",2023,"Angers","Ligue 1","Ibrahim Amadou","FRA","DF,MF","29",1993,4.7,10,7,6,3,1,7,11,63.6,4,7,3,4,10,20,20,0,"https://fbref.com/en/players/9260926b/Ibrahim-Amadou"
"11199","Abdoulaye Bamba_2023",2023,"Angers","Ligue 1","Abdoulaye Bamba","CIV","DF","32",1990,15.2,22,12,15,5,2,16,19,84.2,3,7,3,4,18,40,38,0,"https://fbref.com/en/players/7fecbcdb/Abdoulaye-Bamba"
"11200","Nabil Bentaleb_2023",2023,"Angers","Ligue 1","Nabil Bentaleb","ALG","MF","27",1994,27.7,74,40,31,35,8,36,61,59,25,33,11,22,44,118,29,3,"https://fbref.com/en/players/3189f61a/Nabil-Bentaleb"
"11201","Paul Bernardoni_2023",2023,"Angers","Ligue 1","Paul Bernardoni","FRA","GK","25",1997,27,2,0,2,0,0,2,3,66.7,1,1,0,1,1,3,12,1,"https://fbref.com/en/players/28dabd43/Paul-Bernardoni"
"11202","Miha Blažič_2023",2023,"Angers","Ligue 1","Miha Blažič","SVN","DF","29",1993,22,8,6,8,0,0,7,15,46.7,8,25,19,6,22,30,80,1,"https://fbref.com/en/players/3cdfc63e/Miha-Blazic"
"11203","Antonin Bobichon_2023",2023,"Angers","Ligue 1","Antonin Bobichon","FRA","MF","26",1995,0.2,0,0,0,0,0,0,0,NA,0,1,0,1,0,0,0,0,"https://fbref.com/en/players/7d937aa1/Antonin-Bobichon"
"11204","Sofiane Boufal_2023",2023,"Angers","Ligue 1","Sofiane Boufal","MAR","FW,MF","28",1993,9.3,14,9,7,4,3,3,14,21.4,11,6,0,6,5,19,1,0,"https://fbref.com/en/players/b0c71810/Sofiane-Boufal"
"11205","Ousmane Camara_2023",2023,"Angers","Ligue 1","Ousmane Camara","FRA","DF","19",2003,5.8,10,6,5,5,0,5,12,41.7,7,4,2,2,11,21,15,0,"https://fbref.com/en/players/7d3dfdfd/Ousmane-Camara"
"11206","Pierrick Capelle_2023",2023,"Angers","Ligue 1","Pierrick Capelle","FRA","MF,DF","35",1987,15.9,36,21,17,15,4,22,55,40,33,24,3,21,15,51,24,0,"https://fbref.com/en/players/79b2399c/Pierrick-Capelle"
"11207","Ilyes Cheti_2023",2023,"Angers","Ligue 1","Ilyes Cheti","ALG","DF","27",1995,2.3,6,4,4,0,2,5,8,62.5,3,5,1,4,4,10,7,0,"https://fbref.com/en/players/9d498560/Ilyes-Cheti"
"11208","Lois Diony_2023",2023,"Angers","Ligue 1","Lois Diony","FRA","FW","29",1992,5.6,1,0,0,1,0,1,3,33.3,2,2,0,2,0,1,1,0,"https://fbref.com/en/players/4be0b467/Lois-Diony"
"11209","Souleyman Doumbia_2023",2023,"Angers","Ligue 1","Souleyman Doumbia","CIV","DF,FW","25",1996,19.9,45,31,31,13,1,17,31,54.8,14,20,3,17,27,72,27,1,"https://fbref.com/en/players/9daeac61/Souleyman-Doumbia"
"11210","Yahia Fofana_2023",2023,"Angers","Ligue 1","Yahia Fofana","FRA","GK","21",2000,11,0,0,0,0,0,0,0,NA,0,0,0,0,1,1,4,1,"https://fbref.com/en/players/9d420dad/Yahia-Fofana"
"11211","Faouzi Ghoulam_2023",2023,"Angers","Ligue 1","Faouzi Ghoulam","ALG","DF","31",1991,5.3,3,3,1,1,1,3,5,60,2,4,2,2,4,7,12,1,"https://fbref.com/en/players/c5adc293/Faouzi-Ghoulam"
"11212","Cédric Hountondji_2023",2023,"Angers","Ligue 1","Cédric Hountondji","BEN","DF","28",1994,34.4,50,36,31,17,2,19,29,65.5,10,44,22,22,59,109,132,1,"https://fbref.com/en/players/00891164/Cedric-Hountondji"
"11213","Adrien Hunou_2023",2023,"Angers","Ligue 1","Adrien Hunou","FRA","MF,FW","28",1994,24.8,39,20,17,16,6,16,45,35.6,29,35,0,35,7,46,7,0,"https://fbref.com/en/players/d14229f3/Adrien-Hunou"
"11214","Marin Jakoliš_2023",2023,"Angers","Ligue 1","Marin Jakoliš","CRO","FW","25",1996,0.3,1,1,0,0,1,0,0,NA,0,0,0,0,0,1,0,0,"https://fbref.com/en/players/96f4ebc0/Marin-Jakolis"
"11215","Justin-Noël Kalumba_2023",2023,"Angers","Ligue 1","Justin-Noël Kalumba","FRA","DF","17",2004,6.1,9,5,5,2,2,5,16,31.3,11,4,1,3,4,13,5,0,"https://fbref.com/en/players/32e2163d/Justin-Noel-Kalumba"
"11216","Jean Mattéo Bahoya_2023",2023,"Angers","Ligue 1","Jean Mattéo Bahoya","FRA","FW,MF","17",2005,3,7,3,1,3,3,4,7,57.1,3,4,0,4,0,7,0,0,"https://fbref.com/en/players/70d4c949/Jean-Matteo-Bahoya"
"11217","Jason Mbock_2023",2023,"Angers","Ligue 1","Jason Mbock","FRA","MF,FW","22",1999,0.3,0,0,0,0,0,0,0,NA,0,0,0,0,0,0,0,0,"https://fbref.com/en/players/890bc029/Jason-Mbock"
"11218","Farid El Melali_2023",2023,"Angers","Ligue 1","Farid El Melali","ALG","DF,FW","25",1997,9,21,12,7,12,2,11,22,50,11,16,0,16,8,29,7,0,"https://fbref.com/en/players/d21e361a/Farid-El-Melali"
"11219","Batista Mendy_2023",2023,"Angers","Ligue 1","Batista Mendy","FRA","MF,DF","22",2000,31.8,70,30,34,28,8,37,53,69.8,16,38,6,32,21,91,29,2,"https://fbref.com/en/players/e472a6f6/Batista-Mendy"
"11220","Ibrahima Niane_2023",2023,"Angers","Ligue 1","Ibrahima Niane","SEN","FW","23",1999,12.6,6,2,1,4,1,1,6,16.7,5,8,2,6,1,7,9,0,"https://fbref.com/en/players/46faabfa/Ibrahima-Niane"
"11221","Zinédine Ould Khaled_2023",2023,"Angers","Ligue 1","Zinédine Ould Khaled","FRA","MF,FW","22",2000,0.6,1,1,0,1,0,0,1,0,1,0,0,0,2,3,0,0,"https://fbref.com/en/players/6b4436ba/Zinedine-Ould-Khaled"
"11222","Azzedine Ounahi_2023",2023,"Angers","Ligue 1","Azzedine Ounahi","MAR","MF,FW","22",2000,12.5,19,8,5,13,1,10,20,50,10,8,0,8,15,34,4,1,"https://fbref.com/en/players/83299cc0/Azzedine-Ounahi"
"11223","Lilian Raolisoa_2023",2023,"Angers","Ligue 1","Lilian Raolisoa","FRA","DF,MF","22",2000,1.9,11,9,6,3,2,7,10,70,3,3,1,2,3,14,5,0,"https://fbref.com/en/players/79a793b7/Lilian-Raolisoa"
"11224","Halid Šabanović_2023",2023,"Angers","Ligue 1","Halid Šabanović","BIH","DF","22",1999,7.1,8,6,7,1,0,6,8,75,2,8,2,6,8,16,12,0,"https://fbref.com/en/players/8299e363/Halid-Sabanovic"
"11225","Amine Salama_2023",2023,"Angers","Ligue 1","Amine Salama","FRA","FW,MF","22",2000,13.9,11,9,3,7,1,2,12,16.7,10,8,2,6,10,21,2,0,"https://fbref.com/en/players/bc7cc472/Amine-Salama"
"11226","Abdallah Sima_2023",2023,"Angers","Ligue 1","Abdallah Sima","SEN","FW","21",2001,20.4,22,13,4,15,3,7,19,36.8,12,8,0,8,4,26,19,0,"https://fbref.com/en/players/fdbde523/Abdallah-Sima"
"11227","Waniss Taibi_2023",2023,"Angers","Ligue 1","Waniss Taibi","FRA","MF","20",2002,2.1,9,5,4,4,1,2,4,50,2,1,0,1,2,11,2,0,"https://fbref.com/en/players/95192fe4/Waniss-Taibi"
"11228","Sada Thioub_2023",2023,"Angers","Ligue 1","Sada Thioub","SEN","DF,FW","27",1995,11.8,19,10,9,8,2,8,17,47.1,9,13,0,13,7,26,5,1,"https://fbref.com/en/players/f4bc42b1/Sada-Thioub"
"11229","Yan Valery_2023",2023,"Angers","Ligue 1","Yan Valery","TUN","DF","23",1999,27.7,54,39,28,20,6,20,37,54.1,17,35,15,20,34,88,82,0,"https://fbref.com/en/players/531a4aa8/Yan-Valery"
"11230","Gabriel Dos Santos_2023",2023,"Arsenal","Premier League","Gabriel Dos Santos","BRA","DF","24",1997,37.9,48,30,29,15,4,18,27,66.7,9,49,26,23,32,80,125,2,"https://fbref.com/en/players/67ac5bb8/Gabriel-Dos-Santos"
"11231","Mohamed Elneny_2023",2023,"Arsenal","Premier League","Mohamed Elneny","EGY","MF","30",1992,1.3,1,1,1,0,0,1,1,100,0,0,0,0,0,1,0,0,"https://fbref.com/en/players/47a34c4f/Mohamed-Elneny"
"11232","Rob Holding_2023",2023,"Arsenal","Premier League","Rob Holding","ENG","DF","26",1995,6.3,8,5,4,4,0,3,6,50,3,6,5,1,3,11,27,1,"https://fbref.com/en/players/d79a8c87/Rob-Holding"
"11233","Gabriel Jesus_2023",2023,"Arsenal","Premier League","Gabriel Jesus","BRA","FW","25",1997,22.9,33,25,16,8,9,15,31,48.4,16,27,3,24,11,44,15,1,"https://fbref.com/en/players/b66315ae/Gabriel-Jesus"
"11234","Jorginho_2023",2023,"Arsenal","Premier League","Jorginho","ITA","MF","30",1991,9.5,18,13,6,10,2,5,24,20.8,19,7,2,5,9,27,8,0,"https://fbref.com/en/players/45db685d/Jorginho"
"11235","Jakub Kiwior_2023",2023,"Arsenal","Premier League","Jakub Kiwior","POL","DF","22",2000,4.7,7,5,6,1,0,5,8,62.5,3,5,3,2,6,13,10,0,"https://fbref.com/en/players/dc3e663e/Jakub-Kiwior"
"11236","Marquinhos_2023",2023,"Arsenal","Premier League","Marquinhos","BRA","MF","19",2003,0,0,0,0,0,0,0,0,NA,0,0,0,0,0,0,0,0,"https://fbref.com/en/players/59878425/Marquinhos"
"11237","Martinelli_2023",2023,"Arsenal","Premier League","Martinelli","BRA","FW","21",2001,31,31,18,13,12,6,9,22,40.9,13,24,1,23,9,40,14,0,"https://fbref.com/en/players/48a5a5d6/Martinelli"
"11238","Reiss Nelson_2023",2023,"Arsenal","Premier League","Reiss Nelson","ENG","FW","22",1999,2.4,4,1,2,1,1,2,4,50,2,3,0,3,0,4,4,0,"https://fbref.com/en/players/c5bdb6e3/Reiss-Nelson"
"11239","Eddie Nketiah_2023",2023,"Arsenal","Premier League","Eddie Nketiah","ENG","FW","23",1999,12.1,13,9,6,2,5,2,8,25,6,7,1,6,1,14,7,0,"https://fbref.com/en/players/a53649b7/Eddie-Nketiah"
"11240","Ethan Nwaneri_2023",2023,"Arsenal","Premier League","Ethan Nwaneri","ENG","FW","15",2007,0,0,0,0,0,0,0,0,NA,0,1,0,1,0,0,0,0,"https://fbref.com/en/players/7f94982c/Ethan-Nwaneri"
"11241","Thomas Partey_2023",2023,"Arsenal","Premier League","Thomas Partey","GHA","MF","29",1993,27.6,70,40,20,35,15,25,52,48.1,27,26,5,21,28,98,41,1,"https://fbref.com/en/players/529f49ab/Thomas-Partey"
"11242","Aaron Ramsdale_2023",2023,"Arsenal","Premier League","Aaron Ramsdale","ENG","GK","24",1998,38,1,1,1,0,0,1,1,100,0,0,0,0,0,1,20,6,"https://fbref.com/en/players/466fb2c5/Aaron-Ramsdale"
"11243","Bukayo Saka_2023",2023,"Arsenal","Premier League","Bukayo Saka","ENG","FW","20",2001,35.3,63,34,22,15,26,20,44,45.5,24,38,0,38,14,77,19,0,"https://fbref.com/en/players/bc7dc64d/Bukayo-Saka"
"11244","William Saliba_2023",2023,"Arsenal","Premier League","William Saliba","FRA","DF","21",2001,26.8,34,20,23,9,2,15,18,83.3,3,13,10,3,19,53,85,4,"https://fbref.com/en/players/972aeb2a/William-Saliba"
"11245","Albert Sambi Lokonga_2023",2023,"Arsenal","Premier League","Albert Sambi Lokonga","BEL","MF","22",1999,2.2,1,1,0,0,1,0,2,0,2,1,0,1,5,6,2,0,"https://fbref.com/en/players/1b4f1169/Albert-Sambi-Lokonga"
"11246","Emile Smith Rowe_2023",2023,"Arsenal","Premier League","Emile Smith Rowe","ENG","MF,FW","22",2000,1.9,1,1,1,0,0,1,3,33.3,2,1,0,1,0,1,2,0,"https://fbref.com/en/players/17695062/Emile-Smith-Rowe"
"11247","Cédric Soares_2023",2023,"Arsenal","Premier League","Cédric Soares","POR","DF","30",1991,0.3,0,0,0,0,0,0,1,0,1,1,0,1,0,0,1,0,"https://fbref.com/en/players/839c14e1/Cedric-Soares"
"11248","Kieran Tierney_2023",2023,"Arsenal","Premier League","Kieran Tierney","SCO","DF","25",1997,8.8,20,11,9,9,2,12,16,75,4,8,2,6,11,31,25,0,"https://fbref.com/en/players/fce2302c/Kieran-Tierney"
"11249","Takehiro Tomiyasu_2023",2023,"Arsenal","Premier League","Takehiro Tomiyasu","JPN","DF","23",1998,7.4,27,18,12,10,5,13,18,72.2,5,7,0,7,14,41,15,1,"https://fbref.com/en/players/b3af9be1/Takehiro-Tomiyasu"
"11250","Leandro Trossard_2023",2023,"Arsenal","Premier League","Leandro Trossard","BEL","FW","27",1994,10.3,12,7,4,2,6,6,18,33.3,12,18,0,18,6,18,3,1,"https://fbref.com/en/players/38ceb24a/Leandro-Trossard"
"11251","Fabio Vieira_2023",2023,"Arsenal","Premier League","Fabio Vieira","POR","MF,FW","22",2000,5.7,6,4,3,0,3,3,5,60,2,5,0,5,4,10,2,0,"https://fbref.com/en/players/6412cc03/Fabio-Vieira"
"11252","Ben White_2023",2023,"Arsenal","Premier League","Ben White","ENG","DF","24",1997,33.9,60,31,23,30,7,42,70,60,28,47,11,36,22,82,79,1,"https://fbref.com/en/players/35e413f1/Ben-White"
"11253","Granit Xhaka_2023",2023,"Arsenal","Premier League","Granit Xhaka","SUI","MF","29",1992,33.3,34,27,11,18,5,16,41,39,25,28,10,18,15,49,45,1,"https://fbref.com/en/players/e61b8aee/Granit-Xhaka"
"11254","Oleksandr Zinchenko_2023",2023,"Arsenal","Premier League","Oleksandr Zinchenko","UKR","DF","25",1996,23.5,40,18,14,17,9,21,39,53.8,18,20,2,18,22,62,38,2,"https://fbref.com/en/players/51cf8561/Oleksandr-Zinchenko"
"11255","Martin Ødegaard_2023",2023,"Arsenal","Premier League","Martin Ødegaard","NOR","MF","23",1998,34.7,36,23,12,14,10,14,47,29.8,33,20,5,15,6,42,12,1,"https://fbref.com/en/players/79300479/Martin-Odegaard"
"11256","Cameron Archer_2023",2023,"Aston Villa","Premier League","Cameron Archer","ENG","FW,MF","21",2001,0.5,0,0,0,0,0,0,0,NA,0,0,0,0,0,0,0,0,"https://fbref.com/en/players/05e8ca6d/Cameron-Archer"
"11257","Ludwig Augustinsson_2023",2023,"Aston Villa","Premier League","Ludwig Augustinsson","SWE","DF","28",1994,0.9,1,1,1,0,0,0,0,NA,0,0,0,0,0,1,1,0,"https://fbref.com/en/players/9fec8860/Ludwig-Augustinsson"
"11258","Leon Bailey_2023",2023,"Aston Villa","Premier League","Leon Bailey","JAM","FW,MF","24",1997,21.9,14,6,6,7,1,5,20,25,15,13,0,13,6,20,12,0,"https://fbref.com/en/players/3a233281/Leon-Bailey"
"11259","Jan Bednarek_2023",2023,"Aston Villa","Premier League","Jan Bednarek","POL","DF","26",1996,1.1,3,3,0,3,0,1,1,100,0,3,1,2,2,5,5,0,"https://fbref.com/en/players/4115ce4e/Jan-Bednarek"
"11260","Emi Buendía_2023",2023,"Aston Villa","Premier League","Emi Buendía","ARG","MF,FW","25",1996,26.8,52,23,20,20,12,21,74,28.4,53,20,2,18,20,72,17,0,"https://fbref.com/en/players/66b76d44/Emi-Buendia"
"11261","Diego Carlos_2023",2023,"Aston Villa","Premier League","Diego Carlos","BRA","DF","29",1993,2.3,1,0,0,1,0,0,1,0,1,2,2,0,1,2,2,0,"https://fbref.com/en/players/b4a014b1/Diego-Carlos"
"11262","Matty Cash_2023",2023,"Aston Villa","Premier League","Matty Cash","POL","DF","24",1997,20.2,55,32,36,15,4,26,37,70.3,11,20,5,15,26,81,43,0,"https://fbref.com/en/players/2389cdc2/Matty-Cash"
"11263","Calum Chambers_2023",2023,"Aston Villa","Premier League","Calum Chambers","ENG","DF,MF","27",1995,3.9,9,6,7,2,0,6,8,75,2,5,4,1,7,16,10,1,"https://fbref.com/en/players/dc6f5bdd/Calum-Chambers"
"11264","Philippe Coutinho_2023",2023,"Aston Villa","Premier League","Philippe Coutinho","BRA","MF,FW","30",1992,8.8,19,14,8,8,3,9,15,60,6,11,1,10,4,23,2,0,"https://fbref.com/en/players/0ef89a37/Philippe-Coutinho"
"11265","Leander Dendoncker_2023",2023,"Aston Villa","Premier League","Leander Dendoncker","BEL","MF","27",1995,7.7,19,9,11,6,2,11,21,52.4,10,19,4,15,10,29,12,0,"https://fbref.com/en/players/5a7301ae/Leander-Dendoncker"
"11266","Lucas Digne_2023",2023,"Aston Villa","Premier League","Lucas Digne","FRA","DF","29",1993,16.7,30,12,20,9,1,20,33,60.6,13,18,5,13,18,48,45,0,"https://fbref.com/en/players/1b84dbe1/Lucas-Digne"
"11267","Jhon Durán_2023",2023,"Aston Villa","Premier League","Jhon Durán","COL","FW,MF","18",2003,1.5,2,2,0,1,1,1,4,25,3,0,0,0,2,4,2,0,"https://fbref.com/en/players/414184f7/Jhon-Duran"
"11268","Danny Ings_2023",2023,"Aston Villa","Premier League","Danny Ings","ENG","FW","30",1992,9.2,10,5,1,6,3,1,6,16.7,5,12,1,11,1,11,11,0,"https://fbref.com/en/players/07802f7f/Danny-Ings"
"11269","Boubacar Kamara_2023",2023,"Aston Villa","Premier League","Boubacar Kamara","FRA","MF","22",1999,19.7,58,25,25,23,10,27,56,48.2,29,38,12,26,19,77,24,2,"https://fbref.com/en/players/cc77354e/Boubacar-Kamara"
"11270","Ezri Konsa_2023",2023,"Aston Villa","Premier League","Ezri Konsa","ENG","DF","24",1997,36.9,42,20,25,15,2,18,26,69.2,8,41,23,18,26,68,120,3,"https://fbref.com/en/players/0313a347/Ezri-Konsa"
"11271","Douglas Luiz_2023",2023,"Aston Villa","Premier League","Douglas Luiz","BRA","MF","24",1998,32.5,73,42,31,32,10,30,63,47.6,33,36,7,29,40,113,27,2,"https://fbref.com/en/players/6f7d826d/Douglas-Luiz"
"11272","Emiliano Martínez_2023",2023,"Aston Villa","Premier League","Emiliano Martínez","ARG","GK","29",1992,34.9,0,0,0,0,0,0,2,0,2,0,0,0,1,1,23,1,"https://fbref.com/en/players/7956236f/Emiliano-Martinez"
"11273","John McGinn_2023",2023,"Aston Villa","Premier League","John McGinn","SCO","MF,FW","27",1994,29.9,66,36,27,29,10,34,71,47.9,37,43,4,39,24,90,19,0,"https://fbref.com/en/players/90f91999/John-McGinn"
"11274","Tyrone Mings_2023",2023,"Aston Villa","Premier League","Tyrone Mings","ENG","DF","29",1993,35,15,7,10,5,0,9,20,45,11,40,21,19,54,69,163,2,"https://fbref.com/en/players/8397a50c/Tyrone-Mings"
"11275","Álex Moreno_2023",2023,"Aston Villa","Premier League","Álex Moreno","ESP","DF","29",1993,14.8,23,14,15,5,3,13,36,36.1,23,18,3,15,7,30,37,2,"https://fbref.com/en/players/16e9d0ea/Alex-Moreno"
"11276","Robin Olsen_2023",2023,"Aston Villa","Premier League","Robin Olsen","SWE","GK","32",1990,3.1,0,0,0,0,0,0,2,0,2,0,0,0,0,0,1,0,"https://fbref.com/en/players/e7ee38c3/Robin-Olsen"
"11277","Jacob Ramsey_2023",2023,"Aston Villa","Premier League","Jacob Ramsey","ENG","MF,FW","21",2001,29.3,69,39,23,35,11,32,69,46.4,37,48,8,40,23,92,34,0,"https://fbref.com/en/players/1544f145/Jacob-Ramsey"
"11278","Morgan Sanson_2023",2023,"Aston Villa","Premier League","Morgan Sanson","FRA","MF","27",1994,0.1,2,1,1,1,0,1,1,100,0,0,0,0,0,2,0,0,"https://fbref.com/en/players/6e7f1353/Morgan-Sanson"
"11279","Bertrand Traoré_2023",2023,"Aston Villa","Premier League","Bertrand Traoré","BFA","FW,MF","26",1995,2.6,1,1,1,0,0,1,4,25,3,5,0,5,2,3,0,0,"https://fbref.com/en/players/c47541e0/Bertrand-Traore"
"11280","Ollie Watkins_2023",2023,"Aston Villa","Premier League","Ollie Watkins","ENG","FW","26",1995,34.7,19,13,3,13,3,10,27,37,17,21,4,17,10,29,39,0,"https://fbref.com/en/players/aed3a70f/Ollie-Watkins"
"11281","Ashley Young_2023",2023,"Aston Villa","Premier League","Ashley Young","ENG","DF","37",1985,22.6,50,27,34,15,1,37,49,75.5,12,25,11,14,21,71,65,0,"https://fbref.com/en/players/be927d03/Ashley-Young"
"11282","Jeremie Boga_2023",2023,"Atalanta","Serie A","Jeremie Boga","CIV","MF,FW","25",1997,8.7,9,5,3,2,4,2,5,40,3,6,0,6,1,10,1,0,"https://fbref.com/en/players/fe012aca/Jeremie-Boga"
"11283","Tommaso De Nipoti_2023",2023,"Atalanta","Serie A","Tommaso De Nipoti","ITA","MF","19",2003,0,1,0,0,1,0,0,0,NA,0,0,0,0,0,1,0,0,"https://fbref.com/en/players/7f9d956a/Tommaso-De-Nipoti"
"11284","Merih Demiral_2023",2023,"Atalanta","Serie A","Merih Demiral","TUR","DF","24",1998,17.1,41,29,30,11,0,26,36,72.2,10,24,7,17,24,65,57,1,"https://fbref.com/en/players/e3cceee6/Merih-Demiral"
"11285","Berat Djimsiti_2023",2023,"Atalanta","Serie A","Berat Djimsiti","ALB","DF","29",1993,20,34,19,21,13,0,17,25,68,8,17,7,10,36,70,74,1,"https://fbref.com/en/players/6eee05f1/Berat-Djimsiti"
"11286","Éderson_2023",2023,"Atalanta","Serie A","Éderson","BRA","MF","23",1999,24.6,67,34,18,42,7,29,66,43.9,37,56,7,49,36,103,31,0,"https://fbref.com/en/players/a9202def/Ederson"
"11287","Hans Hateboer_2023",2023,"Atalanta","Serie A","Hans Hateboer","NED","DF","28",1994,15.5,21,13,11,8,2,11,27,40.7,16,23,4,19,12,33,25,0,"https://fbref.com/en/players/3b333ac3/Hans-Hateboer"
"11288","Rasmus Højlund_2023",2023,"Atalanta","Serie A","Rasmus Højlund","DEN","FW","19",2003,20.4,4,3,0,2,2,1,6,16.7,5,9,1,8,1,5,5,0,"https://fbref.com/en/players/491a433d/Rasmus-Hojlund"
"11289","Teun Koopmeiners_2023",2023,"Atalanta","Serie A","Teun Koopmeiners","NED","MF","24",1998,31.8,46,26,15,24,7,28,55,50.9,27,41,5,36,19,65,36,2,"https://fbref.com/en/players/a26fb8aa/Teun-Koopmeiners"
"11290","Ademola Lookman_2023",2023,"Atalanta","Serie A","Ademola Lookman","NGA","FW,MF","24",1997,19.2,13,5,2,6,5,3,15,20,12,18,0,18,4,17,1,0,"https://fbref.com/en/players/7c104bb7/Ademola-Lookman"
"11291","José Luis Palomino_2023",2023,"Atalanta","Serie A","José Luis Palomino","ARG","DF","32",1990,8.4,23,14,16,7,0,11,19,57.9,8,11,4,7,28,51,20,0,"https://fbref.com/en/players/921f6058/Jose-Luis-Palomino"
"11292","Ruslan Malinovskyi_2023",2023,"Atalanta","Serie A","Ruslan Malinovskyi","UKR","MF,FW","29",1993,6.1,14,8,5,6,3,6,17,35.3,11,8,1,7,5,19,2,0,"https://fbref.com/en/players/48d5bd33/Ruslan-Malinovskyi"
"11293","Luis Muriel_2023",2023,"Atalanta","Serie A","Luis Muriel","COL","FW,MF","31",1991,11.9,9,6,2,3,4,5,16,31.3,11,9,0,9,2,11,2,0,"https://fbref.com/en/players/eb2fe5b6/Luis-Muriel"
"11294","Juan Musso_2023",2023,"Atalanta","Serie A","Juan Musso","ARG","GK","28",1994,23.1,1,1,1,0,0,1,1,100,0,0,0,0,0,1,11,1,"https://fbref.com/en/players/a111cf41/Juan-Musso"
"11295","Joakim Mæhle_2023",2023,"Atalanta","Serie A","Joakim Mæhle","DEN","DF,MF","25",1997,24.5,32,18,12,7,13,22,39,56.4,17,29,6,23,24,56,26,0,"https://fbref.com/en/players/c459a650/Joakim-Maehle"
"11296","Caleb Okoli_2023",2023,"Atalanta","Serie A","Caleb Okoli","ITA","DF","21",2001,10.7,21,17,14,6,1,10,25,40,15,10,5,5,30,51,44,3,"https://fbref.com/en/players/8ec109e6/Caleb-Okoli"
"11297","Mario Pašalić_2023",2023,"Atalanta","Serie A","Mario Pašalić","CRO","MF,FW","27",1995,19.7,22,10,6,14,2,6,23,26.1,17,22,4,18,21,43,13,0,"https://fbref.com/en/players/e599253a/Mario-Pasalic"
"11298","Marten de Roon_2023",2023,"Atalanta","Serie A","Marten de Roon","NED","MF","31",1991,32.9,77,39,37,35,5,37,81,45.7,44,37,4,33,36,113,58,0,"https://fbref.com/en/players/2a1beb34/Marten-de-Roon"
"11299","Francesco Rossi_2023",2023,"Atalanta","Serie A","Francesco Rossi","ITA","GK","31",1991,0,0,0,0,0,0,0,0,NA,0,0,0,0,0,0,0,0,"https://fbref.com/en/players/7b5f516f/Francesco-Rossi"
"11300","Matteo Ruggeri_2023",2023,"Atalanta","Serie A","Matteo Ruggeri","ITA","DF,MF","20",2002,9.2,17,12,5,9,3,8,16,50,8,14,3,11,12,29,16,0,"https://fbref.com/en/players/ae9898c5/Matteo-Ruggeri"
"11301","Giorgio Scalvini_2023",2023,"Atalanta","Serie A","Giorgio Scalvini","ITA","DF","18",2003,25.9,54,29,30,18,6,29,55,52.7,26,36,13,23,56,110,57,2,"https://fbref.com/en/players/1e9aa637/Giorgio-Scalvini"
"11302","Brandon Soppy_2023",2023,"Atalanta","Serie A","Brandon Soppy","FRA","DF","20",2002,7.1,8,5,4,4,0,3,9,33.3,6,10,0,10,3,11,7,0,"https://fbref.com/en/players/28f66c2e/Brandon-Soppy"
"11303","Marco Sportiello_2023",2023,"Atalanta","Serie A","Marco Sportiello","ITA","GK","30",1992,14.9,1,0,1,0,0,1,3,33.3,2,0,0,0,0,1,2,0,"https://fbref.com/en/players/ac4003af/Marco-Sportiello"
"11304","Rafael Tolói_2023",2023,"Atalanta","Serie A","Rafael Tolói","ITA","DF","31",1990,30.9,69,44,37,32,0,35,64,54.7,29,42,18,24,57,126,88,1,"https://fbref.com/en/players/c56dc39e/Rafael-Toloi"
"11305","Lukáš Vorlický_2023",2023,"Atalanta","Serie A","Lukáš Vorlický","CZE","MF,FW","20",2002,0.3,0,0,0,0,0,0,0,NA,0,0,0,0,1,1,0,0,"https://fbref.com/en/players/f052fb01/Lukas-Vorlicky"
"11306","Duván Zapata_2023",2023,"Atalanta","Serie A","Duván Zapata","COL","FW","31",1991,15.4,8,4,1,3,4,3,5,60,2,6,2,4,4,12,17,1,"https://fbref.com/en/players/d3de9af0/Duvan-Zapata"
"11307","Davide Zappacosta_2023",2023,"Atalanta","Serie A","Davide Zappacosta","ITA","DF","30",1992,16.3,34,18,17,12,5,15,22,68.2,7,23,2,21,9,43,16,0,"https://fbref.com/en/players/7fe90ccd/Davide-Zappacosta"
"11308","Nadir Zortea_2023",2023,"Atalanta","Serie A","Nadir Zortea","ITA","DF,MF","23",1999,2.5,10,5,3,7,0,3,4,75,1,4,0,4,0,10,4,0,"https://fbref.com/en/players/82598b71/Nadir-Zortea"
"11309","Julen Agirrezabala_2023",2023,"Athletic Club","La Liga","Julen Agirrezabala","ESP","GK","21",2000,7.5,0,0,0,0,0,0,0,NA,0,0,0,0,0,0,2,0,"https://fbref.com/en/players/a2c1a8d3/Julen-Agirrezabala"
"11310","Yeray Álvarez_2023",2023,"Athletic Club","La Liga","Yeray Álvarez","ESP","DF","27",1995,25.9,34,23,26,7,1,24,31,77.4,7,23,13,10,48,82,101,0,"https://fbref.com/en/players/3ecc11d8/Yeray-Alvarez"
"11311","Mikel Balenziaga_2023",2023,"Athletic Club","La Liga","Mikel Balenziaga","ESP","DF","34",1988,1.3,4,4,1,2,1,4,4,100,0,0,0,0,1,5,2,0,"https://fbref.com/en/players/1fe67e86/Mikel-Balenziaga"
"11312","Yuri Berchiche_2023",2023,"Athletic Club","La Liga","Yuri Berchiche","ESP","DF","32",1990,26.7,56,32,28,20,8,35,59,59.3,24,37,12,25,40,96,59,1,"https://fbref.com/en/players/b6e50615/Yuri-Berchiche"
"11313","Álex Berenguer_2023",2023,"Athletic Club","La Liga","Álex Berenguer","ESP","FW","27",1995,25.5,58,37,17,25,16,23,60,38.3,37,37,4,33,10,68,6,0,"https://fbref.com/en/players/dc1c2fce/Alex-Berenguer"
"11314","Ander Capa_2023",2023,"Athletic Club","La Liga","Ander Capa","ESP","DF","30",1992,1.2,1,1,1,0,0,1,5,20,4,5,0,5,0,1,2,0,"https://fbref.com/en/players/37f1cf47/Ander-Capa"
"11315","Malcom Abdulai Ares Djalo_2023",2023,"Athletic Club","La Liga","Malcom Abdulai Ares Djalo","ESP","FW,MF","20",2001,0.9,4,2,2,1,1,4,4,100,0,1,0,1,2,6,1,0,"https://fbref.com/en/players/a461f098/Malcom-Abdulai-Ares-Djalo"
"11316","Dani García_2023",2023,"Athletic Club","La Liga","Dani García","ESP","MF","32",1990,16.5,46,27,17,25,4,29,47,61.7,18,21,6,15,19,65,21,1,"https://fbref.com/en/players/240d3a0b/Dani-Garcia"
"11317","Raúl García_2023",2023,"Athletic Club","La Liga","Raúl García","ESP","FW,MF","36",1986,10.7,12,8,3,4,5,5,15,33.3,10,13,1,12,6,18,9,0,"https://fbref.com/en/players/b418dbd4/Raul-Garcia"
"11318","Gorka Guruzeta_2023",2023,"Athletic Club","La Liga","Gorka Guruzeta","ESP","FW","25",1996,15.8,24,20,6,12,6,11,24,45.8,13,23,2,21,4,28,8,0,"https://fbref.com/en/players/6b5ea2f4/Gorka-Guruzeta"
"11319","Ander Herrera_2023",2023,"Athletic Club","La Liga","Ander Herrera","ESP","MF","32",1989,7.7,18,10,8,7,3,6,18,33.3,12,12,3,9,11,29,12,0,"https://fbref.com/en/players/436a9dd0/Ander-Herrera"
"11320","Iñigo Lekue_2023",2023,"Athletic Club","La Liga","Iñigo Lekue","ESP","DF","29",1993,14.7,24,17,20,4,0,12,19,63.2,7,16,2,14,13,37,31,1,"https://fbref.com/en/players/59b7d823/Inigo-Lekue"
"11321","Óscar de Marcos_2023",2023,"Athletic Club","La Liga","Óscar de Marcos","ESP","DF","33",1989,31.3,67,33,34,22,11,40,76,52.6,36,42,6,36,29,96,59,0,"https://fbref.com/en/players/9f323c71/Oscar-de-Marcos"
"11322","Iñigo Martínez_2023",2023,"Athletic Club","La Liga","Iñigo Martínez","ESP","DF","31",1991,14.9,18,8,11,7,0,6,9,66.7,3,17,11,6,18,36,55,0,"https://fbref.com/en/players/3fc45c73/Inigo-Martinez"
"11323","Jon Morcillo_2023",2023,"Athletic Club","La Liga","Jon Morcillo","ESP","FW,MF","23",1998,0.8,1,0,1,0,0,0,1,0,1,0,0,0,1,2,0,0,"https://fbref.com/en/players/b7d7f3bf/Jon-Morcillo"
"11324","Iker Muniain_2023",2023,"Athletic Club","La Liga","Iker Muniain","ESP","MF,FW","29",1992,18.8,21,16,7,11,3,6,17,35.3,11,10,1,9,4,25,2,0,"https://fbref.com/en/players/c05dfb74/Iker-Muniain"
"11325","Aitor Paredes_2023",2023,"Athletic Club","La Liga","Aitor Paredes","ESP","DF","22",2000,9.5,7,6,4,2,1,6,11,54.5,5,11,7,4,14,21,26,0,"https://fbref.com/en/players/b906757a/Aitor-Paredes"
"11326","Oihan Sancet_2023",2023,"Athletic Club","La Liga","Oihan Sancet","ESP","MF","22",2000,28.1,27,16,2,19,6,11,37,29.7,26,10,0,10,4,31,9,1,"https://fbref.com/en/players/bdb624a3/Oihan-Sancet"
"11327","Unai Simón_2023",2023,"Athletic Club","La Liga","Unai Simón","ESP","GK","25",1997,30.5,2,0,2,0,0,1,1,100,0,1,0,1,0,2,9,3,"https://fbref.com/en/players/5dcf3e90/Unai-Simon"
"11328","Unai Vencedor Paris_2023",2023,"Athletic Club","La Liga","Unai Vencedor Paris","ESP","MF","21",2000,2.1,3,1,0,3,0,1,6,16.7,5,5,0,5,1,4,1,0,"https://fbref.com/en/players/4112ace5/Unai-Vencedor-Paris"
"11329","Mikel Vesga_2023",2023,"Athletic Club","La Liga","Mikel Vesga","ESP","MF","29",1993,28.6,57,35,21,31,5,25,68,36.8,43,39,8,31,36,93,39,3,"https://fbref.com/en/players/b0fce72c/Mikel-Vesga"
"11330","Asier Villalibre_2023",2023,"Athletic Club","La Liga","Asier Villalibre","ESP","FW","24",1997,1.1,0,0,0,0,0,0,0,NA,0,0,0,0,0,0,1,0,"https://fbref.com/en/players/57be54ec/Asier-Villalibre"
"11331","Daniel Vivian_2023",2023,"Athletic Club","La Liga","Daniel Vivian","ESP","DF","23",1999,26.4,57,32,36,16,5,36,45,80,9,27,14,13,24,81,90,3,"https://fbref.com/en/players/ab7bf91d/Daniel-Vivian"
"11332","Iñaki Williams_2023",2023,"Athletic Club","La Liga","Iñaki Williams","GHA","FW","28",1994,31.5,22,16,5,14,3,9,24,37.5,15,18,3,15,7,29,34,0,"https://fbref.com/en/players/6a99e0b1/Inaki-Williams"
"11333","Nico Williams_2023",2023,"Athletic Club","La Liga","Nico Williams","ESP","FW","20",2002,29.5,31,16,10,15,6,19,41,46.3,22,40,2,38,8,39,14,1,"https://fbref.com/en/players/afdc14d7/Nico-Williams"
"11334","Oier Zarraga_2023",2023,"Athletic Club","La Liga","Oier Zarraga","ESP","MF","23",1999,9.5,14,9,5,7,2,8,20,40,12,7,0,7,10,24,5,0,"https://fbref.com/en/players/968a1c2f/Oier-Zarraga"
"11335","Pablo Barrios_2023",2023,"Atlético Madrid","La Liga","Pablo Barrios","ESP","MF","19",2003,8,19,10,3,10,6,8,15,53.3,7,12,2,10,9,28,6,1,"https://fbref.com/en/players/45736cec/Pablo-Barrios"
"11336","Yannick Carrasco_2023",2023,"Atlético Madrid","La Liga","Yannick Carrasco","BEL","DF,MF","28",1993,25.7,35,14,21,10,4,23,54,42.6,31,23,1,22,12,47,19,0,"https://fbref.com/en/players/de39485a/Yannick-Carrasco"
"11337","Ángel Correa_2023",2023,"Atlético Madrid","La Liga","Ángel Correa","ARG","FW,MF","27",1995,16.2,12,6,6,3,3,5,16,31.3,11,17,0,17,10,22,6,1,"https://fbref.com/en/players/01eb744d/Angel-Correa"
"11338","Matheus Cunha_2023",2023,"Atlético Madrid","La Liga","Matheus Cunha","BRA","FW,MF","23",1999,4.2,4,1,1,3,0,0,3,0,3,4,1,3,2,6,3,0,"https://fbref.com/en/players/dc62b55d/Matheus-Cunha"
"11339","Rodrigo De Paul_2023",2023,"Atlético Madrid","La Liga","Rodrigo De Paul","ARG","MF","28",1994,21.4,35,21,11,18,6,18,35,51.4,17,20,3,17,8,43,7,0,"https://fbref.com/en/players/162efffd/Rodrigo-De-Paul"
"11340","Matt Doherty_2023",2023,"Atlético Madrid","La Liga","Matt Doherty","IRL","DF","30",1992,0.2,0,0,0,0,0,0,0,NA,0,2,0,2,0,0,0,0,"https://fbref.com/en/players/d557d734/Matt-Doherty"
"11341","Felipe_2023",2023,"Atlético Madrid","La Liga","Felipe","BRA","DF","33",1989,2.2,3,2,1,2,0,2,4,50,2,2,2,0,0,3,7,0,"https://fbref.com/en/players/51a3c4c8/Felipe"
"11342","João Félix_2023",2023,"Atlético Madrid","La Liga","João Félix","POR","FW,MF","22",1999,7.2,10,7,2,3,5,1,6,16.7,5,1,0,1,3,13,2,0,"https://fbref.com/en/players/8aafd64f/Joao-Felix"
"11343","Antonio Gomis_2023",2023,"Atlético Madrid","La Liga","Antonio Gomis","ESP","GK","19",2003,0.1,0,0,0,0,0,0,0,NA,0,0,0,0,0,0,0,0,"https://fbref.com/en/players/f0f4671c/Antonio-Gomis"
"11344","Ivo Grbić_2023",2023,"Atlético Madrid","La Liga","Ivo Grbić","CRO","GK","26",1996,10.2,0,0,0,0,0,0,0,NA,0,0,0,0,0,0,9,1,"https://fbref.com/en/players/3f034750/Ivo-Grbic"
"11345","Antoine Griezmann_2023",2023,"Atlético Madrid","La Liga","Antoine Griezmann","FRA","FW,MF","31",1991,31.8,49,34,15,23,11,20,66,30.3,46,34,3,31,24,73,31,0,"https://fbref.com/en/players/df69b544/Antoine-Griezmann"
"11346","Mario Hermoso_2023",2023,"Atlético Madrid","La Liga","Mario Hermoso","ESP","DF","27",1995,23.4,22,15,14,6,2,9,30,30,21,19,9,10,19,41,85,1,"https://fbref.com/en/players/555f3a0b/Mario-Hermoso"
"11347","Koke_2023",2023,"Atlético Madrid","La Liga","Koke","ESP","MF","30",1992,28.3,55,38,23,25,7,28,72,38.9,44,35,13,22,20,75,19,0,"https://fbref.com/en/players/55126f3b/Koke"
"11348","Geoffrey Kondogbia_2023",2023,"Atlético Madrid","La Liga","Geoffrey Kondogbia","CTA","MF","29",1993,11.2,40,23,19,20,1,17,25,68,8,9,1,8,26,66,12,1,"https://fbref.com/en/players/cce181df/Geoffrey-Kondogbia"
"11349","Thomas Lemar_2023",2023,"Atlético Madrid","La Liga","Thomas Lemar","FRA","MF","26",1995,13.9,30,18,10,13,7,10,28,35.7,18,12,3,9,7,37,12,0,"https://fbref.com/en/players/4dbd0916/Thomas-Lemar"
"11350","Marcos Llorente_2023",2023,"Atlético Madrid","La Liga","Marcos Llorente","ESP","MF,DF","27",1995,18.9,32,15,16,10,6,17,30,56.7,13,26,2,24,17,49,19,0,"https://fbref.com/en/players/02c15616/Marcos-Llorente"
"11351","Reinildo Mandava_2023",2023,"Atlético Madrid","La Liga","Reinildo Mandava","MOZ","DF","28",1994,20.6,66,43,46,19,1,38,49,77.6,11,27,12,15,30,96,59,0,"https://fbref.com/en/players/c20bdcd7/Reinildo-Mandava"
"11352","José María Giménez_2023",2023,"Atlético Madrid","La Liga","José María Giménez","URU","DF","27",1995,26.9,43,25,28,14,1,24,35,68.6,11,37,17,20,24,67,138,1,"https://fbref.com/en/players/f0da930c/Jose-Maria-Gimenez"
"11353","Carlos Martín_2023",2023,"Atlético Madrid","La Liga","Carlos Martín","ESP","FW,MF","20",2002,0.3,2,2,0,2,0,2,3,66.7,1,0,0,0,1,3,0,0,"https://fbref.com/en/players/64035864/Carlos-Martin"
"11354","Memphis_2023",2023,"Atlético Madrid","La Liga","Memphis","NED","FW","28",1994,3,1,0,0,0,1,0,1,0,1,0,0,0,0,1,0,0,"https://fbref.com/en/players/8f696594/Memphis"
"11355","Nahuel Molina_2023",2023,"Atlético Madrid","La Liga","Nahuel Molina","ARG","DF","24",1998,31.9,69,43,38,18,13,39,91,42.9,52,38,7,31,18,87,63,1,"https://fbref.com/en/players/23610943/Nahuel-Molina"
"11356","Álvaro Morata_2023",2023,"Atlético Madrid","La Liga","Álvaro Morata","ESP","FW","29",1992,21.1,16,11,4,8,4,3,8,37.5,5,11,3,8,0,16,23,0,"https://fbref.com/en/players/129af0db/Alvaro-Morata"
"11357","Saúl Ñíguez_2023",2023,"Atlético Madrid","La Liga","Saúl Ñíguez","ESP","MF,DF","27",1994,12.2,42,27,18,18,6,22,37,59.5,15,27,5,22,15,57,29,0,"https://fbref.com/en/players/c14bc029/Saul-Niguez"
"11358","Jan Oblak_2023",2023,"Atlético Madrid","La Liga","Jan Oblak","SVN","GK","29",1993,27.7,0,0,0,0,0,0,0,NA,0,0,0,0,1,1,8,0,"https://fbref.com/en/players/ee8508c0/Jan-Oblak"
"11359","Sergio Reguilón_2023",2023,"Atlético Madrid","La Liga","Sergio Reguilón","ESP","DF","25",1996,3.4,7,5,5,2,0,5,7,71.4,2,3,0,3,2,9,4,0,"https://fbref.com/en/players/3353737a/Sergio-Reguilon"
"11360","Stefan Savić_2023",2023,"Atlético Madrid","La Liga","Stefan Savić","MNE","DF","31",1991,21.6,39,26,29,7,3,26,39,66.7,13,17,8,9,33,72,67,2,"https://fbref.com/en/players/f6ac68c1/Stefan-Savic"
"11361","Axel Witsel_2023",2023,"Atlético Madrid","La Liga","Axel Witsel","BEL","DF,MF","33",1989,25.1,36,22,22,11,3,17,31,54.8,14,20,11,9,23,59,76,0,"https://fbref.com/en/players/5dfc6ad5/Axel-Witsel"
"11362","Maximilian Bauer_2023",2023,"Augsburg","Bundesliga","Maximilian Bauer","GER","DF","22",2000,20.5,31,17,18,12,1,17,34,50,17,25,9,16,23,54,79,1,"https://fbref.com/en/players/44a20f0c/Maximilian-Bauer"
"11363","Julian Baumgartlinger_2023",2023,"Augsburg","Bundesliga","Julian Baumgartlinger","AUT","MF","34",1988,6.2,15,4,5,6,4,6,19,31.6,13,4,2,2,4,19,15,0,"https://fbref.com/en/players/69374ff5/Julian-Baumgartlinger"
"11364","Noah Joel Sarenren Bazee_2023",2023,"Augsburg","Bundesliga","Noah Joel Sarenren Bazee","NGA","MF,FW","25",1996,0.2,0,0,0,0,0,0,1,0,1,1,0,1,0,0,0,0,"https://fbref.com/en/players/fbbc8e15/Noah-Joel-Sarenren-Bazee"
"11365","Mergim Berisha_2023",2023,"Augsburg","Bundesliga","Mergim Berisha","GER","FW","24",1998,18.7,11,6,4,3,4,4,14,28.6,10,16,1,15,0,11,19,0,"https://fbref.com/en/players/eb6e14be/Mergim-Berisha"
"11366","Daniel Caligiuri_2023",2023,"Augsburg","Bundesliga","Daniel Caligiuri","ITA","DF,MF","34",1988,3.2,8,5,5,3,0,4,5,80,1,3,2,1,3,11,2,0,"https://fbref.com/en/players/d1273f09/Daniel-Caligiuri"
"11367","Irvin Cardona_2023",2023,"Augsburg","Bundesliga","Irvin Cardona","FRA","MF,FW","24",1997,3.5,1,1,1,0,0,1,5,20,4,3,0,3,4,5,8,0,"https://fbref.com/en/players/5e080f73/Irvin-Cardona"
"11368","David Čolina_2023",2023,"Augsburg","Bundesliga","David Čolina","CRO","DF,FW","22",2000,1.8,4,1,1,1,2,2,2,100,0,8,0,8,4,8,3,0,"https://fbref.com/en/players/dd5bbe0d/David-Colina"
"11369","Ermedin Demirović_2023",2023,"Augsburg","Bundesliga","Ermedin Demirović","BIH","FW,MF","24",1998,26.3,31,14,9,12,10,9,22,40.9,13,31,4,27,14,45,37,0,"https://fbref.com/en/players/ed79b7d3/Ermedin-Demirovic"
"11370","Niklas Dorsch_2023",2023,"Augsburg","Bundesliga","Niklas Dorsch","GER","MF","24",1998,5.4,21,12,8,11,2,9,16,56.3,7,9,3,6,6,27,9,0,"https://fbref.com/en/players/7f73bdf4/Niklas-Dorsch"
"11371","Dion Drena Beljo_2023",2023,"Augsburg","Bundesliga","Dion Drena Beljo","CRO","FW","20",2002,12.5,7,6,3,2,2,2,13,15.4,11,15,2,13,1,8,14,0,"https://fbref.com/en/players/9a2e3a23/Dion-Drena-Beljo"
"11372","Arne Engels_2023",2023,"Augsburg","Bundesliga","Arne Engels","BEL","MF","18",2003,16,20,9,9,10,1,8,19,42.1,11,17,5,12,15,35,12,1,"https://fbref.com/en/players/554bcc91/Arne-Engels"
"11373","Ohis Felix Uduokhai_2023",2023,"Augsburg","Bundesliga","Ohis Felix Uduokhai","GER","DF","24",1997,16.1,30,20,14,13,3,15,29,51.7,14,27,14,13,29,59,61,1,"https://fbref.com/en/players/677da306/Ohis-Felix-Uduokhai"
"11374","Raphael Framberger_2023",2023,"Augsburg","Bundesliga","Raphael Framberger","GER","DF,FW","26",1995,2,10,6,6,4,0,3,5,60,2,2,1,1,2,12,5,0,"https://fbref.com/en/players/626fab5f/Raphael-Framberger"
"11375","Rafał Gikiewicz_2023",2023,"Augsburg","Bundesliga","Rafał Gikiewicz","POL","GK","34",1987,23,2,2,2,0,0,2,3,66.7,1,0,0,0,0,2,15,5,"https://fbref.com/en/players/17376543/Rafal-Gikiewicz"
"11376","Jeffrey Gouweleeuw_2023",2023,"Augsburg","Bundesliga","Jeffrey Gouweleeuw","NED","DF","31",1991,31.1,42,27,19,17,6,24,49,49,25,41,23,18,50,92,141,2,"https://fbref.com/en/players/1025db8e/Jeffrey-Gouweleeuw"
"11377","Carlos Gruezo_2023",2023,"Augsburg","Bundesliga","Carlos Gruezo","ECU","MF","27",1995,10.7,21,12,12,9,0,9,16,56.3,7,13,4,9,10,31,15,0,"https://fbref.com/en/players/f2dd9a21/Carlos-Gruezo"
"11378","Robert Gumny_2023",2023,"Augsburg","Bundesliga","Robert Gumny","POL","DF","24",1998,22.4,34,24,13,15,6,11,27,40.7,16,21,7,14,26,60,62,1,"https://fbref.com/en/players/1df0c0b9/Robert-Gumny"
"11379","André Hahn_2023",2023,"Augsburg","Bundesliga","André Hahn","GER","FW,MF","31",1990,4.3,9,5,4,4,1,8,12,66.7,4,9,2,7,4,13,14,0,"https://fbref.com/en/players/cd82452e/Andre-Hahn"
"11380","Iago_2023",2023,"Augsburg","Bundesliga","Iago","BRA","DF,MF","25",1997,17.8,34,16,20,10,4,11,29,37.9,18,18,5,13,17,51,53,0,"https://fbref.com/en/players/054849d2/Iago"
"11381","Fredrik Jensen_2023",2023,"Augsburg","Bundesliga","Fredrik Jensen","FIN","FW,MF","24",1997,10.3,15,10,8,3,4,5,10,50,5,12,5,7,4,19,12,0,"https://fbref.com/en/players/3eeb80e0/Fredrik-Jensen"
"11382","Tomáš Koubek_2023",2023,"Augsburg","Bundesliga","Tomáš Koubek","CZE","GK","29",1992,11,0,0,0,0,0,0,0,NA,0,0,0,0,0,0,7,0,"https://fbref.com/en/players/dc366c36/Tomas-Koubek"
"11383","Arne Maier_2023",2023,"Augsburg","Bundesliga","Arne Maier","GER","MF","23",1999,21.8,31,22,17,11,3,10,18,55.6,8,21,0,21,15,46,22,0,"https://fbref.com/en/players/ab700320/Arne-Maier"
"11384","Nathanael Mbuku_2023",2023,"Augsburg","Bundesliga","Nathanael Mbuku","FRA","MF,FW","20",2002,0.4,1,0,0,1,0,0,0,NA,0,0,0,0,0,1,0,0,"https://fbref.com/en/players/46750e9c/Nathanael-Mbuku"
"11385","Florian Niederlechner_2023",2023,"Augsburg","Bundesliga","Florian Niederlechner","GER","FW,MF","31",1990,10.1,10,5,5,4,1,4,7,57.1,3,16,2,14,1,11,9,0,"https://fbref.com/en/players/d6862409/Florian-Niederlechner"
"11386","Reece Oxford_2023",2023,"Augsburg","Bundesliga","Reece Oxford","ENG","DF","23",1998,1,1,1,1,0,0,0,0,NA,0,4,3,1,1,2,5,0,"https://fbref.com/en/players/8b6e0db2/Reece-Oxford"
"11387","Mads Pedersen_2023",2023,"Augsburg","Bundesliga","Mads Pedersen","DEN","DF,MF","25",1996,20.4,44,23,31,11,2,22,33,66.7,11,32,9,23,20,64,41,1,"https://fbref.com/en/players/582a5247/Mads-Pedersen"
"11388","Ricardo Pepi_2023",2023,"Augsburg","Bundesliga","Ricardo Pepi","USA","FW","19",2003,1.1,1,1,1,0,0,1,1,100,0,1,0,1,0,1,1,0,"https://fbref.com/en/players/a2b1ed42/Ricardo-Pepi"
"11389","Lukas Petkov_2023",2023,"Augsburg","Bundesliga","Lukas Petkov","GER","MF,FW","21",2000,1.6,5,1,4,1,0,2,3,66.7,1,4,1,3,1,6,0,0,"https://fbref.com/en/players/f503ef6e/Lukas-Petkov"
"11390","Elvis Rexhbeçaj_2023",2023,"Augsburg","Bundesliga","Elvis Rexhbeçaj","GER","MF","24",1997,28,51,30,18,24,9,29,59,49.2,30,40,13,27,17,68,40,0,"https://fbref.com/en/players/1ae836b1/Elvis-Rexhbecaj"
"11391","Ruben Vargas_2023",2023,"Augsburg","Bundesliga","Ruben Vargas","SUI","MF,FW","23",1998,12.6,15,7,6,7,2,5,11,45.5,6,8,2,6,6,21,16,1,"https://fbref.com/en/players/6ecbddf6/Ruben-Vargas"
"11392","Renato Veiga_2023",2023,"Augsburg","Bundesliga","Renato Veiga","POR","DF","19",2003,7.1,9,6,4,3,2,7,9,77.8,2,20,6,14,7,16,29,1,"https://fbref.com/en/players/fc8fcbd1/Renato-Veiga"
"11393","Frederik Winther_2023",2023,"Augsburg","Bundesliga","Frederik Winther","DEN","DF","21",2001,1,2,2,1,1,0,0,2,0,2,1,1,0,0,2,7,0,"https://fbref.com/en/players/a1257b5e/Frederik-Winther"
"11394","Kelvin Yeboah_2023",2023,"Augsburg","Bundesliga","Kelvin Yeboah","ITA","FW,MF","22",2000,3.9,6,4,2,4,0,2,5,40,3,7,0,7,1,7,2,0,"https://fbref.com/en/players/ea0893d6/Kelvin-Yeboah"
"11395","Aaron Zehnter_2023",2023,"Augsburg","Bundesliga","Aaron Zehnter","GER","DF","17",2004,0,0,0,0,0,0,0,1,0,1,0,0,0,1,1,0,0,"https://fbref.com/en/players/65bf7e2b/Aaron-Zehnter"
"11396","Matthis Abline_2023",2023,"Auxerre","Ligue 1","Matthis Abline","FRA","FW,MF","19",2003,9,4,2,0,3,1,0,5,0,5,6,1,5,1,5,1,0,"https://fbref.com/en/players/0e46fa2f/Matthis-Abline"
"11397","Mathias Autret_2023",2023,"Auxerre","Ligue 1","Mathias Autret","FRA","MF,FW","31",1991,14.3,22,10,10,10,2,7,16,43.8,9,14,2,12,12,34,13,0,"https://fbref.com/en/players/7dfbba27/Mathias-Autret"
"11398","Dénys Bain_2023",2023,"Auxerre","Ligue 1","Dénys Bain","FRA","DF","29",1993,1.4,4,3,3,1,0,1,2,50,1,2,1,1,2,6,4,0,"https://fbref.com/en/players/5065d67d/Denys-Bain"
"11399","Quentin Bernard_2023",2023,"Auxerre","Ligue 1","Quentin Bernard","FRA","DF","33",1989,7,9,7,4,2,3,7,15,46.7,8,9,1,8,15,24,17,0,"https://fbref.com/en/players/3916b09c/Quentin-Bernard"
"11400","Kenji-Van Boto_2023",2023,"Auxerre","Ligue 1","Kenji-Van Boto","MAD","DF","26",1996,2,3,2,2,0,1,2,4,50,2,0,0,0,1,4,3,0,"https://fbref.com/en/players/c03b7266/Kenji-Van-Boto"
"11401","Ousmane Camara_2023",2023,"Auxerre","Ligue 1","Ousmane Camara","GUI","FW,MF","20",2001,0.3,1,1,0,0,1,0,0,NA,0,0,0,0,0,1,0,0,"https://fbref.com/en/players/5a6b06cd/Ousmane-Camara"
"11402","Gaëtan Charbonnier_2023",2023,"Auxerre","Ligue 1","Gaëtan Charbonnier","FRA","FW,MF","33",1988,2.8,2,1,0,2,0,0,4,0,4,2,0,2,0,2,5,0,"https://fbref.com/en/players/18ebca4b/Gaetan-Charbonnier"
"11403","Alexandre Coeff_2023",2023,"Auxerre","Ligue 1","Alexandre Coeff","FRA","DF","30",1992,6.5,10,5,6,4,0,4,9,44.4,5,9,4,5,8,18,35,1,"https://fbref.com/en/players/c4065f40/Alexandre-Coeff"
"11404","Nuno da Costa_2023",2023,"Auxerre","Ligue 1","Nuno da Costa","CPV","FW,MF","31",1991,22.3,45,23,14,23,8,11,46,23.9,35,21,1,20,20,65,15,0,"https://fbref.com/en/players/909222de/Nuno-da-Costa"
"11405","Benoît Costil_2023",2023,"Auxerre","Ligue 1","Benoît Costil","FRA","GK","35",1987,19,2,0,2,0,0,2,4,50,2,0,0,0,0,2,5,0,"https://fbref.com/en/players/2434f24a/Benoit-Costil"
"11406","Kévin Danois_2023",2023,"Auxerre","Ligue 1","Kévin Danois","FRA","MF","18",2004,0,1,1,0,1,0,0,0,NA,0,0,0,0,1,2,0,0,"https://fbref.com/en/players/e76f6fbe/Kevin-Danois"
"11407","Siriki Dembélé_2023",2023,"Auxerre","Ligue 1","Siriki Dembélé","CIV","MF,FW","25",1996,4.1,10,6,4,3,3,4,12,33.3,8,2,0,2,1,11,2,0,"https://fbref.com/en/players/11f54bd5/Siriki-Dembele"
"11408","Rémy Dugimont_2023",2023,"Auxerre","Ligue 1","Rémy Dugimont","FRA","FW,MF","36",1986,1.3,2,1,0,1,1,1,2,50,1,3,0,3,0,2,5,0,"https://fbref.com/en/players/6d7ede84/Remy-Dugimont"
"11409","Gauthier Hein_2023",2023,"Auxerre","Ligue 1","Gauthier Hein","FRA","MF,FW","25",1996,20.8,27,20,13,11,3,18,48,37.5,30,10,0,10,6,33,10,0,"https://fbref.com/en/players/563fcd6b/Gauthier-Hein"
"11410","Julian Jeanvier_2023",2023,"Auxerre","Ligue 1","Julian Jeanvier","GUI","DF","30",1992,19.6,32,17,24,8,0,13,22,59.1,9,24,17,7,27,59,96,1,"https://fbref.com/en/players/5cb215fc/Julian-Jeanvier"
"11411","Paul Joly_2023",2023,"Auxerre","Ligue 1","Paul Joly","FRA","DF","22",2000,9.6,33,21,21,10,2,19,35,54.3,16,13,2,11,24,57,29,2,"https://fbref.com/en/players/5b4bc323/Paul-Joly"
"11412","Jubal_2023",2023,"Auxerre","Ligue 1","Jubal","BRA","DF","28",1993,35.7,41,26,29,11,1,19,38,50,19,57,34,23,53,94,193,0,"https://fbref.com/en/players/56ae428b/Jubal"
"11413","Donovan Léon_2023",2023,"Auxerre","Ligue 1","Donovan Léon","GUF","GK","29",1992,2,0,0,0,0,0,0,0,NA,0,0,0,0,0,0,1,0,"https://fbref.com/en/players/51c83a90/Donovan-Leon"
"11414","Youssouf M'Changama_2023",2023,"Auxerre","Ligue 1","Youssouf M'Changama","COM","MF","31",1990,12,22,11,7,12,3,7,13,53.8,6,6,0,6,15,37,6,1,"https://fbref.com/en/players/e05082d1/Youssouf-MChangama"
"11415","Han-Noah Massengo_2023",2023,"Auxerre","Ligue 1","Han-Noah Massengo","FRA","MF","21",2001,12.4,27,15,10,15,2,7,16,43.8,9,12,3,9,14,41,7,0,"https://fbref.com/en/players/eba1e557/Han-Noah-Massengo"
"11416","Gideon Mensah_2023",2023,"Auxerre","Ligue 1","Gideon Mensah","GHA","DF","24",1998,25.1,80,44,43,32,5,44,77,57.1,33,33,10,23,38,118,41,0,"https://fbref.com/en/players/9bdd8118/Gideon-Mensah"
"11417","M'Baye Niang_2023",2023,"Auxerre","Ligue 1","M'Baye Niang","SEN","FW","27",1994,16.5,13,7,1,8,4,3,13,23.1,10,22,1,21,1,14,20,0,"https://fbref.com/en/players/2054d037/MBaye-Niang"
"11418","Théo Pellenard_2023",2023,"Auxerre","Ligue 1","Théo Pellenard","FRA","DF","28",1994,1.1,1,0,1,0,0,1,1,100,0,3,1,2,2,3,2,0,"https://fbref.com/en/players/97fb4608/Theo-Pellenard"
"11419","Brayann Pereira_2023",2023,"Auxerre","Ligue 1","Brayann Pereira","FRA","DF","19",2003,2,6,5,5,1,0,1,5,20,4,2,2,0,2,8,8,1,"https://fbref.com/en/players/5c42e7ce/Brayann-Pereira"
"11420","Gaëtan Perrin_2023",2023,"Auxerre","Ligue 1","Gaëtan Perrin","FRA","MF,FW","26",1996,15.5,17,8,5,6,6,8,30,26.7,22,15,0,15,10,27,9,0,"https://fbref.com/en/players/10dd88f9/Gaetan-Perrin"
"11421","Ionuț Radu_2023",2023,"Auxerre","Ligue 1","Ionuț Radu","ROU","GK","25",1997,17,0,0,0,0,0,0,0,NA,0,0,0,0,0,0,3,2,"https://fbref.com/en/players/67f649be/Ionut-Radu"
"11422","Rayan Raveloson_2023",2023,"Auxerre","Ligue 1","Rayan Raveloson","MAD","DF,MF","25",1997,27,38,23,21,16,1,23,33,69.7,10,43,12,31,39,77,70,0,"https://fbref.com/en/players/fb3236a7/Rayan-Raveloson"
"11423","Kays Ruiz_2023",2023,"Auxerre","Ligue 1","Kays Ruiz","MAR","MF","19",2002,0.7,1,1,1,0,0,0,1,0,1,2,1,1,3,4,0,0,"https://fbref.com/en/players/90a9cc01/Kays-Ruiz"
"11424","Hamza Sakhi_2023",2023,"Auxerre","Ligue 1","Hamza Sakhi","MAR","MF","26",1996,18.4,44,22,22,17,5,22,42,52.4,20,16,1,15,25,69,9,0,"https://fbref.com/en/players/c9151d66/Hamza-Sakhi"
"11425","Lassine Sinayoko_2023",2023,"Auxerre","Ligue 1","Lassine Sinayoko","MLI","MF,FW","22",1999,17.4,33,15,14,12,7,21,40,52.5,19,12,0,12,18,51,17,0,"https://fbref.com/en/players/5e5249c8/Lassine-Sinayoko"
"11426","Birama Touré_2023",2023,"Auxerre","Ligue 1","Birama Touré","MLI","MF","30",1992,37.8,80,47,35,35,10,34,93,36.6,59,54,9,45,67,147,49,0,"https://fbref.com/en/players/a4b798a9/Birama-Toure"
"11427","Souleymane Touré_2023",2023,"Auxerre","Ligue 1","Souleymane Touré","FRA","DF","19",2003,17.6,29,13,19,9,1,16,20,80,4,32,12,20,26,55,56,1,"https://fbref.com/en/players/01fd01e8/Souleymane-Toure"
"11428","Akim Zedadka_2023",2023,"Auxerre","Ligue 1","Akim Zedadka","ALG","DF","27",1995,17.8,35,21,21,10,4,18,32,56.3,14,17,3,14,23,58,51,1,"https://fbref.com/en/players/0ff630d0/Akim-Zedadka"
"11429","Ángel Alarcón_2023",2023,"Barcelona","La Liga","Ángel Alarcón","ESP","FW","18",2004,0.3,NA,0,NA,NA,NA,NA,NA,NA,NA,NA,NA,NA,0,NA,NA,NA,"https://fbref.com/en/players/455c26a4/Angel-Alarcon"
"11430","Jordi Alba_2023",2023,"Barcelona","La Liga","Jordi Alba","ESP","DF","33",1989,15.8,25,18,13,11,1,12,28,42.9,16,12,5,7,11,36,23,0,"https://fbref.com/en/players/4601e194/Jordi-Alba"
"11431","Marcos Alonso_2023",2023,"Barcelona","La Liga","Marcos Alonso","ESP","DF","31",1990,13,15,10,10,5,0,9,12,75,3,14,10,4,11,26,32,0,"https://fbref.com/en/players/f4290206/Marcos-Alonso"
"11432","Ronald Araújo_2023",2023,"Barcelona","La Liga","Ronald Araújo","URU","DF","23",1999,20,26,18,12,13,1,6,9,66.7,3,15,7,8,12,38,41,1,"https://fbref.com/en/players/2bef2bca/Ronald-Araujo"
"11433","Pierre-Emerick Aubameyang_2023",2023,"Barcelona","La Liga","Pierre-Emerick Aubameyang","GAB","FW","33",1989,0.1,0,0,0,0,0,0,0,NA,0,0,0,0,0,0,0,0,"https://fbref.com/en/players/d5dd5f1f/Pierre-Emerick-Aubameyang"
"11434","Alejandro Balde_2023",2023,"Barcelona","La Liga","Alejandro Balde","ESP","DF","18",2003,27.5,42,30,22,16,4,24,41,58.5,17,25,3,22,12,54,17,1,"https://fbref.com/en/players/5ccc9672/Alejandro-Balde"
"11435","Héctor Bellerín_2023",2023,"Barcelona","La Liga","Héctor Bellerín","ESP","DF","27",1995,1.6,2,0,0,2,0,2,3,66.7,1,2,0,2,3,5,2,0,"https://fbref.com/en/players/f874dd44/Hector-Bellerin"
"11436","Sergio Busquets_2023",2023,"Barcelona","La Liga","Sergio Busquets","ESP","MF","34",1988,26,58,26,24,26,8,29,51,56.9,22,32,6,26,27,85,36,2,"https://fbref.com/en/players/5ab0ea87/Sergio-Busquets"
"11437","Andreas Christensen_2023",2023,"Barcelona","La Liga","Andreas Christensen","DEN","DF","26",1996,19.6,20,15,9,11,0,10,16,62.5,6,14,12,2,21,41,47,0,"https://fbref.com/en/players/1cb49278/Andreas-Christensen"
"11438","Ousmane Dembélé_2023",2023,"Barcelona","La Liga","Ousmane Dembélé","FRA","FW","25",1997,15.7,19,12,4,8,7,4,15,26.7,11,10,1,9,0,19,2,0,"https://fbref.com/en/players/b19db005/Ousmane-Dembele"
"11439","Ansu Fati_2023",2023,"Barcelona","La Liga","Ansu Fati","ESP","FW","19",2002,15.5,16,9,8,4,4,5,18,27.8,13,19,0,19,5,21,6,0,"https://fbref.com/en/players/0ba976e4/Ansu-Fati"
"11440","Eric García_2023",2023,"Barcelona","La Liga","Eric García","ESP","DF,MF","21",2001,15.7,24,16,16,5,3,9,20,45,11,23,10,13,19,43,36,1,"https://fbref.com/en/players/2bed3eab/Eric-Garcia"
"11441","Aleix Garrido_2023",2023,"Barcelona","La Liga","Aleix Garrido","ESP","FW","18",2004,0.1,2,1,1,0,1,1,1,100,0,1,0,1,0,2,0,0,"https://fbref.com/en/players/5757adc3/Aleix-Garrido"
"11442","Gavi_2023",2023,"Barcelona","La Liga","Gavi","ESP","MF,FW","17",2004,28.1,47,31,7,30,10,21,55,38.2,34,32,5,27,18,65,22,0,"https://fbref.com/en/players/19cae58d/Gavi"
"11443","Frenkie de Jong_2023",2023,"Barcelona","La Liga","Frenkie de Jong","NED","MF","25",1997,28.2,46,26,16,21,9,17,41,41.5,24,11,1,10,35,81,22,1,"https://fbref.com/en/players/1bacc518/Frenkie-de-Jong"
"11444","Franck Kessié_2023",2023,"Barcelona","La Liga","Franck Kessié","CIV","MF","25",1996,11,15,9,6,6,3,8,18,44.4,10,10,2,8,12,27,11,2,"https://fbref.com/en/players/05e19d6a/Franck-Kessie"
"11445","Jules Koundé_2023",2023,"Barcelona","La Liga","Jules Koundé","FRA","DF","23",1998,27,37,23,18,13,6,21,31,67.7,10,24,9,15,19,56,61,3,"https://fbref.com/en/players/4d1666ff/Jules-Kounde"
"11446","Robert Lewandowski_2023",2023,"Barcelona","La Liga","Robert Lewandowski","POL","FW","33",1988,31.6,17,11,2,5,10,7,14,50,7,20,0,20,2,19,14,0,"https://fbref.com/en/players/8d78e732/Robert-Lewandowski"
"11447","Memphis_2023",2023,"Barcelona","La Liga","Memphis","NED","FW","28",1994,1.3,1,1,1,0,0,0,1,0,1,0,0,0,0,1,0,0,"https://fbref.com/en/players/8f696594/Memphis"
"11448","Pedri_2023",2023,"Barcelona","La Liga","Pedri","ESP","MF","19",2002,22,39,22,15,17,7,13,45,28.9,32,27,0,27,13,52,8,1,"https://fbref.com/en/players/0d9b2d31/Pedri"
"11449","Iñaki Peña_2023",2023,"Barcelona","La Liga","Iñaki Peña","ESP","GK","23",1999,0.8,0,0,0,0,0,0,0,NA,0,0,0,0,0,0,0,1,"https://fbref.com/en/players/cc1c5035/Inaki-Pena"
"11450","Gerard Piqué_2023",2023,"Barcelona","La Liga","Gerard Piqué","ESP","DF","35",1987,4.3,5,4,1,4,0,4,4,100,0,2,1,1,2,7,19,0,"https://fbref.com/en/players/adfc9123/Gerard-Pique"
"11451","Raphinha_2023",2023,"Barcelona","La Liga","Raphinha","BRA","FW","25",1996,23,29,19,10,7,12,11,31,35.5,20,33,1,32,14,43,11,1,"https://fbref.com/en/players/3423f250/Raphinha"
"11452","Chadi Riad_2023",2023,"Barcelona","La Liga","Chadi Riad","MAR","MF","19",2003,0,0,0,0,0,0,0,0,NA,0,0,0,0,0,0,0,0,"https://fbref.com/en/players/b3b9b8b8/Chadi-Riad"
"11453","Sergi Roberto_2023",2023,"Barcelona","La Liga","Sergi Roberto","ESP","DF,MF","30",1992,14.5,22,15,12,6,4,7,18,38.9,11,15,7,8,11,33,16,0,"https://fbref.com/en/players/335fa267/Sergi-Roberto"
"11454","Marc-André ter Stegen_2023",2023,"Barcelona","La Liga","Marc-André ter Stegen","GER","GK","30",1992,37.2,0,0,0,0,0,0,0,NA,0,0,0,0,1,1,7,3,"https://fbref.com/en/players/6f51e382/Marc-Andre-ter-Stegen"
"11455","Pablo Torre_2023",2023,"Barcelona","La Liga","Pablo Torre","ESP","FW,MF","19",2003,1.6,2,1,0,1,1,2,4,50,2,1,0,1,2,4,1,0,"https://fbref.com/en/players/04e531b6/Pablo-Torre"
"11456","Ferrán Torres_2023",2023,"Barcelona","La Liga","Ferrán Torres","ESP","FW,MF","22",2000,15.5,13,7,4,5,4,5,20,25,15,11,2,9,3,16,5,0,"https://fbref.com/en/players/9e1035f8/Ferran-Torres"
"11457","Lamine Yamal_2023",2023,"Barcelona","La Liga","Lamine Yamal","ESP","FW","15",2007,0.1,0,0,0,0,0,0,0,NA,0,0,0,0,0,0,0,0,"https://fbref.com/en/players/82ec26c1/Lamine-Yamal"
"11458","Daley Blind_2023",2023,"Bayern Munich","Bundesliga","Daley Blind","NED","DF,MF","32",1990,1.5,2,0,2,0,0,0,1,0,1,4,2,2,2,4,6,0,"https://fbref.com/en/players/691bef82/Daley-Blind"
"11459","João Cancelo_2023",2023,"Bayern Munich","Bundesliga","João Cancelo","POR","DF,FW","28",1994,11.2,23,14,9,10,4,10,23,43.5,13,14,2,12,15,38,22,0,"https://fbref.com/en/players/bd6351cd/Joao-Cancelo"
"11460","Kingsley Coman_2023",2023,"Bayern Munich","Bundesliga","Kingsley Coman","FRA","FW,MF","26",1996,15.7,11,8,3,5,3,7,17,41.2,10,19,1,18,2,13,7,0,"https://fbref.com/en/players/042e8a49/Kingsley-Coman"
"11461","Alphonso Davies_2023",2023,"Bayern Munich","Bundesliga","Alphonso Davies","CAN","DF","21",2000,22.7,45,28,25,13,7,18,39,46.2,21,28,4,24,24,69,24,4,"https://fbref.com/en/players/d781d855/Alphonso-Davies"
"11462","Serge Gnabry_2023",2023,"Bayern Munich","Bundesliga","Serge Gnabry","GER","FW,MF","27",1995,21.6,35,23,11,14,10,17,43,39.5,26,24,1,23,11,46,5,1,"https://fbref.com/en/players/88e357ef/Serge-Gnabry"
"11463","Leon Goretzka_2023",2023,"Bayern Munich","Bundesliga","Leon Goretzka","GER","MF","27",1995,19.2,43,24,21,16,6,27,48,56.3,21,40,3,37,30,73,32,0,"https://fbref.com/en/players/cc86b9a3/Leon-Goretzka"
"11464","Ryan Gravenberch_2023",2023,"Bayern Munich","Bundesliga","Ryan Gravenberch","NED","MF","20",2002,6.4,17,8,4,10,3,7,13,53.8,6,9,1,8,9,26,10,0,"https://fbref.com/en/players/b8e740fb/Ryan-Gravenberch"
"11465","Lucas Hernández_2023",2023,"Bayern Munich","Bundesliga","Lucas Hernández","FRA","DF","26",1996,5.3,6,4,3,3,0,5,6,83.3,1,2,1,1,5,11,7,0,"https://fbref.com/en/players/c3ee18ef/Lucas-Hernandez"
"11466","Arijon Ibrahimović_2023",2023,"Bayern Munich","Bundesliga","Arijon Ibrahimović","GER","MF","16",2005,0.2,1,1,1,0,0,0,0,NA,0,0,0,0,0,1,0,0,"https://fbref.com/en/players/f5c4fd91/Arijon-Ibrahimovic"
"11467","Joshua Kimmich_2023",2023,"Bayern Munich","Bundesliga","Joshua Kimmich","GER","MF","27",1995,31.2,78,49,24,46,8,38,72,52.8,34,36,7,29,41,119,39,2,"https://fbref.com/en/players/49296448/Joshua-Kimmich"
"11468","Matthijs de Ligt_2023",2023,"Bayern Munich","Bundesliga","Matthijs de Ligt","NED","DF","22",1999,26.7,32,23,15,16,1,15,24,62.5,9,31,20,11,23,55,85,0,"https://fbref.com/en/players/d6e53a3a/Matthijs-de-Ligt"
"11469","Sadio Mané_2023",2023,"Bayern Munich","Bundesliga","Sadio Mané","SEN","FW,MF","30",1992,15.8,11,5,3,3,5,1,9,11.1,8,15,2,13,0,11,4,0,"https://fbref.com/en/players/c691bfe2/Sadio-Mane"
"11470","Eric Maxim Choupo-Moting_2023",2023,"Bayern Munich","Bundesliga","Eric Maxim Choupo-Moting","CMR","FW","33",1989,12.4,10,7,2,6,2,1,2,50,1,8,0,8,0,10,5,0,"https://fbref.com/en/players/0e6bc38c/Eric-Maxim-Choupo-Moting"
"11471","Noussair Mazraoui_2023",2023,"Bayern Munich","Bundesliga","Noussair Mazraoui","MAR","DF","24",1997,11.9,29,21,9,9,11,15,24,62.5,9,13,2,11,10,39,25,0,"https://fbref.com/en/players/b74277a0/Noussair-Mazraoui"
"11472","Thomas Müller_2023",2023,"Bayern Munich","Bundesliga","Thomas Müller","GER","FW,MF","32",1989,18.5,21,12,5,9,7,6,16,37.5,10,19,3,16,4,25,16,0,"https://fbref.com/en/players/3c6089ab/Thomas-Muller"
"11473","Jamal Musiala_2023",2023,"Bayern Munich","Bundesliga","Jamal Musiala","GER","MF,FW","19",2003,24.4,34,23,9,16,9,13,35,37.1,22,30,3,27,19,53,3,0,"https://fbref.com/en/players/2c0558b8/Jamal-Musiala"
"11474","Manuel Neuer_2023",2023,"Bayern Munich","Bundesliga","Manuel Neuer","GER","GK","36",1986,12,0,0,0,0,0,0,0,NA,0,0,0,0,0,0,4,1,"https://fbref.com/en/players/8778c910/Manuel-Neuer"
"11475","Benjamin Pavard_2023",2023,"Bayern Munich","Bundesliga","Benjamin Pavard","FRA","DF","26",1996,27,70,41,36,26,8,36,48,75,12,35,16,19,44,114,83,0,"https://fbref.com/en/players/45a03961/Benjamin-Pavard"
"11476","Marcel Sabitzer_2023",2023,"Bayern Munich","Bundesliga","Marcel Sabitzer","AUT","MF","28",1994,7,27,14,11,10,6,10,17,58.8,7,3,0,3,10,37,9,0,"https://fbref.com/en/players/e280527c/Marcel-Sabitzer"
"11477","Leroy Sané_2023",2023,"Bayern Munich","Bundesliga","Leroy Sané","GER","MF,FW","26",1996,22.3,38,30,11,19,8,18,36,50,18,11,1,10,3,41,1,2,"https://fbref.com/en/players/2b114be3/Leroy-Sane"
"11478","Bouna Sarr_2023",2023,"Bayern Munich","Bundesliga","Bouna Sarr","SEN","FW","30",1992,0,0,0,0,0,0,0,0,NA,0,0,0,0,0,0,0,0,"https://fbref.com/en/players/1a4b9094/Bouna-Sarr"
"11479","Yann Sommer_2023",2023,"Bayern Munich","Bundesliga","Yann Sommer","SUI","GK","33",1988,19,0,0,0,0,0,0,0,NA,0,0,0,0,1,1,5,1,"https://fbref.com/en/players/420c18a1/Yann-Sommer"
"11480","Josip Stanišić_2023",2023,"Bayern Munich","Bundesliga","Josip Stanišić","CRO","DF","22",2000,6.4,19,11,14,2,3,12,17,70.6,5,9,1,8,7,26,11,3,"https://fbref.com/en/players/7ed08d5c/Josip-Stanisic"
"11481","Mathys Tel_2023",2023,"Bayern Munich","Bundesliga","Mathys Tel","FRA","FW","17",2005,4.6,2,2,0,1,1,1,1,100,0,5,1,4,0,2,2,0,"https://fbref.com/en/players/829aa60c/Mathys-Tel"
"11482","Sven Ulreich_2023",2023,"Bayern Munich","Bundesliga","Sven Ulreich","GER","GK","33",1988,3,1,1,1,0,0,1,1,100,0,0,0,0,0,1,0,1,"https://fbref.com/en/players/7d3e7da6/Sven-Ulreich"
"11483","Dayot Upamecano_2023",2023,"Bayern Munich","Bundesliga","Dayot Upamecano","FRA","DF","23",1998,26.1,65,37,43,22,0,28,45,62.2,17,26,6,20,27,92,71,4,"https://fbref.com/en/players/d248cd8f/Dayot-Upamecano"
"11484","Gabriel Vidovic_2023",2023,"Bayern Munich","Bundesliga","Gabriel Vidovic","CRO","FW","18",2003,0.2,0,0,0,0,0,0,0,NA,0,0,0,0,0,0,0,0,"https://fbref.com/en/players/5360a956/Gabriel-Vidovic"
"11485","Paul Wanner_2023",2023,"Bayern Munich","Bundesliga","Paul Wanner","GER","MF","16",2005,0.3,3,1,1,2,0,1,1,100,0,0,0,0,0,3,1,0,"https://fbref.com/en/players/cb64672e/Paul-Wanner"
"11486","Abner_2023",2023,"Betis","La Liga","Abner","BRA","DF","22",2000,6.7,12,9,9,2,1,7,16,43.8,9,8,2,6,8,20,24,0,"https://fbref.com/en/players/7f9c5d2d/Abner"
"11487","Paul Akouokou_2023",2023,"Betis","La Liga","Paul Akouokou","CIV","MF,DF","24",1997,5,16,9,13,3,0,13,20,65,7,2,2,0,12,28,17,1,"https://fbref.com/en/players/31f5b89b/Paul-Akouokou"
"11488","Claudio Bravo_2023",2023,"Betis","La Liga","Claudio Bravo","CHI","GK","39",1983,12,0,0,0,0,0,0,0,NA,0,0,0,0,2,2,1,1,"https://fbref.com/en/players/10072610/Claudio-Bravo"
"11489","Sergio Canales_2023",2023,"Betis","La Liga","Sergio Canales","ESP","FW,MF","31",1991,26.7,25,14,10,8,7,14,33,42.4,19,18,0,18,14,39,8,0,"https://fbref.com/en/players/a6de370d/Sergio-Canales"
"11490","William Carvalho_2023",2023,"Betis","La Liga","William Carvalho","POR","MF","30",1992,27.1,43,27,18,23,2,17,44,38.6,27,27,6,21,16,59,22,0,"https://fbref.com/en/players/dee86451/William-Carvalho"
"11491","Juan Cruz_2023",2023,"Betis","La Liga","Juan Cruz","ESP","FW","22",2000,2,1,0,0,1,0,1,3,33.3,2,1,0,1,0,1,0,0,"https://fbref.com/en/players/cc2dd8a5/Juan-Cruz"
"11492","Fran Delgado_2023",2023,"Betis","La Liga","Fran Delgado","ESP","DF","21",2001,0.1,0,0,0,0,0,0,0,NA,0,0,0,0,0,0,0,0,"https://fbref.com/en/players/e7d2a50b/Fran-Delgado"
"11493","Nabil Fekir_2023",2023,"Betis","La Liga","Nabil Fekir","FRA","MF","29",1993,10.7,11,5,3,3,5,2,9,22.2,7,6,2,4,1,12,0,0,"https://fbref.com/en/players/bece776f/Nabil-Fekir"
"11494","Luiz Felipe_2023",2023,"Betis","La Liga","Luiz Felipe","ITA","DF","25",1997,19.6,34,23,23,11,0,18,34,52.9,16,43,24,19,28,62,106,0,"https://fbref.com/en/players/15d0c248/Luiz-Felipe"
"11495","Felix Garreta_2023",2023,"Betis","La Liga","Felix Garreta","ESP","DF","18",2004,1,1,0,0,1,0,0,0,NA,0,1,1,0,1,2,4,0,"https://fbref.com/en/players/9a26fa06/Felix-Garreta"
"11496","Édgar González_2023",2023,"Betis","La Liga","Édgar González","ESP","DF","25",1997,19.7,28,19,18,7,3,14,27,51.9,13,12,9,3,21,49,120,0,"https://fbref.com/en/players/49d028db/Edgar-Gonzalez"
"11497","Roberto González_2023",2023,"Betis","La Liga","Roberto González","ESP","FW,MF","21",2001,0.6,0,0,0,0,0,0,1,0,1,0,0,0,1,1,0,0,"https://fbref.com/en/players/56545648/Roberto-Gonzalez"
"11498","Andrés Guardado_2023",2023,"Betis","La Liga","Andrés Guardado","MEX","MF","35",1986,15.3,41,25,17,20,4,18,43,41.9,25,14,5,9,23,64,29,0,"https://fbref.com/en/players/ef322658/Andres-Guardado"
"11499","Luiz Henrique_2023",2023,"Betis","La Liga","Luiz Henrique","BRA","FW","21",2001,20.1,48,34,27,15,6,20,44,45.5,24,22,0,22,14,62,17,0,"https://fbref.com/en/players/8059806f/Luiz-Henrique"
"11500","Borja Iglesias_2023",2023,"Betis","La Liga","Borja Iglesias","ESP","FW","29",1993,26.3,8,4,3,3,2,2,13,15.4,11,9,1,8,1,9,17,0,"https://fbref.com/en/players/75645f0e/Borja-Iglesias"
"11501","Joaquín_2023",2023,"Betis","La Liga","Joaquín","ESP","MF,FW","41",1981,5.5,3,3,2,1,0,1,3,33.3,2,7,2,5,4,7,5,0,"https://fbref.com/en/players/4c5b14d2/Joaquin"
"11502","Willian José_2023",2023,"Betis","La Liga","Willian José","BRA","FW","30",1991,8.1,9,6,6,3,0,4,9,44.4,5,4,0,4,1,10,15,0,"https://fbref.com/en/players/d87e2cae/Willian-Jose"
"11503","Juanmi_2023",2023,"Betis","La Liga","Juanmi","ESP","FW","29",1993,10.3,14,10,4,7,3,7,31,22.6,24,10,0,10,4,18,4,0,"https://fbref.com/en/players/84399660/Juanmi"
"11504","Juan Miranda_2023",2023,"Betis","La Liga","Juan Miranda","ESP","DF","22",2000,16.4,23,16,16,6,1,14,29,48.3,15,20,7,13,20,43,63,0,"https://fbref.com/en/players/ead61f73/Juan-Miranda"
"11505","Martín Montoya_2023",2023,"Betis","La Liga","Martín Montoya","ESP","DF","31",1991,5,13,8,9,4,0,10,12,83.3,2,6,1,5,9,22,14,1,"https://fbref.com/en/players/5cec2487/Martin-Montoya"
"11506","Álex Moreno_2023",2023,"Betis","La Liga","Álex Moreno","ESP","DF","29",1993,15,29,22,19,10,0,18,36,50,18,17,4,13,17,46,39,0,"https://fbref.com/en/players/16e9d0ea/Alex-Moreno"
"11507","Loren Morón_2023",2023,"Betis","La Liga","Loren Morón","ESP","FW","28",1993,0.2,2,2,0,1,1,0,0,NA,0,0,0,0,0,2,1,0,"https://fbref.com/en/players/3aa4a3be/Loren-Moron"
"11508","Ayoze Pérez_2023",2023,"Betis","La Liga","Ayoze Pérez","ESP","FW,MF","29",1993,15.4,31,15,9,16,6,10,40,25,30,22,0,22,13,44,5,0,"https://fbref.com/en/players/819aa8e7/Ayoze-Perez"
"11509","Germán Pezzella_2023",2023,"Betis","La Liga","Germán Pezzella","ARG","DF","31",1991,27.9,41,28,32,9,0,26,38,68.4,12,32,15,17,50,91,129,1,"https://fbref.com/en/players/8c725b43/German-Pezzella"
"11510","Rodri_2023",2023,"Betis","La Liga","Rodri","ESP","FW,MF","22",2000,17.8,16,11,5,9,2,8,17,47.1,9,10,0,10,13,29,2,0,"https://fbref.com/en/players/85bed4ee/Rodri"
"11511","Guido Rodríguez_2023",2023,"Betis","La Liga","Guido Rodríguez","ARG","MF","28",1994,31.9,115,75,59,50,6,54,101,53.5,47,58,14,44,42,157,76,1,"https://fbref.com/en/players/34e393f2/Guido-Rodriguez"
"11512","Aitor Ruibal_2023",2023,"Betis","La Liga","Aitor Ruibal","ESP","DF,FW","26",1996,16.2,47,29,35,9,3,31,58,53.4,27,17,2,15,24,71,41,0,"https://fbref.com/en/players/a55d8df5/Aitor-Ruibal"
"11513","Víctor Ruiz_2023",2023,"Betis","La Liga","Víctor Ruiz","ESP","DF","33",1989,6.2,5,3,3,2,0,3,3,100,0,10,7,3,6,11,34,0,"https://fbref.com/en/players/b3dc6eca/Victor-Ruiz"
"11514","Youssouf Sabaly_2023",2023,"Betis","La Liga","Youssouf Sabaly","SEN","DF","29",1993,18.7,45,23,29,14,2,22,33,66.7,11,35,8,27,19,64,52,1,"https://fbref.com/en/players/fbbb9269/Youssouf-Sabaly"
"11515","Rui Silva_2023",2023,"Betis","La Liga","Rui Silva","POR","GK","28",1994,26,4,1,4,0,0,4,4,100,0,0,0,0,0,4,12,1,"https://fbref.com/en/players/ea83bfa6/Rui-Silva"
"11516","Christopher Antwi-Adjei_2023",2023,"Bochum","Bundesliga","Christopher Antwi-Adjei","GHA","FW,MF","28",1994,22,23,15,7,8,8,10,29,34.5,19,17,0,17,5,28,16,0,"https://fbref.com/en/players/0a3f6cde/Christopher-Antwi-Adjei"
"11517","Takuma Asano_2023",2023,"Bochum","Bundesliga","Takuma Asano","JPN","FW,MF","27",1994,19,14,9,4,4,6,7,16,43.8,9,17,1,16,8,22,8,0,"https://fbref.com/en/players/13ddc856/Takuma-Asano"
"11518","Moritz Broschinski_2023",2023,"Bochum","Bundesliga","Moritz Broschinski","GER","FW,MF","21",2000,2.4,0,0,0,0,0,0,5,0,5,1,0,1,0,0,6,0,"https://fbref.com/en/players/bbd79358/Moritz-Broschinski"
"11519","Philipp Förster_2023",2023,"Bochum","Bundesliga","Philipp Förster","GER","MF","27",1995,14.5,31,19,11,15,5,12,40,30,28,22,0,22,6,37,6,0,"https://fbref.com/en/players/76fa965f/Philipp-Forster"
"11520","Cristian Gamboa_2023",2023,"Bochum","Bundesliga","Cristian Gamboa","CRC","DF","32",1989,16.4,42,24,27,14,1,21,31,67.7,10,20,7,13,16,58,34,1,"https://fbref.com/en/players/f27680d9/Cristian-Gamboa"
"11521","Silvère Ganvoula M'Boussy_2023",2023,"Bochum","Bundesliga","Silvère Ganvoula M'Boussy","CGO","FW,MF","26",1996,2.7,2,2,0,1,1,0,0,NA,0,0,0,0,0,2,3,0,"https://fbref.com/en/players/6c731625/Silvere-Ganvoula-MBoussy"
"11522","Jacek Góralski_2023",2023,"Bochum","Bundesliga","Jacek Góralski","POL","MF","29",1992,1.6,6,3,3,3,0,4,6,66.7,2,4,0,4,3,9,5,0,"https://fbref.com/en/players/83b9c48f/Jacek-Goralski"
"11523","Dominique Heintz_2023",2023,"Bochum","Bundesliga","Dominique Heintz","GER","DF","28",1993,8.8,13,9,5,7,1,6,17,35.3,11,11,7,4,12,25,34,0,"https://fbref.com/en/players/699fb8db/Dominique-Heintz"
"11524","Philipp Hofmann_2023",2023,"Bochum","Bundesliga","Philipp Hofmann","GER","FW","29",1993,29.2,18,11,0,13,5,5,12,41.7,7,20,8,12,6,24,48,0,"https://fbref.com/en/players/877bc844/Philipp-Hofmann"
"11525","Gerrit Holtmann_2023",2023,"Bochum","Bundesliga","Gerrit Holtmann","PHI","FW,MF","27",1995,10.5,14,7,6,7,1,12,21,57.1,9,15,1,14,2,16,4,0,"https://fbref.com/en/players/2979c05a/Gerrit-Holtmann"
"11526","Jannes Horn_2023",2023,"Bochum","Bundesliga","Jannes Horn","GER","DF,FW","25",1997,0.7,2,1,1,1,0,1,1,100,0,1,0,1,3,5,2,0,"https://fbref.com/en/players/2b83fa49/Jannes-Horn"
"11527","Saidy Janko_2023",2023,"Bochum","Bundesliga","Saidy Janko","GAM","DF","26",1995,12.6,23,15,13,8,2,12,20,60,8,24,10,14,11,34,33,1,"https://fbref.com/en/players/689c9cf4/Saidy-Janko"
"11528","Pierre Kunde_2023",2023,"Bochum","Bundesliga","Pierre Kunde","CMR","MF,FW","27",1995,4.2,12,6,3,8,1,6,14,42.9,8,7,1,6,7,19,9,0,"https://fbref.com/en/players/9ceb7642/Pierre-Kunde"
"11529","Vassilis Lambropoulos_2023",2023,"Bochum","Bundesliga","Vassilis Lambropoulos","GRE","DF","32",1990,7,10,8,7,3,0,6,9,66.7,3,5,3,2,13,23,41,0,"https://fbref.com/en/players/591477c9/Vassilis-Lambropoulos"
"11530","Anthony Losilla_2023",2023,"Bochum","Bundesliga","Anthony Losilla","FRA","MF","36",1986,30.2,76,49,32,34,10,38,77,49.4,39,39,12,27,37,113,67,0,"https://fbref.com/en/players/07c7eb0c/Anthony-Losilla"
"11531","Erhan Mašović_2023",2023,"Bochum","Bundesliga","Erhan Mašović","SRB","DF,MF","23",1998,24.2,50,31,28,21,1,30,51,58.8,21,30,14,16,27,77,79,0,"https://fbref.com/en/players/a396fb61/Erhan-Masovic"
"11532","Tim Oermann_2023",2023,"Bochum","Bundesliga","Tim Oermann","GER","DF","18",2003,2.2,2,1,2,0,0,1,1,100,0,3,2,1,1,3,8,1,"https://fbref.com/en/players/57ec75bf/Tim-Oermann"
"11533","Ivan Ordets_2023",2023,"Bochum","Bundesliga","Ivan Ordets","UKR","DF","30",1992,27.2,31,19,21,9,1,16,28,57.1,12,34,17,17,57,88,139,0,"https://fbref.com/en/players/86c75897/Ivan-Ordets"
"11534","Jordi Osei-Tutu_2023",2023,"Bochum","Bundesliga","Jordi Osei-Tutu","ENG","DF,FW","23",1998,8.3,23,18,13,5,5,12,23,52.2,11,12,5,7,10,33,8,0,"https://fbref.com/en/players/0a16eb36/Jordi-Osei-Tutu"
"11535","Patrick Osterhage_2023",2023,"Bochum","Bundesliga","Patrick Osterhage","GER","MF","22",2000,11.4,20,17,8,10,2,11,16,68.8,5,17,6,11,12,32,25,0,"https://fbref.com/en/players/9662c9ec/Patrick-Osterhage"
"11536","Manuel Riemann_2023",2023,"Bochum","Bundesliga","Manuel Riemann","GER","GK","33",1988,34,3,2,3,0,0,3,5,60,2,1,0,1,5,8,23,7,"https://fbref.com/en/players/9f941969/Manuel-Riemann"
"11537","Keven Schlotterbeck_2023",2023,"Bochum","Bundesliga","Keven Schlotterbeck","GER","DF","25",1997,8.2,17,9,12,5,0,9,11,81.8,2,11,5,6,14,31,49,0,"https://fbref.com/en/players/f6bdc830/Keven-Schlotterbeck"
"11538","Danilo Soares_2023",2023,"Bochum","Bundesliga","Danilo Soares","BRA","DF","30",1991,19.6,72,46,42,23,7,43,72,59.7,29,29,6,23,30,102,56,1,"https://fbref.com/en/players/c05f2f8c/Danilo-Soares"
"11539","Kostas Stafylidis_2023",2023,"Bochum","Bundesliga","Kostas Stafylidis","GRE","DF,MF","28",1993,11.6,27,16,13,8,6,10,24,41.7,14,21,8,13,20,47,31,1,"https://fbref.com/en/players/861e0116/Kostas-Stafylidis"
"11540","Kevin Stöger_2023",2023,"Bochum","Bundesliga","Kevin Stöger","AUT","MF","28",1993,28.9,84,45,38,32,14,31,94,33,63,27,4,23,26,110,21,1,"https://fbref.com/en/players/e5649a78/Kevin-Stoger"
"11541","Simon Zoller_2023",2023,"Bochum","Bundesliga","Simon Zoller","GER","FW","31",1991,16.2,11,4,2,8,1,4,12,33.3,8,14,1,13,6,17,21,0,"https://fbref.com/en/players/29f7cfd9/Simon-Zoller"
"11542","Michel Aebischer_2023",2023,"Bologna","Serie A","Michel Aebischer","SUI","FW,MF","25",1997,17.1,12,6,3,6,3,2,18,11.1,16,14,2,12,7,19,9,0,"https://fbref.com/en/players/f9c927de/Michel-Aebischer"
"11543","Marko Arnautović_2023",2023,"Bologna","Serie A","Marko Arnautović","AUT","FW","33",1989,17,9,6,2,5,2,1,6,16.7,5,11,1,10,2,11,10,0,"https://fbref.com/en/players/00459419/Marko-Arnautovic"
"11544","Francesco Bardi_2023",2023,"Bologna","Serie A","Francesco Bardi","ITA","GK","30",1992,1,0,0,0,0,0,0,0,NA,0,0,0,0,0,0,0,0,"https://fbref.com/en/players/0acda699/Francesco-Bardi"
"11545","Musa Barrow_2023",2023,"Bologna","Serie A","Musa Barrow","GAM","FW,MF","23",1998,21.8,21,4,10,6,5,8,14,57.1,6,25,1,24,1,22,7,0,"https://fbref.com/en/players/e5bf73f3/Musa-Barrow"
"11546","Kevin Bonifazi_2023",2023,"Bologna","Serie A","Kevin Bonifazi","ITA","DF","26",1996,10,13,8,7,6,0,6,12,50,6,11,8,3,12,25,39,0,"https://fbref.com/en/players/fb77bfef/Kevin-Bonifazi"
"11547","Andrea Cambiaso_2023",2023,"Bologna","Serie A","Andrea Cambiaso","ITA","DF","22",2000,24.1,57,34,34,20,3,28,65,43.1,37,26,2,24,26,83,33,1,"https://fbref.com/en/players/247ed022/Andrea-Cambiaso"
"11548","Lorenzo De Silvestri_2023",2023,"Bologna","Serie A","Lorenzo De Silvestri","ITA","DF","34",1988,7.5,3,2,2,0,1,3,7,42.9,4,6,5,1,3,6,20,0,"https://fbref.com/en/players/e74f0e59/Lorenzo-De-Silvestri"
"11549","Nicolás Domínguez_2023",2023,"Bologna","Serie A","Nicolás Domínguez","ARG","MF","24",1998,25.6,79,49,34,33,12,39,76,51.3,37,29,3,26,21,100,29,1,"https://fbref.com/en/players/20b3a502/Nicolas-Dominguez"
"11550","Lewis Ferguson_2023",2023,"Bologna","Serie A","Lewis Ferguson","SCO","MF,FW","22",1999,25.7,44,25,16,20,8,20,40,50,20,22,7,15,19,63,25,0,"https://fbref.com/en/players/ee64a822/Lewis-Ferguson"
"11551","Denso Kasius_2023",2023,"Bologna","Serie A","Denso Kasius","NED","DF","19",2002,3.8,12,6,7,4,1,8,10,80,2,6,3,3,3,15,6,0,"https://fbref.com/en/players/7ae36711/Denso-Kasius"
"11552","Giorgos Kyriakopoulos_2023",2023,"Bologna","Serie A","Giorgos Kyriakopoulos","GRE","DF,FW","26",1996,7.8,13,6,4,5,4,10,23,43.5,13,14,2,12,4,17,10,0,"https://fbref.com/en/players/0a483542/Giorgos-Kyriakopoulos"
"11553","Jhon Lucumí_2023",2023,"Bologna","Serie A","Jhon Lucumí","COL","DF","24",1998,32.2,53,37,39,13,1,24,43,55.8,19,43,26,17,35,88,100,1,"https://fbref.com/en/players/80490d7f/Jhon-Lucumi"
"11554","Charalambos Lykogiannis_2023",2023,"Bologna","Serie A","Charalambos Lykogiannis","GRE","DF","28",1993,12.3,16,8,5,6,5,5,13,38.5,8,9,4,5,15,31,30,0,"https://fbref.com/en/players/5efc5389/Charalambos-Lykogiannis"
"11555","Gary Medel_2023",2023,"Bologna","Serie A","Gary Medel","CHI","MF,DF","34",1987,16.4,25,15,16,7,2,9,16,56.3,7,17,10,7,28,53,34,0,"https://fbref.com/en/players/563a68ad/Gary-Medel"
"11556","Nikola Moro_2023",2023,"Bologna","Serie A","Nikola Moro","CRO","MF","24",1998,13.6,32,21,11,15,6,14,36,38.9,22,15,2,13,8,40,18,0,"https://fbref.com/en/players/ff579c7e/Nikola-Moro"
"11557","Riccardo Orsolini_2023",2023,"Bologna","Serie A","Riccardo Orsolini","ITA","FW","25",1997,23.6,30,19,15,10,5,17,41,41.5,24,29,3,26,8,38,18,0,"https://fbref.com/en/players/e14ec482/Riccardo-Orsolini"
"11558","Stefan Posch_2023",2023,"Bologna","Serie A","Stefan Posch","AUT","DF","25",1997,28.1,81,43,41,29,11,44,75,58.7,31,44,15,29,35,116,69,0,"https://fbref.com/en/players/7f609bfc/Stefan-Posch"
"11559","Niklas Pyyhtiä_2023",2023,"Bologna","Serie A","Niklas Pyyhtiä","FIN","MF","18",2003,1.2,1,0,0,1,0,0,1,0,1,1,1,0,1,2,4,0,"https://fbref.com/en/players/88f53b75/Niklas-Pyyhtia"
"11560","Antonio Raimondo_2023",2023,"Bologna","Serie A","Antonio Raimondo","ITA","FW","18",2004,0.2,0,0,0,0,0,0,0,NA,0,0,0,0,0,0,1,0,"https://fbref.com/en/players/ce1a6c7e/Antonio-Raimondo"
"11561","Nicola Sansone_2023",2023,"Bologna","Serie A","Nicola Sansone","ITA","FW","30",1991,8.2,12,4,6,4,2,5,10,50,5,0,0,0,0,12,4,0,"https://fbref.com/en/players/7eb97a8e/Nicola-Sansone"
"11562","Jerdy Schouten_2023",2023,"Bologna","Serie A","Jerdy Schouten","NED","MF","25",1997,27.9,63,38,28,33,2,27,49,55.1,22,40,17,23,40,103,43,1,"https://fbref.com/en/players/2cfae697/Jerdy-Schouten"
"11563","Łukasz Skorupski_2023",2023,"Bologna","Serie A","Łukasz Skorupski","POL","GK","31",1991,37,2,1,2,0,0,1,2,50,1,0,0,0,0,2,19,2,"https://fbref.com/en/players/ab4449d6/Lukasz-Skorupski"
"11564","Roberto Soriano_2023",2023,"Bologna","Serie A","Roberto Soriano","ITA","FW,MF","31",1991,14.7,31,16,9,16,6,13,25,52,12,23,2,21,6,37,14,0,"https://fbref.com/en/players/9d4c45d6/Roberto-Soriano"
"11565","Joaquin Sosa_2023",2023,"Bologna","Serie A","Joaquin Sosa","URU","DF","20",2002,7.6,6,2,5,1,0,4,18,22.2,14,5,3,2,6,12,31,0,"https://fbref.com/en/players/50841bef/Joaquin-Sosa"
"11566","Adama Soumaoro_2023",2023,"Bologna","Serie A","Adama Soumaoro","FRA","DF","30",1992,20.7,25,17,11,12,2,5,7,71.4,2,18,13,5,15,40,75,1,"https://fbref.com/en/players/7b075c75/Adama-Soumaoro"
"11567","Emanuel Vignato_2023",2023,"Bologna","Serie A","Emanuel Vignato","ITA","MF,FW","21",2000,2.7,4,4,2,2,0,2,4,50,2,2,0,2,3,7,0,0,"https://fbref.com/en/players/ec5dae45/Emanuel-Vignato"
"11568","Joshua Zirkzee_2023",2023,"Bologna","Serie A","Joshua Zirkzee","NED","FW","21",2001,9.1,4,2,1,1,2,2,7,28.6,5,4,1,3,4,8,4,0,"https://fbref.com/en/players/028e70b9/Joshua-Zirkzee"
"11569","Jaidon Anthony_2023",2023,"Bournemouth","Premier League","Jaidon Anthony","ENG","MF,FW","22",1999,14,30,17,15,9,6,8,24,33.3,16,30,3,27,10,40,19,0,"https://fbref.com/en/players/e4238fb1/Jaidon-Anthony"
"11570","Owen Bevan_2023",2023,"Bournemouth","Premier League","Owen Bevan","WAL","DF","18",2003,0.1,0,0,0,0,0,0,0,NA,0,0,0,0,0,0,0,0,"https://fbref.com/en/players/87966294/Owen-Bevan"
"11571","Philip Billing_2023",2023,"Bournemouth","Premier League","Philip Billing","DEN","MF,FW","26",1996,30.7,63,36,21,33,9,11,40,27.5,29,48,8,40,31,94,58,1,"https://fbref.com/en/players/d328a254/Philip-Billing"
"11572","David Brooks_2023",2023,"Bournemouth","Premier League","David Brooks","WAL","FW,MF","25",1997,1.9,1,0,1,0,0,0,1,0,1,2,0,2,2,3,5,0,"https://fbref.com/en/players/dc4cae05/David-Brooks"
"11573","Ryan Christie_2023",2023,"Bournemouth","Premier League","Ryan Christie","SCO","MF,FW","27",1995,20.4,34,22,10,23,1,14,49,28.6,35,16,4,12,26,60,20,0,"https://fbref.com/en/players/26ce2263/Ryan-Christie"
"11574","Lewis Cook_2023",2023,"Bournemouth","Premier League","Lewis Cook","ENG","MF","25",1997,19.1,37,22,10,22,5,18,42,42.9,24,29,10,19,23,60,31,0,"https://fbref.com/en/players/2afc7272/Lewis-Cook"
"11575","Siriki Dembélé_2023",2023,"Bournemouth","Premier League","Siriki Dembélé","CIV","FW,MF","25",1996,1.2,3,1,2,1,0,0,1,0,1,1,0,1,1,4,1,0,"https://fbref.com/en/players/11f54bd5/Siriki-Dembele"
"11576","Ryan Fredericks_2023",2023,"Bournemouth","Premier League","Ryan Fredericks","ENG","DF","29",1992,5.9,3,2,2,0,1,1,4,25,3,7,2,5,1,4,27,0,"https://fbref.com/en/players/c067631c/Ryan-Fredericks"
"11577","Hamed Junior Traorè_2023",2023,"Bournemouth","Premier League","Hamed Junior Traorè","CIV","FW,MF","22",2000,4.7,17,11,5,9,3,6,18,33.3,12,9,0,9,2,19,1,0,"https://fbref.com/en/players/570bb4b9/Hamed-Junior-Traore"
"11578","Lloyd Kelly_2023",2023,"Bournemouth","Premier League","Lloyd Kelly","ENG","DF","23",1998,22.7,33,18,23,9,1,13,19,68.4,6,26,15,11,26,59,101,1,"https://fbref.com/en/players/f31def1e/Lloyd-Kelly"
"11579","Jefferson Lerma_2023",2023,"Bournemouth","Premier League","Jefferson Lerma","COL","MF","27",1994,36.1,50,30,23,23,4,20,45,44.4,25,32,15,17,47,97,91,1,"https://fbref.com/en/players/9b5ce51a/Jefferson-Lerma"
"11580","Jamal Lowe_2023",2023,"Bournemouth","Premier League","Jamal Lowe","JAM","MF,FW","28",1994,0.1,0,0,0,0,0,0,0,NA,0,0,0,0,0,0,0,0,"https://fbref.com/en/players/b2856bc0/Jamal-Lowe"
"11581","Emiliano Marcondes_2023",2023,"Bournemouth","Premier League","Emiliano Marcondes","DEN","MF","27",1995,0.1,0,0,0,0,0,0,0,NA,0,0,0,0,0,0,1,0,"https://fbref.com/en/players/4d960fc3/Emiliano-Marcondes"
"11582","Chris Mepham_2023",2023,"Bournemouth","Premier League","Chris Mepham","WAL","DF","24",1997,24.4,45,22,37,8,0,19,30,63.3,11,40,27,13,30,75,152,0,"https://fbref.com/en/players/fed96827/Chris-Mepham"
"11583","Kieffer Moore_2023",2023,"Bournemouth","Premier League","Kieffer Moore","WAL","FW","29",1992,14.2,14,11,2,9,3,5,16,31.3,11,12,5,7,1,15,26,0,"https://fbref.com/en/players/01ce9e70/Kieffer-Moore"
"11584","Neto_2023",2023,"Bournemouth","Premier League","Neto","BRA","GK","33",1989,26.5,3,1,3,0,0,3,3,100,0,0,0,0,0,3,10,3,"https://fbref.com/en/players/a9dc785c/Neto"
"11585","Dango Ouattara_2023",2023,"Bournemouth","Premier League","Dango Ouattara","BFA","MF,FW","20",2002,13.8,28,15,20,6,2,13,32,40.6,19,20,3,17,13,41,29,1,"https://fbref.com/en/players/2f9e4435/Dango-Ouattara"
"11586","Ben Pearson_2023",2023,"Bournemouth","Premier League","Ben Pearson","ENG","MF","27",1995,3.2,7,3,3,3,1,1,3,33.3,2,4,0,4,2,9,6,0,"https://fbref.com/en/players/a6b461e7/Ben-Pearson"
"11587","Joe Rothwell_2023",2023,"Bournemouth","Premier League","Joe Rothwell","ENG","MF","27",1995,11.3,20,13,7,12,1,7,21,33.3,14,14,3,11,9,29,7,0,"https://fbref.com/en/players/10a10454/Joe-Rothwell"
"11588","Antoine Semenyo_2023",2023,"Bournemouth","Premier League","Antoine Semenyo","GHA","FW,MF","22",2000,2.9,1,0,0,0,1,1,6,16.7,5,10,1,9,2,3,4,0,"https://fbref.com/en/players/efd2ec23/Antoine-Semenyo"
"11589","Marcos Senesi_2023",2023,"Bournemouth","Premier League","Marcos Senesi","ARG","DF","25",1997,27.7,50,35,28,22,0,23,43,53.5,20,38,20,18,43,93,146,2,"https://fbref.com/en/players/35141f4c/Marcos-Senesi"
"11590","Adam Smith_2023",2023,"Bournemouth","Premier League","Adam Smith","ENG","DF","31",1991,32.7,49,29,27,19,3,29,60,48.3,31,30,13,17,25,74,81,1,"https://fbref.com/en/players/20b104bc/Adam-Smith"
"11591","Dominic Solanke_2023",2023,"Bournemouth","Premier League","Dominic Solanke","ENG","FW,MF","24",1997,31.8,15,9,8,3,4,5,22,22.7,17,26,7,19,6,21,46,0,"https://fbref.com/en/players/e77dc3b2/Dominic-Solanke"
"11592","Jack Stacey_2023",2023,"Bournemouth","Premier League","Jack Stacey","ENG","DF","26",1996,3.3,5,4,3,1,1,2,5,40,3,3,1,2,5,10,15,0,"https://fbref.com/en/players/558807c0/Jack-Stacey"
"11593","Junior Stanislas_2023",2023,"Bournemouth","Premier League","Junior Stanislas","ENG","MF","32",1989,0.7,0,0,0,0,0,0,0,NA,0,2,1,1,0,0,0,0,"https://fbref.com/en/players/6992791d/Junior-Stanislas"
"11594","Jack Stephens_2023",2023,"Bournemouth","Premier League","Jack Stephens","ENG","DF","28",1994,13,15,11,10,4,1,6,10,60,4,23,16,7,16,31,53,0,"https://fbref.com/en/players/6adbc307/Jack-Stephens"
"11595","Marcus Tavernier_2023",2023,"Bournemouth","Premier League","Marcus Tavernier","ENG","MF,FW","23",1999,19.4,33,22,19,11,3,11,32,34.4,21,25,4,21,9,42,23,0,"https://fbref.com/en/players/5c0da4a4/Marcus-Tavernier"
"11596","Mark Travers_2023",2023,"Bournemouth","Premier League","Mark Travers","IRL","GK","23",1999,11.5,0,0,0,0,0,0,0,NA,0,1,0,1,0,0,6,0,"https://fbref.com/en/players/fe558029/Mark-Travers"
"11597","Matías Viña_2023",2023,"Bournemouth","Premier League","Matías Viña","URU","DF","24",1997,5.1,19,11,9,8,2,14,30,46.7,16,13,1,12,4,23,22,0,"https://fbref.com/en/players/08eb3b58/Matias-Vina"
"11598","Illia Zabarnyi_2023",2023,"Bournemouth","Premier League","Illia Zabarnyi","UKR","DF","19",2002,3.3,4,2,4,0,0,3,7,42.9,4,7,2,5,3,7,14,0,"https://fbref.com/en/players/88968486/Illia-Zabarnyi"
"11599","Jordan Zemura_2023",2023,"Bournemouth","Premier League","Jordan Zemura","ZIM","DF","22",1999,16.2,39,24,24,14,1,23,43,53.5,20,31,9,22,16,55,32,0,"https://fbref.com/en/players/e8271ad9/Jordan-Zemura"
"11600","Kristoffer Ajer_2023",2023,"Brentford","Premier League","Kristoffer Ajer","NOR","DF","24",1998,8.5,11,8,5,4,2,9,16,56.3,7,6,5,1,7,18,22,0,"https://fbref.com/en/players/a8c0acb7/Kristoffer-Ajer"
"11601","Shandon Baptiste_2023",2023,"Brentford","Premier League","Shandon Baptiste","GRN","MF","24",1998,6.9,15,9,6,6,3,7,17,41.2,10,10,2,8,7,22,10,0,"https://fbref.com/en/players/2886c9b5/Shandon-Baptiste"
"11602","Mads Bech Sørensen_2023",2023,"Brentford","Premier League","Mads Bech Sørensen","DEN","DF,MF","23",1999,0.2,0,0,0,0,0,0,0,NA,0,0,0,0,1,1,1,0,"https://fbref.com/en/players/30db8574/Mads-Bech-Sorensen"
"11603","Sergi Canós_2023",2023,"Brentford","Premier League","Sergi Canós","ESP","FW,DF","25",1997,0.9,0,0,0,0,0,0,2,0,2,3,1,2,0,0,1,0,"https://fbref.com/en/players/1137759d/Sergi-Canos"
"11604","Mikkel Damsgaard_2023",2023,"Brentford","Premier League","Mikkel Damsgaard","DEN","MF,FW","22",2000,11,31,21,13,13,5,15,42,35.7,27,20,2,18,10,41,14,0,"https://fbref.com/en/players/215f3907/Mikkel-Damsgaard"
"11605","Josh Dasilva_2023",2023,"Brentford","Premier League","Josh Dasilva","ENG","MF","23",1998,15.4,18,9,6,6,6,6,16,37.5,10,22,6,16,5,23,7,1,"https://fbref.com/en/players/60344e4f/Josh-Dasilva"
"11606","Halil Dervişoğlu_2023",2023,"Brentford","Premier League","Halil Dervişoğlu","TUR","MF","22",1999,0.1,0,0,0,0,0,0,1,0,1,0,0,0,0,0,0,0,"https://fbref.com/en/players/9d8cf204/Halil-Dervisoglu"
"11607","Saman Ghoddos_2023",2023,"Brentford","Premier League","Saman Ghoddos","IRN","MF,FW","28",1993,1.5,2,1,0,1,1,1,3,33.3,2,5,1,4,4,6,2,0,"https://fbref.com/en/players/f7b1d4e0/Saman-Ghoddos"
"11608","Rico Henry_2023",2023,"Brentford","Premier League","Rico Henry","ENG","DF","25",1997,36,57,31,20,28,9,22,41,53.7,19,29,8,21,30,87,84,1,"https://fbref.com/en/players/8a3c1dc7/Rico-Henry"
"11609","Aaron Hickey_2023",2023,"Brentford","Premier League","Aaron Hickey","SCO","DF","20",2002,21.3,38,26,27,11,0,18,32,56.3,14,18,7,11,17,55,32,1,"https://fbref.com/en/players/1780bb4a/Aaron-Hickey"
"11610","Vitaly Janelt_2023",2023,"Brentford","Premier League","Vitaly Janelt","GER","MF,DF","24",1998,24.5,54,27,20,24,10,21,49,42.9,28,29,9,20,29,83,26,0,"https://fbref.com/en/players/8449d35e/Vitaly-Janelt"
"11611","Pontus Jansson_2023",2023,"Brentford","Premier League","Pontus Jansson","SWE","DF","31",1991,8,5,3,4,1,0,3,5,60,2,13,9,4,9,14,38,0,"https://fbref.com/en/players/172e52d8/Pontus-Jansson"
"11612","Mathias Jensen_2023",2023,"Brentford","Premier League","Mathias Jensen","DEN","MF","26",1996,31.1,70,35,28,30,12,34,97,35.1,63,54,5,49,32,102,24,1,"https://fbref.com/en/players/0f134faf/Mathias-Jensen"
"11613","Mathias Jørgensen_2023",2023,"Brentford","Premier League","Mathias Jørgensen","DEN","DF","32",1990,12.3,17,8,9,8,0,9,21,42.9,12,19,12,7,16,33,39,1,"https://fbref.com/en/players/0db5d2c8/Mathias-Jorgensen"
"11614","Keane Lewis-Potter_2023",2023,"Brentford","Premier League","Keane Lewis-Potter","ENG","FW,MF","21",2001,3.6,1,0,0,1,0,0,0,NA,0,5,1,4,0,1,2,0,"https://fbref.com/en/players/41f08ac8/Keane-Lewis-Potter"
"11615","Bryan Mbeumo_2023",2023,"Brentford","Premier League","Bryan Mbeumo","CMR","FW","22",1999,32.3,26,18,5,13,8,8,42,19,34,24,1,23,13,39,21,0,"https://fbref.com/en/players/6afaebf2/Bryan-Mbeumo"
"11616","Ben Mee_2023",2023,"Brentford","Premier League","Ben Mee","ENG","DF","32",1989,36.3,45,24,28,13,4,20,37,54.1,17,54,42,12,48,93,122,1,"https://fbref.com/en/players/8df7a2fb/Ben-Mee"
"11617","Christian Nørgaard_2023",2023,"Brentford","Premier League","Christian Nørgaard","DEN","MF","28",1994,19.6,52,30,21,29,2,18,48,37.5,30,32,9,23,34,86,41,2,"https://fbref.com/en/players/df0a4c90/Christian-Norgaard"
"11618","Frank Onyeka_2023",2023,"Brentford","Premier League","Frank Onyeka","NGA","MF","24",1998,9.4,19,14,11,7,1,10,25,40,15,16,3,13,10,29,16,0,"https://fbref.com/en/players/2944f86f/Frank-Onyeka"
"11619","Ethan Pinnock_2023",2023,"Brentford","Premier League","Ethan Pinnock","JAM","DF","29",1993,30,52,28,33,12,7,18,24,75,6,41,31,10,35,87,215,2,"https://fbref.com/en/players/e541326e/Ethan-Pinnock"
"11620","David Raya_2023",2023,"Brentford","Premier League","David Raya","ESP","GK","26",1995,38,0,0,0,0,0,0,2,0,2,1,0,1,1,1,10,2,"https://fbref.com/en/players/98ea5115/David-Raya"
"11621","Mads Roerslev_2023",2023,"Brentford","Premier League","Mads Roerslev","DEN","DF","23",1999,12.3,22,12,19,3,0,16,33,48.5,17,14,5,9,9,31,38,0,"https://fbref.com/en/players/57c94db2/Mads-Roerslev"
"11622","Kevin Schade_2023",2023,"Brentford","Premier League","Kevin Schade","GER","FW","20",2001,8.1,12,8,7,2,3,5,10,50,5,7,0,7,4,16,6,0,"https://fbref.com/en/players/52afb588/Kevin-Schade"
"11623","Ivan Toney_2023",2023,"Brentford","Premier League","Ivan Toney","ENG","FW","26",1996,32.8,23,13,4,9,10,7,23,30.4,16,24,9,15,14,37,36,0,"https://fbref.com/en/players/e09f279b/Ivan-Toney"
"11624","Yoane Wissa_2023",2023,"Brentford","Premier League","Yoane Wissa","COD","FW","25",1996,17.8,17,12,4,7,6,6,13,46.2,7,10,0,10,6,23,15,0,"https://fbref.com/en/players/2500cef9/Yoane-Wissa"
"11625","Taïryk Arconte_2023",2023,"Brest","Ligue 1","Taïryk Arconte","FRA","FW","18",2003,1.4,1,1,0,0,1,0,3,0,3,1,0,1,0,1,2,0,"https://fbref.com/en/players/c5e6c017/Tairyk-Arconte"
"11626","Youcef Belaïli_2023",2023,"Brest","Ligue 1","Youcef Belaïli","ALG","FW,MF","30",1992,4,5,2,3,2,0,2,7,28.6,5,2,0,2,1,6,1,0,"https://fbref.com/en/players/1a248246/Youcef-Belaili"
"11627","Haris Belkebla_2023",2023,"Brest","Ligue 1","Haris Belkebla","ALG","MF","28",1994,29.5,80,48,35,40,5,44,85,51.8,41,32,6,26,52,132,21,3,"https://fbref.com/en/players/2b1bed19/Haris-Belkebla"
"11628","Marco Bizot_2023",2023,"Brest","Ligue 1","Marco Bizot","NED","GK","31",1991,37,0,0,0,0,0,0,1,0,1,1,0,1,0,0,24,4,"https://fbref.com/en/players/3d214e5f/Marco-Bizot"
"11629","Joaquín Blázquez_2023",2023,"Brest","Ligue 1","Joaquín Blázquez","ARG","GK","21",2001,1,0,0,0,0,0,0,0,NA,0,0,0,0,0,0,2,0,"https://fbref.com/en/players/6a9e4913/Joaquin-Blazquez"
"11630","Lilian Brassier_2023",2023,"Brest","Ligue 1","Lilian Brassier","FRA","DF","22",1999,34.4,42,30,31,8,3,23,32,71.9,9,42,19,23,53,95,132,1,"https://fbref.com/en/players/5b146df3/Lilian-Brassier"
"11631","Mahdi Camara_2023",2023,"Brest","Ligue 1","Mahdi Camara","FRA","MF","24",1998,20.2,63,36,18,38,7,25,43,58.1,18,35,4,31,40,103,16,0,"https://fbref.com/en/players/8577e60a/Mahdi-Camara"
"11632","Axel Camblan_2023",2023,"Brest","Ligue 1","Axel Camblan","FRA","FW,MF","18",2003,0.8,2,2,1,1,0,0,1,0,1,0,0,0,0,2,0,0,"https://fbref.com/en/players/9f4a940f/Axel-Camblan"
"11633","Irvin Cardona_2023",2023,"Brest","Ligue 1","Irvin Cardona","FRA","FW,MF","24",1997,2.6,2,0,1,1,0,0,3,0,3,3,0,3,2,4,2,0,"https://fbref.com/en/players/5e080f73/Irvin-Cardona"
"11634","Brendan Chardonnet_2023",2023,"Brest","Ligue 1","Brendan Chardonnet","FRA","DF","27",1994,27.7,45,27,27,18,0,20,38,52.6,18,40,19,21,63,108,86,1,"https://fbref.com/en/players/16aa7d4c/Brendan-Chardonnet"
"11635","Achraf Dari_2023",2023,"Brest","Ligue 1","Achraf Dari","MAR","DF","23",1999,14.6,21,14,15,5,1,14,20,70,6,16,10,6,19,40,65,2,"https://fbref.com/en/players/5069b796/Achraf-Dari"
"11636","Romain Del Castillo_2023",2023,"Brest","Ligue 1","Romain Del Castillo","FRA","MF,FW","26",1996,15.8,39,24,13,17,9,16,36,44.4,20,14,1,13,11,50,5,0,"https://fbref.com/en/players/0be95d34/Romain-Del-Castillo"
"11637","Karamoko Dembele_2023",2023,"Brest","Ligue 1","Karamoko Dembele","SCO","FW,MF","19",2003,2,2,0,1,1,0,2,2,100,0,1,0,1,1,3,0,0,"https://fbref.com/en/players/7304f3b1/Karamoko-Dembele"
"11638","Jean-Kevin Duverne_2023",2023,"Brest","Ligue 1","Jean-Kevin Duverne","FRA","DF","25",1997,27.9,72,38,44,24,4,42,73,57.5,31,33,5,28,28,100,65,1,"https://fbref.com/en/players/0cbc8baa/Jean-Kevin-Duverne"
"11639","Alberth Elis_2023",2023,"Brest","Ligue 1","Alberth Elis","HON","MF,FW","26",1996,2.9,4,3,1,2,1,1,7,14.3,6,1,0,1,1,5,2,0,"https://fbref.com/en/players/104b4ad3/Alberth-Elis"
"11640","Noah Fadiga_2023",2023,"Brest","Ligue 1","Noah Fadiga","SEN","DF","22",1999,14.5,30,21,18,9,3,14,26,53.8,12,17,7,10,26,56,18,0,"https://fbref.com/en/players/83f03b07/Noah-Fadiga"
"11641","Christophe Hérelle_2023",2023,"Brest","Ligue 1","Christophe Hérelle","MTQ","DF","29",1992,11.8,10,4,7,2,1,4,13,30.8,9,16,11,5,20,30,48,0,"https://fbref.com/en/players/3681cfff/Christophe-Herelle"
"11642","Franck Honorat_2023",2023,"Brest","Ligue 1","Franck Honorat","FRA","FW,MF","25",1996,28.2,41,29,20,8,13,19,34,55.9,15,22,2,20,21,62,18,0,"https://fbref.com/en/players/db7849ca/Franck-Honorat"
"11643","Kenny Lala_2023",2023,"Brest","Ligue 1","Kenny Lala","FRA","DF","30",1991,15.7,36,19,19,15,2,22,38,57.9,16,15,5,10,21,57,28,0,"https://fbref.com/en/players/770d7eb8/Kenny-Lala"
"11644","Jérémy Le Douaron_2023",2023,"Brest","Ligue 1","Jérémy Le Douaron","FRA","MF,FW","24",1998,23,15,9,5,9,1,3,27,11.1,24,29,2,27,11,26,30,0,"https://fbref.com/en/players/88c4d190/Jeremy-Le-Douaron"
"11645","Pierre Lees-Melou_2023",2023,"Brest","Ligue 1","Pierre Lees-Melou","FRA","MF","29",1993,30.7,97,55,55,37,5,57,123,46.3,66,48,13,35,52,149,46,1,"https://fbref.com/en/players/f5044e54/Pierre-Lees-Melou"
"11646","Félix Lemaréchal_2023",2023,"Brest","Ligue 1","Félix Lemaréchal","CIV","MF","18",2003,3.2,5,5,2,1,2,0,3,0,3,6,0,6,1,6,2,0,"https://fbref.com/en/players/8ca9415f/Felix-Lemarechal"
"11647","Banzouzi Locko_2023",2023,"Brest","Ligue 1","Banzouzi Locko","FRA","DF","20",2002,3,4,3,2,1,1,2,3,66.7,1,4,0,4,2,6,13,0,"https://fbref.com/en/players/40221fa7/Banzouzi-Locko"
"11648","Hugo Magnetti_2023",2023,"Brest","Ligue 1","Hugo Magnetti","FRA","MF","24",1998,18.8,43,27,18,23,2,23,63,36.5,40,21,1,20,25,68,12,0,"https://fbref.com/en/players/d4d35152/Hugo-Magnetti"
"11649","Hianga Mananga Mbock_2023",2023,"Brest","Ligue 1","Hianga Mananga Mbock","FRA","MF","22",1999,0.2,0,0,0,0,0,0,1,0,1,0,0,0,0,0,0,0,"https://fbref.com/en/players/0f86995c/Hianga-Mananga-Mbock"
"11650","Steve Mounié_2023",2023,"Brest","Ligue 1","Steve Mounié","BEN","FW","27",1994,18.4,13,5,1,7,5,5,14,35.7,9,18,7,11,3,16,20,0,"https://fbref.com/en/players/19ba6c6d/Steve-Mounie"
"11651","Mathias Pereira Lage_2023",2023,"Brest","Ligue 1","Mathias Pereira Lage","POR","MF,FW","25",1996,14,20,7,5,14,1,11,29,37.9,18,10,1,9,14,34,12,0,"https://fbref.com/en/players/8846a40f/Mathias-Pereira-Lage"
"11652","Islam Slimani_2023",2023,"Brest","Ligue 1","Islam Slimani","ALG","FW","34",1988,11,5,3,2,2,1,0,3,0,3,2,0,2,1,6,11,0,"https://fbref.com/en/players/ffec9769/Islam-Slimani"
"11653","Jere Uronen_2023",2023,"Brest","Ligue 1","Jere Uronen","FIN","DF","28",1994,3.3,8,5,4,4,0,7,12,58.3,5,6,2,4,7,15,5,0,"https://fbref.com/en/players/d75f3980/Jere-Uronen"
"11654","Yasin Ayari_2023",2023,"Brighton","Premier League","Yasin Ayari","SWE","MF","18",2003,0.7,2,2,1,1,0,0,4,0,4,1,0,1,0,2,0,0,"https://fbref.com/en/players/f173303a/Yasin-Ayari"
"11655","Facundo Buonanotte_2023",2023,"Brighton","Premier League","Facundo Buonanotte","ARG","FW,MF","17",2004,6.3,2,1,1,1,0,1,22,4.5,21,5,2,3,4,6,3,0,"https://fbref.com/en/players/468a7a91/Facundo-Buonanotte"
"11656","Moisés Caicedo_2023",2023,"Brighton","Premier League","Moisés Caicedo","ECU","MF","20",2001,34.9,100,50,41,47,12,40,68,58.8,28,43,7,36,56,156,31,3,"https://fbref.com/en/players/16264a81/Moises-Caicedo"
"11657","Julio César Enciso_2023",2023,"Brighton","Premier League","Julio César Enciso","PAR","FW,MF","18",2004,9,13,4,3,6,4,8,13,61.5,5,9,0,9,4,17,2,0,"https://fbref.com/en/players/9cfbad36/Julio-Cesar-Enciso"
"11658","Levi Colwill_2023",2023,"Brighton","Premier League","Levi Colwill","ENG","DF","19",2003,13.6,8,7,4,4,0,4,9,44.4,5,5,3,2,15,23,37,1,"https://fbref.com/en/players/700783e7/Levi-Colwill"
"11659","Lewis Dunk_2023",2023,"Brighton","Premier League","Lewis Dunk","ENG","DF","30",1991,36,30,19,19,9,2,18,41,43.9,23,37,27,10,34,64,81,1,"https://fbref.com/en/players/282f75f3/Lewis-Dunk"
"11660","Pervis Estupiñán_2023",2023,"Brighton","Premier League","Pervis Estupiñán","ECU","DF","24",1998,29.7,61,31,36,19,6,35,60,58.3,25,30,8,22,37,98,37,1,"https://fbref.com/en/players/d38fdf53/Pervis-Estupinan"
"11661","Evan Ferguson_2023",2023,"Brighton","Premier League","Evan Ferguson","IRL","FW","17",2004,10.6,6,3,1,3,2,1,7,14.3,6,11,1,10,2,8,6,0,"https://fbref.com/en/players/4596da74/Evan-Ferguson"
"11662","Billy Gilmour_2023",2023,"Brighton","Premier League","Billy Gilmour","SCO","MF","21",2001,5.6,5,2,2,2,1,2,8,25,6,5,2,3,6,11,5,0,"https://fbref.com/en/players/df10e27c/Billy-Gilmour"
"11663","Pascal Groß_2023",2023,"Brighton","Premier League","Pascal Groß","GER","MF,DF","31",1991,36,59,38,23,27,9,25,55,45.5,30,32,10,22,13,72,21,1,"https://fbref.com/en/players/8aec0537/Pascal-Gross"
"11664","Jan Paul van Hecke_2023",2023,"Brighton","Premier League","Jan Paul van Hecke","NED","DF","22",2000,3.3,8,6,3,4,1,5,5,100,0,8,5,3,6,14,9,0,"https://fbref.com/en/players/4fd08daa/Jan-Paul-van-Hecke"
"11665","Jack Hinshelwood_2023",2023,"Brighton","Premier League","Jack Hinshelwood","ENG","FW","17",2005,0,1,0,1,0,0,0,0,NA,0,0,0,0,0,1,0,0,"https://fbref.com/en/players/e98211e7/Jack-Hinshelwood"
"11666","Adam Lallana_2023",2023,"Brighton","Premier League","Adam Lallana","ENG","MF,FW","34",1988,8,9,4,6,2,1,0,7,0,7,6,0,6,2,11,1,0,"https://fbref.com/en/players/99813635/Adam-Lallana"
"11667","Tariq Lamptey_2023",2023,"Brighton","Premier League","Tariq Lamptey","GHA","DF","21",2000,5,11,6,6,4,1,5,7,71.4,2,7,3,4,7,18,2,0,"https://fbref.com/en/players/f4e433d4/Tariq-Lamptey"
"11668","Alexis Mac Allister_2023",2023,"Brighton","Premier League","Alexis Mac Allister","ARG","MF","23",1998,32.1,70,39,22,40,8,34,70,48.6,36,26,2,24,22,92,10,1,"https://fbref.com/en/players/83d074ff/Alexis-Mac-Allister"
"11669","Solly March_2023",2023,"Brighton","Premier League","Solly March","ENG","FW,DF","28",1994,30.2,53,31,16,17,20,8,28,28.6,20,34,3,31,24,77,32,0,"https://fbref.com/en/players/bb5fbd2b/Solly-March"
"11670","Kaoru Mitoma_2023",2023,"Brighton","Premier League","Kaoru Mitoma","JPN","FW,MF","25",1997,25.8,44,27,15,16,13,20,41,48.8,21,25,0,25,17,61,10,0,"https://fbref.com/en/players/74618572/Kaoru-Mitoma"
"11671","Andrew Moran_2023",2023,"Brighton","Premier League","Andrew Moran","IRL","FW","18",2003,0.1,0,0,0,0,0,0,0,NA,0,1,0,1,0,0,0,0,"https://fbref.com/en/players/c4720845/Andrew-Moran"
"11672","Enock Mwepu_2023",2023,"Brighton","Premier League","Enock Mwepu","ZAM","FW,MF","24",1998,2.4,10,5,1,6,3,3,4,75,1,3,1,2,1,11,1,0,"https://fbref.com/en/players/1d5cab82/Enock-Mwepu"
"11673","Odeluga Offiah_2023",2023,"Brighton","Premier League","Odeluga Offiah","ENG","DF","19",2002,0.3,1,1,1,0,0,0,2,0,2,0,0,0,0,1,1,0,"https://fbref.com/en/players/65c3efa2/Odeluga-Offiah"
"11674","Cameron Peupion_2023",2023,"Brighton","Premier League","Cameron Peupion","AUS","MF","19",2002,0.1,0,0,0,0,0,0,0,NA,0,0,0,0,0,0,0,0,"https://fbref.com/en/players/0bdeb013/Cameron-Peupion"
"11675","Robert Sánchez_2023",2023,"Brighton","Premier League","Robert Sánchez","ESP","GK","24",1997,23,1,0,1,0,0,0,0,NA,0,0,0,0,3,4,9,2,"https://fbref.com/en/players/6a713852/Robert-Sanchez"
"11676","Jeremy Sarmiento_2023",2023,"Brighton","Premier League","Jeremy Sarmiento","ECU","MF","20",2002,2,6,3,4,1,1,2,5,40,3,2,0,2,1,7,0,0,"https://fbref.com/en/players/ac0d576d/Jeremy-Sarmiento"
"11677","Jason Steele_2023",2023,"Brighton","Premier League","Jason Steele","ENG","GK","31",1990,15,0,0,0,0,0,0,1,0,1,0,0,0,0,0,6,1,"https://fbref.com/en/players/28300a16/Jason-Steele"
"11678","Leandro Trossard_2023",2023,"Brighton","Premier League","Leandro Trossard","BEL","FW,MF","27",1994,14.6,10,6,7,1,2,1,8,12.5,7,17,0,17,6,16,1,0,"https://fbref.com/en/players/38ceb24a/Leandro-Trossard"
"11679","Deniz Undav_2023",2023,"Brighton","Premier League","Deniz Undav","GER","FW,MF","26",1996,7,7,4,2,2,3,2,8,25,6,4,1,3,0,7,1,0,"https://fbref.com/en/players/dd549382/Deniz-Undav"
"11680","Joël Veltman_2023",2023,"Brighton","Premier League","Joël Veltman","NED","DF","30",1992,24.3,62,32,44,14,4,37,57,64.9,20,27,8,19,19,81,51,0,"https://fbref.com/en/players/dad4b285/Joel-Veltman"
"11681","Adam Webster_2023",2023,"Brighton","Premier League","Adam Webster","ENG","DF","27",1995,22.1,22,12,10,9,3,11,19,57.9,8,30,19,11,19,41,55,4,"https://fbref.com/en/players/c40b6180/Adam-Webster"
"11682","Danny Welbeck_2023",2023,"Brighton","Premier League","Danny Welbeck","ENG","FW","31",1990,20.6,15,7,0,7,8,4,11,36.4,7,24,2,22,5,20,20,0,"https://fbref.com/en/players/ce5143da/Danny-Welbeck"
"11683","Joseph Aidoo_2023",2023,"Celta Vigo","La Liga","Joseph Aidoo","GHA","DF","26",1995,34.7,51,36,33,17,1,16,28,57.1,12,26,14,12,31,82,150,0,"https://fbref.com/en/players/18abe173/Joseph-Aidoo"
"11684","Iago Aspas_2023",2023,"Celta Vigo","La Liga","Iago Aspas","ESP","FW","34",1987,31.9,8,4,0,4,4,3,22,13.6,19,10,1,9,7,15,23,0,"https://fbref.com/en/players/7dcf86f6/Iago-Aspas"
"11685","Fran Beltrán_2023",2023,"Celta Vigo","La Liga","Fran Beltrán","ESP","MF","23",1999,31.7,34,22,15,14,5,14,55,25.5,41,29,5,24,53,87,35,2,"https://fbref.com/en/players/ed5c5fa3/Fran-Beltran"
"11686","Franco Cervi_2023",2023,"Celta Vigo","La Liga","Franco Cervi","ARG","MF,DF","28",1994,21,76,46,29,36,11,33,66,50,33,33,1,32,36,112,16,0,"https://fbref.com/en/players/5e1028e5/Franco-Cervi"
"11687","Carlos Dominguez_2023",2023,"Celta Vigo","La Liga","Carlos Dominguez","ESP","DF","21",2001,1.2,1,1,0,1,0,1,2,50,1,1,1,0,0,1,7,0,"https://fbref.com/en/players/3521abfe/Carlos-Dominguez"
"11688","Pablo Durán_2023",2023,"Celta Vigo","La Liga","Pablo Durán","ESP","MF,DF","21",2001,0.4,0,0,0,0,0,0,0,NA,0,2,1,1,1,1,2,0,"https://fbref.com/en/players/6db116ec/Pablo-Duran"
"11689","Javi Galán_2023",2023,"Celta Vigo","La Liga","Javi Galán","ESP","DF","27",1994,35.1,104,72,60,40,4,48,98,49,50,54,5,49,41,145,63,1,"https://fbref.com/en/players/a4b00319/Javi-Galan"
"11690","Luca de la Torre_2023",2023,"Celta Vigo","La Liga","Luca de la Torre","USA","MF","24",1998,16.5,28,19,11,14,3,12,32,37.5,20,22,1,21,9,37,6,0,"https://fbref.com/en/players/e9241b40/Luca-de-la-Torre"
"11691","Hugo Mallo_2023",2023,"Celta Vigo","La Liga","Hugo Mallo","ESP","DF","31",1991,24,53,29,34,14,5,28,42,66.7,14,28,7,21,24,77,73,0,"https://fbref.com/en/players/cb574619/Hugo-Mallo"
"11692","Agustín Marchesín_2023",2023,"Celta Vigo","La Liga","Agustín Marchesín","ARG","GK","34",1988,19,0,0,0,0,0,0,1,0,1,0,0,0,0,0,7,0,"https://fbref.com/en/players/853b7c48/Agustin-Marchesin"
"11693","Fernando Medrano_2023",2023,"Celta Vigo","La Liga","Fernando Medrano","ESP","DF","22",2000,0.1,2,1,2,0,0,1,1,100,0,0,0,0,1,3,1,0,"https://fbref.com/en/players/d854c9d0/Fernando-Medrano"
"11694","Óscar Mingueza_2023",2023,"Celta Vigo","La Liga","Óscar Mingueza","ESP","DF","23",1999,14.3,37,21,27,9,1,25,32,78.1,7,10,4,6,12,49,25,0,"https://fbref.com/en/players/056269d7/Oscar-Mingueza"
"11695","Unai Núñez_2023",2023,"Celta Vigo","La Liga","Unai Núñez","ESP","DF","25",1997,35,47,35,29,15,3,18,34,52.9,16,27,17,10,72,119,135,1,"https://fbref.com/en/players/be170419/Unai-Nunez"
"11696","Gonçalo Paciência_2023",2023,"Celta Vigo","La Liga","Gonçalo Paciência","POR","FW,MF","27",1994,7.4,8,5,0,5,3,2,7,28.6,5,9,1,8,0,8,4,0,"https://fbref.com/en/players/962e54cb/Goncalo-Paciencia"
"11697","Carles Pérez_2023",2023,"Celta Vigo","La Liga","Carles Pérez","ESP","MF,FW","24",1998,23.8,39,23,12,17,10,22,66,33.3,44,29,3,26,6,45,9,0,"https://fbref.com/en/players/a8f21b9f/Carles-Perez"
"11698","Óscar Rodríguez Arnaiz_2023",2023,"Celta Vigo","La Liga","Óscar Rodríguez Arnaiz","ESP","MF","24",1998,19.7,32,25,12,15,5,13,28,46.4,15,16,2,14,24,56,15,0,"https://fbref.com/en/players/19709006/Oscar-Rodriguez-Arnaiz"
"11699","Miguel Rodríguez_2023",2023,"Celta Vigo","La Liga","Miguel Rodríguez","ESP","MF,FW","19",2003,2.8,7,5,4,3,0,4,11,36.4,7,6,0,6,1,8,3,0,"https://fbref.com/en/players/958d67bb/Miguel-Rodriguez"
"11700","Haris Seferović_2023",2023,"Celta Vigo","La Liga","Haris Seferović","SUI","FW","30",1992,9.9,6,3,1,4,1,3,8,37.5,5,7,1,6,1,7,6,1,"https://fbref.com/en/players/a45eac1f/Haris-Seferovic"
"11701","Augusto Solari_2023",2023,"Celta Vigo","La Liga","Augusto Solari","ARG","MF","30",1992,2.9,10,6,6,3,1,3,11,27.3,8,5,0,5,4,14,3,0,"https://fbref.com/en/players/3ca6106c/Augusto-Solari"
"11702","Hugo Sotelo_2023",2023,"Celta Vigo","La Liga","Hugo Sotelo","ESP","MF","18",2003,0.2,0,0,0,0,0,0,0,NA,0,0,0,0,0,0,0,0,"https://fbref.com/en/players/3aa74860/Hugo-Sotelo"
"11703","Jørgen Strand Larsen_2023",2023,"Celta Vigo","La Liga","Jørgen Strand Larsen","NOR","FW","22",2000,18.9,15,7,3,5,7,7,30,23.3,23,14,5,9,3,18,24,0,"https://fbref.com/en/players/f553b2b3/Jorgen-Strand-Larsen"
"11704","Williot Swedberg_2023",2023,"Celta Vigo","La Liga","Williot Swedberg","SWE","MF","18",2004,0.6,3,1,1,0,2,0,0,NA,0,2,0,2,0,3,1,0,"https://fbref.com/en/players/184fe4b2/Williot-Swedberg"
"11705","Renato Tapia_2023",2023,"Celta Vigo","La Liga","Renato Tapia","PER","MF,DF","27",1995,16.1,47,25,21,21,5,18,37,48.6,19,29,11,18,19,66,37,0,"https://fbref.com/en/players/34269bdf/Renato-Tapia"
"11706","Kevin Vázquez_2023",2023,"Celta Vigo","La Liga","Kevin Vázquez","ESP","DF,MF","29",1993,4.9,13,8,5,7,1,8,12,66.7,4,4,1,3,2,15,8,0,"https://fbref.com/en/players/ee923664/Kevin-Vazquez"
"11707","Gabriel Veiga_2023",2023,"Celta Vigo","La Liga","Gabriel Veiga","ESP","MF","20",2002,25.5,43,19,14,25,4,16,52,30.8,36,30,3,27,21,64,6,0,"https://fbref.com/en/players/35a6e5c7/Gabriel-Veiga"
"11708","Iván Villar_2023",2023,"Celta Vigo","La Liga","Iván Villar","ESP","GK","25",1997,19,0,0,0,0,0,0,1,0,1,0,0,0,0,0,7,0,"https://fbref.com/en/players/cde52ef5/Ivan-Villar"
"11709","Kepa Arrizabalaga_2023",2023,"Chelsea","Premier League","Kepa Arrizabalaga","ESP","GK","27",1994,28.5,2,2,2,0,0,2,3,66.7,1,0,0,0,1,3,16,2,"https://fbref.com/en/players/28d596a0/Kepa-Arrizabalaga"
"11710","Pierre-Emerick Aubameyang_2023",2023,"Chelsea","Premier League","Pierre-Emerick Aubameyang","GAB","FW","33",1989,6.2,1,0,1,0,0,0,1,0,1,2,0,2,2,3,4,2,"https://fbref.com/en/players/d5dd5f1f/Pierre-Emerick-Aubameyang"
"11711","César Azpilicueta_2023",2023,"Chelsea","Premier League","César Azpilicueta","ESP","DF","32",1989,17,43,25,23,15,5,22,37,59.5,15,26,5,21,19,62,54,1,"https://fbref.com/en/players/53cad200/Cesar-Azpilicueta"
"11712","Benoît Badiashile_2023",2023,"Chelsea","Premier League","Benoît Badiashile","FRA","DF","21",2001,10.1,14,8,10,4,0,9,14,64.3,5,5,2,3,16,30,34,1,"https://fbref.com/en/players/06df8256/Benoit-Badiashile"
"11713","Armando Broja_2023",2023,"Chelsea","Premier League","Armando Broja","ALB","FW","20",2001,3.3,4,1,0,3,1,1,1,100,0,10,1,9,1,5,1,0,"https://fbref.com/en/players/97220da2/Armando-Broja"
"11714","Trevoh Chalobah_2023",2023,"Chelsea","Premier League","Trevoh Chalobah","ENG","DF","23",1999,17.9,31,20,22,6,3,24,34,70.6,10,17,7,10,24,55,56,1,"https://fbref.com/en/players/5515376c/Trevoh-Chalobah"
"11715","Ben Chilwell_2023",2023,"Chelsea","Premier League","Ben Chilwell","ENG","DF,MF","25",1996,15.6,21,17,12,8,1,13,25,52,12,21,2,19,18,39,26,0,"https://fbref.com/en/players/d2424d1b/Ben-Chilwell"
"11716","Carney Chukwuemeka_2023",2023,"Chelsea","Premier League","Carney Chukwuemeka","ENG","MF,FW","18",2003,3.9,13,7,7,6,0,3,5,60,2,7,0,7,6,19,1,0,"https://fbref.com/en/players/b2f9c73e/Carney-Chukwuemeka"
"11717","Marc Cucurella_2023",2023,"Chelsea","Premier League","Marc Cucurella","ESP","DF","24",1998,18.6,66,33,40,15,11,30,60,50,30,28,8,20,16,82,48,1,"https://fbref.com/en/players/1daec722/Marc-Cucurella"
"11718","João Félix_2023",2023,"Chelsea","Premier League","João Félix","POR","FW,MF","22",1999,10.5,14,7,5,6,3,4,12,33.3,8,3,0,3,1,15,1,1,"https://fbref.com/en/players/8aafd64f/Joao-Felix"
"11719","Enzo Fernández_2023",2023,"Chelsea","Premier League","Enzo Fernández","ARG","MF","21",2001,17.2,45,27,25,17,3,21,56,37.5,35,32,2,30,16,61,12,1,"https://fbref.com/en/players/5ff4ab71/Enzo-Fernandez"
"11720","Datro Fofana_2023",2023,"Chelsea","Premier League","Datro Fofana","CIV","FW","19",2002,0.8,3,1,1,1,1,1,1,100,0,1,0,1,0,3,0,0,"https://fbref.com/en/players/e82900ef/Datro-Fofana"
"11721","Wesley Fofana_2023",2023,"Chelsea","Premier League","Wesley Fofana","FRA","DF","21",2000,13.1,30,18,19,7,4,13,26,50,13,17,10,7,20,50,33,2,"https://fbref.com/en/players/132a82f1/Wesley-Fofana"
"11722","Conor Gallagher_2023",2023,"Chelsea","Premier League","Conor Gallagher","ENG","MF","22",2000,18,46,33,17,19,10,10,37,27,27,41,10,31,23,69,18,1,"https://fbref.com/en/players/c2731c10/Conor-Gallagher"
"11723","Lewis Hall_2023",2023,"Chelsea","Premier League","Lewis Hall","ENG","DF","17",2004,7.3,23,12,19,4,0,15,22,68.2,7,8,0,8,11,34,11,1,"https://fbref.com/en/players/da011f18/Lewis-Hall"
"11724","Kai Havertz_2023",2023,"Chelsea","Premier League","Kai Havertz","GER","FW,MF","23",1999,28.5,34,16,4,20,10,10,30,33.3,20,28,0,28,7,41,41,0,"https://fbref.com/en/players/fed7cb61/Kai-Havertz"
"11725","Omari Hutchinson_2023",2023,"Chelsea","Premier League","Omari Hutchinson","ENG","FW","18",2003,0.3,0,0,0,0,0,0,0,NA,0,0,0,0,1,1,0,0,"https://fbref.com/en/players/bd9553e6/Omari-Hutchinson"
"11726","Reece James_2023",2023,"Chelsea","Premier League","Reece James","ENG","DF,MF","22",1999,13.8,31,20,10,18,3,15,19,78.9,4,17,2,15,12,43,23,0,"https://fbref.com/en/players/1265a93a/Reece-James"
"11727","Jorginho_2023",2023,"Chelsea","Premier League","Jorginho","ITA","MF","30",1991,14.2,42,23,22,14,6,22,46,47.8,24,18,3,15,21,63,7,0,"https://fbref.com/en/players/45db685d/Jorginho"
"11728","N'Golo Kanté_2023",2023,"Chelsea","Premier League","N'Golo Kanté","FRA","MF","31",1991,5.8,16,10,4,10,2,4,8,50,4,11,0,11,6,22,2,0,"https://fbref.com/en/players/b9fbae28/NGolo-Kante"
"11729","Kalidou Koulibaly_2023",2023,"Chelsea","Premier League","Kalidou Koulibaly","SEN","DF","31",1991,20,45,31,34,8,3,26,40,65,14,30,13,17,29,74,77,0,"https://fbref.com/en/players/da974c7b/Kalidou-Koulibaly"
"11730","Mateo Kovačić_2023",2023,"Chelsea","Premier League","Mateo Kovačić","CRO","MF","28",1994,19,36,24,16,14,6,14,36,38.9,22,10,1,9,19,55,16,0,"https://fbref.com/en/players/79c0821a/Mateo-Kovacic"
"11731","Ruben Loftus-Cheek_2023",2023,"Chelsea","Premier League","Ruben Loftus-Cheek","ENG","MF,DF","26",1996,17.1,25,14,8,14,3,12,21,57.1,9,15,2,13,12,37,23,0,"https://fbref.com/en/players/e97fd090/Ruben-Loftus-Cheek"
"11732","Noni Madueke_2023",2023,"Chelsea","Premier League","Noni Madueke","ENG","FW","20",2002,7.1,12,8,5,4,3,6,13,46.2,7,13,2,11,4,16,7,0,"https://fbref.com/en/players/bf34eebd/Noni-Madueke"
"11733","Edouard Mendy_2023",2023,"Chelsea","Premier League","Edouard Mendy","SEN","GK","30",1992,9.5,0,0,0,0,0,0,0,NA,0,0,0,0,0,0,3,3,"https://fbref.com/en/players/33887998/Edouard-Mendy"
"11734","Mason Mount_2023",2023,"Chelsea","Premier League","Mason Mount","ENG","MF,FW","23",1999,18.3,33,19,6,16,11,14,27,51.9,13,24,6,18,8,41,9,0,"https://fbref.com/en/players/9674002f/Mason-Mount"
"11735","Mykhailo Mudryk_2023",2023,"Chelsea","Premier League","Mykhailo Mudryk","UKR","FW,MF","21",2001,7.3,11,9,2,4,5,4,13,30.8,9,7,1,6,0,11,3,0,"https://fbref.com/en/players/049a888d/Mykhailo-Mudryk"
"11736","Christian Pulisic_2023",2023,"Chelsea","Premier League","Christian Pulisic","USA","FW,DF","23",1998,9.1,11,6,3,6,2,3,5,60,2,8,1,7,4,15,4,0,"https://fbref.com/en/players/1bf33a9a/Christian-Pulisic"
"11737","Thiago Silva_2023",2023,"Chelsea","Premier League","Thiago Silva","BRA","DF","37",1984,26.1,41,27,24,17,0,21,31,67.7,10,38,29,9,34,75,111,2,"https://fbref.com/en/players/86e7deaf/Thiago-Silva"
"11738","Raheem Sterling_2023",2023,"Chelsea","Premier League","Raheem Sterling","ENG","FW,MF","27",1994,21,18,10,5,4,9,8,14,57.1,6,17,0,17,2,20,5,0,"https://fbref.com/en/players/b400bde0/Raheem-Sterling"
"11739","Denis Zakaria_2023",2023,"Chelsea","Premier League","Denis Zakaria","SUI","MF","25",1996,4.6,9,5,5,2,2,2,8,25,6,4,1,3,3,12,10,0,"https://fbref.com/en/players/384d58d9/Denis-Zakaria"
"11740","Hakim Ziyech_2023",2023,"Chelsea","Premier League","Hakim Ziyech","MAR","FW,MF","29",1993,7.3,20,12,12,5,3,4,9,44.4,5,8,0,8,5,25,5,1,"https://fbref.com/en/players/6622454d/Hakim-Ziyech"
"11741","Jim Allevinah_2023",2023,"Clermont Foot","Ligue 1","Jim Allevinah","GAB","DF,FW","27",1995,24.9,39,24,24,11,4,19,62,30.6,43,24,2,22,24,63,26,1,"https://fbref.com/en/players/1956b948/Jim-Allevinah"
"11742","Komnen Andrić_2023",2023,"Clermont Foot","Ligue 1","Komnen Andrić","SRB","FW","27",1995,16.1,13,5,2,7,4,2,15,13.3,13,8,1,7,8,21,13,0,"https://fbref.com/en/players/af3ddb2e/Komnen-Andric"
"11743","Brandon Baiye_2023",2023,"Clermont Foot","Ligue 1","Brandon Baiye","BEL","MF","21",2000,0.6,3,2,2,1,0,2,3,66.7,1,1,0,1,1,4,3,0,"https://fbref.com/en/players/7e3e825e/Brandon-Baiye"
"11744","Jérémie Bela_2023",2023,"Clermont Foot","Ligue 1","Jérémie Bela","ANG","DF,MF","29",1993,8.3,6,4,2,1,3,3,4,75,1,10,1,9,9,15,8,0,"https://fbref.com/en/players/5680bf3f/Jeremie-Bela"
"11745","Jason Berthomier_2023",2023,"Clermont Foot","Ligue 1","Jason Berthomier","FRA","MF","32",1990,0.3,0,0,0,0,0,0,0,NA,0,0,0,0,0,0,0,0,"https://fbref.com/en/players/03e91055/Jason-Berthomier"
"11746","Jean-Claude Billong_2023",2023,"Clermont Foot","Ligue 1","Jean-Claude Billong","CMR","MF","28",1993,0.3,0,0,0,0,0,0,0,NA,0,1,1,0,1,1,0,0,"https://fbref.com/en/players/a3e1d20d/Jean-Claude-Billong"
"11747","Neto Borges_2023",2023,"Clermont Foot","Ligue 1","Neto Borges","BRA","DF","25",1996,31.5,75,45,45,20,10,46,75,61.3,29,45,11,34,41,116,62,1,"https://fbref.com/en/players/9f936061/Neto-Borges"
"11748","Maximiliano Caufriez_2023",2023,"Clermont Foot","Ligue 1","Maximiliano Caufriez","BEL","DF","25",1997,24.7,40,24,31,8,1,20,28,71.4,8,33,18,15,34,74,70,0,"https://fbref.com/en/players/c92c24f0/Maximiliano-Caufriez"
"11749","Souleymane Cissé_2023",2023,"Clermont Foot","Ligue 1","Souleymane Cissé","FRA","DF","19",2002,0.4,1,1,1,0,0,1,1,100,0,1,1,0,1,2,2,0,"https://fbref.com/en/players/ff4d0258/Souleymane-Cisse"
"11750","Baila Diallo_2023",2023,"Clermont Foot","Ligue 1","Baila Diallo","FRA","DF,MF","21",2001,1,1,0,1,0,0,0,0,NA,0,1,1,0,0,1,1,0,"https://fbref.com/en/players/fb55f63a/Baila-Diallo"
"11751","Mory Diaw_2023",2023,"Clermont Foot","Ligue 1","Mory Diaw","SEN","GK","29",1993,37,0,0,0,0,0,0,4,0,4,0,0,0,2,2,13,5,"https://fbref.com/en/players/f41a69e6/Mory-Diaw"
"11752","Ouparine Djoco_2023",2023,"Clermont Foot","Ligue 1","Ouparine Djoco","SEN","GK","24",1998,1,0,0,0,0,0,0,0,NA,0,0,0,0,0,0,1,0,"https://fbref.com/en/players/62124972/Ouparine-Djoco"
"11753","Jodel Dossou_2023",2023,"Clermont Foot","Ligue 1","Jodel Dossou","BEN","MF,DF","30",1992,2.9,7,4,3,2,2,4,4,100,0,2,1,1,1,8,0,0,"https://fbref.com/en/players/a1dbfcb1/Jodel-Dossou"
"11754","Johan Gastien_2023",2023,"Clermont Foot","Ligue 1","Johan Gastien","FRA","MF","34",1988,28.9,62,34,30,23,9,38,111,34.2,73,37,7,30,36,98,25,1,"https://fbref.com/en/players/868eaba0/Johan-Gastien"
"11755","Maxime Gonalons_2023",2023,"Clermont Foot","Ligue 1","Maxime Gonalons","FRA","MF","33",1989,16.1,52,32,25,21,6,25,53,47.2,28,21,1,20,20,72,7,1,"https://fbref.com/en/players/b8c1de25/Maxime-Gonalons"
"11756","Saîf-Eddine Khaoui_2023",2023,"Clermont Foot","Ligue 1","Saîf-Eddine Khaoui","TUN","MF","27",1995,22.5,47,28,14,25,8,15,47,31.9,32,17,2,15,33,80,8,0,"https://fbref.com/en/players/796b1c41/Saif-Eddine-Khaoui"
"11757","Cheick Konaté_2023",2023,"Clermont Foot","Ligue 1","Cheick Konaté","CIV","DF","18",2004,6.4,19,12,10,7,2,13,22,59.1,9,7,1,6,13,32,8,1,"https://fbref.com/en/players/1361e5bc/Cheick-Konate"
"11758","Grejohn Kyei_2023",2023,"Clermont Foot","Ligue 1","Grejohn Kyei","FRA","FW","26",1995,24.8,16,7,2,9,5,4,13,30.8,9,14,3,11,6,22,22,0,"https://fbref.com/en/players/397ba086/Grejohn-Kyei"
"11759","Yohann Magnin_2023",2023,"Clermont Foot","Ligue 1","Yohann Magnin","FRA","MF","25",1997,26.7,89,54,37,45,7,54,106,50.9,52,50,12,38,25,114,46,0,"https://fbref.com/en/players/caa7aaea/Yohann-Magnin"
"11760","Yanis Massolin_2023",2023,"Clermont Foot","Ligue 1","Yanis Massolin","FRA","MF","19",2002,0.7,2,1,1,0,1,0,1,0,1,1,0,1,2,4,0,0,"https://fbref.com/en/players/6ea05ca7/Yanis-Massolin"
"11761","Aïman Maurer_2023",2023,"Clermont Foot","Ligue 1","Aïman Maurer","MAR","MF","17",2004,5.6,2,1,1,1,0,1,10,10,9,1,0,1,3,5,5,0,"https://fbref.com/en/players/87d31635/Aiman-Maurer"
"11762","Arial Mendy_2023",2023,"Clermont Foot","Ligue 1","Arial Mendy","SEN","DF","27",1994,2.5,4,2,3,0,1,2,2,100,0,2,0,2,4,8,4,0,"https://fbref.com/en/players/9f0f4b49/Arial-Mendy"
"11763","Florent Ogier_2023",2023,"Clermont Foot","Ligue 1","Florent Ogier","FRA","DF","33",1989,18.9,33,16,20,12,1,22,39,56.4,17,22,13,9,18,51,64,1,"https://fbref.com/en/players/6993927b/Florent-Ogier"
"11764","Elba Rashani_2023",2023,"Clermont Foot","Ligue 1","Elba Rashani","KVX","MF,FW","29",1993,24,39,26,13,19,7,13,39,33.3,26,27,2,25,21,60,19,0,"https://fbref.com/en/players/25749008/Elba-Rashani"
"11765","Muhammed Saracevic Cham_2023",2023,"Clermont Foot","Ligue 1","Muhammed Saracevic Cham","AUT","MF","21",2000,21.9,30,15,15,4,11,13,35,37.1,22,13,0,13,7,37,5,0,"https://fbref.com/en/players/f527a32c/Muhammed-Saracevic-Cham"
"11766","Alidu Seidu_2023",2023,"Clermont Foot","Ligue 1","Alidu Seidu","GHA","DF","22",2000,27.3,52,31,35,14,3,31,51,60.8,20,28,14,14,52,104,50,2,"https://fbref.com/en/players/cea59f02/Alidu-Seidu"
"11767","Mateusz Wieteska_2023",2023,"Clermont Foot","Ligue 1","Mateusz Wieteska","POL","DF","25",1997,34.6,41,23,28,13,0,19,33,57.6,14,44,28,16,56,97,97,4,"https://fbref.com/en/players/3ecc8c5f/Mateusz-Wieteska"
"11768","Mehdi Zeffane_2023",2023,"Clermont Foot","Ligue 1","Mehdi Zeffane","ALG","DF,MF","30",1992,7.3,12,7,5,7,0,4,21,19,17,14,6,8,22,34,12,0,"https://fbref.com/en/players/c8c02ac7/Mehdi-Zeffane"
"11769","Christian Acella_2023",2023,"Cremonese","Serie A","Christian Acella","ITA","MF","20",2002,0.2,1,0,1,0,0,0,2,0,2,0,0,0,0,1,0,0,"https://fbref.com/en/players/771a2cfe/Christian-Acella"
"11770","Felix Afena-Gyan_2023",2023,"Cremonese","Serie A","Felix Afena-Gyan","GHA","FW,MF","19",2003,9.1,7,3,4,1,2,2,10,20,8,5,1,4,1,8,6,0,"https://fbref.com/en/players/0154d290/Felix-Afena-Gyan"
"11771","Emanuel Aiwum_2023",2023,"Cremonese","Serie A","Emanuel Aiwum","AUT","DF","21",2000,18.4,55,34,36,17,2,33,47,70.2,14,28,16,12,25,80,52,3,"https://fbref.com/en/players/d810c13b/Emanuel-Aiwum"
"11772","Santiago Ascacíbar_2023",2023,"Cremonese","Serie A","Santiago Ascacíbar","ARG","MF","25",1997,8.1,29,14,17,10,2,14,35,40,21,14,2,12,13,42,11,0,"https://fbref.com/en/players/e26fcca3/Santiago-Ascacibar"
"11773","Jaime Báez_2023",2023,"Cremonese","Serie A","Jaime Báez","URU","DF","27",1995,1.1,4,2,3,0,1,3,6,50,3,0,0,0,0,4,2,1,"https://fbref.com/en/players/dfd24c07/Jaime-Baez"
"11774","Alberto Basso_2023",2023,"Cremonese","Serie A","Alberto Basso","ITA","MF","18",2004,0.2,0,0,0,0,0,0,0,NA,0,0,0,0,0,0,0,0,"https://fbref.com/en/players/2ce215f2/Alberto-Basso"
"11775","Marco Benassi_2023",2023,"Cremonese","Serie A","Marco Benassi","ITA","MF","27",1994,11.1,26,15,9,11,6,15,24,62.5,9,13,1,12,12,38,19,0,"https://fbref.com/en/players/0000acda/Marco-Benassi"
"11776","Matteo Bianchetti_2023",2023,"Cremonese","Serie A","Matteo Bianchetti","ITA","DF","29",1993,23.7,32,19,21,9,2,20,32,62.5,12,31,17,14,20,52,111,0,"https://fbref.com/en/players/b3a20f18/Matteo-Bianchetti"
"11777","Cristian Buonaiuto_2023",2023,"Cremonese","Serie A","Cristian Buonaiuto","ITA","MF,FW","29",1992,10.9,25,16,8,11,6,12,26,46.2,14,11,0,11,14,39,7,0,"https://fbref.com/en/players/f3a9fa26/Cristian-Buonaiuto"
"11778","Marco Carnesecchi_2023",2023,"Cremonese","Serie A","Marco Carnesecchi","ITA","GK","22",2000,27,1,1,1,0,0,1,2,50,1,0,0,0,0,1,11,2,"https://fbref.com/en/players/8ec56e62/Marco-Carnesecchi"
"11779","Michele Castagnetti_2023",2023,"Cremonese","Serie A","Michele Castagnetti","ITA","MF","32",1989,15.7,46,21,20,24,2,18,54,33.3,36,14,4,10,15,61,22,0,"https://fbref.com/en/players/ad92526f/Michele-Castagnetti"
"11780","Vlad Chiricheș_2023",2023,"Cremonese","Serie A","Vlad Chiricheș","ROU","DF","32",1989,10.9,35,20,27,7,1,16,24,66.7,8,36,23,13,22,57,44,0,"https://fbref.com/en/players/c316607a/Vlad-Chiriches"
"11781","Daniel Ciofani_2023",2023,"Cremonese","Serie A","Daniel Ciofani","ITA","FW","37",1985,11.8,6,3,1,2,3,4,7,57.1,3,7,1,6,2,8,10,0,"https://fbref.com/en/players/b09a3ecc/Daniel-Ciofani"
"11782","Cyriel Dessers_2023",2023,"Cremonese","Serie A","Cyriel Dessers","NGA","FW","27",1994,17.6,11,4,4,4,3,2,6,33.3,4,14,2,12,3,14,5,0,"https://fbref.com/en/players/dcb38abe/Cyriel-Dessers"
"11783","Samuel Di Carmine_2023",2023,"Cremonese","Serie A","Samuel Di Carmine","ITA","FW,MF","33",1988,0.3,0,0,0,0,0,0,0,NA,0,0,0,0,0,0,0,0,"https://fbref.com/en/players/ef94dc2f/Samuel-Di-Carmine"
"11784","Gonzalo Escalante_2023",2023,"Cremonese","Serie A","Gonzalo Escalante","ARG","MF","29",1993,6.2,16,8,8,8,0,10,13,76.9,3,7,1,6,10,26,4,0,"https://fbref.com/en/players/3f79a1c8/Gonzalo-Escalante"
"11785","Alex Ferrari_2023",2023,"Cremonese","Serie A","Alex Ferrari","ITA","DF","28",1994,11.2,40,23,32,7,1,28,42,66.7,14,19,4,15,25,65,45,1,"https://fbref.com/en/players/d0dbca9f/Alex-Ferrari"
"11786","Pablo Galdames Millán_2023",2023,"Cremonese","Serie A","Pablo Galdames Millán","CHI","MF","25",1996,8.2,14,10,8,3,3,5,33,15.2,28,13,2,11,10,24,13,0,"https://fbref.com/en/players/dd403465/Pablo-Galdames-Millan"
"11787","Paolo Ghiglione_2023",2023,"Cremonese","Serie A","Paolo Ghiglione","ITA","DF","25",1997,7.9,16,11,10,3,3,10,23,43.5,13,9,4,5,4,20,12,0,"https://fbref.com/en/players/71dc23da/Paolo-Ghiglione"
"11788","Jack Hendry_2023",2023,"Cremonese","Serie A","Jack Hendry","SCO","DF","27",1995,2.4,0,0,0,0,0,0,1,0,1,2,1,1,1,1,7,0,"https://fbref.com/en/players/ffed43e3/Jack-Hendry"
"11789","Luka Lochoshvili_2023",2023,"Cremonese","Serie A","Luka Lochoshvili","GEO","DF","24",1998,20.4,45,19,30,11,4,22,31,71,9,31,10,21,22,67,89,0,"https://fbref.com/en/players/c8ad0857/Luka-Lochoshvili"
"11790","Soualiho Meïté_2023",2023,"Cremonese","Serie A","Soualiho Meïté","FRA","MF","28",1994,26.3,47,31,25,15,7,22,46,47.8,24,27,6,21,27,74,36,0,"https://fbref.com/en/players/5cec2c74/Soualiho-Meite"
"11791","Tommaso Milanese_2023",2023,"Cremonese","Serie A","Tommaso Milanese","ITA","MF","20",2002,0.3,0,0,0,0,0,0,0,NA,0,1,1,0,0,0,0,0,"https://fbref.com/en/players/b2561711/Tommaso-Milanese"
"11792","David Okereke_2023",2023,"Cremonese","Serie A","David Okereke","NGA","FW,MF","24",1997,25.2,12,8,4,5,3,3,16,18.8,13,23,3,20,10,22,12,0,"https://fbref.com/en/players/d125f22f/David-Okereke"
"11793","Charles Pickel_2023",2023,"Cremonese","Serie A","Charles Pickel","SUI","MF","25",1997,27.6,55,23,25,26,4,32,57,56.1,25,37,5,32,24,79,36,1,"https://fbref.com/en/players/f71ad8cb/Charles-Pickel"
"11794","Giacomo Quagliata_2023",2023,"Cremonese","Serie A","Giacomo Quagliata","ITA","DF","22",2000,7.8,10,8,7,1,2,5,11,45.5,6,7,2,5,11,21,8,0,"https://fbref.com/en/players/1b9c7401/Giacomo-Quagliata"
"11795","Ionuț Radu_2023",2023,"Cremonese","Serie A","Ionuț Radu","ROU","GK","25",1997,9,0,0,0,0,0,0,0,NA,0,0,0,0,0,0,1,3,"https://fbref.com/en/players/67f649be/Ionut-Radu"
"11796","Mouhamadou Sarr_2023",2023,"Cremonese","Serie A","Mouhamadou Sarr","SEN","GK","25",1997,2,0,0,0,0,0,0,0,NA,0,0,0,0,0,0,2,0,"https://fbref.com/en/players/b959a0d1/Mouhamadou-Sarr"
"11797","Leonardo Sernicola_2023",2023,"Cremonese","Serie A","Leonardo Sernicola","ITA","DF","25",1997,25.7,45,33,25,13,7,29,43,67.4,14,23,6,17,38,83,55,0,"https://fbref.com/en/players/dd7febd8/Leonardo-Sernicola"
"11798","Frank Tsadjout_2023",2023,"Cremonese","Serie A","Frank Tsadjout","ITA","FW","23",1999,11.7,10,8,3,6,1,3,9,33.3,6,7,1,6,8,18,9,0,"https://fbref.com/en/players/0588a092/Frank-Tsadjout"
"11799","Emanuele Valeri_2023",2023,"Cremonese","Serie A","Emanuele Valeri","ITA","DF","23",1998,30.9,54,27,29,21,4,29,69,42,40,17,3,14,22,76,44,1,"https://fbref.com/en/players/ec52b661/Emanuele-Valeri"
"11800","Johan Vásquez_2023",2023,"Cremonese","Serie A","Johan Vásquez","MEX","DF","23",1998,20.1,41,26,34,7,0,18,39,46.2,21,27,20,7,45,86,93,1,"https://fbref.com/en/players/5eaed77a/Johan-Vasquez"
"11801","Luca Zanimacchia_2023",2023,"Cremonese","Serie A","Luca Zanimacchia","ITA","MF,FW","24",1998,8.3,21,13,11,6,4,8,21,38.1,13,9,0,9,9,30,5,0,"https://fbref.com/en/players/5e834dce/Luca-Zanimacchia"
"11802","Naouirou Ahamada_2023",2023,"Crystal Palace","Premier League","Naouirou Ahamada","FRA","MF,FW","20",2002,1,3,2,3,0,0,1,3,33.3,2,2,0,2,0,3,0,0,"https://fbref.com/en/players/a6c58494/Naouirou-Ahamada"
"11803","Joachim Andersen_2023",2023,"Crystal Palace","Premier League","Joachim Andersen","DEN","DF","26",1996,30.9,42,22,30,12,0,16,32,50,16,28,13,15,24,66,188,0,"https://fbref.com/en/players/e34fc66d/Joachim-Andersen"
"11804","Jordan Ayew_2023",2023,"Crystal Palace","Premier League","Jordan Ayew","GHA","FW,MF","30",1991,30.2,66,41,23,20,23,21,53,39.6,32,35,4,31,15,81,31,0,"https://fbref.com/en/players/da052c14/Jordan-Ayew"
"11805","Nathaniel Clyne_2023",2023,"Crystal Palace","Premier League","Nathaniel Clyne","ENG","DF","31",1991,18.2,27,16,13,9,5,14,23,60.9,9,22,4,18,19,46,34,0,"https://fbref.com/en/players/0442183b/Nathaniel-Clyne"
"11806","Cheick Doucouré_2023",2023,"Crystal Palace","Premier League","Cheick Doucouré","MLI","MF","22",2000,30.8,77,46,40,33,4,29,52,55.8,23,47,13,34,56,133,48,0,"https://fbref.com/en/players/ce4f40c7/Cheick-Doucoure"
"11807","Malcolm Ebiowei_2023",2023,"Crystal Palace","Premier League","Malcolm Ebiowei","ENG","MF,FW","18",2003,0.4,1,1,1,0,0,0,1,0,1,2,0,2,0,1,0,0,"https://fbref.com/en/players/fa9fa773/Malcolm-Ebiowei"
"11808","Odsonne Édouard_2023",2023,"Crystal Palace","Premier League","Odsonne Édouard","FRA","FW","24",1998,20,25,13,7,12,6,7,13,53.8,6,17,5,12,3,28,22,0,"https://fbref.com/en/players/0562b7f1/Odsonne-Edouard"
"11809","Eberechi Eze_2023",2023,"Crystal Palace","Premier League","Eberechi Eze","ENG","MF,FW","24",1998,29.3,42,24,17,18,7,18,38,47.4,20,22,0,22,13,55,10,0,"https://fbref.com/en/players/ae4fc6a4/Eberechi-Eze"
"11810","Vicente Guaita_2023",2023,"Crystal Palace","Premier League","Vicente Guaita","ESP","GK","35",1987,27,0,0,0,0,0,0,0,NA,0,0,0,0,0,0,9,1,"https://fbref.com/en/players/ab13a5aa/Vicente-Guaita"
"11811","Marc Guéhi_2023",2023,"Crystal Palace","Premier League","Marc Guéhi","ENG","DF","22",2000,37,52,27,39,11,2,26,42,61.9,16,45,24,21,45,97,134,3,"https://fbref.com/en/players/d0706b27/Marc-Guehi"
"11812","Will Hughes_2023",2023,"Crystal Palace","Premier League","Will Hughes","ENG","MF","27",1995,9.4,29,16,11,16,2,11,20,55,9,16,7,9,16,45,9,0,"https://fbref.com/en/players/a0666d3e/Will-Hughes"
"11813","Sam Johnstone_2023",2023,"Crystal Palace","Premier League","Sam Johnstone","ENG","GK","29",1993,9,0,0,0,0,0,0,0,NA,0,0,0,0,0,0,5,0,"https://fbref.com/en/players/9e5708be/Sam-Johnstone"
"11814","Jean-Philippe Mateta_2023",2023,"Crystal Palace","Premier League","Jean-Philippe Mateta","FRA","FW","25",1997,8.6,7,1,2,4,1,1,3,33.3,2,3,1,2,3,10,18,0,"https://fbref.com/en/players/50e6dc35/Jean-Philippe-Mateta"
"11815","James McArthur_2023",2023,"Crystal Palace","Premier League","James McArthur","SCO","MF","34",1987,0.6,1,1,1,0,0,1,1,100,0,2,1,1,1,2,2,0,"https://fbref.com/en/players/cee31595/James-McArthur"
"11816","Luka Milivojević_2023",2023,"Crystal Palace","Premier League","Luka Milivojević","SRB","MF","31",1991,5.7,13,7,7,4,2,7,10,70,3,13,4,9,12,25,10,0,"https://fbref.com/en/players/2ce2508a/Luka-Milivojevic"
"11817","Tyrick Mitchell_2023",2023,"Crystal Palace","Premier League","Tyrick Mitchell","ENG","DF","22",1999,32.1,71,49,43,23,5,30,53,56.6,23,48,11,37,42,113,78,0,"https://fbref.com/en/players/5cbd1eb0/Tyrick-Mitchell"
"11818","Michael Olise_2023",2023,"Crystal Palace","Premier League","Michael Olise","FRA","FW,MF","20",2001,30.5,58,34,28,26,4,25,60,41.7,35,46,1,45,26,84,17,0,"https://fbref.com/en/players/c4486bac/Michael-Olise"
"11819","David Ozoh_2023",2023,"Crystal Palace","Premier League","David Ozoh","","FW","17",2005,0,0,0,0,0,0,0,0,NA,0,0,0,0,0,0,0,0,"https://fbref.com/en/players/d00d45ab/David-Ozoh"
"11820","Chris Richards_2023",2023,"Crystal Palace","Premier League","Chris Richards","USA","DF","22",2000,5,9,6,8,1,0,5,7,71.4,2,10,1,9,8,17,31,0,"https://fbref.com/en/players/0a3d6d2b/Chris-Richards"
"11821","Jaïro Riedewald_2023",2023,"Crystal Palace","Premier League","Jaïro Riedewald","NED","DF,MF","25",1996,0.7,2,1,2,0,0,0,1,0,1,2,0,2,0,2,4,0,"https://fbref.com/en/players/7a1f2c08/Jairo-Riedewald"
"11822","Albert Sambi Lokonga_2023",2023,"Crystal Palace","Premier League","Albert Sambi Lokonga","BEL","MF","22",1999,6,13,10,7,4,2,8,12,66.7,4,8,3,5,7,20,10,0,"https://fbref.com/en/players/1b4f1169/Albert-Sambi-Lokonga"
"11823","Jeffrey Schlupp_2023",2023,"Crystal Palace","Premier League","Jeffrey Schlupp","GHA","MF,FW","29",1992,28.1,66,46,28,29,9,22,43,51.2,21,39,8,31,23,89,38,0,"https://fbref.com/en/players/3312f911/Jeffrey-Schlupp"
"11824","James Tomkins_2023",2023,"Crystal Palace","Premier League","James Tomkins","ENG","DF","33",1989,3.8,4,2,2,1,1,1,3,33.3,2,3,2,1,5,9,19,0,"https://fbref.com/en/players/e7ca0439/James-Tomkins"
"11825","Joel Ward_2023",2023,"Crystal Palace","Premier League","Joel Ward","ENG","DF","32",1989,25.1,50,36,30,11,9,30,41,73.2,11,32,16,16,25,75,80,1,"https://fbref.com/en/players/8a7ff278/Joel-Ward"
"11826","Joseph Whitworth_2023",2023,"Crystal Palace","Premier League","Joseph Whitworth","ENG","GK","18",2004,2,0,0,0,0,0,0,0,NA,0,0,0,0,0,0,1,0,"https://fbref.com/en/players/3f847d95/Joseph-Whitworth"
"11827","Wilfried Zaha_2023",2023,"Crystal Palace","Premier League","Wilfried Zaha","CIV","FW,MF","29",1992,25.4,32,20,12,12,8,8,21,38.1,13,21,1,20,16,48,9,0,"https://fbref.com/en/players/b2bc3b1f/Wilfried-Zaha"
"11828","Tomás Alarcón_2023",2023,"Cádiz","La Liga","Tomás Alarcón","CHI","MF","23",1999,2.5,3,2,0,2,1,1,2,50,1,1,0,1,2,5,2,0,"https://fbref.com/en/players/99ea2ddd/Tomas-Alarcon"
"11829","Rubén Alcaraz_2023",2023,"Cádiz","La Liga","Rubén Alcaraz","ESP","MF","31",1991,22.7,43,31,24,18,1,19,54,35.2,35,23,8,15,19,62,37,0,"https://fbref.com/en/players/036bba5f/Ruben-Alcaraz"
"11830","Iván Alejo_2023",2023,"Cádiz","La Liga","Iván Alejo","ESP","MF,FW","27",1995,14.6,32,21,19,9,4,17,37,45.9,20,18,3,15,5,37,12,1,"https://fbref.com/en/players/3d7e48ce/Ivan-Alejo"
"11831","José Antonio_2023",2023,"Cádiz","La Liga","José Antonio","ESP","MF,DF","18",2004,0.5,2,1,0,0,2,0,0,NA,0,0,0,0,0,2,0,0,"https://fbref.com/en/players/62a583ee/Jose-Antonio"
"11832","Santiago Arzamendia_2023",2023,"Cádiz","La Liga","Santiago Arzamendia","PAR","DF,MF","24",1998,5.4,9,8,7,1,1,6,21,28.6,15,11,1,10,2,11,15,1,"https://fbref.com/en/players/759d8dd7/Santiago-Arzamendia"
"11833","Blanco_2023",2023,"Cádiz","La Liga","Blanco","ESP","MF","22",2000,1.8,6,4,5,1,0,4,6,66.7,2,5,0,5,1,7,3,0,"https://fbref.com/en/players/506daeac/Blanco"
"11834","Theo Bongonda_2023",2023,"Cádiz","La Liga","Theo Bongonda","COD","MF,FW","26",1995,21.5,28,20,11,14,3,17,40,42.5,23,21,2,19,6,34,14,0,"https://fbref.com/en/players/0da6a13e/Theo-Bongonda"
"11835","Cala_2023",2023,"Cádiz","La Liga","Cala","ESP","DF","32",1989,1.5,2,1,1,1,0,1,2,50,1,2,1,1,1,3,12,0,"https://fbref.com/en/players/fe05804b/Cala"
"11836","Isaac Carcelen_2023",2023,"Cádiz","La Liga","Isaac Carcelen","ESP","DF","29",1993,24.4,69,51,41,22,6,41,63,65.1,22,35,11,24,19,88,80,1,"https://fbref.com/en/players/c4b888df/Isaac-Carcelen"
"11837","Víctor Chust_2023",2023,"Cádiz","La Liga","Víctor Chust","ESP","DF","22",2000,10.7,9,6,7,2,0,4,7,57.1,3,8,3,5,10,19,53,0,"https://fbref.com/en/players/ec1a731e/Victor-Chust"
"11838","Mamady Diarra_2023",2023,"Cádiz","La Liga","Mamady Diarra","MLI","MF,DF","22",2000,0.7,2,1,2,0,0,1,2,50,1,2,0,2,0,2,0,0,"https://fbref.com/en/players/80211dc5/Mamady-Diarra"
"11839","Youba Diarra_2023",2023,"Cádiz","La Liga","Youba Diarra","MLI","MF","24",1998,1.1,3,0,2,1,0,1,5,20,4,7,1,6,2,5,3,0,"https://fbref.com/en/players/d61759ec/Youba-Diarra"
"11840","Gonzalo Escalante_2023",2023,"Cádiz","La Liga","Gonzalo Escalante","ARG","MF","29",1993,12.5,36,24,15,20,1,15,29,51.7,14,18,4,14,17,53,26,1,"https://fbref.com/en/players/3f79a1c8/Gonzalo-Escalante"
"11841","Alfonso Espino_2023",2023,"Cádiz","La Liga","Alfonso Espino","URU","DF","30",1992,34.7,87,56,55,20,12,48,96,50,48,52,11,41,48,135,99,3,"https://fbref.com/en/players/db001fa9/Alfonso-Espino"
"11842","Fali_2023",2023,"Cádiz","La Liga","Fali","ESP","DF,MF","28",1993,19,27,19,19,8,0,18,29,62.1,11,24,15,9,13,40,70,1,"https://fbref.com/en/players/72a84002/Fali"
"11843","Álex Fernández_2023",2023,"Cádiz","La Liga","Álex Fernández","ESP","MF,FW","29",1992,17.5,13,7,6,4,3,4,14,28.6,10,14,1,13,8,21,19,0,"https://fbref.com/en/players/aa677a35/Alex-Fernandez"
"11844","Carlos García_2023",2023,"Cádiz","La Liga","Carlos García","ESP","DF","22",2000,0.3,0,0,0,0,0,0,0,NA,0,0,0,0,0,0,2,0,"https://fbref.com/en/players/661e2822/Carlos-Garcia"
"11845","David Gil_2023",2023,"Cádiz","La Liga","David Gil","ESP","GK","28",1994,4,0,0,0,0,0,0,0,NA,0,0,0,0,0,0,3,0,"https://fbref.com/en/players/fea23125/David-Gil"
"11846","Álvaro Giménez_2023",2023,"Cádiz","La Liga","Álvaro Giménez","ESP","FW","31",1991,0.2,0,0,0,0,0,0,1,0,1,0,0,0,0,0,0,0,"https://fbref.com/en/players/18017beb/Alvaro-Gimenez"
"11847","Sergi Guardiola_2023",2023,"Cádiz","La Liga","Sergi Guardiola","ESP","FW","31",1991,12.9,9,7,0,6,3,3,12,25,9,5,0,5,3,12,7,0,"https://fbref.com/en/players/32974271/Sergi-Guardiola"
"11848","Luis Hernández_2023",2023,"Cádiz","La Liga","Luis Hernández","ESP","DF","33",1989,35,33,21,25,7,1,22,36,61.1,14,31,24,7,31,64,145,0,"https://fbref.com/en/players/02d2c436/Luis-Hernandez"
"11849","Jeremías Ledesma_2023",2023,"Cádiz","La Liga","Jeremías Ledesma","ARG","GK","29",1993,34,3,2,3,0,0,3,7,42.9,4,1,0,1,2,5,23,3,"https://fbref.com/en/players/6c4776b1/Jeremias-Ledesma"
"11850","Anthony Lozano_2023",2023,"Cádiz","La Liga","Anthony Lozano","HON","FW","29",1993,16,6,4,1,4,1,1,7,14.3,6,12,1,11,3,9,17,0,"https://fbref.com/en/players/38699c72/Anthony-Lozano"
"11851","Awer Mabil_2023",2023,"Cádiz","La Liga","Awer Mabil","AUS","MF,FW","26",1995,1.8,2,0,0,1,1,1,3,33.3,2,1,1,0,0,2,1,0,"https://fbref.com/en/players/922da988/Awer-Mabil"
"11852","José Mari_2023",2023,"Cádiz","La Liga","José Mari","ESP","MF","34",1987,4.4,16,7,12,3,1,10,16,62.5,6,3,1,2,5,21,9,0,"https://fbref.com/en/players/6f4c734d/Jose-Mari"
"11853","Roger Martí_2023",2023,"Cádiz","La Liga","Roger Martí","ESP","FW","31",1991,7.1,6,4,2,3,1,1,8,12.5,7,7,0,7,2,8,7,0,"https://fbref.com/en/players/0ae4e09a/Roger-Marti"
"11854","Mamadou Mbaye_2023",2023,"Cádiz","La Liga","Mamadou Mbaye","SEN","DF","24",1998,8.4,10,7,7,3,0,6,8,75,2,10,8,2,7,17,50,1,"https://fbref.com/en/players/8aae94b9/Mamadou-Mbaye"
"11855","Jorge Meré_2023",2023,"Cádiz","La Liga","Jorge Meré","ESP","DF","25",1997,6.7,11,7,9,2,0,5,8,62.5,3,9,6,3,6,17,32,0,"https://fbref.com/en/players/9f979eb2/Jorge-Mere"
"11856","Francisco Mwepu_2023",2023,"Cádiz","La Liga","Francisco Mwepu","ZAM","FW","22",2000,0.2,1,0,0,1,0,0,0,NA,0,0,0,0,0,1,0,0,"https://fbref.com/en/players/dfe5caa2/Francisco-Mwepu"
"11857","Álvaro Negredo_2023",2023,"Cádiz","La Liga","Álvaro Negredo","ESP","FW","36",1985,8.4,5,4,1,2,2,2,2,100,0,4,1,3,0,5,8,0,"https://fbref.com/en/players/63b0ca6b/Alvaro-Negredo"
"11858","Brian Ocampo_2023",2023,"Cádiz","La Liga","Brian Ocampo","URU","MF,FW","23",1999,12.4,18,15,12,5,1,8,21,38.1,13,13,0,13,3,21,3,0,"https://fbref.com/en/players/2e3995cd/Brian-Ocampo"
"11859","Raúl Parra_2023",2023,"Cádiz","La Liga","Raúl Parra","ESP","DF","22",1999,3.4,4,2,4,0,0,4,9,44.4,5,5,3,2,1,5,9,0,"https://fbref.com/en/players/647d39d2/Raul-Parra"
"11860","Alberto Perea_2023",2023,"Cádiz","La Liga","Alberto Perea","ESP","MF","31",1990,0.5,2,0,2,0,0,0,0,NA,0,2,0,2,0,2,0,0,"https://fbref.com/en/players/5496cc91/Alberto-Perea"
"11861","Lucas Pérez_2023",2023,"Cádiz","La Liga","Lucas Pérez","ESP","FW","33",1988,7,3,2,2,1,0,1,3,33.3,2,2,0,2,1,4,3,0,"https://fbref.com/en/players/a300ac7e/Lucas-Perez"
"11862","Chris Ramos_2023",2023,"Cádiz","La Liga","Chris Ramos","ESP","FW","25",1997,7.9,12,9,2,7,3,4,11,36.4,7,8,3,5,1,13,19,0,"https://fbref.com/en/players/44e07fac/Chris-Ramos"
"11863","Fede San Emeterio_2023",2023,"Cádiz","La Liga","Fede San Emeterio","ESP","MF","25",1997,20.5,41,22,23,16,2,22,46,47.8,24,34,14,20,17,58,28,0,"https://fbref.com/en/players/efecd633/Fede-San-Emeterio"
"11864","Rubén Sobrino_2023",2023,"Cádiz","La Liga","Rubén Sobrino","ESP","MF,FW","30",1992,27.4,55,37,29,17,9,23,56,41.1,33,33,3,30,24,79,20,1,"https://fbref.com/en/players/19b776e9/Ruben-Sobrino"
"11865","Joseba Zaldúa_2023",2023,"Cádiz","La Liga","Joseba Zaldúa","ESP","DF","30",1992,7.1,15,8,10,4,1,7,10,70,3,4,2,2,11,26,22,0,"https://fbref.com/en/players/5ca20b7a/Joseba-Zaldua"
"11866","Karim Adeyemi_2023",2023,"Dortmund","Bundesliga","Karim Adeyemi","GER","FW,MF","20",2002,15.4,16,11,6,6,4,8,30,26.7,22,18,1,17,7,23,3,0,"https://fbref.com/en/players/501055d8/Karim-Adeyemi"
"11867","Jude Bellingham_2023",2023,"Dortmund","Bundesliga","Jude Bellingham","ENG","MF","19",2003,29.9,76,42,28,34,14,34,51,66.7,17,51,4,47,35,111,30,0,"https://fbref.com/en/players/57d88cf9/Jude-Bellingham"
"11868","Julian Brandt_2023",2023,"Dortmund","Bundesliga","Julian Brandt","GER","MF,FW","26",1996,26.6,29,20,6,14,9,12,43,27.9,31,23,0,23,15,44,9,1,"https://fbref.com/en/players/a167537f/Julian-Brandt"
"11869","Jamie Bynoe-Gittens_2023",2023,"Dortmund","Bundesliga","Jamie Bynoe-Gittens","ENG","FW,MF","17",2004,5.9,8,4,2,5,1,2,7,28.6,5,1,0,1,1,9,2,0,"https://fbref.com/en/players/10745192/Jamie-Bynoe-Gittens"
"11870","Emre Can_2023",2023,"Dortmund","Bundesliga","Emre Can","GER","MF","28",1994,21.1,57,28,25,27,5,22,43,51.2,21,16,6,10,25,82,39,1,"https://fbref.com/en/players/a65ce836/Emre-Can"
"11871","Soumaïla Coulibaly_2023",2023,"Dortmund","Bundesliga","Soumaïla Coulibaly","FRA","DF","18",2003,0.5,0,0,0,0,0,0,0,NA,0,0,0,0,0,0,0,1,"https://fbref.com/en/players/9dff291c/Soumaila-Coulibaly"
"11872","Mahmoud Dahoud_2023",2023,"Dortmund","Bundesliga","Mahmoud Dahoud","GER","MF","26",1996,3.7,11,9,3,4,4,7,7,100,0,6,2,4,7,18,3,0,"https://fbref.com/en/players/db4ed67b/Mahmoud-Dahoud"
"11873","Julien Duranville_2023",2023,"Dortmund","Bundesliga","Julien Duranville","BEL","MF","16",2006,0.3,1,1,0,1,0,1,1,100,0,0,0,0,0,1,0,0,"https://fbref.com/en/players/b06a7ae9/Julien-Duranville"
"11874","Raphaël Guerreiro_2023",2023,"Dortmund","Bundesliga","Raphaël Guerreiro","POR","DF,MF","28",1993,25.4,36,20,13,15,8,21,34,61.8,13,21,2,19,36,72,23,0,"https://fbref.com/en/players/048a1cbc/Raphael-Guerreiro"
"11875","Sébastien Haller_2023",2023,"Dortmund","Bundesliga","Sébastien Haller","CIV","FW","28",1994,13.6,5,4,2,1,2,0,4,0,4,8,0,8,1,6,10,0,"https://fbref.com/en/players/ba115a40/Sebastien-Haller"
"11876","Thorgan Hazard_2023",2023,"Dortmund","Bundesliga","Thorgan Hazard","BEL","FW,DF","29",1993,5.2,17,6,5,11,1,12,17,70.6,5,6,0,6,5,22,5,0,"https://fbref.com/en/players/50871bcc/Thorgan-Hazard"
"11877","Mats Hummels_2023",2023,"Dortmund","Bundesliga","Mats Hummels","GER","DF","33",1988,22.4,62,34,38,22,2,32,55,58.2,23,30,16,14,33,95,100,1,"https://fbref.com/en/players/05d548d8/Mats-Hummels"
"11878","Gregor Kobel_2023",2023,"Dortmund","Bundesliga","Gregor Kobel","SUI","GK","24",1997,27,0,0,0,0,0,0,1,0,1,1,0,1,0,0,7,2,"https://fbref.com/en/players/cd59b9df/Gregor-Kobel"
"11879","Donyell Malen_2023",2023,"Dortmund","Bundesliga","Donyell Malen","NED","FW","23",1999,19,13,5,3,4,6,5,12,41.7,7,14,1,13,4,17,11,0,"https://fbref.com/en/players/864163f3/Donyell-Malen"
"11880","Thomas Meunier_2023",2023,"Dortmund","Bundesliga","Thomas Meunier","BEL","DF","30",1991,6.5,16,7,8,5,3,10,17,58.8,7,7,2,5,9,25,16,0,"https://fbref.com/en/players/e162b013/Thomas-Meunier"
"11881","Alexander Meyer_2023",2023,"Dortmund","Bundesliga","Alexander Meyer","GER","GK","31",1991,7,0,0,0,0,0,0,1,0,1,0,0,0,0,0,1,0,"https://fbref.com/en/players/b56dd813/Alexander-Meyer"
"11882","Anthony Modeste_2023",2023,"Dortmund","Bundesliga","Anthony Modeste","FRA","FW","34",1988,9,4,4,2,0,2,2,5,40,3,7,0,7,2,6,22,0,"https://fbref.com/en/players/34e4343c/Anthony-Modeste"
"11883","Youssoufa Moukoko_2023",2023,"Dortmund","Bundesliga","Youssoufa Moukoko","GER","FW","17",2004,12.7,13,7,3,6,4,3,6,50,3,9,0,9,2,15,1,0,"https://fbref.com/en/players/6ce43701/Youssoufa-Moukoko"
"11884","Justin Njinmah_2023",2023,"Dortmund","Bundesliga","Justin Njinmah","GER","FW","21",2000,0.2,0,0,0,0,0,0,0,NA,0,0,0,0,0,0,0,0,"https://fbref.com/en/players/a45241d5/Justin-Njinmah"
"11885","Salih Özcan_2023",2023,"Dortmund","Bundesliga","Salih Özcan","TUR","MF","24",1998,17.5,31,18,10,16,5,16,39,41,23,24,2,22,28,59,19,1,"https://fbref.com/en/players/15413fa5/Salih-Ozcan"
"11886","Antonios Papadopoulos_2023",2023,"Dortmund","Bundesliga","Antonios Papadopoulos","GER","DF","22",1999,0.1,0,0,0,0,0,0,0,NA,0,0,0,0,1,1,0,0,"https://fbref.com/en/players/13d23b29/Antonios-Papadopoulos"
"11887","Marco Pašalić_2023",2023,"Dortmund","Bundesliga","Marco Pašalić","CRO","MF","21",2000,0.1,0,0,0,0,0,0,0,NA,0,0,0,0,0,0,0,0,"https://fbref.com/en/players/1866b0f1/Marco-Pasalic"
"11888","Felix Passlack_2023",2023,"Dortmund","Bundesliga","Felix Passlack","GER","DF","24",1998,0.7,4,3,0,4,0,1,1,100,0,1,1,0,0,4,1,0,"https://fbref.com/en/players/5c899683/Felix-Passlack"
"11889","Marco Reus_2023",2023,"Dortmund","Bundesliga","Marco Reus","GER","MF,FW","33",1989,15,30,17,12,14,4,7,24,29.2,17,12,4,8,8,38,8,0,"https://fbref.com/en/players/36a3ff67/Marco-Reus"
"11890","Gio Reyna_2023",2023,"Dortmund","Bundesliga","Gio Reyna","USA","FW,MF","19",2002,6.9,14,7,2,5,7,5,10,50,5,8,2,6,3,17,5,0,"https://fbref.com/en/players/7fa4e703/Gio-Reyna"
"11891","Tom Rothe_2023",2023,"Dortmund","Bundesliga","Tom Rothe","GER","DF","17",2004,0.3,1,1,0,1,0,1,1,100,0,0,0,0,1,2,2,0,"https://fbref.com/en/players/90c1f9a4/Tom-Rothe"
"11892","Julian Ryerson_2023",2023,"Dortmund","Bundesliga","Julian Ryerson","NOR","DF","24",1997,15.7,27,15,17,7,3,19,37,51.4,18,13,2,11,8,35,28,0,"https://fbref.com/en/players/009a4f60/Julian-Ryerson"
"11893","Nico Schlotterbeck_2023",2023,"Dortmund","Bundesliga","Nico Schlotterbeck","GER","DF","22",1999,25,59,34,34,24,1,37,53,69.8,16,38,21,17,32,91,71,1,"https://fbref.com/en/players/34e12499/Nico-Schlotterbeck"
"11894","Niklas Süle_2023",2023,"Dortmund","Bundesliga","Niklas Süle","GER","DF","26",1995,23.5,25,19,18,3,4,14,23,60.9,9,28,19,9,17,42,53,0,"https://fbref.com/en/players/e33c06cf/Niklas-Sule"
"11895","Marius Wolf_2023",2023,"Dortmund","Bundesliga","Marius Wolf","GER","DF","27",1995,17.4,25,18,9,12,4,16,29,55.2,13,40,10,30,18,43,22,1,"https://fbref.com/en/players/fa661778/Marius-Wolf"
"11896","Paxten Aaronson_2023",2023,"Eint Frankfurt","Bundesliga","Paxten Aaronson","USA","MF,DF","18",2003,1.9,6,5,2,2,2,2,3,66.7,1,2,1,1,0,6,2,0,"https://fbref.com/en/players/4cd41883/Paxten-Aaronson"
"11897","Lucas Alario_2023",2023,"Eint Frankfurt","Bundesliga","Lucas Alario","ARG","FW,MF","29",1992,3.7,3,2,1,0,2,0,1,0,1,0,0,0,2,5,13,0,"https://fbref.com/en/players/834d0be5/Lucas-Alario"
"11898","Faride Alidou_2023",2023,"Eint Frankfurt","Bundesliga","Faride Alidou","GER","DF,MF","21",2001,2,8,5,3,4,1,3,9,33.3,6,3,0,3,1,9,3,0,"https://fbref.com/en/players/00f518d8/Faride-Alidou"
"11899","Rafael Borré_2023",2023,"Eint Frankfurt","Bundesliga","Rafael Borré","COL","MF,FW","26",1995,12,25,15,4,13,8,4,17,23.5,13,10,2,8,2,27,9,0,"https://fbref.com/en/players/c68da769/Rafael-Borre"
"11900","Aurélio Buta_2023",2023,"Eint Frankfurt","Bundesliga","Aurélio Buta","POR","DF","25",1997,14.6,33,19,15,13,5,15,27,55.6,12,18,1,17,9,42,34,0,"https://fbref.com/en/players/b4705807/Aurelio-Buta"
"11901","Timothy Chandler_2023",2023,"Eint Frankfurt","Bundesliga","Timothy Chandler","USA","DF","32",1990,1,2,2,2,0,0,2,2,100,0,1,0,1,0,2,3,0,"https://fbref.com/en/players/b3b7f5a6/Timothy-Chandler"
"11902","Junior Dina Ebimbe_2023",2023,"Eint Frankfurt","Bundesliga","Junior Dina Ebimbe","FRA","DF,MF","21",2000,11.8,30,19,16,14,0,16,33,48.5,17,18,5,13,11,41,20,0,"https://fbref.com/en/players/95bb6ddc/Junior-Dina-Ebimbe"
"11903","Dario Gebuhr_2023",2023,"Eint Frankfurt","Bundesliga","Dario Gebuhr","GER","DF","19",2003,0.2,0,0,0,0,0,0,1,0,1,0,0,0,0,0,0,0,"https://fbref.com/en/players/277be51d/Dario-Gebuhr"
"11904","Mario Götze_2023",2023,"Eint Frankfurt","Bundesliga","Mario Götze","GER","MF","30",1992,30.4,42,25,13,22,7,14,47,29.8,33,25,0,25,13,55,12,0,"https://fbref.com/en/players/9efa1d25/Mario-Gotze"
"11905","Makoto Hasebe_2023",2023,"Eint Frankfurt","Bundesliga","Makoto Hasebe","JPN","DF","38",1984,14.5,18,12,16,2,0,7,22,31.8,15,22,9,13,17,35,45,0,"https://fbref.com/en/players/9ab16552/Makoto-Hasebe"
"11906","Kristijan Jakić_2023",2023,"Eint Frankfurt","Bundesliga","Kristijan Jakić","CRO","DF,MF","25",1997,16.2,33,21,19,12,2,22,41,53.7,19,32,10,22,14,47,49,1,"https://fbref.com/en/players/a8ee54ad/Kristijan-Jakic"
"11907","Daichi Kamada_2023",2023,"Eint Frankfurt","Bundesliga","Daichi Kamada","JPN","MF","25",1996,25.2,51,31,10,37,4,31,57,54.4,26,31,2,29,16,67,17,1,"https://fbref.com/en/players/15b287da/Daichi-Kamada"
"11908","Ansgar Knauff_2023",2023,"Eint Frankfurt","Bundesliga","Ansgar Knauff","GER","DF","20",2002,14.3,36,25,22,11,3,15,34,44.1,19,19,1,18,15,51,26,0,"https://fbref.com/en/players/19a967ab/Ansgar-Knauff"
"11909","Randal Kolo Muani_2023",2023,"Eint Frankfurt","Bundesliga","Randal Kolo Muani","FRA","FW","23",1998,29.2,14,10,3,3,8,1,9,11.1,8,19,2,17,3,17,13,0,"https://fbref.com/en/players/c0b3669f/Randal-Kolo-Muani"
"11910","Filip Kostić_2023",2023,"Eint Frankfurt","Bundesliga","Filip Kostić","SRB","DF,MF","29",1992,0.8,2,0,1,1,0,0,0,NA,0,0,0,0,1,3,0,0,"https://fbref.com/en/players/b1cd37e6/Filip-Kostic"
"11911","Christopher Lenz_2023",2023,"Eint Frankfurt","Bundesliga","Christopher Lenz","GER","DF","27",1994,14.3,29,21,17,7,5,16,37,43.2,21,16,3,13,21,50,34,0,"https://fbref.com/en/players/bbd86530/Christopher-Lenz"
"11912","Jesper Lindstrøm_2023",2023,"Eint Frankfurt","Bundesliga","Jesper Lindstrøm","DEN","MF,FW","22",2000,18.7,26,11,15,7,4,7,22,31.8,15,25,3,22,9,35,9,0,"https://fbref.com/en/players/37dc1a48/Jesper-Lindstrom"
"11913","Philipp Max_2023",2023,"Eint Frankfurt","Bundesliga","Philipp Max","GER","DF","28",1993,7.7,12,9,4,7,1,5,16,31.3,11,10,2,8,3,15,11,0,"https://fbref.com/en/players/826e8b63/Philipp-Max"
"11914","Obite N'Dicka_2023",2023,"Eint Frankfurt","Bundesliga","Obite N'Dicka","FRA","DF","22",1999,29.9,25,18,10,11,4,18,32,56.3,14,47,19,28,31,56,150,0,"https://fbref.com/en/players/441197b8/Obite-NDicka"
"11915","Luca Pellegrini_2023",2023,"Eint Frankfurt","Bundesliga","Luca Pellegrini","ITA","DF","23",1999,6.2,13,8,10,3,0,8,8,100,0,8,2,6,7,20,11,1,"https://fbref.com/en/players/3b61c9ec/Luca-Pellegrini"
"11916","Diant Ramaj_2023",2023,"Eint Frankfurt","Bundesliga","Diant Ramaj","GER","GK","20",2001,1,0,0,0,0,0,0,0,NA,0,0,0,0,0,0,1,0,"https://fbref.com/en/players/b90c4a43/Diant-Ramaj"
"11917","Sebastian Rode_2023",2023,"Eint Frankfurt","Bundesliga","Sebastian Rode","GER","MF","31",1990,15.7,38,24,7,28,3,14,45,31.1,31,18,2,16,16,54,12,0,"https://fbref.com/en/players/e12b0b5b/Sebastian-Rode"
"11918","Hrvoje Smolčić_2023",2023,"Eint Frankfurt","Bundesliga","Hrvoje Smolčić","CRO","DF","21",2000,5.2,8,7,6,2,0,5,10,50,5,11,4,7,6,14,38,0,"https://fbref.com/en/players/c967f6b8/Hrvoje-Smolcic"
"11919","Djibril Sow_2023",2023,"Eint Frankfurt","Bundesliga","Djibril Sow","SUI","MF","25",1997,29.4,41,25,13,25,3,22,44,50,22,22,4,18,28,69,23,0,"https://fbref.com/en/players/4c6facae/Djibril-Sow"
"11920","Almamy Touré_2023",2023,"Eint Frankfurt","Bundesliga","Almamy Touré","MLI","DF","26",1996,4.4,13,7,7,5,1,5,9,55.6,4,9,2,7,10,23,8,0,"https://fbref.com/en/players/c8c60119/Almamy-Toure"
"11921","Kevin Trapp_2023",2023,"Eint Frankfurt","Bundesliga","Kevin Trapp","GER","GK","32",1990,33,1,1,1,0,0,0,2,0,2,2,0,2,0,1,10,0,"https://fbref.com/en/players/ce17b5eb/Kevin-Trapp"
"11922","Tuta_2023",2023,"Eint Frankfurt","Bundesliga","Tuta","BRA","DF","23",1999,30.2,53,35,27,19,7,33,57,57.9,24,47,14,33,49,102,134,2,"https://fbref.com/en/players/35d64857/Tuta"
"11923","Marcel Wenig_2023",2023,"Eint Frankfurt","Bundesliga","Marcel Wenig","GER","MF","18",2004,0,0,0,0,0,0,0,0,NA,0,0,0,0,0,0,0,0,"https://fbref.com/en/players/1c86aa16/Marcel-Wenig"
"11924","Alejandro Alfaro_2023",2023,"Elche","La Liga","Alejandro Alfaro","ESP","MF","20",2002,0.2,0,0,0,0,0,0,0,NA,0,0,0,0,0,0,0,0,"https://fbref.com/en/players/b907d169/Alejandro-Alfaro"
"11925","Édgar Badía_2023",2023,"Elche","La Liga","Édgar Badía","ESP","GK","30",1992,36,1,0,1,0,0,1,2,50,1,0,0,0,0,1,19,3,"https://fbref.com/en/players/e4346678/Edgar-Badia"
"11926","Pedro Bigas_2023",2023,"Elche","La Liga","Pedro Bigas","ESP","DF","31",1990,22.4,37,20,30,7,0,18,29,62.1,11,25,14,11,33,70,95,0,"https://fbref.com/en/players/697295b1/Pedro-Bigas"
"11927","Lautaro Blanco_2023",2023,"Elche","La Liga","Lautaro Blanco","ARG","DF,MF","23",1999,9.7,16,9,10,4,2,9,26,34.6,17,8,1,7,2,18,10,1,"https://fbref.com/en/players/1657f448/Lautaro-Blanco"
"11928","Lucas Boyé_2023",2023,"Elche","La Liga","Lucas Boyé","ARG","FW","26",1996,27.4,36,16,12,16,8,17,35,48.6,18,33,5,28,15,51,46,0,"https://fbref.com/en/players/d49f3e6b/Lucas-Boye"
"11929","Carmona_2023",2023,"Elche","La Liga","Carmona","ESP","MF,DF","20",2002,6.5,16,9,7,6,3,6,16,37.5,10,14,2,12,8,24,9,0,"https://fbref.com/en/players/2dce876a/Carmona"
"11930","Pape Cheikh Diop_2023",2023,"Elche","La Liga","Pape Cheikh Diop","SEN","MF","24",1997,0.4,0,0,0,0,0,0,1,0,1,0,0,0,0,0,0,0,"https://fbref.com/en/players/873ce3a2/Pape-Cheikh-Diop"
"11931","Carlos Clerc_2023",2023,"Elche","La Liga","Carlos Clerc","ESP","DF,MF","30",1992,29.3,75,51,55,16,4,31,50,62,19,29,7,22,28,103,94,1,"https://fbref.com/en/players/33a61a52/Carlos-Clerc"
"11932","Álex Collado_2023",2023,"Elche","La Liga","Álex Collado","ESP","MF","23",1999,8.1,26,14,13,11,2,8,13,61.5,5,12,1,11,2,28,4,0,"https://fbref.com/en/players/85dace26/Alex-Collado"
"11933","John Donald_2023",2023,"Elche","La Liga","John Donald","ESP","MF,DF","21",2000,12.1,20,11,9,9,2,7,14,50,7,14,7,7,14,34,23,1,"https://fbref.com/en/players/5e95c000/John-Donald"
"11934","Nicolás Ezequiel Fernández_2023",2023,"Elche","La Liga","Nicolás Ezequiel Fernández","ARG","MF,DF","22",2000,5.7,23,12,10,7,6,9,17,52.9,8,7,0,7,5,28,2,1,"https://fbref.com/en/players/3409de86/Nicolas-Ezequiel-Fernandez"
"11935","Federico Fernández_2023",2023,"Elche","La Liga","Federico Fernández","ARG","DF","33",1989,1,1,1,1,0,0,1,1,100,0,0,0,0,2,3,12,0,"https://fbref.com/en/players/f25b010f/Federico-Fernandez"
"11936","Fidel_2023",2023,"Elche","La Liga","Fidel","ESP","MF,FW","32",1989,19,15,10,8,5,2,4,38,10.5,34,9,0,9,5,20,8,0,"https://fbref.com/en/players/eb82b6f1/Fidel"
"11937","Diego González_2023",2023,"Elche","La Liga","Diego González","ESP","DF","27",1995,10.6,12,7,9,3,0,7,11,63.6,4,14,12,2,7,19,50,1,"https://fbref.com/en/players/4ac7608e/Diego-Gonzalez"
"11938","Gerard Gumbau_2023",2023,"Elche","La Liga","Gerard Gumbau","ESP","MF","27",1994,30.4,44,25,17,23,4,18,51,35.3,33,32,8,24,28,72,40,0,"https://fbref.com/en/players/ac454a4f/Gerard-Gumbau"
"11939","Raúl Guti_2023",2023,"Elche","La Liga","Raúl Guti","ESP","MF","25",1996,12.4,18,12,8,9,1,8,18,44.4,10,10,3,7,8,26,6,0,"https://fbref.com/en/players/0b2c8585/Raul-Guti"
"11940","Josan_2023",2023,"Elche","La Liga","Josan","ESP","DF,MF","32",1989,12,25,20,20,5,0,14,27,51.9,13,8,0,8,7,32,15,1,"https://fbref.com/en/players/5b28b2f6/Josan"
"11941","Pol Lirola_2023",2023,"Elche","La Liga","Pol Lirola","ESP","DF","24",1997,7,13,6,9,3,1,8,13,61.5,5,3,2,1,7,20,16,0,"https://fbref.com/en/players/ff800ed8/Pol-Lirola"
"11942","Lisandro Magallán_2023",2023,"Elche","La Liga","Lisandro Magallán","ARG","DF","28",1993,10,19,11,11,5,3,10,12,83.3,2,14,5,9,13,32,30,1,"https://fbref.com/en/players/01a49bd2/Lisandro-Magallan"
"11943","Roger Martí_2023",2023,"Elche","La Liga","Roger Martí","ESP","FW","31",1991,7.3,5,2,3,2,0,1,5,20,4,4,0,4,1,6,7,0,"https://fbref.com/en/players/0ae4e09a/Roger-Marti"
"11944","Omar Mascarell_2023",2023,"Elche","La Liga","Omar Mascarell","ESP","MF,DF","29",1993,27.2,53,26,32,19,2,31,64,48.4,33,51,19,32,45,98,54,1,"https://fbref.com/en/players/11fd2b75/Omar-Mascarell"
"11945","Pere Milla_2023",2023,"Elche","La Liga","Pere Milla","ESP","FW,MF","29",1992,20.5,31,20,18,8,5,14,41,34.1,27,18,3,15,9,40,19,1,"https://fbref.com/en/players/335039a2/Pere-Milla"
"11946","Johan Mojica_2023",2023,"Elche","La Liga","Johan Mojica","COL","DF,MF","29",1992,3,6,3,5,1,0,2,3,66.7,1,3,2,1,4,10,5,0,"https://fbref.com/en/players/608f2092/Johan-Mojica"
"11947","Tete Morente_2023",2023,"Elche","La Liga","Tete Morente","ESP","MF,DF","25",1996,23,33,21,18,13,2,15,36,41.7,21,23,3,20,25,58,28,0,"https://fbref.com/en/players/004d185e/Tete-Morente"
"11948","Randy Ntekja_2023",2023,"Elche","La Liga","Randy Ntekja","FRA","FW,MF","24",1997,8.1,15,10,7,6,2,2,11,18.2,9,15,3,12,4,19,9,0,"https://fbref.com/en/players/a6103274/Randy-Ntekja"
"11949","Helibelton Palacios_2023",2023,"Elche","La Liga","Helibelton Palacios","COL","DF","29",1993,21.3,38,20,21,15,2,19,26,73.1,7,26,12,14,20,58,55,0,"https://fbref.com/en/players/ac8b2421/Helibelton-Palacios"
"11950","Javier Pastore_2023",2023,"Elche","La Liga","Javier Pastore","ARG","MF","33",1989,0.1,0,0,0,0,0,0,0,NA,0,0,0,0,0,0,0,0,"https://fbref.com/en/players/881ef58c/Javier-Pastore"
"11951","Ezequiel Ponce_2023",2023,"Elche","La Liga","Ezequiel Ponce","ARG","FW,MF","25",1997,12.5,9,7,0,6,3,0,7,0,7,6,1,5,1,10,13,0,"https://fbref.com/en/players/ccbbe661/Ezequiel-Ponce"
"11952","Domingos Quina_2023",2023,"Elche","La Liga","Domingos Quina","POR","MF","22",1999,3.1,3,2,2,1,0,1,3,33.3,2,5,0,5,3,6,1,0,"https://fbref.com/en/players/41fb0f4e/Domingos-Quina"
"11953","Enzo Roco_2023",2023,"Elche","La Liga","Enzo Roco","CHI","DF","29",1992,18.4,33,13,23,10,0,15,24,62.5,9,22,15,7,17,50,63,1,"https://fbref.com/en/players/37f827ec/Enzo-Roco"
"11954","Gonzalo Verdú_2023",2023,"Elche","La Liga","Gonzalo Verdú","ESP","DF","33",1988,7.8,10,5,8,2,0,4,8,50,4,8,6,2,10,20,33,0,"https://fbref.com/en/players/1c2c55fc/Gonzalo-Verdu"
"11955","Axel Werner_2023",2023,"Elche","La Liga","Axel Werner","ARG","GK","26",1996,2,0,0,0,0,0,0,1,0,1,0,0,0,0,0,0,0,"https://fbref.com/en/players/c0b1a6da/Axel-Werner"
"11956","Jean-Daniel Akpa-Akpro_2023",2023,"Empoli","Serie A","Jean-Daniel Akpa-Akpro","CIV","MF,FW","29",1992,15.1,53,37,25,19,9,23,42,54.8,19,35,4,31,13,66,27,0,"https://fbref.com/en/players/fdf4b948/Jean-Daniel-Akpa-Akpro"
"11957","Nedim Bajrami_2023",2023,"Empoli","Serie A","Nedim Bajrami","ALB","MF,FW","23",1999,10.4,8,4,3,3,2,4,6,66.7,2,5,0,5,7,15,4,0,"https://fbref.com/en/players/f42d6c13/Nedim-Bajrami"
"11958","Tommaso Baldanzi_2023",2023,"Empoli","Serie A","Tommaso Baldanzi","ITA","MF","19",2003,19.7,25,12,9,13,3,7,32,21.9,25,21,1,20,2,27,5,0,"https://fbref.com/en/players/102e2599/Tommaso-Baldanzi"
"11959","Filippo Bandinelli_2023",2023,"Empoli","Serie A","Filippo Bandinelli","ITA","MF","27",1995,25.1,55,34,19,26,10,17,45,37.8,28,20,7,13,18,73,40,0,"https://fbref.com/en/players/d44360be/Filippo-Bandinelli"
"11960","Liberato Cacace_2023",2023,"Empoli","Serie A","Liberato Cacace","NZL","DF","21",2000,6.5,25,10,12,8,5,9,15,60,6,15,7,8,4,29,16,0,"https://fbref.com/en/players/dd86e8e4/Liberato-Cacace"
"11961","Nicolò Cambiaghi_2023",2023,"Empoli","Serie A","Nicolò Cambiaghi","ITA","FW,MF","21",2000,14.3,30,22,11,12,7,8,27,29.6,19,19,1,18,9,39,8,0,"https://fbref.com/en/players/91ff775f/Nicolo-Cambiaghi"
"11962","Francesco Caputo_2023",2023,"Empoli","Serie A","Francesco Caputo","ITA","FW","34",1987,19,2,2,0,1,1,0,1,0,1,7,2,5,2,4,8,0,"https://fbref.com/en/players/5bd72174/Francesco-Caputo"
"11963","Koni De Winter_2023",2023,"Empoli","Serie A","Koni De Winter","BEL","DF","20",2002,11.4,14,9,11,3,0,5,13,38.5,8,14,12,2,6,20,65,0,"https://fbref.com/en/players/f4797849/Koni-De-Winter"
"11964","Duccio Degl'Innocenti_2023",2023,"Empoli","Serie A","Duccio Degl'Innocenti","ITA","MF","19",2003,0,0,0,0,0,0,0,0,NA,0,0,0,0,1,1,0,0,"https://fbref.com/en/players/0e0d6c53/Duccio-DeglInnocenti"
"11965","Mattia Destro_2023",2023,"Empoli","Serie A","Mattia Destro","ITA","FW,MF","31",1991,6.4,1,1,0,1,0,0,0,NA,0,2,0,2,1,2,5,0,"https://fbref.com/en/players/d7d32194/Mattia-Destro"
"11966","Tyronne Ebuehi_2023",2023,"Empoli","Serie A","Tyronne Ebuehi","NGA","DF","26",1995,21.4,22,14,11,7,4,9,13,69.2,4,23,12,11,12,34,79,1,"https://fbref.com/en/players/6af30900/Tyronne-Ebuehi"
"11967","Emmanuel Ekong_2023",2023,"Empoli","Serie A","Emmanuel Ekong","SWE","FW,MF","20",2002,0.2,0,0,0,0,0,0,0,NA,0,0,0,0,0,0,0,0,"https://fbref.com/en/players/c20892ee/Emmanuel-Ekong"
"11968","Jacopo Fazzini_2023",2023,"Empoli","Serie A","Jacopo Fazzini","ITA","MF","19",2003,9.2,31,17,20,8,3,18,34,52.9,16,15,3,12,7,38,19,0,"https://fbref.com/en/players/06b08c45/Jacopo-Fazzini"
"11969","Alberto Grassi_2023",2023,"Empoli","Serie A","Alberto Grassi","ITA","MF","27",1995,13.3,26,21,13,13,0,15,24,62.5,9,23,12,11,27,53,45,0,"https://fbref.com/en/players/6cc97b6a/Alberto-Grassi"
"11970","Nicolas Haas_2023",2023,"Empoli","Serie A","Nicolas Haas","SUI","MF","26",1996,12.8,27,13,16,6,5,12,24,50,12,16,4,12,8,35,27,0,"https://fbref.com/en/players/fa449bba/Nicolas-Haas"
"11971","Liam Henderson_2023",2023,"Empoli","Serie A","Liam Henderson","SCO","MF","26",1996,11.2,13,10,6,5,2,4,21,19,17,10,2,8,10,23,10,0,"https://fbref.com/en/players/d7918b13/Liam-Henderson"
"11972","Ardian Ismajli_2023",2023,"Empoli","Serie A","Ardian Ismajli","ALB","DF","25",1996,23.3,40,32,25,15,0,18,24,75,6,47,31,16,27,67,120,0,"https://fbref.com/en/players/6b635f5c/Ardian-Ismajli"
"11973","Sam Lammers_2023",2023,"Empoli","Serie A","Sam Lammers","NED","FW","25",1997,9.8,20,10,5,9,6,7,11,63.6,4,4,1,3,3,23,8,0,"https://fbref.com/en/players/c283ddef/Sam-Lammers"
"11974","Sebastiano Luperto_2023",2023,"Empoli","Serie A","Sebastiano Luperto","ITA","DF","25",1996,34.8,33,18,24,8,1,9,20,45,11,54,42,12,43,76,163,1,"https://fbref.com/en/players/997fff07/Sebastiano-Luperto"
"11975","Răzvan Marin_2023",2023,"Empoli","Serie A","Răzvan Marin","ROU","MF","26",1996,28.2,44,22,22,21,1,19,40,47.5,21,29,11,18,14,58,33,0,"https://fbref.com/en/players/7fac99d4/Razvan-Marin"
"11976","Herculano Nabian_2023",2023,"Empoli","Serie A","Herculano Nabian","POR","MF","18",2004,0,0,0,0,0,0,0,0,NA,0,0,0,0,0,0,0,0,"https://fbref.com/en/players/c39babc1/Herculano-Nabian"
"11977","Fabiano Parisi_2023",2023,"Empoli","Serie A","Fabiano Parisi","ITA","DF","21",2000,31.4,65,35,37,21,7,30,72,41.7,42,51,16,35,41,106,91,0,"https://fbref.com/en/players/0967845b/Fabiano-Parisi"
"11978","Samuele Perisan_2023",2023,"Empoli","Serie A","Samuele Perisan","ITA","GK","24",1997,7,0,0,0,0,0,0,0,NA,0,0,0,0,0,0,2,0,"https://fbref.com/en/players/00a17eba/Samuele-Perisan"
"11979","Roberto Piccoli_2023",2023,"Empoli","Serie A","Roberto Piccoli","ITA","FW","21",2001,5.7,1,1,1,0,0,0,3,0,3,4,1,3,1,2,9,0,"https://fbref.com/en/players/1cadaf34/Roberto-Piccoli"
"11980","Marko Pjaca_2023",2023,"Empoli","Serie A","Marko Pjaca","CRO","MF,FW","27",1995,5.8,4,3,3,1,0,3,5,60,2,3,0,3,3,7,3,0,"https://fbref.com/en/players/2c38b327/Marko-Pjaca"
"11981","Martin Satriano_2023",2023,"Empoli","Serie A","Martin Satriano","URU","FW","21",2001,18.9,13,8,5,6,2,6,14,42.9,8,5,0,5,3,16,22,0,"https://fbref.com/en/players/86383d0e/Martin-Satriano"
"11982","Petar Stojanović_2023",2023,"Empoli","Serie A","Petar Stojanović","SVN","DF","26",1995,17,42,22,28,10,4,26,43,60.5,17,17,5,12,11,53,55,0,"https://fbref.com/en/players/13b44b02/Petar-Stojanovic"
"11983","Lorenzo Tonelli_2023",2023,"Empoli","Serie A","Lorenzo Tonelli","ITA","DF","32",1990,0.2,0,0,0,0,0,0,1,0,1,0,0,0,0,0,0,0,"https://fbref.com/en/players/8cc29864/Lorenzo-Tonelli"
"11984","Samir Ujkani_2023",2023,"Empoli","Serie A","Samir Ujkani","KVX","GK","34",1988,0.1,0,0,0,0,0,0,0,NA,0,0,0,0,0,0,0,0,"https://fbref.com/en/players/96640846/Samir-Ujkani"
"11985","Guglielmo Vicario_2023",2023,"Empoli","Serie A","Guglielmo Vicario","ITA","GK","25",1996,30.9,1,1,1,0,0,1,2,50,1,0,0,0,0,1,15,2,"https://fbref.com/en/players/77d6fd4d/Guglielmo-Vicario"
"11986","Emanuel Vignato_2023",2023,"Empoli","Serie A","Emanuel Vignato","ITA","MF,FW","21",2000,0.6,2,0,2,0,0,0,0,NA,0,0,0,0,0,2,1,0,"https://fbref.com/en/players/ec5dae45/Emanuel-Vignato"
"11987","Sebastian Walukiewicz_2023",2023,"Empoli","Serie A","Sebastian Walukiewicz","POL","DF","22",2000,6.7,9,6,7,2,0,4,6,66.7,2,10,9,1,7,16,30,0,"https://fbref.com/en/players/217875a4/Sebastian-Walukiewicz"
"11988","Keidi Bare_2023",2023,"Espanyol","La Liga","Keidi Bare","ALB","MF","24",1997,5.6,15,8,7,5,3,7,13,53.8,6,8,2,6,11,26,8,0,"https://fbref.com/en/players/03049c8c/Keidi-Bare"
"11989","Wassim Boullif_2023",2023,"Espanyol","La Liga","Wassim Boullif","ESP","DF","17",2005,1.6,3,1,3,0,0,2,3,66.7,1,5,4,1,0,3,3,0,"https://fbref.com/en/players/7f271d74/Wassim-Boullif"
"11990","Martin Braithwaite_2023",2023,"Espanyol","La Liga","Martin Braithwaite","DEN","FW,MF","31",1991,27.3,12,2,2,4,6,5,14,35.7,9,10,0,10,5,17,11,0,"https://fbref.com/en/players/fd771f95/Martin-Braithwaite"
"11991","Leandro Cabrera_2023",2023,"Espanyol","La Liga","Leandro Cabrera","URU","DF","31",1991,29.7,46,24,34,12,0,28,43,65.1,15,37,23,14,43,89,114,2,"https://fbref.com/en/players/69cbc8b6/Leandro-Cabrera"
"11992","Fernando Calero_2023",2023,"Espanyol","La Liga","Fernando Calero","ESP","DF,MF","26",1995,17.9,46,29,27,15,4,21,34,61.8,13,31,13,18,13,59,52,0,"https://fbref.com/en/players/41b3069f/Fernando-Calero"
"11993","José Carlos Lazo_2023",2023,"Espanyol","La Liga","José Carlos Lazo","ESP","MF,FW","26",1996,1.8,5,3,2,2,1,3,3,100,0,2,0,2,3,8,5,0,"https://fbref.com/en/players/5b93209a/Jose-Carlos-Lazo"
"11994","Sergi Darder_2023",2023,"Espanyol","La Liga","Sergi Darder","ESP","MF","28",1993,36.9,69,38,12,43,14,29,73,39.7,44,34,2,32,24,93,23,0,"https://fbref.com/en/players/070a3904/Sergi-Darder"
"11995","Adri Embarba_2023",2023,"Espanyol","La Liga","Adri Embarba","ESP","FW","30",1992,0.4,1,0,0,1,0,1,1,100,0,1,0,1,0,1,0,0,"https://fbref.com/en/players/db8f0eba/Adri-Embarba"
"11996","Edu Expósito_2023",2023,"Espanyol","La Liga","Edu Expósito","ESP","MF","25",1996,12.9,34,20,16,15,3,13,23,56.5,10,7,0,7,12,46,20,0,"https://fbref.com/en/players/283c7121/Edu-Exposito"
"11997","Álvaro Fernández_2023",2023,"Espanyol","La Liga","Álvaro Fernández","ESP","GK","24",1998,11,0,0,0,0,0,0,0,NA,0,0,0,0,0,0,7,2,"https://fbref.com/en/players/f127d782/Alvaro-Fernandez"
"11998","Joan García_2023",2023,"Espanyol","La Liga","Joan García","ESP","GK","21",2001,1,0,0,0,0,0,0,0,NA,0,0,0,0,0,0,0,0,"https://fbref.com/en/players/87b498b0/Joan-Garcia"
"11999","Óscar Gil_2023",2023,"Espanyol","La Liga","Óscar Gil","ESP","DF","25",1997,28.4,63,37,38,16,9,32,61,52.5,29,51,18,33,31,94,55,1,"https://fbref.com/en/players/6652cf96/Oscar-Gil"
"12000","Dani Gómez_2023",2023,"Espanyol","La Liga","Dani Gómez","ESP","MF,FW","24",1998,1,2,1,1,1,0,1,2,50,1,0,0,0,1,3,0,0,"https://fbref.com/en/players/0e5ddc7c/Dani-Gomez"
"12001","Sergi Gómez_2023",2023,"Espanyol","La Liga","Sergi Gómez","ESP","DF","30",1992,26,29,16,20,9,0,18,22,81.8,4,33,19,14,27,56,125,1,"https://fbref.com/en/players/bc6f5f06/Sergi-Gomez"
"12002","José Gragera_2023",2023,"Espanyol","La Liga","José Gragera","ESP","MF,DF","21",2000,5.1,19,9,11,6,2,6,11,54.5,5,10,4,6,7,26,18,0,"https://fbref.com/en/players/ee45d138/Jose-Gragera"
"12003","Omar El Hilali_2023",2023,"Espanyol","La Liga","Omar El Hilali","MAR","DF,MF","18",2003,1,3,2,3,0,0,1,2,50,1,1,0,1,1,4,6,0,"https://fbref.com/en/players/139560df/Omar-El-Hilali"
"12004","Joselu_2023",2023,"Espanyol","La Liga","Joselu","ESP","FW","32",1990,33.2,13,11,3,4,6,4,17,23.5,13,25,4,21,8,21,43,0,"https://fbref.com/en/players/6265208f/Joselu"
"12005","Luca Koleosho_2023",2023,"Espanyol","La Liga","Luca Koleosho","ITA","FW,DF","17",2004,0.7,2,2,0,0,2,1,2,50,1,1,0,1,0,2,0,0,"https://fbref.com/en/players/fc076f78/Luca-Koleosho"
"12006","Benjamin Lecomte_2023",2023,"Espanyol","La Liga","Benjamin Lecomte","FRA","GK","31",1991,10,0,0,0,0,0,0,0,NA,0,0,0,0,0,0,3,2,"https://fbref.com/en/players/2fa2a875/Benjamin-Lecomte"
"12007","Pol Lozano_2023",2023,"Espanyol","La Liga","Pol Lozano","ESP","MF","22",1999,0.2,0,0,0,0,0,0,0,NA,0,1,0,1,0,0,1,0,"https://fbref.com/en/players/ea610f00/Pol-Lozano"
"12008","Roger Martínez_2023",2023,"Espanyol","La Liga","Roger Martínez","ESP","DF","18",2004,0.1,0,0,0,0,0,0,0,NA,0,0,0,0,0,0,0,0,"https://fbref.com/en/players/937c6ae6/Roger-Martinez"
"12009","César Montes_2023",2023,"Espanyol","La Liga","César Montes","MEX","DF","25",1997,17.7,17,9,10,7,0,10,18,55.6,8,19,12,7,14,31,101,0,"https://fbref.com/en/players/28e957d7/Cesar-Montes"
"12010","Brian Oliván_2023",2023,"Espanyol","La Liga","Brian Oliván","ESP","DF","28",1994,26.7,47,27,30,12,5,17,26,65.4,9,26,6,20,22,69,67,0,"https://fbref.com/en/players/a3e4bf46/Brian-Olivan"
"12011","Fernando Pacheco_2023",2023,"Espanyol","La Liga","Fernando Pacheco","ESP","GK","30",1992,16,0,0,0,0,0,0,1,0,1,0,0,0,1,1,11,0,"https://fbref.com/en/players/97852360/Fernando-Pacheco"
"12012","Pedrosa_2023",2023,"Espanyol","La Liga","Pedrosa","ESP","DF,MF","24",1998,2.5,5,1,5,0,0,4,7,57.1,3,1,1,0,5,10,3,0,"https://fbref.com/en/players/112521d1/Pedrosa"
"12013","Ronaël Pierre-Gabriel_2023",2023,"Espanyol","La Liga","Ronaël Pierre-Gabriel","FRA","DF","24",1998,2.6,17,9,12,4,1,5,11,45.5,6,5,2,3,9,26,11,0,"https://fbref.com/en/players/64ba07c0/Ronael-Pierre-Gabriel"
"12014","Javi Puado_2023",2023,"Espanyol","La Liga","Javi Puado","ESP","FW,MF","24",1998,26,20,11,12,5,3,12,28,42.9,16,12,2,10,10,30,14,0,"https://fbref.com/en/players/2683eda7/Javi-Puado"
"12015","Nico Ribaudo_2023",2023,"Espanyol","La Liga","Nico Ribaudo","ESP","MF,FW","21",2001,13.9,18,13,5,9,4,11,30,36.7,19,19,1,18,5,23,1,0,"https://fbref.com/en/players/ce8039aa/Nico-Ribaudo"
"12016","Rubén_2023",2023,"Espanyol","La Liga","Rubén","ESP","DF,MF","21",2001,9.9,30,15,18,9,3,20,29,69,9,14,4,10,18,48,18,0,"https://fbref.com/en/players/35d4f151/Ruben"
"12017","Vinicius Souza_2023",2023,"Espanyol","La Liga","Vinicius Souza","BRA","MF","23",1999,27,99,66,41,45,13,33,59,55.9,26,31,14,17,48,147,50,1,"https://fbref.com/en/players/6a8a7af8/Vinicius-Souza"
"12018","Denis Suárez_2023",2023,"Espanyol","La Liga","Denis Suárez","ESP","MF,FW","28",1994,10.5,26,20,12,12,2,13,45,28.9,32,11,1,10,5,31,4,0,"https://fbref.com/en/players/12c50af5/Denis-Suarez"
"12019","Nabil Touaizi_2023",2023,"Espanyol","La Liga","Nabil Touaizi","MAR","MF","21",2001,0,0,0,0,0,0,0,0,NA,0,0,0,0,0,0,0,0,"https://fbref.com/en/players/e96b2583/Nabil-Touaizi"
"12020","Aleix Vidal_2023",2023,"Espanyol","La Liga","Aleix Vidal","ESP","MF,FW","32",1989,11.4,11,5,6,3,2,4,22,18.2,18,21,2,19,15,26,14,0,"https://fbref.com/en/players/04965583/Aleix-Vidal"
"12021","Dele Alli_2023",2023,"Everton","Premier League","Dele Alli","ENG","MF","26",1996,0.4,0,0,0,0,0,0,0,NA,0,0,0,0,0,0,0,0,"https://fbref.com/en/players/cea4ee8f/Dele-Alli"
"12022","Asmir Begović_2023",2023,"Everton","Premier League","Asmir Begović","BIH","GK","35",1987,1,0,0,0,0,0,0,0,NA,0,0,0,0,0,0,1,0,"https://fbref.com/en/players/7b4de647/Asmir-Begovic"
"12023","Dominic Calvert-Lewin_2023",2023,"Everton","Premier League","Dominic Calvert-Lewin","ENG","FW","25",1997,12.9,4,2,1,0,3,1,5,20,4,5,1,4,3,7,18,0,"https://fbref.com/en/players/59e6e5bf/Dominic-Calvert-Lewin"
"12024","Thomas Cannon_2023",2023,"Everton","Premier League","Thomas Cannon","IRL","FW","19",2002,0.3,0,0,0,0,0,0,0,NA,0,0,0,0,0,0,0,0,"https://fbref.com/en/players/4506aec5/Thomas-Cannon"
"12025","Conor Coady_2023",2023,"Everton","Premier League","Conor Coady","ENG","DF","29",1993,23.3,14,9,8,6,0,7,15,46.7,8,21,17,4,14,28,88,3,"https://fbref.com/en/players/2928dca2/Conor-Coady"
"12026","Séamus Coleman_2023",2023,"Everton","Premier League","Séamus Coleman","IRL","DF","33",1988,18.4,35,26,21,10,4,19,29,65.5,10,14,7,7,22,57,58,2,"https://fbref.com/en/players/0420d84f/Seamus-Coleman"
"12027","Tom Davies_2023",2023,"Everton","Premier League","Tom Davies","ENG","MF","24",1998,6,15,9,5,9,1,7,14,50,7,10,1,9,4,19,7,1,"https://fbref.com/en/players/9228b07c/Tom-Davies"
"12028","Abdoulaye Doucouré_2023",2023,"Everton","Premier League","Abdoulaye Doucouré","MLI","MF","29",1993,17,31,20,9,15,7,12,37,32.4,25,26,3,23,13,44,11,0,"https://fbref.com/en/players/02b29014/Abdoulaye-Doucoure"
"12029","Idrissa Gana Gueye_2023",2023,"Everton","Premier League","Idrissa Gana Gueye","SEN","MF","32",1989,28.6,97,57,49,35,13,31,60,51.7,29,50,12,38,56,153,34,3,"https://fbref.com/en/players/72c812f3/Idrissa-Gana-Gueye"
"12030","James Garner_2023",2023,"Everton","Premier League","James Garner","ENG","MF,DF","21",2001,8.9,16,13,4,8,4,9,19,47.4,10,9,1,8,12,28,13,0,"https://fbref.com/en/players/4e015693/James-Garner"
"12031","Ben Godfrey_2023",2023,"Everton","Premier League","Ben Godfrey","ENG","DF","24",1998,8.9,20,11,13,5,2,11,29,37.9,18,12,6,6,8,28,33,1,"https://fbref.com/en/players/9f7c837d/Ben-Godfrey"
"12032","Anthony Gordon_2023",2023,"Everton","Premier League","Anthony Gordon","ENG","FW","21",2001,12.2,34,22,17,10,7,8,23,34.8,15,19,0,19,4,38,11,0,"https://fbref.com/en/players/2bd83368/Anthony-Gordon"
"12033","Demarai Gray_2023",2023,"Everton","Premier League","Demarai Gray","JAM","FW,MF","26",1996,27.9,33,24,9,14,10,17,31,54.8,14,23,3,20,13,46,18,0,"https://fbref.com/en/players/4468ec10/Demarai-Gray"
"12034","Mason Holgate_2023",2023,"Everton","Premier League","Mason Holgate","ENG","DF","25",1996,5.6,11,7,8,3,0,3,11,27.3,8,7,3,4,7,18,28,0,"https://fbref.com/en/players/d0042ab9/Mason-Holgate"
"12035","Alex Iwobi_2023",2023,"Everton","Premier League","Alex Iwobi","NGA","MF,FW","26",1996,37.5,69,37,37,28,4,33,65,50.8,32,41,2,39,25,94,29,0,"https://fbref.com/en/players/6ca5ec4b/Alex-Iwobi"
"12036","Michael Keane_2023",2023,"Everton","Premier League","Michael Keane","ENG","DF","29",1993,10.9,7,4,5,2,0,5,8,62.5,3,12,7,5,14,21,55,1,"https://fbref.com/en/players/c5b7c315/Michael-Keane"
"12037","Neal Maupay_2023",2023,"Everton","Premier League","Neal Maupay","FRA","FW","25",1996,12.4,11,5,3,4,4,2,4,50,2,8,0,8,5,16,0,0,"https://fbref.com/en/players/4bcf39f6/Neal-Maupay"
"12038","Dwight McNeil_2023",2023,"Everton","Premier League","Dwight McNeil","ENG","FW,MF","22",1999,27.8,64,41,35,14,15,27,62,43.5,35,46,7,39,31,95,41,0,"https://fbref.com/en/players/fc15fb84/Dwight-McNeil"
"12039","Yerry Mina_2023",2023,"Everton","Premier League","Yerry Mina","COL","DF","27",1994,6.6,15,8,9,6,0,9,11,81.8,2,7,4,3,6,21,28,0,"https://fbref.com/en/players/6d5701f2/Yerry-Mina"
"12040","Vitaliy Mykolenko_2023",2023,"Everton","Premier League","Vitaliy Mykolenko","UKR","DF","23",1999,29.5,58,34,36,19,3,28,51,54.9,23,50,16,34,46,104,99,0,"https://fbref.com/en/players/30d4a2e5/Vitaliy-Mykolenko"
"12041","Amadou Onana_2023",2023,"Everton","Premier League","Amadou Onana","BEL","MF","20",2001,27.6,72,43,24,42,6,30,42,71.4,12,25,6,19,37,109,39,0,"https://fbref.com/en/players/828657ff/Amadou-Onana"
"12042","Nathan Patterson_2023",2023,"Everton","Premier League","Nathan Patterson","SCO","DF,MF","20",2001,14.2,49,24,32,13,4,29,53,54.7,24,24,4,20,15,64,45,0,"https://fbref.com/en/players/230f0471/Nathan-Patterson"
"12043","Jordan Pickford_2023",2023,"Everton","Premier League","Jordan Pickford","ENG","GK","28",1994,37,0,0,0,0,0,0,1,0,1,0,0,0,4,4,15,3,"https://fbref.com/en/players/4806ec67/Jordan-Pickford"
"12044","Isaac Price_2023",2023,"Everton","Premier League","Isaac Price","NIR","MF","18",2003,0.4,0,0,0,0,0,0,1,0,1,1,1,0,0,0,0,0,"https://fbref.com/en/players/b9403c99/Isaac-Price"
"12045","Salomón Rondón_2023",2023,"Everton","Premier League","Salomón Rondón","VEN","FW","32",1989,1.2,0,0,0,0,0,0,0,NA,0,1,1,0,0,0,0,0,"https://fbref.com/en/players/b318a643/Salomon-Rondon"
"12046","Ellis Simms_2023",2023,"Everton","Premier League","Ellis Simms","ENG","FW","21",2001,2.5,0,0,0,0,0,0,0,NA,0,0,0,0,0,0,1,0,"https://fbref.com/en/players/26d3b5be/Ellis-Simms"
"12047","James Tarkowski_2023",2023,"Everton","Premier League","James Tarkowski","ENG","DF","29",1992,38,51,26,36,13,2,20,38,52.6,18,99,78,21,51,102,201,3,"https://fbref.com/en/players/15ea812b/James-Tarkowski"
"12048","Rúben Vinagre_2023",2023,"Everton","Premier League","Rúben Vinagre","POR","DF,MF","23",1999,0.3,2,2,1,1,0,1,2,50,1,0,0,0,0,2,1,0,"https://fbref.com/en/players/b937e490/Ruben-Vinagre"
"12049","Sofyan Amrabat_2023",2023,"Fiorentina","Serie A","Sofyan Amrabat","MAR","MF","25",1996,22.2,39,24,15,17,7,16,29,55.2,13,23,5,18,21,60,18,2,"https://fbref.com/en/players/5a2cb25d/Sofyan-Amrabat"
"12050","Arthur_2023",2023,"Fiorentina","Serie A","Arthur","BRA","FW","24",1998,15.9,9,2,1,4,4,4,8,50,4,10,1,9,1,10,12,0,"https://fbref.com/en/players/a820e429/Arthur"
"12051","Antonín Barák_2023",2023,"Fiorentina","Serie A","Antonín Barák","CZE","MF","27",1994,20,21,9,5,7,9,6,16,37.5,10,16,2,14,3,24,13,0,"https://fbref.com/en/players/01efac19/Antonin-Barak"
"12052","Marco Benassi_2023",2023,"Fiorentina","Serie A","Marco Benassi","ITA","DF","27",1994,1,3,3,2,0,1,3,4,75,1,0,0,0,1,4,1,0,"https://fbref.com/en/players/0000acda/Marco-Benassi"
"12053","Alessandro Bianco_2023",2023,"Fiorentina","Serie A","Alessandro Bianco","ITA","MF","19",2002,1.7,5,2,2,3,0,2,3,66.7,1,1,0,1,0,5,0,0,"https://fbref.com/en/players/d65cf468/Alessandro-Bianco"
"12054","Cristiano Biraghi_2023",2023,"Fiorentina","Serie A","Cristiano Biraghi","ITA","DF","29",1992,28.3,65,38,29,29,7,32,65,49.2,33,32,7,25,14,79,42,1,"https://fbref.com/en/players/9e1577aa/Cristiano-Biraghi"
"12055","Giacomo Bonaventura_2023",2023,"Fiorentina","Serie A","Giacomo Bonaventura","ITA","MF","32",1989,21.2,35,23,14,15,6,24,37,64.9,13,14,0,14,16,51,5,1,"https://fbref.com/en/players/d995ed27/Giacomo-Bonaventura"
"12056","Josip Brekalo_2023",2023,"Fiorentina","Serie A","Josip Brekalo","CRO","FW,MF","24",1998,2.5,2,1,0,1,1,1,4,25,3,1,0,1,1,3,1,0,"https://fbref.com/en/players/d4a2533d/Josip-Brekalo"
"12057","Gaetano Castrovilli_2023",2023,"Fiorentina","Serie A","Gaetano Castrovilli","ITA","MF","25",1997,8,10,8,1,7,2,2,9,22.2,7,5,1,4,8,18,5,0,"https://fbref.com/en/players/0728bebe/Gaetano-Castrovilli"
"12058","Michele Cerofolini_2023",2023,"Fiorentina","Serie A","Michele Cerofolini","ITA","GK","23",1999,5,0,0,0,0,0,0,0,NA,0,0,0,0,1,1,2,0,"https://fbref.com/en/players/efdeaff3/Michele-Cerofolini"
"12059","Dodô_2023",2023,"Fiorentina","Serie A","Dodô","BRA","DF","23",1998,25.9,40,22,20,14,6,22,46,47.8,24,26,2,24,25,65,37,0,"https://fbref.com/en/players/b5f7d10b/Dodo"
"12060","Alfred Duncan_2023",2023,"Fiorentina","Serie A","Alfred Duncan","GHA","MF","29",1993,12.3,18,10,0,17,1,10,21,47.6,11,9,0,9,8,26,6,0,"https://fbref.com/en/players/528492ea/Alfred-Duncan"
"12061","Pierluigi Gollini_2023",2023,"Fiorentina","Serie A","Pierluigi Gollini","ITA","GK","27",1995,3,1,0,1,0,0,1,1,100,0,0,0,0,0,1,2,0,"https://fbref.com/en/players/f0f7f62f/Pierluigi-Gollini"
"12062","Nicolás González_2023",2023,"Fiorentina","Serie A","Nicolás González","ARG","FW,MF","24",1998,15,17,10,3,10,4,5,16,31.3,11,14,0,14,4,21,6,0,"https://fbref.com/en/players/2374aaca/Nicolas-Gonzalez"
"12063","Igor_2023",2023,"Fiorentina","Serie A","Igor","BRA","DF","24",1998,22.9,43,29,21,18,4,20,27,74.1,7,33,14,19,25,68,56,2,"https://fbref.com/en/players/a4e85758/Igor"
"12064","Jonathan Ikone_2023",2023,"Fiorentina","Serie A","Jonathan Ikone","FRA","FW","24",1998,22.3,16,8,5,6,5,5,14,35.7,9,18,1,17,4,20,3,0,"https://fbref.com/en/players/42eaa028/Jonathan-Ikone"
"12065","Luka Jović_2023",2023,"Fiorentina","Serie A","Luka Jović","SRB","FW,MF","24",1997,17,6,3,1,4,1,2,8,25,6,7,2,5,2,8,10,0,"https://fbref.com/en/players/4d8cd038/Luka-Jovic"
"12066","Christian Kouamé_2023",2023,"Fiorentina","Serie A","Christian Kouamé","CIV","FW","24",1997,20.7,27,18,8,10,9,7,14,50,7,15,3,12,12,39,8,0,"https://fbref.com/en/players/58e933d2/Christian-Kouame"
"12067","Youssef Maleh_2023",2023,"Fiorentina","Serie A","Youssef Maleh","MAR","MF","23",1998,3.3,3,1,0,3,0,0,4,0,4,5,0,5,1,4,3,0,"https://fbref.com/en/players/4c8845f7/Youssef-Maleh"
"12068","Rolando Mandragora_2023",2023,"Fiorentina","Serie A","Rolando Mandragora","ITA","MF","25",1997,21.7,42,24,12,22,8,23,52,44.2,29,25,3,22,16,58,21,0,"https://fbref.com/en/players/c7259b83/Rolando-Mandragora"
"12069","Lucas Martínez Quarta_2023",2023,"Fiorentina","Serie A","Lucas Martínez Quarta","ARG","DF","26",1996,24.1,80,48,44,32,4,42,61,68.9,19,41,19,22,48,128,78,1,"https://fbref.com/en/players/3ec3c1c9/Lucas-Martinez-Quarta"
"12070","Nikola Milenković_2023",2023,"Fiorentina","Serie A","Nikola Milenković","SRB","DF","24",1997,23.7,40,25,20,17,3,18,27,66.7,9,27,14,13,22,62,72,0,"https://fbref.com/en/players/bee704fc/Nikola-Milenkovic"
"12071","Luca Ranieri_2023",2023,"Fiorentina","Serie A","Luca Ranieri","ITA","DF","23",1999,5.6,9,4,6,3,0,6,9,66.7,3,5,3,2,11,20,15,1,"https://fbref.com/en/players/8c63fae5/Luca-Ranieri"
"12072","Riccardo Saponara_2023",2023,"Fiorentina","Serie A","Riccardo Saponara","ITA","FW","30",1991,13.4,10,5,3,6,1,5,9,55.6,4,7,1,6,5,15,9,1,"https://fbref.com/en/players/3bb7af3b/Riccardo-Saponara"
"12073","Salvatore Sirigu_2023",2023,"Fiorentina","Serie A","Salvatore Sirigu","ITA","GK","35",1987,1,0,0,0,0,0,0,0,NA,0,0,0,0,0,0,1,0,"https://fbref.com/en/players/10dc46f0/Salvatore-Sirigu"
"12074","Riccardo Sottil_2023",2023,"Fiorentina","Serie A","Riccardo Sottil","ITA","FW","23",1999,9.3,4,3,2,0,2,2,5,40,3,2,0,2,0,4,0,0,"https://fbref.com/en/players/94816803/Riccardo-Sottil"
"12075","Pietro Terracciano_2023",2023,"Fiorentina","Serie A","Pietro Terracciano","ITA","GK","32",1990,29,2,1,2,0,0,2,3,66.7,1,0,0,0,1,3,14,0,"https://fbref.com/en/players/e1b0a70d/Pietro-Terracciano"
"12076","Aleksa Terzić_2023",2023,"Fiorentina","Serie A","Aleksa Terzić","SRB","DF","22",1999,10.4,16,9,9,4,3,11,21,52.4,10,13,4,9,5,21,16,0,"https://fbref.com/en/players/3ef0a2d7/Aleksa-Terzic"
"12077","Lorenzo Venuti_2023",2023,"Fiorentina","Serie A","Lorenzo Venuti","ITA","DF","27",1995,10.3,18,7,6,11,1,11,18,61.1,7,7,2,5,5,23,17,2,"https://fbref.com/en/players/983ff2c7/Lorenzo-Venuti"
"12078","Szymon Żurkowski_2023",2023,"Fiorentina","Serie A","Szymon Żurkowski","POL","MF","24",1997,0.4,0,0,0,0,0,0,0,NA,0,0,0,0,0,0,0,0,"https://fbref.com/en/players/4e1d5e59/Szymon-Zurkowski"
"12079","Ritsu Doan_2023",2023,"Freiburg","Bundesliga","Ritsu Doan","JPN","MF,FW","24",1998,26.9,61,29,19,29,13,25,54,46.3,29,40,1,39,14,75,12,0,"https://fbref.com/en/players/d01bbb6f/Ritsu-Doan"
"12080","Maximilian Eggestein_2023",2023,"Freiburg","Bundesliga","Maximilian Eggestein","GER","MF","25",1996,27.2,51,29,21,24,6,17,35,48.6,18,37,8,29,36,87,27,0,"https://fbref.com/en/players/beb882a8/Maximilian-Eggestein"
"12081","Kimberly Ezekwem_2023",2023,"Freiburg","Bundesliga","Kimberly Ezekwem","GER","DF","21",2001,0.1,0,0,0,0,0,0,0,NA,0,1,0,1,0,0,0,0,"https://fbref.com/en/players/56e6a1c9/Kimberly-Ezekwem"
"12082","Mark Flekken_2023",2023,"Freiburg","Bundesliga","Mark Flekken","NED","GK","29",1993,34,0,0,0,0,0,0,1,0,1,1,0,1,0,0,9,5,"https://fbref.com/en/players/a92ab7be/Mark-Flekken"
"12083","Matthias Ginter_2023",2023,"Freiburg","Bundesliga","Matthias Ginter","GER","DF","28",1994,34,43,20,29,12,2,26,40,65,14,40,24,16,35,78,153,3,"https://fbref.com/en/players/f521b80a/Matthias-Ginter"
"12084","Michael Gregoritsch_2023",2023,"Freiburg","Bundesliga","Michael Gregoritsch","AUT","FW","28",1994,23.9,19,12,6,9,4,3,21,14.3,18,23,4,19,5,24,10,0,"https://fbref.com/en/players/8e235926/Michael-Gregoritsch"
"12085","Vincenzo Grifo_2023",2023,"Freiburg","Bundesliga","Vincenzo Grifo","ITA","MF,FW","29",1993,26.8,29,16,6,15,8,13,31,41.9,18,18,1,17,19,48,19,0,"https://fbref.com/en/players/54e4866f/Vincenzo-Grifo"
"12086","Manuel Gulde_2023",2023,"Freiburg","Bundesliga","Manuel Gulde","GER","DF","31",1991,7.1,14,8,10,4,0,2,4,50,2,5,1,4,19,33,25,0,"https://fbref.com/en/players/25ab9c9c/Manuel-Gulde"
"12087","Christian Günter_2023",2023,"Freiburg","Bundesliga","Christian Günter","GER","DF,MF","29",1993,30.5,29,21,18,9,2,13,43,30.2,30,22,4,18,16,45,41,0,"https://fbref.com/en/players/8593f88c/Christian-Gunter"
"12088","Nicolas Höfler_2023",2023,"Freiburg","Bundesliga","Nicolas Höfler","GER","MF","32",1990,31.3,66,35,28,35,3,27,61,44.3,34,40,13,27,58,124,49,0,"https://fbref.com/en/players/5d8e331f/Nicolas-Hofler"
"12089","Lucas Höler_2023",2023,"Freiburg","Bundesliga","Lucas Höler","GER","FW,MF","28",1994,16.7,19,14,5,7,7,6,22,27.3,16,22,5,17,10,29,17,0,"https://fbref.com/en/players/ca618d23/Lucas-Holer"
"12090","Yannik Keitel_2023",2023,"Freiburg","Bundesliga","Yannik Keitel","GER","MF","22",2000,7.6,11,7,4,6,1,3,5,60,2,6,3,3,13,24,8,0,"https://fbref.com/en/players/d2c580ce/Yannik-Keitel"
"12091","Lukas Kübler_2023",2023,"Freiburg","Bundesliga","Lukas Kübler","GER","DF","29",1992,18.2,37,25,24,9,4,18,30,60,12,25,11,14,29,66,50,0,"https://fbref.com/en/players/2a29eb9b/Lukas-Kubler"
"12092","Daniel Kyereh_2023",2023,"Freiburg","Bundesliga","Daniel Kyereh","GHA","MF,FW","26",1996,6.2,6,4,2,4,0,3,6,50,3,4,0,4,2,8,6,0,"https://fbref.com/en/players/2770726a/Daniel-Kyereh"
"12093","Philipp Lienhart_2023",2023,"Freiburg","Bundesliga","Philipp Lienhart","AUT","DF","26",1996,27.8,29,18,19,10,0,13,27,48.1,14,29,15,14,35,64,97,0,"https://fbref.com/en/players/302527b2/Philipp-Lienhart"
"12094","Nils Petersen_2023",2023,"Freiburg","Bundesliga","Nils Petersen","GER","FW","33",1988,3.1,6,4,0,3,3,2,5,40,3,11,2,9,1,7,6,0,"https://fbref.com/en/players/f93e6e94/Nils-Petersen"
"12095","Merlin Röhl_2023",2023,"Freiburg","Bundesliga","Merlin Röhl","GER","MF,FW","20",2002,0.6,1,0,1,0,0,0,0,NA,0,0,0,0,0,1,1,0,"https://fbref.com/en/players/1f2c7b55/Merlin-Rohl"
"12096","Roland Sallai_2023",2023,"Freiburg","Bundesliga","Roland Sallai","HUN","MF,FW","25",1997,11.1,11,8,4,3,4,4,10,40,6,7,1,6,2,13,11,0,"https://fbref.com/en/players/bf075f6b/Roland-Sallai"
"12097","Kevin Schade_2023",2023,"Freiburg","Bundesliga","Kevin Schade","GER","FW,MF","20",2001,2,6,4,3,2,1,3,5,60,2,0,0,0,0,6,2,0,"https://fbref.com/en/players/52afb588/Kevin-Schade"
"12098","Keven Schlotterbeck_2023",2023,"Freiburg","Bundesliga","Keven Schlotterbeck","GER","DF","25",1997,0.2,0,0,0,0,0,0,0,NA,0,1,1,0,2,2,2,0,"https://fbref.com/en/players/f6bdc830/Keven-Schlotterbeck"
"12099","Jonathan Schmid_2023",2023,"Freiburg","Bundesliga","Jonathan Schmid","FRA","DF","32",1990,0.5,1,1,1,0,0,0,0,NA,0,1,0,1,1,2,1,1,"https://fbref.com/en/players/088ca1bd/Jonathan-Schmid"
"12100","Kenneth Schmidt_2023",2023,"Freiburg","Bundesliga","Kenneth Schmidt","GER","DF","20",2002,2.8,6,3,4,2,0,5,6,83.3,1,4,2,2,0,6,2,0,"https://fbref.com/en/players/7d31f1cb/Kenneth-Schmidt"
"12101","Kiliann Sildillia_2023",2023,"Freiburg","Bundesliga","Kiliann Sildillia","FRA","DF,MF","20",2002,22,33,20,10,19,4,18,30,60,12,24,9,15,21,54,47,1,"https://fbref.com/en/players/313254a3/Kiliann-Sildillia"
"12102","Hugo Siquet_2023",2023,"Freiburg","Bundesliga","Hugo Siquet","BEL","DF","20",2002,0.2,2,2,2,0,0,2,2,100,0,1,0,1,0,2,0,0,"https://fbref.com/en/players/c6cf860f/Hugo-Siquet"
"12103","Robert Wagner_2023",2023,"Freiburg","Bundesliga","Robert Wagner","GER","MF","19",2003,0.4,0,0,0,0,0,0,0,NA,0,2,0,2,0,0,2,0,"https://fbref.com/en/players/e3d3fbeb/Robert-Wagner"
"12104","Noah Weißhaupt_2023",2023,"Freiburg","Bundesliga","Noah Weißhaupt","GER","MF,DF","20",2001,4.7,11,6,3,7,1,2,7,28.6,5,4,0,4,6,17,8,0,"https://fbref.com/en/players/dd676a97/Noah-Weisshaupt"
"12105","Jeong Woo-yeong_2023",2023,"Freiburg","Bundesliga","Jeong Woo-yeong","KOR","MF,FW","22",1999,7.3,7,3,4,2,1,2,5,40,3,7,1,6,1,8,7,0,"https://fbref.com/en/players/6190474d/Jeong-Woo-yeong"
"12106","Tosin Adarabioyo_2023",2023,"Fulham","Premier League","Tosin Adarabioyo","ENG","DF","24",1997,23.2,30,13,22,6,2,16,23,69.6,7,20,15,5,26,56,140,1,"https://fbref.com/en/players/c81d773d/Tosin-Adarabioyo"
"12107","Tom Cairney_2023",2023,"Fulham","Premier League","Tom Cairney","SCO","MF","31",1991,11,17,6,4,8,5,7,10,70,3,18,3,15,5,22,3,0,"https://fbref.com/en/players/a8748947/Tom-Cairney"
"12108","Nathaniel Chalobah_2023",2023,"Fulham","Premier League","Nathaniel Chalobah","ENG","MF","27",1994,0.1,1,1,1,0,0,1,1,100,0,0,0,0,0,1,2,0,"https://fbref.com/en/players/422862ea/Nathaniel-Chalobah"
"12109","Issa Diop_2023",2023,"Fulham","Premier League","Issa Diop","FRA","DF","25",1997,22.4,28,19,18,9,1,17,32,53.1,15,24,17,7,35,63,86,0,"https://fbref.com/en/players/a712ca2b/Issa-Diop"
"12110","Shane Duffy_2023",2023,"Fulham","Premier League","Shane Duffy","IRL","DF,FW","30",1992,0.2,0,0,0,0,0,0,0,NA,0,0,0,0,0,0,0,1,"https://fbref.com/en/players/7314bba4/Shane-Duffy"
"12111","Tyrese Francois_2023",2023,"Fulham","Premier League","Tyrese Francois","AUS","FW","22",2000,0,0,0,0,0,0,0,0,NA,0,0,0,0,0,0,1,0,"https://fbref.com/en/players/6722d4f0/Tyrese-Francois"
"12112","Luke Harris_2023",2023,"Fulham","Premier League","Luke Harris","WAL","MF,FW","17",2005,0.1,0,0,0,0,0,0,0,NA,0,0,0,0,0,0,0,0,"https://fbref.com/en/players/8c3078cd/Luke-Harris"
"12113","Daniel James_2023",2023,"Fulham","Premier League","Daniel James","WAL","FW","24",1997,6.9,9,5,4,4,1,4,8,50,4,5,1,4,1,10,5,0,"https://fbref.com/en/players/c931d9f9/Daniel-James"
"12114","Neeskens Kebano_2023",2023,"Fulham","Premier League","Neeskens Kebano","COD","FW","30",1992,8.5,17,9,8,6,3,9,17,52.9,8,14,0,14,1,18,8,0,"https://fbref.com/en/players/18b999f4/Neeskens-Kebano"
"12115","Layvin Kurzawa_2023",2023,"Fulham","Premier League","Layvin Kurzawa","FRA","DF","29",1992,1.5,3,2,1,1,1,3,3,100,0,1,1,0,2,5,4,0,"https://fbref.com/en/players/41e7ef1c/Layvin-Kurzawa"
"12116","Bernd Leno_2023",2023,"Fulham","Premier League","Bernd Leno","GER","GK","30",1992,36,0,0,0,0,0,0,2,0,2,0,0,0,0,0,18,0,"https://fbref.com/en/players/2628fd2b/Bernd-Leno"
"12117","Saša Lukić_2023",2023,"Fulham","Premier League","Saša Lukić","SRB","MF","25",1996,4.6,8,3,1,4,3,3,7,42.9,4,6,2,4,5,13,3,0,"https://fbref.com/en/players/c6e8cf1f/Sasa-Lukic"
"12118","Kevin Mbabu_2023",2023,"Fulham","Premier League","Kevin Mbabu","SUI","DF,FW","27",1995,1.6,3,2,2,1,0,1,3,33.3,2,2,0,2,3,6,3,0,"https://fbref.com/en/players/493924a7/Kevin-Mbabu"
"12119","Aleksandar Mitrović_2023",2023,"Fulham","Premier League","Aleksandar Mitrović","SRB","FW","27",1994,22.3,14,7,8,4,2,5,12,41.7,7,22,5,17,3,17,20,1,"https://fbref.com/en/players/3925dbd6/Aleksandar-Mitrovic"
"12120","Josh Onomah_2023",2023,"Fulham","Premier League","Josh Onomah","ENG","MF","25",1997,0.2,1,0,1,0,0,0,0,NA,0,1,0,1,0,1,0,0,"https://fbref.com/en/players/6612cd8c/Josh-Onomah"
"12121","João Palhinha_2023",2023,"Fulham","Premier League","João Palhinha","POR","MF","27",1995,34.5,147,83,58,65,24,71,134,53,63,48,5,43,46,193,61,2,"https://fbref.com/en/players/a78ff07f/Joao-Palhinha"
"12122","Andreas Pereira_2023",2023,"Fulham","Premier League","Andreas Pereira","BRA","MF","26",1996,29.9,18,9,3,6,9,8,33,24.2,25,21,3,18,6,24,8,0,"https://fbref.com/en/players/6639e500/Andreas-Pereira"
"12123","Tim Ream_2023",2023,"Fulham","Premier League","Tim Ream","USA","DF","34",1987,32.2,30,16,15,12,3,13,26,50,13,45,24,21,41,71,116,2,"https://fbref.com/en/players/28b40c9c/Tim-Ream"
"12124","Harrison Reed_2023",2023,"Fulham","Premier League","Harrison Reed","ENG","MF","27",1995,31.8,44,27,17,21,6,16,50,32,34,54,12,42,19,63,36,0,"https://fbref.com/en/players/803ae100/Harrison-Reed"
"12125","Bobby Reid_2023",2023,"Fulham","Premier League","Bobby Reid","JAM","FW,DF","29",1993,27.5,42,24,14,14,14,16,34,47.1,18,25,3,22,20,62,28,1,"https://fbref.com/en/players/0f7533cd/Bobby-Reid"
"12126","Antonee Robinson_2023",2023,"Fulham","Premier League","Antonee Robinson","USA","DF","24",1997,34.3,62,38,43,15,4,44,65,67.7,21,49,13,36,53,115,83,3,"https://fbref.com/en/players/289601e6/Antonee-Robinson"
"12127","Marek Rodák_2023",2023,"Fulham","Premier League","Marek Rodák","SVK","GK","25",1996,2,0,0,0,0,0,0,0,NA,0,0,0,0,0,0,1,1,"https://fbref.com/en/players/17acc2ed/Marek-Rodak"
"12128","Cédric Soares_2023",2023,"Fulham","Premier League","Cédric Soares","POR","DF","30",1991,2.2,8,5,4,3,1,3,3,100,0,3,1,2,1,9,5,0,"https://fbref.com/en/players/839c14e1/Cedric-Soares"
"12129","Manor Solomon_2023",2023,"Fulham","Premier League","Manor Solomon","ISR","FW","23",1999,6.4,20,12,12,6,2,9,16,56.3,7,8,0,8,5,25,3,0,"https://fbref.com/en/players/886f9aac/Manor-Solomon"
"12130","Jay Stansfield_2023",2023,"Fulham","Premier League","Jay Stansfield","ENG","FW","19",2002,1,0,0,0,0,0,0,2,0,2,4,1,3,1,1,1,0,"https://fbref.com/en/players/b2626673/Jay-Stansfield"
"12131","Kenny Tete_2023",2023,"Fulham","Premier League","Kenny Tete","NED","DF","26",1995,28.5,83,46,41,29,13,38,50,76,12,48,17,31,52,135,81,1,"https://fbref.com/en/players/77d7c96f/Kenny-Tete"
"12132","Carlos Vinícius_2023",2023,"Fulham","Premier League","Carlos Vinícius","BRA","FW","27",1995,12.3,4,1,0,2,2,0,4,0,4,7,0,7,0,4,10,0,"https://fbref.com/en/players/8b529245/Carlos-Vinicius"
"12133","Willian_2023",2023,"Fulham","Premier League","Willian","BRA","FW","33",1988,23.6,13,8,8,3,2,7,25,28,18,13,0,13,9,22,9,0,"https://fbref.com/en/players/8b9ebd03/Willian"
"12134","Harry Wilson_2023",2023,"Fulham","Premier League","Harry Wilson","WAL","FW","25",1997,12.2,21,13,9,9,3,8,18,44.4,10,17,2,15,6,27,14,0,"https://fbref.com/en/players/c6dc9ecd/Harry-Wilson"
"12135","Omar Alderete_2023",2023,"Getafe","La Liga","Omar Alderete","PAR","DF","25",1996,22.7,35,20,21,14,0,28,40,70,12,23,16,7,26,61,85,0,"https://fbref.com/en/players/bb08bce9/Omar-Alderete"
"12136","Carles Aleñá_2023",2023,"Getafe","La Liga","Carles Aleñá","ESP","MF,FW","24",1998,23.5,18,10,7,5,6,5,34,14.7,29,19,1,18,4,22,18,0,"https://fbref.com/en/players/6c811eb7/Carles-Alena"
"12137","Ángel Algobia_2023",2023,"Getafe","La Liga","Ángel Algobia","ESP","MF","23",1999,12.6,27,13,14,13,0,22,48,45.8,26,15,5,10,3,30,11,0,"https://fbref.com/en/players/acc1aefa/Angel-Algobia"
"12138","Gastón Álvarez_2023",2023,"Getafe","La Liga","Gastón Álvarez","URU","DF","22",2000,16.7,38,30,24,9,5,23,42,54.8,19,15,5,10,15,53,35,0,"https://fbref.com/en/players/852ddfb8/Gaston-Alvarez"
"12139","Jordan Amavi_2023",2023,"Getafe","La Liga","Jordan Amavi","FRA","DF","28",1994,2.2,3,2,3,0,0,1,3,33.3,2,3,0,3,4,7,7,0,"https://fbref.com/en/players/22721b88/Jordan-Amavi"
"12140","Fabrizio Angileri_2023",2023,"Getafe","La Liga","Fabrizio Angileri","ARG","DF","28",1994,6.5,12,9,8,3,1,10,17,58.8,7,8,3,5,7,19,10,0,"https://fbref.com/en/players/fdd26d71/Fabrizio-Angileri"
"12141","Mauro Arambarri_2023",2023,"Getafe","La Liga","Mauro Arambarri","URU","MF","26",1995,11,14,6,9,4,1,3,17,17.6,14,17,5,12,14,28,19,0,"https://fbref.com/en/players/58afe001/Mauro-Arambarri"
"12142","Djené_2023",2023,"Getafe","La Liga","Djené","TOG","DF","30",1991,31.6,41,28,23,17,1,22,38,57.9,16,25,10,15,42,83,81,1,"https://fbref.com/en/players/a4971d84/Djene"
"12143","Domingos Duarte_2023",2023,"Getafe","La Liga","Domingos Duarte","POR","DF","27",1995,29.5,26,18,21,5,0,19,26,73.1,7,29,23,6,39,65,145,0,"https://fbref.com/en/players/93090f69/Domingos-Duarte"
"12144","Munir El Haddadi_2023",2023,"Getafe","La Liga","Munir El Haddadi","MAR","MF,FW","26",1995,12.8,12,7,3,7,2,2,10,20,8,23,2,21,9,21,7,0,"https://fbref.com/en/players/8696bc90/Munir-El-Haddadi"
"12145","Iglesias_2023",2023,"Getafe","La Liga","Iglesias","ESP","DF,MF","24",1998,23.8,61,35,40,18,3,33,65,50.8,32,40,5,35,21,82,91,1,"https://fbref.com/en/players/974322dc/Iglesias"
"12146","Latasa_2023",2023,"Getafe","La Liga","Latasa","ESP","FW","21",2001,5,5,4,2,0,3,1,1,100,0,3,1,2,1,6,8,0,"https://fbref.com/en/players/2bea832e/Latasa"
"12147","Nemanja Maksimović_2023",2023,"Getafe","La Liga","Nemanja Maksimović","SRB","MF","27",1995,22.8,41,30,17,18,6,19,32,59.4,13,36,14,22,34,75,27,0,"https://fbref.com/en/players/00b28772/Nemanja-Maksimovic"
"12148","Jaime Mata_2023",2023,"Getafe","La Liga","Jaime Mata","ESP","FW,MF","33",1988,4.9,13,10,4,5,4,7,22,31.8,15,7,2,5,3,16,6,0,"https://fbref.com/en/players/02319ad7/Jaime-Mata"
"12149","Borja Mayoral_2023",2023,"Getafe","La Liga","Borja Mayoral","ESP","FW","25",1997,30.7,9,4,7,2,0,5,31,16.1,26,18,0,18,3,12,10,0,"https://fbref.com/en/players/64e8ed6d/Borja-Mayoral"
"12150","Luis Milla_2023",2023,"Getafe","La Liga","Luis Milla","ESP","MF","27",1994,20.6,48,30,21,18,9,19,44,43.2,25,13,1,12,32,80,25,1,"https://fbref.com/en/players/19c36442/Luis-Milla"
"12151","Stefan Mitrović_2023",2023,"Getafe","La Liga","Stefan Mitrović","SRB","DF","32",1990,18.7,14,6,12,2,0,7,11,63.6,4,12,10,2,17,31,90,2,"https://fbref.com/en/players/e6777e6b/Stefan-Mitrovic"
"12152","Moises Parra Gutierrez_2023",2023,"Getafe","La Liga","Moises Parra Gutierrez","ESP","FW","20",2002,0.1,1,0,0,1,0,0,0,NA,0,0,0,0,0,1,0,0,"https://fbref.com/en/players/e2dcc60e/Moises-Parra-Gutierrez"
"12153","Portu_2023",2023,"Getafe","La Liga","Portu","ESP","MF,DF","30",1992,19.7,28,21,14,10,4,18,42,42.9,24,23,3,20,17,45,20,1,"https://fbref.com/en/players/1bda5842/Portu"
"12154","Alejandro Revuelta Montero_2023",2023,"Getafe","La Liga","Alejandro Revuelta Montero","ESP","DF","22",2000,0,0,0,0,0,0,0,0,NA,0,0,0,0,0,0,1,0,"https://fbref.com/en/players/14d5b7ac/Alejandro-Revuelta-Montero"
"12155","Jaime Seoane_2023",2023,"Getafe","La Liga","Jaime Seoane","ESP","MF,FW","25",1997,3.6,10,4,3,4,3,2,8,25,6,7,3,4,1,11,2,0,"https://fbref.com/en/players/a62b4888/Jaime-Seoane"
"12156","David Soria_2023",2023,"Getafe","La Liga","David Soria","ESP","GK","29",1993,38,0,0,0,0,0,0,1,0,1,0,0,0,1,1,20,4,"https://fbref.com/en/players/8f8c6934/David-Soria"
"12157","Damián Suárez_2023",2023,"Getafe","La Liga","Damián Suárez","URU","DF,MF","34",1988,21.6,49,33,23,19,7,26,48,54.2,22,40,0,40,15,64,36,0,"https://fbref.com/en/players/ba5004e1/Damian-Suarez"
"12158","Enes Ünal_2023",2023,"Getafe","La Liga","Enes Ünal","TUR","FW","25",1997,33,26,14,5,19,2,7,25,28,18,19,2,17,6,32,35,0,"https://fbref.com/en/players/f8eca1b6/Enes-Unal"
"12159","Gonzalo Villar_2023",2023,"Getafe","La Liga","Gonzalo Villar","ESP","MF","24",1998,5.1,10,5,1,6,3,6,14,42.9,8,9,2,7,6,16,5,0,"https://fbref.com/en/players/bdc74a8f/Gonzalo-Villar"
"12160","Ricard Artero_2023",2023,"Girona","La Liga","Ricard Artero","ESP","MF,FW","19",2003,1.5,3,3,2,1,0,1,1,100,0,2,0,2,1,4,3,0,"https://fbref.com/en/players/5d133e96/Ricard-Artero"
"12161","Santiago Bueno_2023",2023,"Girona","La Liga","Santiago Bueno","URU","DF","23",1998,33.4,63,38,43,19,1,24,36,66.7,12,34,22,12,31,94,105,2,"https://fbref.com/en/players/edc98fac/Santiago-Bueno"
"12162","Alexander Callens_2023",2023,"Girona","La Liga","Alexander Callens","PER","DF","30",1992,1.3,3,3,2,1,0,3,4,75,1,3,1,2,1,4,9,0,"https://fbref.com/en/players/af34f10d/Alexander-Callens"
"12163","Juan Carlos_2023",2023,"Girona","La Liga","Juan Carlos","ESP","GK","34",1988,10,0,0,0,0,0,0,0,NA,0,0,0,0,1,1,7,1,"https://fbref.com/en/players/688b96e3/Juan-Carlos"
"12164","Valentín Castellanos_2023",2023,"Girona","La Liga","Valentín Castellanos","ARG","FW","23",1998,28.9,12,5,2,7,3,0,18,0,18,22,2,20,6,18,26,0,"https://fbref.com/en/players/da76bab4/Valentin-Castellanos"
"12165","Yan Couto_2023",2023,"Girona","La Liga","Yan Couto","BRA","DF,MF","20",2002,12.9,25,18,11,11,3,12,20,60,8,7,2,5,5,30,10,0,"https://fbref.com/en/players/1944818c/Yan-Couto"
"12166","Bernardo Espinosa_2023",2023,"Girona","La Liga","Bernardo Espinosa","COL","DF","33",1989,13.6,6,2,2,4,0,3,9,33.3,6,17,10,7,12,18,70,2,"https://fbref.com/en/players/4242011c/Bernardo-Espinosa"
"12167","Aleix García_2023",2023,"Girona","La Liga","Aleix García","ESP","MF","25",1997,26,37,20,9,18,10,15,33,45.5,18,24,8,16,31,68,35,1,"https://fbref.com/en/players/a10361d2/Aleix-Garcia"
"12168","Borja García_2023",2023,"Girona","La Liga","Borja García","ESP","MF,FW","31",1990,7.5,10,4,7,2,1,2,9,22.2,7,3,1,2,5,15,6,1,"https://fbref.com/en/players/e7f4603c/Borja-Garcia"
"12169","Paulo Gazzaniga_2023",2023,"Girona","La Liga","Paulo Gazzaniga","ARG","GK","30",1992,28,0,0,0,0,0,0,1,0,1,0,0,0,1,1,9,5,"https://fbref.com/en/players/63d17038/Paulo-Gazzaniga"
"12170","Miguel Gutiérrez_2023",2023,"Girona","La Liga","Miguel Gutiérrez","ESP","DF","21",2001,26.6,41,23,23,13,5,23,37,62.2,14,23,5,18,18,59,42,1,"https://fbref.com/en/players/7e98cff1/Miguel-Gutierrez"
"12171","Javi Hernández_2023",2023,"Girona","La Liga","Javi Hernández","ESP","DF","24",1998,12.4,21,12,12,7,2,13,21,61.9,8,10,5,5,7,28,38,0,"https://fbref.com/en/players/9a76c2e9/Javi-Hernandez"
"12172","Yangel Herrera_2023",2023,"Girona","La Liga","Yangel Herrera","VEN","MF,FW","24",1998,10.7,26,9,9,14,3,6,15,40,9,14,1,13,4,30,12,0,"https://fbref.com/en/players/e778654a/Yangel-Herrera"
"12173","Juanpe_2023",2023,"Girona","La Liga","Juanpe","ESP","DF","31",1991,15.8,19,11,10,9,0,11,17,64.7,6,12,9,3,10,29,60,1,"https://fbref.com/en/players/1633fc8a/Juanpe"
"12174","David López_2023",2023,"Girona","La Liga","David López","ESP","DF","32",1989,18.4,31,18,17,13,1,19,27,70.4,8,29,19,10,14,45,64,1,"https://fbref.com/en/players/f03f284b/David-Lopez"
"12175","Iván Martín_2023",2023,"Girona","La Liga","Iván Martín","ESP","MF","23",1999,17.6,9,7,4,4,1,8,23,34.8,15,12,0,12,9,18,12,0,"https://fbref.com/en/players/ae48c5cb/Ivan-Martin"
"12176","Arnau Martinez_2023",2023,"Girona","La Liga","Arnau Martinez","ESP","DF","19",2003,30.4,69,45,41,19,9,38,85,44.7,47,44,10,34,25,94,54,2,"https://fbref.com/en/players/c3e66ffe/Arnau-Martinez"
"12177","Reinier_2023",2023,"Girona","La Liga","Reinier","BRA","MF,FW","20",2002,7.2,12,10,7,3,2,2,8,25,6,6,0,6,5,17,4,0,"https://fbref.com/en/players/6b21b7b5/Reinier"
"12178","Rodrigo Riquelme_2023",2023,"Girona","La Liga","Rodrigo Riquelme","ESP","MF,FW","22",2000,24.2,20,8,8,8,4,9,35,25.7,26,16,0,16,11,31,5,0,"https://fbref.com/en/players/65154df0/Rodrigo-Riquelme"
"12179","Joel Roca_2023",2023,"Girona","La Liga","Joel Roca","ESP","MF,FW","17",2005,0.9,2,2,2,0,0,2,5,40,3,1,1,0,0,2,1,0,"https://fbref.com/en/players/5f21b94c/Joel-Roca"
"12180","Oriol Romeu_2023",2023,"Girona","La Liga","Oriol Romeu","ESP","MF","30",1991,32.8,70,38,36,26,8,26,51,51,25,48,10,38,37,107,54,0,"https://fbref.com/en/players/4b511457/Oriol-Romeu"
"12181","Samuel Sáiz_2023",2023,"Girona","La Liga","Samuel Sáiz","ESP","MF","31",1991,2.7,2,2,0,2,0,1,2,50,1,3,0,3,0,2,1,1,"https://fbref.com/en/players/13e0eb29/Samuel-Saiz"
"12182","Cristhian Stuani_2023",2023,"Girona","La Liga","Cristhian Stuani","URU","FW","35",1986,12.1,13,6,2,7,4,5,14,35.7,9,10,0,10,2,15,5,0,"https://fbref.com/en/players/220c11f1/Cristhian-Stuani"
"12183","Ramón Terrats_2023",2023,"Girona","La Liga","Ramón Terrats","ESP","MF","21",2000,2.4,4,2,1,3,0,2,6,33.3,4,6,2,4,3,7,3,1,"https://fbref.com/en/players/f36016a5/Ramon-Terrats"
"12184","Viktor Tsyhankov_2023",2023,"Girona","La Liga","Viktor Tsyhankov","UKR","MF","24",1997,16.5,8,8,5,1,2,1,14,7.1,13,13,2,11,7,15,12,0,"https://fbref.com/en/players/f7e87032/Viktor-Tsyhankov"
"12185","Oscar Ureña_2023",2023,"Girona","La Liga","Oscar Ureña","ESP","MF","19",2003,1.1,4,2,2,2,0,2,3,66.7,1,2,0,2,1,5,0,0,"https://fbref.com/en/players/2dd7e29d/Oscar-Urena"
"12186","Valery_2023",2023,"Girona","La Liga","Valery","ESP","MF,DF","22",1999,10.7,12,6,4,6,2,5,9,55.6,4,8,1,7,10,22,9,1,"https://fbref.com/en/players/4acd733a/Valery"
"12187","Manu Vallejo_2023",2023,"Girona","La Liga","Manu Vallejo","ESP","FW,MF","25",1997,2.3,4,1,1,2,1,1,6,16.7,5,2,0,2,1,5,3,0,"https://fbref.com/en/players/0bc4e720/Manu-Vallejo"
"12188","Toni Villa_2023",2023,"Girona","La Liga","Toni Villa","ESP","MF,FW","27",1995,9.9,25,18,9,11,5,10,23,43.5,13,8,0,8,8,33,3,0,"https://fbref.com/en/players/636eae97/Toni-Villa"
"12189","Oliver Abildgaard_2023",2023,"Hellas Verona","Serie A","Oliver Abildgaard","DEN","MF","26",1996,6.6,10,6,6,3,1,7,16,43.8,9,7,1,6,5,15,17,0,"https://fbref.com/en/players/8f5cdf66/Oliver-Abildgaard"
"12190","Bruno Amione_2023",2023,"Hellas Verona","Serie A","Bruno Amione","ARG","DF","20",2002,0.6,1,1,1,0,0,1,2,50,1,1,0,1,0,1,4,0,"https://fbref.com/en/players/2df7cc43/Bruno-Amione"
"12191","Antonín Barák_2023",2023,"Hellas Verona","Serie A","Antonín Barák","CZE","MF","27",1994,0.3,0,0,0,0,0,0,0,NA,0,0,0,0,0,0,0,0,"https://fbref.com/en/players/01efac19/Antonin-Barak"
"12192","Jayden Braaf_2023",2023,"Hellas Verona","Serie A","Jayden Braaf","NED","MF,FW","19",2002,3.2,5,3,2,3,0,0,0,NA,0,1,0,1,2,7,1,0,"https://fbref.com/en/players/c609e90e/Jayden-Braaf"
"12193","Juan Cabal_2023",2023,"Hellas Verona","Serie A","Juan Cabal","COL","DF","21",2001,4.9,10,6,7,3,0,7,12,58.3,5,8,5,3,13,23,12,0,"https://fbref.com/en/players/ef6eef89/Juan-Cabal"
"12194","Federico Ceccherini_2023",2023,"Hellas Verona","Serie A","Federico Ceccherini","ITA","DF","30",1992,15.7,25,19,15,9,1,13,23,56.5,10,17,10,7,19,44,55,0,"https://fbref.com/en/players/d9624b51/Federico-Ceccherini"
"12195","Diego Coppola_2023",2023,"Hellas Verona","Serie A","Diego Coppola","ITA","DF","18",2003,13.1,25,17,15,10,0,11,24,45.8,13,20,6,14,14,39,38,0,"https://fbref.com/en/players/22ae86f9/Diego-Coppola"
"12196","Alessandro Cortinovis_2023",2023,"Hellas Verona","Serie A","Alessandro Cortinovis","ITA","MF","21",2001,0.1,1,0,1,0,0,0,0,NA,0,1,0,1,0,1,0,0,"https://fbref.com/en/players/bfc359ed/Alessandro-Cortinovis"
"12197","Paweł Dawidowicz_2023",2023,"Hellas Verona","Serie A","Paweł Dawidowicz","POL","DF","27",1995,18.1,48,31,28,17,3,22,31,71,9,14,9,5,23,71,71,0,"https://fbref.com/en/players/16bb656a/Pawel-Dawidowicz"
"12198","Fabio Depaoli_2023",2023,"Hellas Verona","Serie A","Fabio Depaoli","ITA","DF","25",1997,24.1,48,28,25,16,7,25,44,56.8,19,32,6,26,18,66,33,3,"https://fbref.com/en/players/d97f2e8d/Fabio-Depaoli"
"12199","Josh Doig_2023",2023,"Hellas Verona","Serie A","Josh Doig","SCO","DF","20",2002,15,19,8,6,7,6,6,16,37.5,10,25,6,19,11,30,13,1,"https://fbref.com/en/players/2f69d881/Josh-Doig"
"12200","Ondrej Duda_2023",2023,"Hellas Verona","Serie A","Ondrej Duda","SVK","MF","27",1994,11.8,22,14,7,12,3,9,16,56.3,7,11,0,11,13,35,8,0,"https://fbref.com/en/players/79ca3e23/Ondrej-Duda"
"12201","Davide Faraoni_2023",2023,"Hellas Verona","Serie A","Davide Faraoni","ITA","DF","30",1991,16.5,34,24,19,13,2,16,41,39,25,30,11,19,15,49,37,0,"https://fbref.com/en/players/aae9d04a/Davide-Faraoni"
"12202","Adolfo Gaich_2023",2023,"Hellas Verona","Serie A","Adolfo Gaich","ARG","FW","23",1999,8.1,5,3,0,3,2,1,6,16.7,5,7,2,5,3,8,7,1,"https://fbref.com/en/players/8dfed6e9/Adolfo-Gaich"
"12203","Koray Günter_2023",2023,"Hellas Verona","Serie A","Koray Günter","GER","DF","27",1994,11.1,10,6,1,8,1,4,7,57.1,3,24,15,9,30,40,46,0,"https://fbref.com/en/players/f1f1f238/Koray-Gunter"
"12204","Thomas Henry_2023",2023,"Hellas Verona","Serie A","Thomas Henry","FRA","FW","27",1994,11.4,5,3,1,1,3,1,5,20,4,6,2,4,0,5,14,0,"https://fbref.com/en/players/9ef42479/Thomas-Henry"
"12205","Isak Hien_2023",2023,"Hellas Verona","Serie A","Isak Hien","SWE","DF","23",1999,29,73,36,54,19,0,38,61,62.3,23,40,17,23,31,104,92,1,"https://fbref.com/en/players/12806697/Isak-Hien"
"12206","Martin Hongla_2023",2023,"Hellas Verona","Serie A","Martin Hongla","CMR","MF","24",1998,5.8,8,5,4,4,0,5,5,100,0,7,1,6,6,14,9,0,"https://fbref.com/en/players/b85bf253/Martin-Hongla"
"12207","Ajdin Hrustic_2023",2023,"Hellas Verona","Serie A","Ajdin Hrustic","AUS","MF","26",1996,2.5,2,1,1,1,0,1,2,50,1,2,0,2,0,2,2,1,"https://fbref.com/en/players/1f2d714c/Ajdin-Hrustic"
"12208","Ivan Ilić_2023",2023,"Hellas Verona","Serie A","Ivan Ilić","SRB","MF","21",2001,9.5,16,10,9,7,0,6,11,54.5,5,10,1,9,8,24,14,0,"https://fbref.com/en/players/bb376bed/Ivan-Ilic"
"12209","Yayah Kallon_2023",2023,"Hellas Verona","Serie A","Yayah Kallon","SLE","MF,FW","21",2001,9.6,14,10,5,4,5,7,12,58.3,5,10,0,10,8,22,5,0,"https://fbref.com/en/players/f95f49d2/Yayah-Kallon"
"12210","Kevin Lasagna_2023",2023,"Hellas Verona","Serie A","Kevin Lasagna","ITA","FW,MF","29",1992,17.5,12,6,7,3,2,6,14,42.9,8,17,1,16,5,17,13,0,"https://fbref.com/en/players/09538fdb/Kevin-Lasagna"
"12211","Darko Lazović_2023",2023,"Hellas Verona","Serie A","Darko Lazović","SRB","MF,DF","31",1990,24.9,24,13,9,12,3,13,29,44.8,16,14,3,11,16,40,19,0,"https://fbref.com/en/players/5128bde4/Darko-Lazovic"
"12212","Giangiacomo Magnani_2023",2023,"Hellas Verona","Serie A","Giangiacomo Magnani","ITA","DF","26",1995,17,33,22,20,11,2,19,25,76,6,20,15,5,21,54,76,0,"https://fbref.com/en/players/cce9f582/Giangiacomo-Magnani"
"12213","Lorenzo Montipò_2023",2023,"Hellas Verona","Serie A","Lorenzo Montipò","ITA","GK","26",1996,37,1,0,1,0,0,0,3,0,3,1,0,1,0,1,26,3,"https://fbref.com/en/players/c1d95617/Lorenzo-Montipo"
"12214","Cyril Ngonge_2023",2023,"Hellas Verona","Serie A","Cyril Ngonge","BEL","MF,FW","22",2000,8.3,7,3,2,2,3,3,11,27.3,8,7,0,7,6,13,4,0,"https://fbref.com/en/players/2b8360f1/Cyril-Ngonge"
"12215","Simone Perilli_2023",2023,"Hellas Verona","Serie A","Simone Perilli","ITA","GK","27",1995,1,0,0,0,0,0,0,0,NA,0,0,0,0,0,0,0,0,"https://fbref.com/en/players/b9e11c1d/Simone-Perilli"
"12216","Roberto Piccoli_2023",2023,"Hellas Verona","Serie A","Roberto Piccoli","ITA","FW","21",2001,2.1,1,0,1,0,0,0,2,0,2,2,0,2,0,1,2,0,"https://fbref.com/en/players/1cadaf34/Roberto-Piccoli"
"12217","Panagiotis Retsos_2023",2023,"Hellas Verona","Serie A","Panagiotis Retsos","GRE","DF","23",1998,1.4,5,4,2,2,1,3,3,100,0,4,1,3,2,7,3,0,"https://fbref.com/en/players/4bd00a50/Panagiotis-Retsos"
"12218","Ibrahim Sulemana_2023",2023,"Hellas Verona","Serie A","Ibrahim Sulemana","GHA","MF","19",2003,7.2,19,13,10,7,2,6,12,50,6,8,2,6,14,33,15,0,"https://fbref.com/en/players/230c3f3a/Ibrahim-Sulemana"
"12219","Adrien Tameze_2023",2023,"Hellas Verona","Serie A","Adrien Tameze","CMR","MF","28",1994,33.7,51,30,21,26,4,28,63,44.4,35,51,14,37,37,88,55,2,"https://fbref.com/en/players/8da74c05/Adrien-Tameze"
"12220","Filippo Terracciano_2023",2023,"Hellas Verona","Serie A","Filippo Terracciano","ITA","DF,MF","19",2003,9.1,20,13,11,7,2,15,20,75,5,7,4,3,10,30,14,0,"https://fbref.com/en/players/5cbb5ad6/Filippo-Terracciano"
"12221","Miguel Veloso_2023",2023,"Hellas Verona","Serie A","Miguel Veloso","POR","MF","36",1986,12.9,33,10,20,12,1,16,26,61.5,10,26,6,20,6,39,14,0,"https://fbref.com/en/players/ab1ca213/Miguel-Veloso"
"12222","Simone Verdi_2023",2023,"Hellas Verona","Serie A","Simone Verdi","ITA","MF,FW","30",1992,12.2,15,10,7,5,3,6,17,35.3,11,8,1,7,0,15,2,0,"https://fbref.com/en/players/0375723e/Simone-Verdi"
"12223","Deyovaisio Zeefuik_2023",2023,"Hellas Verona","Serie A","Deyovaisio Zeefuik","NED","DF","24",1998,0.1,1,1,0,1,0,0,0,NA,0,0,0,0,0,1,0,0,"https://fbref.com/en/players/58a2e9f6/Deyovaisio-Zeefuik"
"12224","Milan Đurić_2023",2023,"Hellas Verona","Serie A","Milan Đurić","BIH","FW","32",1990,15.2,2,1,1,0,1,1,3,33.3,2,7,4,3,1,3,24,0,"https://fbref.com/en/players/405f6586/Milan-Djuric"
"12225","Kevin-Prince Boateng_2023",2023,"Hertha BSC","Bundesliga","Kevin-Prince Boateng","GHA","MF","35",1987,5.2,8,6,4,2,2,3,9,33.3,6,11,3,8,3,11,5,0,"https://fbref.com/en/players/f4ec4fd0/Kevin-Prince-Boateng"
"12226","Jean-Paul Boëtius_2023",2023,"Hertha BSC","Bundesliga","Jean-Paul Boëtius","NED","MF","28",1994,11.7,30,16,19,9,2,8,25,32,17,25,5,20,14,44,10,0,"https://fbref.com/en/players/635f2732/Jean-Paul-Boetius"
"12227","Oliver Christensen_2023",2023,"Hertha BSC","Bundesliga","Oliver Christensen","DEN","GK","23",1999,33,1,0,1,0,0,0,2,0,2,0,0,0,0,1,22,2,"https://fbref.com/en/players/af104654/Oliver-Christensen"
"12228","Tolga Ciğerci_2023",2023,"Hertha BSC","Bundesliga","Tolga Ciğerci","TUR","MF","30",1992,7.5,16,13,6,9,1,10,16,62.5,6,6,2,4,8,24,5,0,"https://fbref.com/en/players/6e17c802/Tolga-Cigerci"
"12229","Márton Dárdai_2023",2023,"Hertha BSC","Bundesliga","Márton Dárdai","GER","DF,MF","20",2002,10.5,17,8,9,8,0,9,18,50,9,14,9,5,11,28,45,1,"https://fbref.com/en/players/41bff4fa/Marton-Dardai"
"12230","Vladimír Darida_2023",2023,"Hertha BSC","Bundesliga","Vladimír Darida","CZE","MF","31",1990,0.3,1,1,0,1,0,0,0,NA,0,1,0,1,0,1,0,0,"https://fbref.com/en/players/3eb0f2df/Vladimir-Darida"
"12231","Julian Eitschberger_2023",2023,"Hertha BSC","Bundesliga","Julian Eitschberger","GER","FW","18",2004,0,0,0,0,0,0,0,0,NA,0,0,0,0,0,0,0,0,"https://fbref.com/en/players/943b9602/Julian-Eitschberger"
"12232","Chidera Ejuke_2023",2023,"Hertha BSC","Bundesliga","Chidera Ejuke","NGA","FW,MF","24",1998,9.9,5,4,1,4,0,1,5,20,4,4,0,4,4,9,1,0,"https://fbref.com/en/players/e7f3e8a7/Chidera-Ejuke"
"12233","Tjark Ernst_2023",2023,"Hertha BSC","Bundesliga","Tjark Ernst","GER","GK","19",2003,1,0,0,0,0,0,0,0,NA,0,0,0,0,0,0,1,0,"https://fbref.com/en/players/3f6c3ae0/Tjark-Ernst"
"12234","Stevan Jovetić_2023",2023,"Hertha BSC","Bundesliga","Stevan Jovetić","MNE","FW,MF","32",1989,9.9,3,2,2,1,0,1,11,9.1,10,2,1,1,2,5,10,0,"https://fbref.com/en/players/f36c432f/Stevan-Jovetic"
"12235","Wilfried Kanga_2023",2023,"Hertha BSC","Bundesliga","Wilfried Kanga","CIV","FW","24",1998,15.7,5,4,2,1,2,2,4,50,2,14,3,11,2,7,13,0,"https://fbref.com/en/players/b4c816a9/Wilfried-Kanga"
"12236","Marc-Oliver Kempf_2023",2023,"Hertha BSC","Bundesliga","Marc-Oliver Kempf","GER","DF","27",1995,30.1,44,27,29,14,1,16,22,72.7,6,42,32,10,51,95,143,0,"https://fbref.com/en/players/815c314f/Marc-Oliver-Kempf"
"12237","Jonjoe Kenny_2023",2023,"Hertha BSC","Bundesliga","Jonjoe Kenny","ENG","DF","25",1997,24.9,46,34,27,16,3,24,42,57.1,18,38,9,29,46,92,74,0,"https://fbref.com/en/players/099e666f/Jonjoe-Kenny"
"12238","Pascal Klemens_2023",2023,"Hertha BSC","Bundesliga","Pascal Klemens","GER","DF","17",2005,1,0,0,0,0,0,0,1,0,1,1,0,1,1,1,3,0,"https://fbref.com/en/players/90d88154/Pascal-Klemens"
"12239","Dodi Lukebakio_2023",2023,"Hertha BSC","Bundesliga","Dodi Lukebakio","BEL","FW,MF","24",1997,26.6,18,11,7,8,3,6,27,22.2,21,23,5,18,13,31,17,0,"https://fbref.com/en/players/0c61c77c/Dodi-Lukebakio"
"12240","Myziane Maolida_2023",2023,"Hertha BSC","Bundesliga","Myziane Maolida","FRA","FW,MF","23",1999,1.1,1,1,1,0,0,1,2,50,1,0,0,0,0,1,1,0,"https://fbref.com/en/players/706a60e1/Myziane-Maolida"
"12241","Ibrahim Maza_2023",2023,"Hertha BSC","Bundesliga","Ibrahim Maza","GER","MF,FW","16",2005,0.8,1,1,1,0,0,0,1,0,1,2,0,2,0,1,1,0,"https://fbref.com/en/players/89b3bc5e/Ibrahim-Maza"
"12242","Maximilian Mittelstädt_2023",2023,"Hertha BSC","Bundesliga","Maximilian Mittelstädt","GER","DF,MF","25",1997,9.4,39,20,31,6,2,17,39,43.6,22,13,2,11,26,65,27,0,"https://fbref.com/en/players/88d4144a/Maximilian-Mittelstadt"
"12243","Jessic Ngankam_2023",2023,"Hertha BSC","Bundesliga","Jessic Ngankam","GER","FW,MF","22",2000,9.2,14,9,7,4,3,6,14,42.9,8,6,1,5,1,15,4,0,"https://fbref.com/en/players/bc249af8/Jessic-Ngankam"
"12244","Florian Niederlechner_2023",2023,"Hertha BSC","Bundesliga","Florian Niederlechner","GER","FW","31",1990,8.7,9,7,2,4,3,2,8,25,6,7,0,7,3,12,10,0,"https://fbref.com/en/players/d6862409/Florian-Niederlechner"
"12245","Peter Pekarík_2023",2023,"Hertha BSC","Bundesliga","Peter Pekarík","SVK","DF","35",1986,2.3,4,3,4,0,0,4,6,66.7,2,6,2,4,4,8,7,0,"https://fbref.com/en/players/c18d22f5/Peter-Pekarik"
"12246","Marvin Plattenhardt_2023",2023,"Hertha BSC","Bundesliga","Marvin Plattenhardt","GER","DF","30",1992,26.7,43,33,24,15,4,29,47,61.7,18,25,11,14,15,58,82,0,"https://fbref.com/en/players/f7aa75bd/Marvin-Plattenhardt"
"12247","Marco Richter_2023",2023,"Hertha BSC","Bundesliga","Marco Richter","GER","MF,FW","24",1997,20.4,43,23,18,17,8,19,48,39.6,29,29,2,27,24,67,25,0,"https://fbref.com/en/players/f972644c/Marco-Richter"
"12248","Agustín Rogel_2023",2023,"Hertha BSC","Bundesliga","Agustín Rogel","URU","DF","24",1997,15.8,18,9,13,5,0,11,17,64.7,6,15,8,7,11,29,74,1,"https://fbref.com/en/players/ea42c03f/Agustin-Rogel"
"12249","Tony Rölke_2023",2023,"Hertha BSC","Bundesliga","Tony Rölke","GER","FW","19",2003,0.2,0,0,0,0,0,0,0,NA,0,1,0,1,0,0,1,0,"https://fbref.com/en/players/779aa25c/Tony-Rolke"
"12250","Derry Scherhant_2023",2023,"Hertha BSC","Bundesliga","Derry Scherhant","GER","FW,MF","19",2002,3.2,7,6,3,3,1,4,8,50,4,3,0,3,0,7,5,0,"https://fbref.com/en/players/93cba339/Derry-Scherhant"
"12251","Davie Selke_2023",2023,"Hertha BSC","Bundesliga","Davie Selke","GER","FW","27",1995,3.1,2,1,1,1,0,0,1,0,1,3,1,2,1,3,5,0,"https://fbref.com/en/players/1238a3f9/Davie-Selke"
"12252","Suat Serdar_2023",2023,"Hertha BSC","Bundesliga","Suat Serdar","GER","MF","25",1997,22.5,51,23,14,30,7,20,41,48.8,21,48,12,36,29,80,24,0,"https://fbref.com/en/players/b3325a30/Suat-Serdar"
"12253","Veit Stange_2023",2023,"Hertha BSC","Bundesliga","Veit Stange","GER","MF","18",2004,0.1,1,1,1,0,0,1,1,100,0,0,0,0,0,1,0,0,"https://fbref.com/en/players/e52d33d0/Veit-Stange"
"12254","Ivan Šunjić_2023",2023,"Hertha BSC","Bundesliga","Ivan Šunjić","CRO","MF","25",1996,11,38,20,16,21,1,16,24,66.7,8,17,5,12,13,51,19,1,"https://fbref.com/en/players/e18098de/Ivan-Sunjic"
"12255","Lucas Tousart_2023",2023,"Hertha BSC","Bundesliga","Lucas Tousart","FRA","MF","25",1997,32.7,73,38,35,28,10,27,60,45,33,42,6,36,48,121,75,1,"https://fbref.com/en/players/71ec39ef/Lucas-Tousart"
"12256","Filip Uremović_2023",2023,"Hertha BSC","Bundesliga","Filip Uremović","CRO","DF","25",1997,19.2,38,23,29,8,1,14,22,63.6,8,18,13,5,36,74,88,2,"https://fbref.com/en/players/af842091/Filip-Uremovic"
"12257","Kevin Akpoguma_2023",2023,"Hoffenheim","Bundesliga","Kevin Akpoguma","NGA","DF","27",1995,21.7,75,44,45,27,3,32,45,71.1,13,45,16,29,24,99,70,1,"https://fbref.com/en/players/6ec6fde0/Kevin-Akpoguma"
"12258","Angeliño_2023",2023,"Hoffenheim","Bundesliga","Angeliño","ESP","DF","25",1997,29.1,40,24,19,18,3,23,37,62.2,14,32,6,26,25,65,67,0,"https://fbref.com/en/players/30941e96/Angelino"
"12259","Fisnik Asllani_2023",2023,"Hoffenheim","Bundesliga","Fisnik Asllani","KVX","FW","19",2002,1.9,0,0,0,0,0,0,4,0,4,2,0,2,3,3,3,0,"https://fbref.com/en/players/35f67a30/Fisnik-Asllani"
"12260","Oliver Baumann_2023",2023,"Hoffenheim","Bundesliga","Oliver Baumann","GER","GK","32",1990,34,0,0,0,0,0,0,0,NA,0,0,0,0,0,0,15,1,"https://fbref.com/en/players/47064058/Oliver-Baumann"
"12261","Christoph Baumgartner_2023",2023,"Hoffenheim","Bundesliga","Christoph Baumgartner","AUT","MF,FW","22",1999,28.5,36,19,12,17,7,9,52,17.3,43,57,5,52,15,51,19,1,"https://fbref.com/en/players/437f2b00/Christoph-Baumgartner"
"12262","Ihlas Bebou_2023",2023,"Hoffenheim","Bundesliga","Ihlas Bebou","TOG","FW,DF","28",1994,15.7,19,16,8,7,4,11,17,64.7,6,9,2,7,7,26,15,0,"https://fbref.com/en/players/a53b661f/Ihlas-Bebou"
"12263","Ermin Bičakčić_2023",2023,"Hoffenheim","Bundesliga","Ermin Bičakčić","BIH","DF","32",1990,2.9,8,4,6,1,1,2,6,33.3,4,4,3,1,5,13,14,0,"https://fbref.com/en/players/7aac47fe/Ermin-Bicakcic"
"12264","Tom Bischof_2023",2023,"Hoffenheim","Bundesliga","Tom Bischof","GER","MF,FW","17",2005,3.5,15,10,8,3,4,7,10,70,3,5,1,4,1,16,1,0,"https://fbref.com/en/players/07d3bfec/Tom-Bischof"
"12265","John Brooks_2023",2023,"Hoffenheim","Bundesliga","John Brooks","USA","DF","29",1993,15,18,12,10,8,0,13,18,72.2,5,17,12,5,10,28,105,0,"https://fbref.com/en/players/e27da244/John-Brooks"
"12266","Jacob Bruun Larsen_2023",2023,"Hoffenheim","Bundesliga","Jacob Bruun Larsen","DEN","FW","23",1998,3.6,4,3,0,1,3,3,4,75,1,3,1,2,1,5,0,0,"https://fbref.com/en/players/4e204552/Jacob-Bruun-Larsen"
"12267","Moanes Dabbur_2023",2023,"Hoffenheim","Bundesliga","Moanes Dabbur","ISR","FW","30",1992,10.4,11,8,4,5,2,3,9,33.3,6,8,0,8,5,16,0,0,"https://fbref.com/en/players/eac044ad/Moanes-Dabbur"
"12268","Muhammed Damar_2023",2023,"Hoffenheim","Bundesliga","Muhammed Damar","GER","MF","18",2004,1.8,6,3,1,2,3,1,2,50,1,3,0,3,0,6,0,0,"https://fbref.com/en/players/d3d77413/Muhammed-Damar"
"12269","Thomas Delaney_2023",2023,"Hoffenheim","Bundesliga","Thomas Delaney","DEN","MF","30",1991,3.3,6,3,3,2,1,3,8,37.5,5,5,0,5,1,7,4,0,"https://fbref.com/en/players/fe641c1a/Thomas-Delaney"
"12270","Kasper Dolberg_2023",2023,"Hoffenheim","Bundesliga","Kasper Dolberg","DEN","FW,MF","24",1997,4.5,7,5,1,4,2,4,6,66.7,2,6,2,4,0,7,5,0,"https://fbref.com/en/players/cc83b74d/Kasper-Dolberg"
"12271","Dennis Geiger_2023",2023,"Hoffenheim","Bundesliga","Dennis Geiger","GER","MF","24",1998,21.7,45,25,15,28,2,22,35,62.9,13,27,3,24,24,69,18,2,"https://fbref.com/en/players/37f606f0/Dennis-Geiger"
"12272","Ozan Kabak_2023",2023,"Hoffenheim","Bundesliga","Ozan Kabak","TUR","DF","22",2000,26.5,51,34,27,21,3,17,30,56.7,13,35,23,12,45,96,83,0,"https://fbref.com/en/players/2d61d13a/Ozan-Kabak"
"12273","Pavel Kadeřábek_2023",2023,"Hoffenheim","Bundesliga","Pavel Kadeřábek","CZE","DF","30",1992,18.5,26,20,10,9,7,15,23,65.2,8,12,2,10,14,40,37,1,"https://fbref.com/en/players/79c90e45/Pavel-Kaderabek"
"12274","Andrej Kramarić_2023",2023,"Hoffenheim","Bundesliga","Andrej Kramarić","CRO","MF,FW","31",1991,26.5,5,2,2,1,2,1,11,9.1,10,14,2,12,6,11,13,0,"https://fbref.com/en/players/603cb947/Andrej-Kramaric"
"12275","Stanley N'Soki_2023",2023,"Hoffenheim","Bundesliga","Stanley N'Soki","FRA","DF","23",1999,14.3,22,13,14,7,1,12,22,54.5,10,22,5,17,24,46,34,0,"https://fbref.com/en/players/61590953/Stanley-NSoki"
"12276","Finn Ole Becker_2023",2023,"Hoffenheim","Bundesliga","Finn Ole Becker","GER","MF","22",2000,5.7,10,2,4,6,0,4,7,57.1,3,4,0,4,5,15,8,0,"https://fbref.com/en/players/dd2e62da/Finn-Ole-Becker"
"12277","Stefan Posch_2023",2023,"Hoffenheim","Bundesliga","Stefan Posch","AUT","DF","25",1997,0.2,0,0,0,0,0,0,0,NA,0,0,0,0,0,0,0,0,"https://fbref.com/en/players/7f609bfc/Stefan-Posch"
"12278","Grischa Prömel_2023",2023,"Hoffenheim","Bundesliga","Grischa Prömel","GER","MF","27",1995,16.2,27,19,14,11,2,9,25,36,16,22,4,18,8,35,23,0,"https://fbref.com/en/players/924f9191/Grischa-Promel"
"12279","Eduardo Quaresma_2023",2023,"Hoffenheim","Bundesliga","Eduardo Quaresma","POR","DF","20",2002,1,5,3,3,2,0,1,3,33.3,2,3,2,1,0,5,3,0,"https://fbref.com/en/players/7ec723b7/Eduardo-Quaresma"
"12280","Joshua Quarshie_2023",2023,"Hoffenheim","Bundesliga","Joshua Quarshie","GER","MF","18",2004,0,0,0,0,0,0,0,0,NA,0,0,0,0,0,0,0,0,"https://fbref.com/en/players/3c200e05/Joshua-Quarshie"
"12281","Sebastian Rudy_2023",2023,"Hoffenheim","Bundesliga","Sebastian Rudy","GER","MF","32",1990,8.8,26,12,10,16,0,13,27,48.1,14,27,7,20,11,37,13,0,"https://fbref.com/en/players/80f36c88/Sebastian-Rudy"
"12282","Georginio Rutter_2023",2023,"Hoffenheim","Bundesliga","Georginio Rutter","FRA","FW","20",2002,11.2,7,4,1,4,2,1,3,33.3,2,10,2,8,5,12,6,0,"https://fbref.com/en/players/c64c01fc/Georginio-Rutter"
"12283","Diadie Samassékou_2023",2023,"Hoffenheim","Bundesliga","Diadie Samassékou","MLI","MF,FW","26",1996,0.4,1,0,0,1,0,0,1,0,1,0,0,0,0,1,0,0,"https://fbref.com/en/players/08593525/Diadie-Samassekou"
"12284","Robert Skov_2023",2023,"Hoffenheim","Bundesliga","Robert Skov","DEN","DF","26",1996,15,22,11,14,7,1,10,26,38.5,16,22,8,14,8,30,20,2,"https://fbref.com/en/players/ff98492b/Robert-Skov"
"12285","Angelo Stiller_2023",2023,"Hoffenheim","Bundesliga","Angelo Stiller","GER","MF","21",2001,7.8,26,12,9,13,4,8,12,66.7,4,12,2,10,10,36,14,0,"https://fbref.com/en/players/3b1ed320/Angelo-Stiller"
"12286","Umut Tohumcu_2023",2023,"Hoffenheim","Bundesliga","Umut Tohumcu","GER","MF,DF","17",2004,3,10,5,4,5,1,3,9,33.3,6,4,0,4,2,12,8,0,"https://fbref.com/en/players/e547d3cf/Umut-Tohumcu"
"12287","Kevin Vogt_2023",2023,"Hoffenheim","Bundesliga","Kevin Vogt","GER","DF","30",1991,19.7,15,10,10,5,0,9,22,40.9,13,18,11,7,26,41,67,0,"https://fbref.com/en/players/1d8e9add/Kevin-Vogt"
"12288","Francesco Acerbi_2023",2023,"Inter","Serie A","Francesco Acerbi","ITA","DF","34",1988,26.9,33,19,22,7,4,20,27,74.1,7,25,18,7,41,74,85,2,"https://fbref.com/en/players/b96b595c/Francesco-Acerbi"
"12289","Kristjan Asllani_2023",2023,"Inter","Serie A","Kristjan Asllani","ALB","MF","20",2002,6.6,11,5,1,8,2,7,10,70,3,3,1,2,6,17,4,0,"https://fbref.com/en/players/0fdcef0e/Kristjan-Asllani"
"12290","Nicolò Barella_2023",2023,"Inter","Serie A","Nicolò Barella","ITA","MF","25",1997,29,49,25,17,26,6,28,53,52.8,25,29,5,24,12,61,12,0,"https://fbref.com/en/players/6928979a/Nicolo-Barella"
"12291","Alessandro Bastoni_2023",2023,"Inter","Serie A","Alessandro Bastoni","ITA","DF","23",1999,24,41,20,20,14,7,11,27,40.7,16,27,13,14,24,65,45,0,"https://fbref.com/en/players/75b86fb3/Alessandro-Bastoni"
"12292","Raoul Bellanova_2023",2023,"Inter","Serie A","Raoul Bellanova","ITA","DF","22",2000,5.5,14,6,11,2,1,9,14,64.3,5,6,1,5,4,18,14,0,"https://fbref.com/en/players/e3756e72/Raoul-Bellanova"
"12293","Marcelo Brozović_2023",2023,"Inter","Serie A","Marcelo Brozović","CRO","MF","29",1992,19.7,37,22,13,22,2,11,37,29.7,26,23,7,16,22,59,28,0,"https://fbref.com/en/players/33b8d077/Marcelo-Brozovic"
"12294","Hakan Çalhanoğlu_2023",2023,"Inter","Serie A","Hakan Çalhanoğlu","TUR","MF","28",1994,26.3,48,27,17,26,5,16,43,37.2,27,30,5,25,25,73,13,1,"https://fbref.com/en/players/cd0fa27b/Hakan-Calhanoglu"
"12295","Valentin Carboni_2023",2023,"Inter","Serie A","Valentin Carboni","ARG","MF,DF","17",2005,0.3,1,1,0,1,0,1,3,33.3,2,1,0,1,0,1,0,0,"https://fbref.com/en/players/707b98f1/Valentin-Carboni"
"12296","Alex Cordaz_2023",2023,"Inter","Serie A","Alex Cordaz","ITA","GK","39",1983,0.3,0,0,0,0,0,0,0,NA,0,0,0,0,0,0,0,0,"https://fbref.com/en/players/e66ebabb/Alex-Cordaz"
"12297","Joaquín Correa_2023",2023,"Inter","Serie A","Joaquín Correa","ARG","FW","27",1994,10.6,12,7,3,6,3,4,15,26.7,11,4,1,3,3,15,0,0,"https://fbref.com/en/players/45b9b619/Joaquin-Correa"
"12298","Danilo D'Ambrosio_2023",2023,"Inter","Serie A","Danilo D'Ambrosio","ITA","DF","33",1988,8.1,25,17,17,7,1,15,27,55.6,12,12,4,8,10,35,17,0,"https://fbref.com/en/players/44eb9093/Danilo-DAmbrosio"
"12299","Matteo Darmian_2023",2023,"Inter","Serie A","Matteo Darmian","ITA","DF","32",1989,22.5,56,30,29,15,12,31,47,66,16,33,5,28,21,77,36,0,"https://fbref.com/en/players/96e0490d/Matteo-Darmian"
"12300","Federico Dimarco_2023",2023,"Inter","Serie A","Federico Dimarco","ITA","DF","24",1997,23,31,25,6,18,7,9,19,47.4,10,15,4,11,18,49,20,0,"https://fbref.com/en/players/970b8574/Federico-Dimarco"
"12301","Denzel Dumfries_2023",2023,"Inter","Serie A","Denzel Dumfries","NED","DF","26",1996,24.6,35,18,17,13,5,22,34,64.7,12,33,9,24,12,47,26,0,"https://fbref.com/en/players/481c9ece/Denzel-Dumfries"
"12302","Edin Džeko_2023",2023,"Inter","Serie A","Edin Džeko","BIH","FW","36",1986,19.2,3,2,0,3,0,0,4,0,4,15,1,14,3,6,25,0,"https://fbref.com/en/players/3bb7f478/Edin-Dzeko"
"12303","Roberto Gagliardini_2023",2023,"Inter","Serie A","Roberto Gagliardini","ITA","MF","28",1994,8.7,16,6,9,6,1,10,21,47.6,11,14,5,9,4,20,15,0,"https://fbref.com/en/players/ce30bfc8/Roberto-Gagliardini"
"12304","Robin Gosens_2023",2023,"Inter","Serie A","Robin Gosens","GER","DF","28",1994,13.2,34,18,15,10,9,15,25,60,10,16,2,14,23,57,15,0,"https://fbref.com/en/players/2d970560/Robin-Gosens"
"12305","Samir Handanović_2023",2023,"Inter","Serie A","Samir Handanović","SVN","GK","38",1984,13.7,0,0,0,0,0,0,0,NA,0,0,0,0,0,0,5,0,"https://fbref.com/en/players/74419746/Samir-Handanovic"
"12306","Romelu Lukaku_2023",2023,"Inter","Serie A","Romelu Lukaku","BEL","FW","29",1993,18.4,3,1,1,0,2,2,5,40,3,3,1,2,0,3,16,0,"https://fbref.com/en/players/5eae500a/Romelu-Lukaku"
"12307","Lautaro Martínez_2023",2023,"Inter","Serie A","Lautaro Martínez","ARG","FW","24",1997,28.6,25,14,3,15,7,7,23,30.4,16,31,1,30,13,38,16,1,"https://fbref.com/en/players/f7036e1c/Lautaro-Martinez"
"12308","Henrikh Mkhitaryan_2023",2023,"Inter","Serie A","Henrikh Mkhitaryan","ARM","MF","33",1989,22.1,41,26,13,22,6,14,41,34.1,27,27,4,23,21,62,18,0,"https://fbref.com/en/players/dd0daf32/Henrikh-Mkhitaryan"
"12309","André Onana_2023",2023,"Inter","Serie A","André Onana","CMR","GK","26",1996,24,0,0,0,0,0,0,1,0,1,0,0,0,0,0,5,0,"https://fbref.com/en/players/e9c0c1b2/Andre-Onana"
"12310","Milan Škriniar_2023",2023,"Inter","Serie A","Milan Škriniar","SVK","DF","27",1995,19.7,29,18,14,11,4,18,32,56.3,14,18,13,5,13,42,46,3,"https://fbref.com/en/players/30f5ffa9/Milan-Skriniar"
"12311","Stefan de Vrij_2023",2023,"Inter","Serie A","Stefan de Vrij","NED","DF","30",1992,21.6,28,18,19,9,0,8,14,57.1,6,18,10,8,40,68,80,0,"https://fbref.com/en/players/d0d8dd44/Stefan-de-Vrij"
"12312","Mattia Zanotti_2023",2023,"Inter","Serie A","Mattia Zanotti","ITA","DF","19",2003,0.3,0,0,0,0,0,0,1,0,1,2,0,2,0,0,0,0,"https://fbref.com/en/players/875d65d1/Mattia-Zanotti"
"12313","Tommaso Barbieri_2023",2023,"Juventus","Serie A","Tommaso Barbieri","ITA","DF","19",2002,1.2,3,3,3,0,0,3,8,37.5,5,3,0,3,0,3,2,0,"https://fbref.com/en/players/6f1d7aa8/Tommaso-Barbieri"
"12314","Enzo Barrenechea_2023",2023,"Juventus","Serie A","Enzo Barrenechea","ARG","MF","21",2001,1.8,8,3,3,4,1,3,5,60,2,3,0,3,2,10,3,0,"https://fbref.com/en/players/6caffe81/Enzo-Barrenechea"
"12315","Leonardo Bonucci_2023",2023,"Juventus","Serie A","Leonardo Bonucci","ITA","DF","35",1987,9.8,5,4,1,4,0,2,4,50,2,12,8,4,13,18,29,0,"https://fbref.com/en/players/52ec54d0/Leonardo-Bonucci"
"12316","Gleison Bremer_2023",2023,"Juventus","Serie A","Gleison Bremer","BRA","DF","25",1997,29.3,29,20,23,5,1,19,26,73.1,7,44,22,22,42,71,120,2,"https://fbref.com/en/players/5fd5ed86/Gleison-Bremer"
"12317","Federico Chiesa_2023",2023,"Juventus","Serie A","Federico Chiesa","ITA","DF,MF","24",1997,9.5,22,11,6,6,10,5,14,35.7,9,13,1,12,0,22,1,0,"https://fbref.com/en/players/b0f7e36c/Federico-Chiesa"
"12318","Juan Cuadrado_2023",2023,"Juventus","Serie A","Juan Cuadrado","COL","DF,FW","34",1988,23.1,50,34,34,13,3,27,65,41.5,38,15,2,13,24,74,32,0,"https://fbref.com/en/players/0ab1f153/Juan-Cuadrado"
"12319","Danilo_2023",2023,"Juventus","Serie A","Danilo","BRA","DF","31",1991,35.4,92,62,61,23,8,52,73,71.2,21,39,20,19,47,139,114,1,"https://fbref.com/en/players/94b2001f/Danilo"
"12320","Mattia De Sciglio_2023",2023,"Juventus","Serie A","Mattia De Sciglio","ITA","DF","29",1992,11.6,14,7,8,3,3,9,14,64.3,5,9,3,6,4,18,20,0,"https://fbref.com/en/players/ae4e2852/Mattia-De-Sciglio"
"12321","Ángel Di María_2023",2023,"Juventus","Serie A","Ángel Di María","ARG","FW,MF","34",1988,15.1,10,5,3,5,2,3,19,15.8,16,15,0,15,7,17,0,0,"https://fbref.com/en/players/19cda00b/Angel-Di-Maria"
"12322","Nicolò Fagioli_2023",2023,"Juventus","Serie A","Nicolò Fagioli","ITA","MF","21",2001,16.9,29,19,12,15,2,8,27,29.6,19,16,2,14,8,37,7,1,"https://fbref.com/en/players/366be751/Nicolo-Fagioli"
"12323","Federico Gatti_2023",2023,"Juventus","Serie A","Federico Gatti","ITA","DF","24",1998,16.1,15,11,9,4,2,9,15,60,6,20,14,6,21,36,54,2,"https://fbref.com/en/players/18dd3219/Federico-Gatti"
"12324","Samuel Iling-Junior_2023",2023,"Juventus","Serie A","Samuel Iling-Junior","ENG","DF,FW","18",2003,3.5,7,2,3,1,3,4,9,44.4,5,5,1,4,2,9,6,0,"https://fbref.com/en/players/ba492306/Samuel-Iling-Junior"
"12325","Moise Kean_2023",2023,"Juventus","Serie A","Moise Kean","ITA","FW","22",2000,11.1,8,6,2,5,1,3,7,42.9,4,4,0,4,5,13,2,0,"https://fbref.com/en/players/3d50bcdb/Moise-Kean"
"12326","Filip Kostić_2023",2023,"Juventus","Serie A","Filip Kostić","SRB","DF,FW","29",1992,28.5,41,26,17,20,4,21,47,44.7,26,30,4,26,16,57,32,0,"https://fbref.com/en/players/b1cd37e6/Filip-Kostic"
"12327","Manuel Locatelli_2023",2023,"Juventus","Serie A","Manuel Locatelli","ITA","MF","24",1998,27.2,59,33,26,23,10,30,53,56.6,23,50,22,28,27,86,59,0,"https://fbref.com/en/players/a8a874f1/Manuel-Locatelli"
"12328","Weston McKennie_2023",2023,"Juventus","Serie A","Weston McKennie","USA","MF,DF","23",1998,11.7,14,5,3,9,2,5,8,62.5,3,15,4,11,11,25,15,1,"https://fbref.com/en/players/01c3aff5/Weston-McKennie"
"12329","Arkadiusz Milik_2023",2023,"Juventus","Serie A","Arkadiusz Milik","POL","FW","28",1994,17.6,12,8,2,8,2,2,8,25,6,10,1,9,1,13,14,0,"https://fbref.com/en/players/85613cf0/Arkadiusz-Milik"
"12330","Fabio Miretti_2023",2023,"Juventus","Serie A","Fabio Miretti","ITA","MF,FW","18",2003,13.7,24,11,15,6,3,12,29,41.4,17,20,1,19,4,28,11,0,"https://fbref.com/en/players/34693494/Fabio-Miretti"
"12331","Leandro Paredes_2023",2023,"Juventus","Serie A","Leandro Paredes","ARG","MF","28",1994,10.9,19,13,7,11,1,10,22,45.5,12,8,0,8,17,36,22,0,"https://fbref.com/en/players/dff153a4/Leandro-Paredes"
"12332","Mattia Perin_2023",2023,"Juventus","Serie A","Mattia Perin","ITA","GK","29",1992,10.5,0,0,0,0,0,0,0,NA,0,0,0,0,0,0,0,0,"https://fbref.com/en/players/4c62d0c8/Mattia-Perin"
"12333","Paul Pogba_2023",2023,"Juventus","Serie A","Paul Pogba","FRA","MF,FW","29",1993,1.2,0,0,0,0,0,0,1,0,1,0,0,0,0,0,2,0,"https://fbref.com/en/players/867239d3/Paul-Pogba"
"12334","Adrien Rabiot_2023",2023,"Juventus","Serie A","Adrien Rabiot","FRA","MF","27",1995,30.5,65,35,31,23,11,30,57,52.6,27,37,7,30,26,91,44,1,"https://fbref.com/en/players/8794e251/Adrien-Rabiot"
"12335","Nicolò Rovella_2023",2023,"Juventus","Serie A","Nicolò Rovella","ITA","MF","20",2001,0.3,1,1,0,1,0,1,1,100,0,0,0,0,0,1,0,0,"https://fbref.com/en/players/e58cbfd5/Nicolo-Rovella"
"12336","Daniele Rugani_2023",2023,"Juventus","Serie A","Daniele Rugani","ITA","DF","28",1994,6.3,7,0,6,1,0,4,4,100,0,7,5,2,7,14,32,0,"https://fbref.com/en/players/14b8fcdf/Daniele-Rugani"
"12337","Alex Sandro_2023",2023,"Juventus","Serie A","Alex Sandro","BRA","DF","31",1991,19.9,35,20,16,16,3,15,22,68.2,7,27,10,17,15,50,64,1,"https://fbref.com/en/players/0d82903c/Alex-Sandro"
"12338","Matìas Soulé_2023",2023,"Juventus","Serie A","Matìas Soulé","ARG","MF,FW","19",2003,4.7,7,4,3,2,2,5,7,71.4,2,7,1,6,3,10,3,0,"https://fbref.com/en/players/c13ddd3e/Matias-Soule"
"12339","Wojciech Szczęsny_2023",2023,"Juventus","Serie A","Wojciech Szczęsny","POL","GK","32",1990,27.5,1,0,1,0,0,0,1,0,1,0,0,0,0,1,7,0,"https://fbref.com/en/players/01b8a2b2/Wojciech-Szczesny"
"12340","Dušan Vlahović_2023",2023,"Juventus","Serie A","Dušan Vlahović","SRB","FW","22",2000,21.4,11,6,0,7,4,4,10,40,6,10,3,7,3,14,8,1,"https://fbref.com/en/players/79443529/Dusan-Vlahovic"
"12341","Denis Zakaria_2023",2023,"Juventus","Serie A","Denis Zakaria","SUI","MF","25",1996,1.4,6,3,1,4,1,2,2,100,0,2,0,2,2,8,1,0,"https://fbref.com/en/players/384d58d9/Denis-Zakaria"
"12342","Sargis Adamyan_2023",2023,"Köln","Bundesliga","Sargis Adamyan","ARM","FW,MF","29",1993,7.2,14,7,5,3,6,7,17,41.2,10,12,0,12,4,18,5,0,"https://fbref.com/en/players/22919e97/Sargis-Adamyan"
"12343","Julian Chabot_2023",2023,"Köln","Bundesliga","Julian Chabot","GER","DF","24",1998,20,36,23,19,14,3,20,35,57.1,15,30,18,12,41,77,105,0,"https://fbref.com/en/players/ae7058f9/Julian-Chabot"
"12344","Justin Diehl_2023",2023,"Köln","Bundesliga","Justin Diehl","GER","MF,FW","17",2004,0.2,0,0,0,0,0,0,0,NA,0,0,0,0,0,0,0,0,"https://fbref.com/en/players/d82a310a/Justin-Diehl"
"12345","Florian Dietz_2023",2023,"Köln","Bundesliga","Florian Dietz","GER","FW","23",1998,4.4,2,1,0,2,0,1,4,25,3,4,1,3,0,2,2,0,"https://fbref.com/en/players/8779ddf8/Florian-Dietz"
"12346","Ondrej Duda_2023",2023,"Köln","Bundesliga","Ondrej Duda","SVK","MF","27",1994,7.7,9,8,2,5,2,4,11,36.4,7,7,1,6,2,11,3,0,"https://fbref.com/en/players/79ca3e23/Ondrej-Duda"
"12347","Kingsley Ehizibue_2023",2023,"Köln","Bundesliga","Kingsley Ehizibue","NED","DF","27",1995,0.7,0,0,0,0,0,0,0,NA,0,1,0,1,2,2,1,0,"https://fbref.com/en/players/76b2817e/Kingsley-Ehizibue"
"12348","Jonas Hector_2023",2023,"Köln","Bundesliga","Jonas Hector","GER","DF","32",1990,31.4,112,66,59,43,10,66,113,58.4,47,61,9,52,39,151,74,1,"https://fbref.com/en/players/c2009df3/Jonas-Hector"
"12349","Timo Hübers_2023",2023,"Köln","Bundesliga","Timo Hübers","GER","DF","26",1996,28.4,43,28,35,8,0,24,52,46.2,28,27,13,14,58,101,153,0,"https://fbref.com/en/players/94302c52/Timo-Hubers"
"12350","Denis Huseinbasic_2023",2023,"Köln","Bundesliga","Denis Huseinbasic","GER","MF,FW","21",2001,8.8,23,9,8,11,4,10,25,40,15,16,2,14,4,27,5,0,"https://fbref.com/en/players/b116c6e3/Denis-Huseinbasic"
"12351","Florian Kainz_2023",2023,"Köln","Bundesliga","Florian Kainz","AUT","MF,FW","29",1992,26,21,10,7,12,2,8,26,30.8,18,27,6,21,32,53,30,1,"https://fbref.com/en/players/94c18565/Florian-Kainz"
"12352","Luca Kilian_2023",2023,"Köln","Bundesliga","Luca Kilian","GER","DF","22",1999,12.5,22,16,14,7,1,12,21,57.1,9,16,8,8,11,33,48,0,"https://fbref.com/en/players/610aa1e9/Luca-Kilian"
"12353","Tim Lemperle_2023",2023,"Köln","Bundesliga","Tim Lemperle","GER","FW,MF","20",2002,1.5,6,4,3,1,2,3,5,60,2,5,0,5,1,7,4,0,"https://fbref.com/en/players/792ffa71/Tim-Lemperle"
"12354","Dimitris Limnios_2023",2023,"Köln","Bundesliga","Dimitris Limnios","GRE","FW","24",1998,0.4,0,0,0,0,0,0,0,NA,0,0,0,0,1,1,0,0,"https://fbref.com/en/players/62c7067a/Dimitris-Limnios"
"12355","Dejan Ljubicic_2023",2023,"Köln","Bundesliga","Dejan Ljubicic","AUT","MF,FW","24",1997,19,25,14,7,14,4,13,40,32.5,27,20,1,19,8,33,8,1,"https://fbref.com/en/players/c455a2b2/Dejan-Ljubicic"
"12356","Linton Maina_2023",2023,"Köln","Bundesliga","Linton Maina","GER","FW,MF","23",1999,24.9,18,12,5,11,2,7,30,23.3,23,19,0,19,5,23,9,0,"https://fbref.com/en/players/e5d85da8/Linton-Maina"
"12357","Eric Martel_2023",2023,"Köln","Bundesliga","Eric Martel","GER","MF","20",2002,22.4,66,41,29,30,7,30,60,50,30,29,9,20,33,99,49,0,"https://fbref.com/en/players/92a16062/Eric-Martel"
"12358","Mathias Olesen_2023",2023,"Köln","Bundesliga","Mathias Olesen","LUX","MF","21",2001,5.3,10,5,4,4,2,5,8,62.5,3,6,1,5,2,12,3,0,"https://fbref.com/en/players/86adbcc7/Mathias-Olesen"
"12359","Kristian Pedersen_2023",2023,"Köln","Bundesliga","Kristian Pedersen","DEN","DF","27",1994,3.1,5,4,4,1,0,0,2,0,2,3,0,3,6,11,17,0,"https://fbref.com/en/players/5154b2ba/Kristian-Pedersen"
"12360","Kingsley Schindler_2023",2023,"Köln","Bundesliga","Kingsley Schindler","GHA","DF,MF","29",1993,12.1,23,12,13,8,2,18,28,64.3,10,14,2,12,15,38,24,0,"https://fbref.com/en/players/bd527260/Kingsley-Schindler"
"12361","Benno Schmitz_2023",2023,"Köln","Bundesliga","Benno Schmitz","GER","DF","27",1994,26.9,64,42,31,28,5,42,82,51.2,40,34,4,30,26,90,57,0,"https://fbref.com/en/players/ad00b1a8/Benno-Schmitz"
"12362","Marvin Schwäbe_2023",2023,"Köln","Bundesliga","Marvin Schwäbe","GER","GK","27",1995,34,1,0,1,0,0,1,1,100,0,0,0,0,2,3,8,2,"https://fbref.com/en/players/87436846/Marvin-Schwabe"
"12363","Davie Selke_2023",2023,"Köln","Bundesliga","Davie Selke","GER","FW","27",1995,9.7,0,0,0,0,0,0,4,0,4,4,1,3,0,0,11,0,"https://fbref.com/en/players/1238a3f9/Davie-Selke"
"12364","Ellyes Skhiri_2023",2023,"Köln","Bundesliga","Ellyes Skhiri","TUN","MF","27",1995,31.7,79,44,29,42,8,26,66,39.4,40,52,12,40,56,135,48,0,"https://fbref.com/en/players/c2211709/Ellyes-Skhiri"
"12365","Nikola Soldo_2023",2023,"Köln","Bundesliga","Nikola Soldo","CRO","DF","21",2001,6.6,15,9,8,7,0,7,11,63.6,4,7,6,1,7,22,28,0,"https://fbref.com/en/players/4f627629/Nikola-Soldo"
"12366","Jan Thielmann_2023",2023,"Köln","Bundesliga","Jan Thielmann","GER","FW","20",2002,9.7,9,8,3,4,2,2,11,18.2,9,16,3,13,9,18,7,0,"https://fbref.com/en/players/fd53759d/Jan-Thielmann"
"12367","Steffen Tigges_2023",2023,"Köln","Bundesliga","Steffen Tigges","GER","FW","24",1998,17.7,12,7,1,8,3,4,14,28.6,10,13,2,11,8,20,17,0,"https://fbref.com/en/players/6b8887c2/Steffen-Tigges"
"12368","Mark Uth_2023",2023,"Köln","Bundesliga","Mark Uth","GER","MF,FW","30",1991,0.5,0,0,0,0,0,0,0,NA,0,0,0,0,0,0,0,0,"https://fbref.com/en/players/a3ddb1b9/Mark-Uth"
"12369","Luis Alberto_2023",2023,"Lazio","Serie A","Luis Alberto","ESP","MF","29",1992,27.1,49,29,18,20,11,23,72,31.9,49,35,6,29,9,58,4,0,"https://fbref.com/en/players/5294a83f/Luis-Alberto"
"12370","Felipe Anderson_2023",2023,"Lazio","Serie A","Felipe Anderson","BRA","FW","29",1993,32.9,80,50,31,41,8,31,88,35.2,57,58,6,52,31,111,27,0,"https://fbref.com/en/players/9f1893b9/Felipe-Anderson"
"12371","Marcos Antônio_2023",2023,"Lazio","Serie A","Marcos Antônio","BRA","MF","22",2000,6.6,9,6,4,5,0,9,20,45,11,7,2,5,11,20,18,0,"https://fbref.com/en/players/108fe016/Marcos-Antonio"
"12372","Toma Bašić_2023",2023,"Lazio","Serie A","Toma Bašić","CRO","MF","25",1996,5.7,6,4,4,1,1,3,8,37.5,5,9,0,9,7,13,8,0,"https://fbref.com/en/players/80556f08/Toma-Basic"
"12373","Marco Bertini_2023",2023,"Lazio","Serie A","Marco Bertini","ITA","MF","19",2002,0,0,0,0,0,0,0,0,NA,0,0,0,0,0,0,0,0,"https://fbref.com/en/players/4b520f96/Marco-Bertini"
"12374","Matteo Cancellieri_2023",2023,"Lazio","Serie A","Matteo Cancellieri","ITA","FW","20",2002,2.8,10,4,5,3,2,5,9,55.6,4,4,0,4,1,11,2,0,"https://fbref.com/en/players/b6a1cdf9/Matteo-Cancellieri"
"12375","Nicolò Casale_2023",2023,"Lazio","Serie A","Nicolò Casale","ITA","DF","24",1998,27.1,42,20,28,14,0,22,34,64.7,12,25,17,8,17,59,73,1,"https://fbref.com/en/players/3f5f38fb/Nicolo-Casale"
"12376","Danilo Cataldi_2023",2023,"Lazio","Serie A","Danilo Cataldi","ITA","MF","27",1994,21.3,25,16,7,15,3,14,40,35,26,23,9,14,24,49,33,0,"https://fbref.com/en/players/ba3d3bea/Danilo-Cataldi"
"12377","Mario Gila_2023",2023,"Lazio","Serie A","Mario Gila","ESP","DF","21",2000,1,3,1,3,0,0,0,1,0,1,0,0,0,3,6,3,0,"https://fbref.com/en/players/9c435456/Mario-Gila"
"12378","Elseid Hysaj_2023",2023,"Lazio","Serie A","Elseid Hysaj","ALB","DF","28",1994,22.2,39,23,24,11,4,23,41,56.1,18,31,7,24,20,59,42,0,"https://fbref.com/en/players/2f3452eb/Elseid-Hysaj"
"12379","Ciro Immobile_2023",2023,"Lazio","Serie A","Ciro Immobile","ITA","FW","32",1990,24.7,11,5,4,4,3,6,9,66.7,3,10,2,8,1,12,14,0,"https://fbref.com/en/players/4431aed2/Ciro-Immobile"
"12380","Manuel Lazzari_2023",2023,"Lazio","Serie A","Manuel Lazzari","ITA","DF","28",1993,20.9,33,21,13,14,6,21,36,58.3,15,20,6,14,18,51,36,1,"https://fbref.com/en/players/02caf6e0/Manuel-Lazzari"
"12381","Adam Marušić_2023",2023,"Lazio","Serie A","Adam Marušić","MNE","DF","29",1992,30.7,41,30,23,14,4,25,39,64.1,14,20,6,14,38,79,63,1,"https://fbref.com/en/players/d4535821/Adam-Marusic"
"12382","Luís Maximiano_2023",2023,"Lazio","Serie A","Luís Maximiano","POR","GK","23",1999,0.1,0,0,0,0,0,0,0,NA,0,0,0,0,0,0,0,0,"https://fbref.com/en/players/3318286e/Luis-Maximiano"
"12383","Sergej Milinković-Savić_2023",2023,"Lazio","Serie A","Sergej Milinković-Savić","SRB","MF","27",1995,33.6,58,35,22,23,13,24,67,35.8,43,50,12,38,28,86,49,0,"https://fbref.com/en/players/4e6dbac4/Sergej-Milinkovic-Savic"
"12384","Patric_2023",2023,"Lazio","Serie A","Patric","ESP","DF","29",1993,15.7,17,11,12,3,2,11,16,68.8,5,17,12,5,11,28,53,1,"https://fbref.com/en/players/f7223718/Patric"
"12385","Pedro_2023",2023,"Lazio","Serie A","Pedro","ESP","FW","35",1987,21.1,35,24,14,10,11,11,30,36.7,19,18,2,16,6,41,4,1,"https://fbref.com/en/players/3ca7254a/Pedro"
"12386","Luca Pellegrini_2023",2023,"Lazio","Serie A","Luca Pellegrini","ITA","DF","23",1999,2,1,0,0,1,0,1,4,25,3,3,0,3,7,8,4,0,"https://fbref.com/en/players/3b61c9ec/Luca-Pellegrini"
"12387","Ivan Provedel_2023",2023,"Lazio","Serie A","Ivan Provedel","ITA","GK","28",1994,37.9,1,0,1,0,0,0,0,NA,0,0,0,0,0,1,15,1,"https://fbref.com/en/players/277da414/Ivan-Provedel"
"12388","Ștefan Radu_2023",2023,"Lazio","Serie A","Ștefan Radu","ROU","FW","35",1986,0,0,0,0,0,0,0,0,NA,0,0,0,0,0,0,0,0,"https://fbref.com/en/players/53de807a/Stefan-Radu"
"12389","Alessio Romagnoli_2023",2023,"Lazio","Serie A","Alessio Romagnoli","ITA","DF","27",1995,32.5,33,15,19,14,0,11,22,50,11,33,26,7,38,71,108,0,"https://fbref.com/en/players/3ead85f9/Alessio-Romagnoli"
"12390","Luka Romero_2023",2023,"Lazio","Serie A","Luka Romero","ARG","FW","17",2004,1.7,0,0,0,0,0,0,3,0,3,4,0,4,3,3,1,0,"https://fbref.com/en/players/ca6edaa0/Luka-Romero"
"12391","Matías Vecino_2023",2023,"Lazio","Serie A","Matías Vecino","URU","MF","30",1991,18.8,47,27,13,23,11,23,48,47.9,25,33,10,23,16,63,39,1,"https://fbref.com/en/players/44ac04e9/Matias-Vecino"
"12392","Mattia Zaccagni_2023",2023,"Lazio","Serie A","Mattia Zaccagni","ITA","FW","27",1995,30.8,42,28,16,18,8,14,38,36.8,24,37,3,34,21,63,10,1,"https://fbref.com/en/players/d85c238b/Mattia-Zaccagni"
"12393","Kristoffer Askildsen_2023",2023,"Lecce","Serie A","Kristoffer Askildsen","NOR","MF","21",2001,8.1,7,3,2,3,2,4,10,40,6,15,4,11,11,18,6,0,"https://fbref.com/en/players/a69cc629/Kristoffer-Askildsen"
"12394","Lameck Banda_2023",2023,"Lecce","Serie A","Lameck Banda","ZAM","FW,MF","21",2001,18.2,30,20,13,14,3,15,41,36.6,26,24,2,22,8,38,5,0,"https://fbref.com/en/players/8a6de8c7/Lameck-Banda"
"12395","Federico Baschirotto_2023",2023,"Lecce","Serie A","Federico Baschirotto","ITA","DF","25",1996,37,40,30,35,5,0,22,36,61.1,14,45,29,16,36,76,192,0,"https://fbref.com/en/players/5a08ee41/Federico-Baschirotto"
"12396","Kristijan Bistrović_2023",2023,"Lecce","Serie A","Kristijan Bistrović","CRO","MF","24",1998,5.1,3,1,3,0,0,0,5,0,5,3,0,3,0,3,4,0,"https://fbref.com/en/players/79370f8c/Kristijan-Bistrovic"
"12397","Alexis Blin_2023",2023,"Lecce","Serie A","Alexis Blin","FRA","MF","25",1996,26.4,69,39,27,33,9,38,73,52.1,35,55,15,40,34,103,74,0,"https://fbref.com/en/players/c69ef855/Alexis-Blin"
"12398","Tommaso Cassandro_2023",2023,"Lecce","Serie A","Tommaso Cassandro","ITA","DF","22",2000,0.1,1,1,0,1,0,0,0,NA,0,1,1,0,0,1,0,0,"https://fbref.com/en/players/6c4307ee/Tommaso-Cassandro"
"12399","Pietro Ceccaroni_2023",2023,"Lecce","Serie A","Pietro Ceccaroni","ITA","DF","26",1995,0.5,0,0,0,0,0,0,0,NA,0,1,1,0,3,3,2,0,"https://fbref.com/en/players/4d1efb48/Pietro-Ceccaroni"
"12400","Assan Ceesay_2023",2023,"Lecce","Serie A","Assan Ceesay","GAM","FW","28",1994,20.1,23,18,7,8,8,9,17,52.9,8,15,2,13,3,26,24,0,"https://fbref.com/en/players/07f8bcc8/Assan-Ceesay"
"12401","Lorenzo Colombo_2023",2023,"Lecce","Serie A","Lorenzo Colombo","ITA","FW","20",2002,16.8,17,9,1,9,7,6,14,42.9,8,22,0,22,2,19,7,0,"https://fbref.com/en/players/04df29a5/Lorenzo-Colombo"
"12402","Kastriot Dermaku_2023",2023,"Lecce","Serie A","Kastriot Dermaku","ALB","DF","30",1992,0.4,0,0,0,0,0,0,0,NA,0,0,0,0,0,0,0,0,"https://fbref.com/en/players/2990c466/Kastriot-Dermaku"
"12403","Federico Di Francesco_2023",2023,"Lecce","Serie A","Federico Di Francesco","ITA","FW,MF","28",1994,22.6,28,16,7,11,10,9,19,47.4,10,16,0,16,8,36,14,0,"https://fbref.com/en/players/1fca9171/Federico-Di-Francesco"
"12404","Wladimiro Falcone_2023",2023,"Lecce","Serie A","Wladimiro Falcone","ITA","GK","27",1995,38,2,0,2,0,0,2,2,100,0,0,0,0,2,4,21,3,"https://fbref.com/en/players/9f5a610b/Wladimiro-Falcone"
"12405","Antonino Gallo_2023",2023,"Lecce","Serie A","Antonino Gallo","ITA","DF","22",2000,27.6,56,36,35,12,9,38,57,66.7,19,37,6,31,13,69,71,0,"https://fbref.com/en/players/c74d63ac/Antonino-Gallo"
"12406","Valentin Gendrey_2023",2023,"Lecce","Serie A","Valentin Gendrey","FRA","DF","22",2000,34.5,88,57,54,25,9,40,71,56.3,31,45,4,41,37,125,89,0,"https://fbref.com/en/players/822ed0ec/Valentin-Gendrey"
"12407","Joan Gonzàlez_2023",2023,"Lecce","Serie A","Joan Gonzàlez","ESP","MF","20",2002,24.4,48,28,20,18,10,17,51,33.3,34,37,8,29,16,64,28,0,"https://fbref.com/en/players/f025eade/Joan-Gonzalez"
"12408","Morten Hjulmand_2023",2023,"Lecce","Serie A","Morten Hjulmand","DEN","MF","23",1999,32.9,90,52,49,40,1,37,67,55.2,30,43,11,32,72,162,54,0,"https://fbref.com/en/players/d4456fb3/Morten-Hjulmand"
"12409","Þórir Jóhann Helgason_2023",2023,"Lecce","Serie A","Þórir Jóhann Helgason","ISL","MF","21",2000,2.5,2,2,1,0,1,2,3,66.7,1,3,1,2,3,5,3,0,"https://fbref.com/en/players/dc765618/Thorir-Johann-Helgason"
"12410","Marcin Listkowski_2023",2023,"Lecce","Serie A","Marcin Listkowski","POL","MF,FW","24",1998,0.9,0,0,0,0,0,0,0,NA,0,0,0,0,3,3,2,0,"https://fbref.com/en/players/a3695ac2/Marcin-Listkowski"
"12411","Youssef Maleh_2023",2023,"Lecce","Serie A","Youssef Maleh","MAR","MF","23",1998,7.5,17,8,3,7,7,6,14,42.9,8,20,1,19,5,22,10,0,"https://fbref.com/en/players/4c8845f7/Youssef-Maleh"
"12412","Yıldırım Mert Çetin_2023",2023,"Lecce","Serie A","Yıldırım Mert Çetin","TUR","DF","25",1997,0.2,1,0,1,0,0,0,0,NA,0,0,0,0,1,2,1,0,"https://fbref.com/en/players/c730da00/Yildirim-Mert-Cetin"
"12413","Remi Oudin_2023",2023,"Lecce","Serie A","Remi Oudin","FRA","FW,MF","25",1996,14.7,25,13,9,12,4,10,23,43.5,13,16,2,14,29,54,23,0,"https://fbref.com/en/players/ea02beaf/Remi-Oudin"
"12414","Giuseppe Pezzella_2023",2023,"Lecce","Serie A","Giuseppe Pezzella","ITA","DF","24",1997,10.2,21,9,16,2,3,9,16,56.3,7,11,3,8,8,29,31,1,"https://fbref.com/en/players/149c5f5d/Giuseppe-Pezzella"
"12415","Marin Pongračić_2023",2023,"Lecce","Serie A","Marin Pongračić","CRO","DF","24",1997,8.8,16,14,8,7,1,5,7,71.4,2,4,3,1,16,32,31,0,"https://fbref.com/en/players/2a6cd437/Marin-Pongracic"
"12416","Pablo Rodríguez_2023",2023,"Lecce","Serie A","Pablo Rodríguez","ESP","FW,MF","20",2001,0.6,2,1,2,0,0,0,2,0,2,3,0,3,0,2,0,0,"https://fbref.com/en/players/1d4e63b6/Pablo-Rodriguez"
"12417","Simone Romagnoli_2023",2023,"Lecce","Serie A","Simone Romagnoli","ITA","DF","32",1990,1.9,6,5,3,3,0,2,2,100,0,4,1,3,1,7,11,0,"https://fbref.com/en/players/09899de8/Simone-Romagnoli"
"12418","Gabriel Strefezza_2023",2023,"Lecce","Serie A","Gabriel Strefezza","BRA","FW,MF","25",1997,27.1,50,24,18,20,12,27,53,50.9,26,36,3,33,16,66,15,0,"https://fbref.com/en/players/674cfc5a/Gabriel-Strefezza"
"12419","Alessandro Tuia_2023",2023,"Lecce","Serie A","Alessandro Tuia","ITA","DF","32",1990,5.7,10,6,6,4,0,3,9,33.3,6,3,1,2,15,25,29,0,"https://fbref.com/en/players/26c54058/Alessandro-Tuia"
"12420","Samuel Umtiti_2023",2023,"Lecce","Serie A","Samuel Umtiti","FRA","DF","28",1993,23.5,52,34,25,25,2,18,26,69.2,8,26,14,12,26,78,79,0,"https://fbref.com/en/players/3eed9821/Samuel-Umtiti"
"12421","Joel Voelkerling Persson_2023",2023,"Lecce","Serie A","Joel Voelkerling Persson","SWE","FW,MF","19",2003,1.1,1,1,0,0,1,0,1,0,1,1,0,1,0,1,0,0,"https://fbref.com/en/players/b3ef6517/Joel-Voelkerling-Persson"
"12422","Brenden Aaronson_2023",2023,"Leeds United","Premier League","Brenden Aaronson","USA","MF,FW","21",2000,26.4,45,18,16,22,7,15,46,32.6,31,43,3,40,5,50,6,1,"https://fbref.com/en/players/5bc43860/Brenden-Aaronson"
"12423","Tyler Adams_2023",2023,"Leeds United","Premier League","Tyler Adams","USA","MF","23",1999,24,89,46,44,35,10,50,77,64.9,27,48,8,40,35,124,29,0,"https://fbref.com/en/players/2b09d998/Tyler-Adams"
"12424","Luke Ayling_2023",2023,"Leeds United","Premier League","Luke Ayling","ENG","DF","30",1991,22.8,66,37,42,15,9,42,85,49.4,43,34,11,23,26,92,52,2,"https://fbref.com/en/players/420d7c7d/Luke-Ayling"
"12425","Patrick Bamford_2023",2023,"Leeds United","Premier League","Patrick Bamford","ENG","FW","28",1993,16.8,9,6,0,6,3,4,20,20,16,12,5,7,5,14,13,0,"https://fbref.com/en/players/93feac6e/Patrick-Bamford"
"12426","Liam Cooper_2023",2023,"Leeds United","Premier League","Liam Cooper","SCO","DF","30",1991,15.8,38,23,27,9,2,23,36,63.9,13,16,8,8,34,72,57,3,"https://fbref.com/en/players/dc64b8b3/Liam-Cooper"
"12427","Cody Drameh_2023",2023,"Leeds United","Premier League","Cody Drameh","ENG","DF","20",2001,0.8,5,4,0,4,1,2,3,66.7,1,0,0,0,1,6,1,0,"https://fbref.com/en/players/e0d1510a/Cody-Drameh"
"12428","Junior Firpo_2023",2023,"Leeds United","Premier League","Junior Firpo","ESP","DF","25",1996,15.2,47,25,27,15,5,24,46,52.2,22,23,7,16,24,71,40,0,"https://fbref.com/en/players/24f59bb2/Junior-Firpo"
"12429","Adam Forshaw_2023",2023,"Leeds United","Premier League","Adam Forshaw","ENG","MF","30",1991,5.3,12,9,5,7,0,7,17,41.2,10,9,1,8,4,16,2,0,"https://fbref.com/en/players/9f1938ab/Adam-Forshaw"
"12430","Joe Gelhardt_2023",2023,"Leeds United","Premier League","Joe Gelhardt","ENG","FW","20",2002,2.4,6,2,1,3,2,3,5,60,2,5,0,5,0,6,4,0,"https://fbref.com/en/players/01962d0d/Joe-Gelhardt"
"12431","Degnand Gnonto_2023",2023,"Leeds United","Premier League","Degnand Gnonto","ITA","FW,MF","18",2003,15,27,17,7,15,5,10,30,33.3,20,24,1,23,5,32,7,0,"https://fbref.com/en/players/75fdd638/Degnand-Gnonto"
"12432","Sam Greenwood_2023",2023,"Leeds United","Premier League","Sam Greenwood","ENG","MF,FW","20",2002,4.7,15,7,7,8,0,8,21,38.1,13,10,2,8,1,16,1,0,"https://fbref.com/en/players/f3354c07/Sam-Greenwood"
"12433","Darko Gyabi_2023",2023,"Leeds United","Premier League","Darko Gyabi","ENG","FW","18",2004,0.1,2,2,1,1,0,0,0,NA,0,2,0,2,0,2,0,0,"https://fbref.com/en/players/56d838f7/Darko-Gyabi"
"12434","Jack Harrison_2023",2023,"Leeds United","Premier League","Jack Harrison","ENG","FW,MF","25",1996,30.1,41,17,5,15,21,12,52,23.1,40,47,2,45,22,63,25,0,"https://fbref.com/en/players/aa849a12/Jack-Harrison"
"12435","Daniel James_2023",2023,"Leeds United","Premier League","Daniel James","WAL","FW","24",1997,2.2,6,2,1,3,2,3,6,50,3,4,0,4,2,8,2,0,"https://fbref.com/en/players/c931d9f9/Daniel-James"
"12436","Mateo Joseph_2023",2023,"Leeds United","Premier League","Mateo Joseph","ENG","FW,MF","18",2003,0.3,0,0,0,0,0,0,0,NA,0,1,0,1,0,0,1,0,"https://fbref.com/en/players/6ad43f9a/Mateo-Joseph"
"12437","Mateusz Klich_2023",2023,"Leeds United","Premier League","Mateusz Klich","POL","MF,FW","32",1990,3.1,12,8,3,4,5,7,13,53.8,6,4,0,4,0,12,1,0,"https://fbref.com/en/players/282679b4/Mateusz-Klich"
"12438","Robin Koch_2023",2023,"Leeds United","Premier League","Robin Koch","GER","DF","26",1996,35.3,53,30,32,16,5,24,56,42.9,32,44,21,23,43,96,152,1,"https://fbref.com/en/players/ea6bc03a/Robin-Koch"
"12439","Diego Llorente_2023",2023,"Leeds United","Premier League","Diego Llorente","ESP","DF","28",1993,7.2,13,10,8,5,0,4,8,50,4,6,2,4,15,28,24,2,"https://fbref.com/en/players/bba30585/Diego-Llorente"
"12440","Weston McKennie_2023",2023,"Leeds United","Premier League","Weston McKennie","USA","MF","23",1998,16,30,13,5,18,7,10,29,34.5,19,22,3,19,22,52,26,0,"https://fbref.com/en/players/01c3aff5/Weston-McKennie"
"12441","Illan Meslier_2023",2023,"Leeds United","Premier League","Illan Meslier","FRA","GK","22",2000,34,2,1,2,0,0,2,4,50,2,0,0,0,1,3,30,3,"https://fbref.com/en/players/6b625ac2/Illan-Meslier"
"12442","Rasmus Nissen_2023",2023,"Leeds United","Premier League","Rasmus Nissen","DEN","DF","25",1997,21.8,62,35,35,21,6,42,76,55.3,34,32,14,18,35,97,61,0,"https://fbref.com/en/players/39769cff/Rasmus-Nissen"
"12443","Joel Robles_2023",2023,"Leeds United","Premier League","Joel Robles","ESP","GK","32",1990,4,0,0,0,0,0,0,1,0,1,0,0,0,0,0,2,1,"https://fbref.com/en/players/cda0b317/Joel-Robles"
"12444","Marc Roca_2023",2023,"Leeds United","Premier League","Marc Roca","ESP","MF","25",1996,25.7,66,40,27,34,5,20,65,30.8,45,34,10,24,23,89,24,2,"https://fbref.com/en/players/da27e268/Marc-Roca"
"12445","Rodrigo_2023",2023,"Leeds United","Premier League","Rodrigo","ESP","FW,MF","31",1991,21.5,24,10,2,15,7,8,19,42.1,11,16,4,12,6,30,21,1,"https://fbref.com/en/players/1fb1c435/Rodrigo"
"12446","Georginio Rutter_2023",2023,"Leeds United","Premier League","Georginio Rutter","FRA","FW,MF","20",2002,3,10,9,5,3,2,5,8,62.5,3,5,0,5,3,13,3,0,"https://fbref.com/en/players/c64c01fc/Georginio-Rutter"
"12447","Luis Sinisterra_2023",2023,"Leeds United","Premier League","Luis Sinisterra","COL","FW","23",1999,9.6,21,14,8,9,4,11,18,61.1,7,11,1,10,8,29,2,0,"https://fbref.com/en/players/8e16dd48/Luis-Sinisterra"
"12448","Pascal Struijk_2023",2023,"Leeds United","Premier League","Pascal Struijk","NED","DF","22",1999,24.4,84,57,43,31,10,49,75,65.3,26,32,12,20,32,116,70,1,"https://fbref.com/en/players/f4d296e4/Pascal-Struijk"
"12449","Crysencio Summerville_2023",2023,"Leeds United","Premier League","Crysencio Summerville","NED","FW","20",2001,15.8,30,20,14,14,2,11,23,47.8,12,20,2,18,13,43,11,0,"https://fbref.com/en/players/df04eb4b/Crysencio-Summerville"
"12450","Maximilian Wöber_2023",2023,"Leeds United","Premier League","Maximilian Wöber","AUT","DF","24",1998,14.1,25,18,9,15,1,16,24,66.7,8,32,14,18,27,52,67,1,"https://fbref.com/en/players/4b803b3c/Maximilian-Wober"
"12451","Marc Albrighton_2023",2023,"Leicester City","Premier League","Marc Albrighton","ENG","FW,MF","32",1989,2.6,4,1,0,2,2,1,8,12.5,7,6,2,4,1,5,5,0,"https://fbref.com/en/players/b827d5b3/Marc-Albrighton"
"12452","Daniel Amartey_2023",2023,"Leicester City","Premier League","Daniel Amartey","GHA","DF","27",1994,17.9,19,8,13,5,1,12,14,85.7,2,24,17,7,8,27,71,0,"https://fbref.com/en/players/1a4ef233/Daniel-Amartey"
"12453","Harvey Barnes_2023",2023,"Leicester City","Premier League","Harvey Barnes","ENG","FW,MF","24",1997,30.1,26,14,8,14,4,14,42,33.3,28,32,1,31,8,34,12,0,"https://fbref.com/en/players/3ea50f67/Harvey-Barnes"
"12454","Victor Bernth Kristiansen_2023",2023,"Leicester City","Premier League","Victor Bernth Kristiansen","DEN","DF","19",2002,9.9,38,23,18,16,4,22,30,73.3,8,16,4,12,3,41,26,0,"https://fbref.com/en/players/505486d6/Victor-Bernth-Kristiansen"
"12455","Lewis Brunt_2023",2023,"Leicester City","Premier League","Lewis Brunt","ENG","DF","21",2000,0.3,0,0,0,0,0,0,0,NA,0,0,0,0,0,0,2,0,"https://fbref.com/en/players/a2081c6b/Lewis-Brunt"
"12456","Timothy Castagne_2023",2023,"Leicester City","Premier League","Timothy Castagne","BEL","DF","26",1995,36.2,87,44,53,27,7,41,84,48.8,43,50,13,37,43,130,110,0,"https://fbref.com/en/players/197640fd/Timothy-Castagne"
"12457","Patson Daka_2023",2023,"Leicester City","Premier League","Patson Daka","ZAM","FW","23",1998,13.2,14,8,6,8,0,3,12,25,9,14,2,12,7,21,7,0,"https://fbref.com/en/players/ca45605e/Patson-Daka"
"12458","Kiernan Dewsbury-Hall_2023",2023,"Leicester City","Premier League","Kiernan Dewsbury-Hall","ENG","MF","23",1998,25.6,53,29,14,34,5,19,47,40.4,28,55,13,42,28,81,21,0,"https://fbref.com/en/players/5c74c0f5/Kiernan-Dewsbury-Hall"
"12459","Jonny Evans_2023",2023,"Leicester City","Premier League","Jonny Evans","NIR","DF","34",1988,11.7,13,5,12,1,0,7,11,63.6,4,15,11,4,18,31,51,0,"https://fbref.com/en/players/f8fcd2a5/Jonny-Evans"
"12460","Wout Faes_2023",2023,"Leicester City","Premier League","Wout Faes","BEL","DF","24",1998,31,56,33,28,26,2,28,44,63.6,16,53,37,16,41,97,113,2,"https://fbref.com/en/players/9c221d14/Wout-Faes"
"12461","Wesley Fofana_2023",2023,"Leicester City","Premier League","Wesley Fofana","FRA","DF","21",2000,2,4,2,1,2,1,1,3,33.3,2,1,1,0,9,13,5,0,"https://fbref.com/en/players/132a82f1/Wesley-Fofana"
"12462","Kelechi Iheanacho_2023",2023,"Leicester City","Premier League","Kelechi Iheanacho","NGA","FW,MF","25",1996,12.5,7,2,0,3,4,3,10,30,7,9,1,8,0,7,8,0,"https://fbref.com/en/players/c92e1a31/Kelechi-Iheanacho"
"12463","Daniel Iversen_2023",2023,"Leicester City","Premier League","Daniel Iversen","DEN","GK","25",1997,12,0,0,0,0,0,0,0,NA,0,0,0,0,0,0,6,1,"https://fbref.com/en/players/10d221cd/Daniel-Iversen"
"12464","James Justin_2023",2023,"Leicester City","Premier League","James Justin","ENG","DF","24",1998,13.9,20,18,7,12,1,9,14,64.3,5,24,6,18,15,35,47,0,"https://fbref.com/en/players/fb614c44/James-Justin"
"12465","James Maddison_2023",2023,"Leicester City","Premier League","James Maddison","ENG","MF,FW","25",1996,27.6,51,26,25,19,7,19,50,38,31,19,1,18,13,64,6,1,"https://fbref.com/en/players/ee38d9c5/James-Maddison"
"12466","Nampalys Mendy_2023",2023,"Leicester City","Premier League","Nampalys Mendy","SEN","MF","30",1992,8.4,13,9,7,6,0,8,15,53.3,7,20,4,16,13,26,2,0,"https://fbref.com/en/players/1598599e/Nampalys-Mendy"
"12467","Wilfred Ndidi_2023",2023,"Leicester City","Premier League","Wilfred Ndidi","NGA","MF","25",1996,18.7,61,42,34,24,3,17,43,39.5,26,32,14,18,38,99,48,3,"https://fbref.com/en/players/6b47c5db/Wilfred-Ndidi"
"12468","Ricardo Pereira_2023",2023,"Leicester City","Premier League","Ricardo Pereira","POR","DF,MF","28",1993,5,11,7,8,3,0,7,17,41.2,10,8,2,6,4,15,20,0,"https://fbref.com/en/players/75a72a99/Ricardo-Pereira"
"12469","Ayoze Pérez_2023",2023,"Leicester City","Premier League","Ayoze Pérez","ESP","MF,FW","29",1993,4.2,11,8,5,4,2,8,19,42.1,11,6,0,6,2,13,3,0,"https://fbref.com/en/players/819aa8e7/Ayoze-Perez"
"12470","Dennis Praet_2023",2023,"Leicester City","Premier League","Dennis Praet","BEL","MF,FW","28",1994,7.2,12,9,5,6,1,6,11,54.5,5,12,2,10,5,17,6,0,"https://fbref.com/en/players/86695068/Dennis-Praet"
"12471","Boubakary Soumaré_2023",2023,"Leicester City","Premier League","Boubakary Soumaré","FRA","MF","23",1999,18.1,57,34,29,26,2,23,43,53.5,20,15,4,11,33,90,27,1,"https://fbref.com/en/players/ae59b359/Boubakary-Soumare"
"12472","Harry Souttar_2023",2023,"Leicester City","Premier League","Harry Souttar","AUS","DF","23",1998,11,15,9,10,5,0,7,18,38.9,11,16,12,4,12,27,45,0,"https://fbref.com/en/players/0a6cb1b1/Harry-Souttar"
"12473","Çağlar Söyüncü_2023",2023,"Leicester City","Premier League","Çağlar Söyüncü","TUR","DF","26",1996,5.9,14,9,10,4,0,7,10,70,3,9,8,1,7,21,30,0,"https://fbref.com/en/players/21166ff4/Caglar-Soyuncu"
"12474","Tetê_2023",2023,"Leicester City","Premier League","Tetê","BRA","FW","22",2000,8.2,14,8,5,7,2,6,21,28.6,15,9,0,9,2,16,3,0,"https://fbref.com/en/players/7120a04d/Tete"
"12475","Luke Thomas_2023",2023,"Leicester City","Premier League","Luke Thomas","ENG","DF","21",2001,11.9,23,19,15,5,3,15,32,46.9,17,20,4,16,27,50,35,0,"https://fbref.com/en/players/fc027d02/Luke-Thomas"
"12476","Youri Tielemans_2023",2023,"Leicester City","Premier League","Youri Tielemans","BEL","MF","25",1997,26,66,39,27,30,9,23,61,37.7,38,35,8,27,28,94,24,1,"https://fbref.com/en/players/56f7a928/Youri-Tielemans"
"12477","Jamie Vardy_2023",2023,"Leicester City","Premier League","Jamie Vardy","ENG","FW","35",1987,20.6,10,5,4,3,3,1,7,14.3,6,17,3,14,2,12,30,0,"https://fbref.com/en/players/45963054/Jamie-Vardy"
"12478","Danny Ward_2023",2023,"Leicester City","Premier League","Danny Ward","WAL","GK","29",1993,26,1,1,1,0,0,1,3,33.3,2,0,0,0,0,1,14,2,"https://fbref.com/en/players/d3ce0e89/Danny-Ward"
"12479","Salis Abdul Samed_2023",2023,"Lens","Ligue 1","Salis Abdul Samed","GHA","MF","22",2000,32.2,46,26,18,23,5,29,52,55.8,23,38,9,29,36,82,26,0,"https://fbref.com/en/players/82464ce3/Salis-Abdul-Samed"
"12480","Patrick Berg_2023",2023,"Lens","Ligue 1","Patrick Berg","NOR","MF,FW","24",1997,0.3,0,0,0,0,0,0,1,0,1,0,0,0,1,1,0,0,"https://fbref.com/en/players/e4114f5d/Patrick-Berg"
"12481","Ismaëlben Boura_2023",2023,"Lens","Ligue 1","Ismaëlben Boura","FRA","DF,FW","21",2000,1,6,4,4,2,0,5,6,83.3,1,2,1,1,2,8,3,0,"https://fbref.com/en/players/62e02107/Ismaelben-Boura"
"12482","Adam Buksa_2023",2023,"Lens","Ligue 1","Adam Buksa","POL","FW,MF","26",1996,1.1,1,0,0,0,1,0,3,0,3,0,0,0,0,1,0,0,"https://fbref.com/en/players/3b676989/Adam-Buksa"
"12483","Jimmy Cabot_2023",2023,"Lens","Ligue 1","Jimmy Cabot","FRA","DF,MF","28",1994,5.7,20,12,10,8,2,12,26,46.2,14,5,0,5,4,24,12,0,"https://fbref.com/en/players/46359159/Jimmy-Cabot"
"12484","Alexis Claude-Maurice_2023",2023,"Lens","Ligue 1","Alexis Claude-Maurice","FRA","MF,FW","24",1998,6.7,14,9,5,8,1,6,16,37.5,10,6,0,6,2,16,1,0,"https://fbref.com/en/players/741418c3/Alexis-Claude-Maurice"
"12485","David Pereira da Costa_2023",2023,"Lens","Ligue 1","David Pereira da Costa","POR","MF,FW","21",2001,15.6,13,7,1,10,2,7,19,36.8,12,19,1,18,11,24,6,0,"https://fbref.com/en/players/59948ef7/David-Pereira-da-Costa"
"12486","Kevin Danso_2023",2023,"Lens","Ligue 1","Kevin Danso","AUT","DF","23",1998,35.9,37,19,25,11,1,19,30,63.3,11,48,34,14,33,70,124,0,"https://fbref.com/en/players/6e33125f/Kevin-Danso"
"12487","Seko Fofana_2023",2023,"Lens","Ligue 1","Seko Fofana","CIV","MF","27",1995,34.1,28,13,8,18,2,15,39,38.5,24,17,4,13,19,47,14,0,"https://fbref.com/en/players/5313ed43/Seko-Fofana"
"12488","Steven Fortes_2023",2023,"Lens","Ligue 1","Steven Fortes","CPV","DF","30",1992,0.1,0,0,0,0,0,0,0,NA,0,0,0,0,0,0,0,0,"https://fbref.com/en/players/574aa9ec/Steven-Fortes"
"12489","Przemysław Frankowski_2023",2023,"Lens","Ligue 1","Przemysław Frankowski","POL","DF,MF","27",1995,31.5,77,51,37,31,9,39,80,48.8,41,38,6,32,41,118,42,2,"https://fbref.com/en/players/00a8d210/Przemyslaw-Frankowski"
"12490","Angelo Fulgini_2023",2023,"Lens","Ligue 1","Angelo Fulgini","FRA","MF,FW","25",1996,9.5,14,7,2,4,8,5,14,35.7,9,11,0,11,8,22,2,0,"https://fbref.com/en/players/4b96c347/Angelo-Fulgini"
"12491","Ignatius Ganago_2023",2023,"Lens","Ligue 1","Ignatius Ganago","CMR","FW","23",1999,0.7,0,0,0,0,0,0,0,NA,0,0,0,0,0,0,1,0,"https://fbref.com/en/players/23c63b7f/Ignatius-Ganago"
"12492","Jonathan Gradit_2023",2023,"Lens","Ligue 1","Jonathan Gradit","FRA","DF","29",1992,31.4,62,40,30,25,7,31,53,58.5,22,40,26,14,38,100,83,0,"https://fbref.com/en/players/06c48679/Jonathan-Gradit"
"12493","Massadio Haïdara_2023",2023,"Lens","Ligue 1","Massadio Haïdara","MLI","DF,MF","29",1992,18.6,24,16,9,9,6,12,24,50,12,26,9,17,36,60,39,1,"https://fbref.com/en/players/5167c97e/Massadio-Haidara"
"12494","Gaël Kakuta_2023",2023,"Lens","Ligue 1","Gaël Kakuta","COD","FW","31",1991,0.2,0,0,0,0,0,0,0,NA,0,0,0,0,0,0,1,0,"https://fbref.com/en/players/5b1bf5e3/Gael-Kakuta"
"12495","Rémy Labeau Lascary_2023",2023,"Lens","Ligue 1","Rémy Labeau Lascary","GLP","FW,MF","19",2003,1.4,4,2,4,0,0,0,0,NA,0,4,0,4,1,5,0,0,"https://fbref.com/en/players/c90f380c/Remy-Labeau-Lascary"
"12496","Julien Le Cardinal_2023",2023,"Lens","Ligue 1","Julien Le Cardinal","FRA","DF","24",1997,1.8,6,4,5,0,1,4,6,66.7,2,3,0,3,2,8,5,0,"https://fbref.com/en/players/547a72ad/Julien-Le-Cardinal"
"12497","Jean-Louis Leca_2023",2023,"Lens","Ligue 1","Jean-Louis Leca","FRA","GK","36",1985,1,0,0,0,0,0,0,0,NA,0,0,0,0,0,0,0,1,"https://fbref.com/en/players/edbe46dc/Jean-Louis-Leca"
"12498","Deiver Machado_2023",2023,"Lens","Ligue 1","Deiver Machado","COL","DF,MF","28",1993,24.3,45,26,18,20,7,21,34,61.8,13,21,4,17,21,66,27,0,"https://fbref.com/en/players/b3f8bdef/Deiver-Machado"
"12499","Facundo Medina_2023",2023,"Lens","Ligue 1","Facundo Medina","ARG","DF","23",1999,30.9,31,20,16,15,0,13,35,37.1,22,25,9,16,26,57,62,1,"https://fbref.com/en/players/6f5ec8bb/Facundo-Medina"
"12500","Jean Onana_2023",2023,"Lens","Ligue 1","Jean Onana","CMR","MF,DF","22",2000,9,28,17,8,17,3,10,22,45.5,12,15,5,10,18,46,20,0,"https://fbref.com/en/players/b5bb8188/Jean-Onana"
"12501","Loïs Openda_2023",2023,"Lens","Ligue 1","Loïs Openda","BEL","FW","22",2000,28,11,9,2,6,3,2,13,15.4,11,9,0,9,2,13,6,0,"https://fbref.com/en/players/8652a85c/Lois-Openda"
"12502","Łukasz Poręba_2023",2023,"Lens","Ligue 1","Łukasz Poręba","POL","MF","22",2000,2.9,5,4,2,1,2,2,3,66.7,1,3,0,3,4,9,2,0,"https://fbref.com/en/players/be98f358/Lukasz-Poreba"
"12503","Wesley Saïd_2023",2023,"Lens","Ligue 1","Wesley Saïd","FRA","FW,MF","27",1995,7.2,4,1,1,2,1,2,6,33.3,4,4,0,4,1,5,2,0,"https://fbref.com/en/players/90fcf472/Wesley-Said"
"12504","Brice Samba_2023",2023,"Lens","Ligue 1","Brice Samba","FRA","GK","28",1994,37,1,0,1,0,0,1,2,50,1,1,0,1,0,1,12,2,"https://fbref.com/en/players/60d90c55/Brice-Samba"
"12505","Florian Sotoca_2023",2023,"Lens","Ligue 1","Florian Sotoca","FRA","MF,FW","31",1990,33.9,39,19,11,17,11,15,40,37.5,25,41,2,39,29,68,51,0,"https://fbref.com/en/players/7a42d0df/Florian-Sotoca"
"12506","Adrien Thomasson_2023",2023,"Lens","Ligue 1","Adrien Thomasson","FRA","MF,FW","28",1993,14.2,24,17,8,11,5,12,45,26.7,33,25,2,23,4,28,17,0,"https://fbref.com/en/players/c76b7567/Adrien-Thomasson"
"12507","Christopher Wooh_2023",2023,"Lens","Ligue 1","Christopher Wooh","CMR","MF","20",2001,0,0,0,0,0,0,0,1,0,1,0,0,0,0,0,1,0,"https://fbref.com/en/players/b003239d/Christopher-Wooh"
"12508","Amine Adli_2023",2023,"Leverkusen","Bundesliga","Amine Adli","FRA","FW,MF","22",2000,15.9,18,10,4,6,8,5,17,29.4,12,28,2,26,6,24,7,0,"https://fbref.com/en/players/dcfb17f4/Amine-Adli"
"12509","Nadiem Amiri_2023",2023,"Leverkusen","Bundesliga","Nadiem Amiri","GER","MF,FW","25",1996,10.9,15,6,5,8,2,9,20,45,11,12,1,11,6,21,10,2,"https://fbref.com/en/players/555d5edd/Nadiem-Amiri"
"12510","Robert Andrich_2023",2023,"Leverkusen","Bundesliga","Robert Andrich","GER","MF","27",1994,26.7,61,38,30,27,4,26,45,57.8,19,27,9,18,42,103,55,2,"https://fbref.com/en/players/e0b113a7/Robert-Andrich"
"12511","Charles Aránguiz_2023",2023,"Leverkusen","Bundesliga","Charles Aránguiz","CHI","MF","33",1989,5.5,17,7,7,10,0,12,20,60,8,4,0,4,7,24,4,0,"https://fbref.com/en/players/56413b1f/Charles-Aranguiz"
"12512","Ayman Azhil_2023",2023,"Leverkusen","Bundesliga","Ayman Azhil","MAR","MF","21",2001,0,0,0,0,0,0,0,0,NA,0,0,0,0,0,0,0,0,"https://fbref.com/en/players/ce81d82d/Ayman-Azhil"
"12513","Sardar Azmoun_2023",2023,"Leverkusen","Bundesliga","Sardar Azmoun","IRN","FW,MF","27",1995,10.3,6,3,1,4,1,1,7,14.3,6,4,0,4,2,8,14,0,"https://fbref.com/en/players/10549b49/Sardar-Azmoun"
"12514","Mitchel Bakker_2023",2023,"Leverkusen","Bundesliga","Mitchel Bakker","NED","DF,MF","22",2000,18.4,16,8,9,7,0,6,15,40,9,20,2,18,15,31,20,2,"https://fbref.com/en/players/a8567629/Mitchel-Bakker"
"12515","Karim Bellarabi_2023",2023,"Leverkusen","Bundesliga","Karim Bellarabi","GER","FW,MF","32",1990,0.9,2,0,1,1,0,2,3,66.7,1,0,0,0,0,2,0,0,"https://fbref.com/en/players/bee0bab1/Karim-Bellarabi"
"12516","Kerem Demirbay_2023",2023,"Leverkusen","Bundesliga","Kerem Demirbay","GER","MF","29",1993,17.2,36,18,16,17,3,18,34,52.9,16,26,6,20,16,52,11,0,"https://fbref.com/en/players/54b4dc4e/Kerem-Demirbay"
"12517","Moussa Diaby_2023",2023,"Leverkusen","Bundesliga","Moussa Diaby","FRA","FW,MF","23",1999,30,14,8,4,8,2,7,14,50,7,8,0,8,5,19,3,0,"https://fbref.com/en/players/aeed5c06/Moussa-Diaby"
"12518","Timothy Fosu-Mensah_2023",2023,"Leverkusen","Bundesliga","Timothy Fosu-Mensah","NED","DF","24",1998,2.1,7,5,3,3,1,4,4,100,0,2,0,2,0,7,1,0,"https://fbref.com/en/players/a9142dc3/Timothy-Fosu-Mensah"
"12519","Jeremie Frimpong_2023",2023,"Leverkusen","Bundesliga","Jeremie Frimpong","NED","DF,MF","21",2000,30.1,53,27,22,26,5,23,44,52.3,21,24,3,21,16,69,40,0,"https://fbref.com/en/players/74f2e748/Jeremie-Frimpong"
"12520","Piero Hincapié_2023",2023,"Leverkusen","Bundesliga","Piero Hincapié","ECU","DF","20",2002,27.3,51,34,28,20,3,25,38,65.8,13,41,20,21,31,82,83,1,"https://fbref.com/en/players/0c7a48f8/Piero-Hincapie"
"12521","Adam Hložek_2023",2023,"Leverkusen","Bundesliga","Adam Hložek","CZE","FW,MF","20",2002,14.3,9,4,4,3,2,3,9,33.3,6,9,2,7,6,15,9,0,"https://fbref.com/en/players/5521f419/Adam-Hlozek"
"12522","Lukáš Hrádecký_2023",2023,"Leverkusen","Bundesliga","Lukáš Hrádecký","FIN","GK","32",1989,33,0,0,0,0,0,0,0,NA,0,0,0,0,0,0,3,3,"https://fbref.com/en/players/ad3389d5/Lukas-Hradecky"
"12523","Callum Hudson-Odoi_2023",2023,"Leverkusen","Bundesliga","Callum Hudson-Odoi","ENG","FW,MF","21",2000,6.7,5,3,4,0,1,1,1,100,0,0,0,0,2,7,4,0,"https://fbref.com/en/players/15f3ec41/Callum-Hudson-Odoi"
"12524","Odilon Kossonou_2023",2023,"Leverkusen","Bundesliga","Odilon Kossonou","CIV","DF","21",2001,16.9,21,14,12,7,2,8,16,50,8,26,11,15,24,45,58,1,"https://fbref.com/en/players/1f3afdcb/Odilon-Kossonou"
"12525","Andrey Lunyov_2023",2023,"Leverkusen","Bundesliga","Andrey Lunyov","RUS","GK","30",1991,1,0,0,0,0,0,0,0,NA,0,0,0,0,0,0,0,0,"https://fbref.com/en/players/8a6ab963/Andrey-Lunyov"
"12526","Noah Mbamba_2023",2023,"Leverkusen","Bundesliga","Noah Mbamba","BEL","MF","17",2005,0,0,0,0,0,0,0,0,NA,0,0,0,0,0,0,0,0,"https://fbref.com/en/players/e75129bd/Noah-Mbamba"
"12527","Exequiel Palacios_2023",2023,"Leverkusen","Bundesliga","Exequiel Palacios","ARG","MF","23",1998,18.4,59,36,20,33,6,29,48,60.4,19,29,2,27,33,92,28,0,"https://fbref.com/en/players/e82adcab/Exequiel-Palacios"
"12528","Paulinho_2023",2023,"Leverkusen","Bundesliga","Paulinho","BRA","FW","22",2000,0.9,0,0,0,0,0,0,0,NA,0,1,0,1,0,0,2,0,"https://fbref.com/en/players/53070b63/Paulinho"
"12529","Joel Pohjanpalo_2023",2023,"Leverkusen","Bundesliga","Joel Pohjanpalo","FIN","FW,MF","27",1994,0,0,0,0,0,0,0,0,NA,0,0,0,0,0,0,0,0,"https://fbref.com/en/players/ea003d07/Joel-Pohjanpalo"
"12530","Patrik Schick_2023",2023,"Leverkusen","Bundesliga","Patrik Schick","CZE","FW","26",1996,10.5,0,0,0,0,0,0,1,0,1,4,1,3,1,1,7,0,"https://fbref.com/en/players/5d4f7d61/Patrik-Schick"
"12531","Daley Sinkgraven_2023",2023,"Leverkusen","Bundesliga","Daley Sinkgraven","NED","DF,MF","27",1995,3.8,10,7,7,3,0,7,9,77.8,2,8,4,4,5,15,7,0,"https://fbref.com/en/players/73000a79/Daley-Sinkgraven"
"12532","Jonathan Tah_2023",2023,"Leverkusen","Bundesliga","Jonathan Tah","GER","DF","26",1996,27.6,25,12,21,4,0,12,18,66.7,6,30,18,12,40,65,118,0,"https://fbref.com/en/players/bd142efb/Jonathan-Tah"
"12533","Edmond Tapsoba_2023",2023,"Leverkusen","Bundesliga","Edmond Tapsoba","BFA","DF","23",1999,31.9,51,30,35,12,4,30,42,71.4,12,40,17,23,36,87,109,1,"https://fbref.com/en/players/a73c8f95/Edmond-Tapsoba"
"12534","Florian Wirtz_2023",2023,"Leverkusen","Bundesliga","Florian Wirtz","GER","FW,MF","19",2003,12.1,18,10,9,7,2,8,16,50,8,15,1,14,1,19,6,0,"https://fbref.com/en/players/e7fcf289/Florian-Wirtz"
"12535","Benjamin André_2023",2023,"Lille","Ligue 1","Benjamin André","FRA","MF","31",1990,32.4,128,74,51,60,17,65,121,53.7,56,50,8,42,47,175,60,0,"https://fbref.com/en/players/ef9c1c95/Benjamin-Andre"
"12536","Carlos Baleba_2023",2023,"Lille","Ligue 1","Carlos Baleba","CMR","MF","18",2004,5.3,13,11,2,9,2,9,14,64.3,5,13,3,10,1,14,3,2,"https://fbref.com/en/players/a1390d2f/Carlos-Baleba"
"12537","Jonathan Bamba_2023",2023,"Lille","Ligue 1","Jonathan Bamba","CIV","FW","26",1996,30.9,37,17,12,14,11,14,45,31.1,31,36,1,35,22,59,14,0,"https://fbref.com/en/players/b2bd0f6c/Jonathan-Bamba"
"12538","Rémy Cabella_2023",2023,"Lille","Ligue 1","Rémy Cabella","FRA","MF,FW","32",1990,28.1,64,37,21,28,15,29,64,45.3,35,41,5,36,17,81,7,1,"https://fbref.com/en/players/148e136f/Remy-Cabella"
"12539","Leonardo César Jardim_2023",2023,"Lille","Ligue 1","Leonardo César Jardim","BRA","GK","27",1995,6,NA,0,NA,NA,NA,NA,NA,NA,NA,NA,NA,NA,0,NA,NA,NA,"https://fbref.com/en/players/f5dfc256/Leonardo-Cesar-Jardim"
"12540","Lucas Chevalier_2023",2023,"Lille","Ligue 1","Lucas Chevalier","FRA","GK","20",2001,32,2,1,2,0,0,2,2,100,0,1,0,1,2,4,7,2,"https://fbref.com/en/players/b3d76d84/Lucas-Chevalier"
"12541","Jonathan David_2023",2023,"Lille","Ligue 1","Jonathan David","CAN","FW","22",2000,35.2,24,17,6,11,7,10,27,37,17,20,2,18,8,32,13,0,"https://fbref.com/en/players/ce50fd99/Jonathan-David"
"12542","Bafodé Diakité_2023",2023,"Lille","Ligue 1","Bafodé Diakité","FRA","DF","21",2001,29.5,54,35,23,24,7,32,57,56.1,25,37,8,29,17,71,58,0,"https://fbref.com/en/players/1bfb6fef/Bafode-Diakite"
"12543","Tiago Djaló_2023",2023,"Lille","Ligue 1","Tiago Djaló","POR","DF","22",2000,22.4,31,21,23,7,1,13,20,65,7,17,11,6,23,54,60,1,"https://fbref.com/en/players/b2336681/Tiago-Djalo"
"12544","José Fonte_2023",2023,"Lille","Ligue 1","José Fonte","POR","DF","38",1983,28.8,23,17,18,4,1,10,21,47.6,11,27,14,13,25,48,112,2,"https://fbref.com/en/players/90f87966/Jose-Fonte"
"12545","André Gomes_2023",2023,"Lille","Ligue 1","André Gomes","POR","MF","29",1993,18.1,37,19,12,17,8,19,52,36.5,33,20,5,15,9,46,16,1,"https://fbref.com/en/players/1961b2aa/Andre-Gomes"
"12546","Angel Gomes_2023",2023,"Lille","Ligue 1","Angel Gomes","ENG","MF","21",2000,31.3,41,19,12,21,8,18,49,36.7,31,22,2,20,13,54,11,1,"https://fbref.com/en/players/645a3363/Angel-Gomes"
"12547","Gabriel Gudmundsson_2023",2023,"Lille","Ligue 1","Gabriel Gudmundsson","SWE","DF,FW","23",1999,9.3,19,11,7,10,2,12,22,54.5,10,11,2,9,10,29,20,0,"https://fbref.com/en/players/d5d22a58/Gabriel-Gudmundsson"
"12548","Ismaily_2023",2023,"Lille","Ligue 1","Ismaily","BRA","DF","32",1990,19.8,41,18,16,16,9,17,32,53.1,15,25,5,20,21,62,39,0,"https://fbref.com/en/players/cf182add/Ismaily"
"12549","Mohamed Lamine Bayo_2023",2023,"Lille","Ligue 1","Mohamed Lamine Bayo","GUI","FW,MF","24",1998,7.2,3,3,0,2,1,0,12,0,12,3,1,2,0,3,1,0,"https://fbref.com/en/players/01870104/Mohamed-Lamine-Bayo"
"12550","Jonas Martin_2023",2023,"Lille","Ligue 1","Jonas Martin","FRA","MF","32",1990,3.1,9,7,4,5,0,5,14,35.7,9,3,1,2,7,16,3,0,"https://fbref.com/en/players/468fdbad/Jonas-Martin"
"12551","Amine Messoussa_2023",2023,"Lille","Ligue 1","Amine Messoussa","FRA","FW","17",2004,0,0,0,0,0,0,0,0,NA,0,0,0,0,0,0,0,0,"https://fbref.com/en/players/f29131b5/Amine-Messoussa"
"12552","Adam Ounas_2023",2023,"Lille","Ligue 1","Adam Ounas","ALG","FW,MF","25",1996,11.8,20,11,4,10,6,8,13,61.5,5,16,0,16,7,27,5,0,"https://fbref.com/en/players/ed90babd/Adam-Ounas"
"12553","Simon Ramet_2023",2023,"Lille","Ligue 1","Simon Ramet","FRA","DF","19",2003,0,0,0,0,0,0,0,0,NA,0,0,0,0,0,0,0,0,"https://fbref.com/en/players/ed8cecc9/Simon-Ramet"
"12554","Alexsandro Ribeiro_2023",2023,"Lille","Ligue 1","Alexsandro Ribeiro","BRA","DF","22",1999,17.9,32,18,24,7,1,19,28,67.9,9,11,2,9,25,57,59,1,"https://fbref.com/en/players/102c9665/Alexsandro-Ribeiro"
"12555","Alan Virginius_2023",2023,"Lille","Ligue 1","Alan Virginius","FRA","FW","19",2003,2.9,3,2,1,1,1,0,4,0,4,0,0,0,2,5,1,0,"https://fbref.com/en/players/01becd60/Alan-Virginius"
"12556","Timothy Weah_2023",2023,"Lille","Ligue 1","Timothy Weah","USA","DF,FW","22",2000,19.4,24,14,13,9,2,16,29,55.2,13,17,3,14,23,47,18,0,"https://fbref.com/en/players/8eec784d/Timothy-Weah"
"12557","Yusuf Yazıcı_2023",2023,"Lille","Ligue 1","Yusuf Yazıcı","TUR","MF","25",1997,2.2,0,0,0,0,0,0,0,NA,0,2,0,2,0,0,1,0,"https://fbref.com/en/players/f5c8b425/Yusuf-Yazici"
"12558","Leny Yoro_2023",2023,"Lille","Ligue 1","Leny Yoro","FRA","DF","16",2005,8.5,11,5,8,3,0,4,9,44.4,5,6,1,5,18,29,27,1,"https://fbref.com/en/players/6763f716/Leny-Yoro"
"12559","Akim Zedadka_2023",2023,"Lille","Ligue 1","Akim Zedadka","ALG","DF,MF","27",1995,3.9,1,1,1,0,0,0,2,0,2,3,0,3,2,3,6,0,"https://fbref.com/en/players/0ff630d0/Akim-Zedadka"
"12560","Edon Zhegrova_2023",2023,"Lille","Ligue 1","Edon Zhegrova","KVX","FW,MF","23",1999,11.7,18,12,6,7,5,12,20,60,8,9,0,9,2,20,2,0,"https://fbref.com/en/players/34a88e3e/Edon-Zhegrova"
"12561","Thiago Alcántara_2023",2023,"Liverpool","Premier League","Thiago Alcántara","ESP","MF","31",1991,13.9,43,24,20,21,2,14,23,60.9,9,15,3,12,21,64,13,2,"https://fbref.com/en/players/77e84962/Thiago-Alcantara"
"12562","Trent Alexander-Arnold_2023",2023,"Liverpool","Premier League","Trent Alexander-Arnold","ENG","DF","23",1998,32.5,57,40,32,16,9,42,79,53.2,37,25,7,18,43,100,41,2,"https://fbref.com/en/players/cd1acf9d/Trent-Alexander-Arnold"
"12563","Alisson_2023",2023,"Liverpool","Premier League","Alisson","BRA","GK","29",1992,37,0,0,0,0,0,0,3,0,3,3,0,3,0,0,20,0,"https://fbref.com/en/players/7a2e46a8/Alisson"
"12564","Stefan Bajcetic_2023",2023,"Liverpool","Premier League","Stefan Bajcetic","ESP","MF","17",2004,5.8,9,6,5,3,1,8,27,29.6,19,7,0,7,9,18,4,0,"https://fbref.com/en/players/32e8417f/Stefan-Bajcetic"
"12565","Fabio Carvalho_2023",2023,"Liverpool","Premier League","Fabio Carvalho","POR","MF,FW","19",2002,3.9,8,8,3,3,2,3,6,50,3,6,0,6,6,14,0,0,"https://fbref.com/en/players/966e28d0/Fabio-Carvalho"
"12566","Bobby Clark_2023",2023,"Liverpool","Premier League","Bobby Clark","ENG","MF","17",2005,0.1,0,0,0,0,0,0,0,NA,0,2,0,2,0,0,0,0,"https://fbref.com/en/players/73341ace/Bobby-Clark"
"12567","Luis Díaz_2023",2023,"Liverpool","Premier League","Luis Díaz","COL","FW","25",1997,11.1,17,11,4,8,5,8,15,53.3,7,8,0,8,6,23,2,0,"https://fbref.com/en/players/4a1a9578/Luis-Diaz"
"12568","Ben Doak_2023",2023,"Liverpool","Premier League","Ben Doak","SCO","FW","16",2005,0.3,3,2,1,2,0,1,1,100,0,1,0,1,0,3,0,0,"https://fbref.com/en/players/733f1a7d/Ben-Doak"
"12569","Harvey Elliott_2023",2023,"Liverpool","Premier League","Harvey Elliott","ENG","MF,FW","19",2003,17.9,27,18,6,12,9,9,36,25,27,26,1,25,15,42,8,0,"https://fbref.com/en/players/c8387671/Harvey-Elliott"
"12570","Fabinho_2023",2023,"Liverpool","Premier League","Fabinho","BRA","MF","28",1993,29.7,65,38,18,40,7,24,62,38.7,38,38,11,27,37,102,40,0,"https://fbref.com/en/players/7f3b388c/Fabinho"
"12571","Roberto Firmino_2023",2023,"Liverpool","Premier League","Roberto Firmino","BRA","FW,MF","30",1991,13.5,17,12,2,12,3,4,21,19,17,16,1,15,7,24,2,0,"https://fbref.com/en/players/4c370d81/Roberto-Firmino"
"12572","Cody Gakpo_2023",2023,"Liverpool","Premier League","Cody Gakpo","NED","FW,MF","23",1999,16.2,26,15,4,13,9,13,38,34.2,25,13,1,12,4,30,2,0,"https://fbref.com/en/players/1971591f/Cody-Gakpo"
"12573","Joe Gomez_2023",2023,"Liverpool","Premier League","Joe Gomez","ENG","DF","25",1997,16.3,28,21,15,11,2,11,19,57.9,8,17,11,6,24,52,51,2,"https://fbref.com/en/players/7a11550b/Joe-Gomez"
"12574","Jordan Henderson_2023",2023,"Liverpool","Premier League","Jordan Henderson","ENG","MF","32",1990,23,32,23,10,18,4,15,36,41.7,21,21,3,18,21,53,16,1,"https://fbref.com/en/players/935e6b8f/Jordan-Henderson"
"12575","Curtis Jones_2023",2023,"Liverpool","Premier League","Curtis Jones","ENG","MF","21",2001,11.5,34,17,8,12,14,18,31,58.1,13,12,2,10,3,37,9,0,"https://fbref.com/en/players/4fb9c88f/Curtis-Jones"
"12576","Diogo Jota_2023",2023,"Liverpool","Premier League","Diogo Jota","POR","FW","25",1996,12.6,23,15,8,8,7,12,37,32.4,25,5,0,5,3,26,11,0,"https://fbref.com/en/players/178ae8f8/Diogo-Jota"
"12577","Naby Keïta_2023",2023,"Liverpool","Premier League","Naby Keïta","GUI","MF","27",1995,3.3,5,4,2,3,0,1,4,25,3,1,0,1,2,7,3,0,"https://fbref.com/en/players/f25c8e3a/Naby-Keita"
"12578","Caoimhín Kelleher_2023",2023,"Liverpool","Premier League","Caoimhín Kelleher","IRL","GK","23",1998,1,0,0,0,0,0,0,0,NA,0,0,0,0,0,0,0,0,"https://fbref.com/en/players/62d7ef38/Caoimhin-Kelleher"
"12579","Ibrahima Konaté_2023",2023,"Liverpool","Premier League","Ibrahima Konaté","FRA","DF","23",1999,17.2,38,26,25,13,0,16,27,59.3,11,12,5,7,26,64,61,4,"https://fbref.com/en/players/5ed9b537/Ibrahima-Konate"
"12580","Joël Matip_2023",2023,"Liverpool","Premier League","Joël Matip","CMR","DF","30",1991,12.1,14,8,12,2,0,11,23,47.8,12,8,3,5,21,35,45,3,"https://fbref.com/en/players/b217ef29/Joel-Matip"
"12581","James Milner_2023",2023,"Liverpool","Premier League","James Milner","ENG","MF,DF","36",1986,10.1,26,16,11,11,4,15,34,44.1,19,14,2,12,12,38,15,0,"https://fbref.com/en/players/2f90f6b8/James-Milner"
"12582","Darwin Núñez_2023",2023,"Liverpool","Premier League","Darwin Núñez","URU","FW","23",1999,18.8,11,5,2,4,5,4,17,23.5,13,10,0,10,3,14,13,0,"https://fbref.com/en/players/4d77b365/Darwin-Nunez"
"12583","Alex Oxlade-Chamberlain_2023",2023,"Liverpool","Premier League","Alex Oxlade-Chamberlain","ENG","FW,MF","28",1993,3.7,5,4,1,2,2,1,5,20,4,5,2,3,1,6,4,0,"https://fbref.com/en/players/38c7feef/Alex-Oxlade-Chamberlain"
"12584","Nathaniel Phillips_2023",2023,"Liverpool","Premier League","Nathaniel Phillips","ENG","DF","25",1997,0.7,2,1,0,2,0,2,2,100,0,0,0,0,2,4,1,0,"https://fbref.com/en/players/515ebe8d/Nathaniel-Phillips"
"12585","Andrew Robertson_2023",2023,"Liverpool","Premier League","Andrew Robertson","SCO","DF","28",1994,28.7,38,21,12,16,10,21,41,51.2,20,32,5,27,18,56,50,3,"https://fbref.com/en/players/2e4f5f03/Andrew-Robertson"
"12586","Mohamed Salah_2023",2023,"Liverpool","Premier League","Mohamed Salah","EGY","FW","30",1992,36.6,21,12,4,5,12,10,26,38.5,16,21,0,21,6,27,4,0,"https://fbref.com/en/players/e342ad68/Mohamed-Salah"
"12587","Kostas Tsimikas_2023",2023,"Liverpool","Premier League","Kostas Tsimikas","GRE","DF","26",1996,8.6,14,9,10,2,2,10,16,62.5,6,8,1,7,12,26,15,0,"https://fbref.com/en/players/f315ca93/Kostas-Tsimikas"
"12588","Virgil van Dijk_2023",2023,"Liverpool","Premier League","Virgil van Dijk","NED","DF","31",1991,31.5,27,14,13,11,3,8,19,42.1,11,24,16,8,31,58,138,2,"https://fbref.com/en/players/e06683ca/Virgil-van-Dijk"
"12589","Laurent Abergel_2023",2023,"Lorient","Ligue 1","Laurent Abergel","FRA","MF","29",1993,26,92,52,59,30,3,39,92,42.4,53,47,8,39,34,126,39,0,"https://fbref.com/en/players/31626657/Laurent-Abergel"
"12590","Adil Aouchiche_2023",2023,"Lorient","Ligue 1","Adil Aouchiche","FRA","MF","20",2002,2.8,5,2,3,1,1,1,9,11.1,8,1,0,1,4,9,1,0,"https://fbref.com/en/players/b94b8be1/Adil-Aouchiche"
"12591","Quentin Boisgard_2023",2023,"Lorient","Ligue 1","Quentin Boisgard","FRA","MF","25",1997,2,6,2,1,4,1,3,4,75,1,3,1,2,4,10,2,0,"https://fbref.com/en/players/f6496133/Quentin-Boisgard"
"12592","Igor Carioca_2023",2023,"Lorient","Ligue 1","Igor Carioca","BRA","DF","25",1996,5.1,18,11,12,2,4,12,21,57.1,9,7,0,7,5,23,17,0,"https://fbref.com/en/players/e3e32fbb/Igor-Carioca"
"12593","Yoann Cathline_2023",2023,"Lorient","Ligue 1","Yoann Cathline","FRA","FW,MF","20",2002,12.1,19,12,7,6,6,5,12,41.7,7,10,1,9,8,27,16,1,"https://fbref.com/en/players/4db5915d/Yoann-Cathline"
"12594","Stéphane Diarra_2023",2023,"Lorient","Ligue 1","Stéphane Diarra","FRA","FW,MF","23",1998,11.8,25,17,14,9,2,11,29,37.9,18,13,1,12,22,47,9,0,"https://fbref.com/en/players/29939a1d/Stephane-Diarra"
"12595","Bamba Dieng_2023",2023,"Lorient","Ligue 1","Bamba Dieng","SEN","FW","22",2000,8.3,19,10,5,12,2,3,11,27.3,8,6,0,6,2,21,6,0,"https://fbref.com/en/players/40774c6b/Bamba-Dieng"
"12596","Ckene Doucouré_2023",2023,"Lorient","Ligue 1","Ckene Doucouré","COM","FW,MF","20",2002,1.5,2,2,2,0,0,1,2,50,1,0,0,0,1,3,0,0,"https://fbref.com/en/players/92d90c8f/Ckene-Doucoure"
"12597","Romain Faivre_2023",2023,"Lorient","Ligue 1","Romain Faivre","FRA","MF,FW","24",1998,13.8,13,8,5,4,4,5,25,20,20,11,0,11,1,14,4,0,"https://fbref.com/en/players/745ca0a3/Romain-Faivre"
"12598","Adrian Grbić_2023",2023,"Lorient","Ligue 1","Adrian Grbić","AUT","MF,FW","25",1996,0.3,0,0,0,0,0,0,1,0,1,3,0,3,0,0,0,0,"https://fbref.com/en/players/4a987ffa/Adrian-Grbic"
"12599","Bonke Innocent_2023",2023,"Lorient","Ligue 1","Bonke Innocent","NGA","MF","26",1996,13.1,28,17,13,14,1,11,36,30.6,25,22,5,17,26,54,31,0,"https://fbref.com/en/players/546bb36e/Bonke-Innocent"
"12600","Eli Junior Kroupi_2023",2023,"Lorient","Ligue 1","Eli Junior Kroupi","FRA","FW,MF","16",2006,0.1,0,0,0,0,0,0,1,0,1,0,0,0,1,1,0,0,"https://fbref.com/en/players/b2fe86e5/Eli-Junior-Kroupi"
"12601","Gedeon Kalulu_2023",2023,"Lorient","Ligue 1","Gedeon Kalulu","COD","DF","24",1997,27.1,64,34,43,14,7,30,48,62.5,18,32,3,29,28,92,79,2,"https://fbref.com/en/players/dd211559/Gedeon-Kalulu"
"12602","Ayman Kari_2023",2023,"Lorient","Ligue 1","Ayman Kari","FRA","MF,DF","17",2004,1.1,0,0,0,0,0,0,0,NA,0,4,0,4,3,3,0,0,"https://fbref.com/en/players/0e8d7b6c/Ayman-Kari"
"12603","Ibrahima Koné_2023",2023,"Lorient","Ligue 1","Ibrahima Koné","MLI","FW","23",1999,17.5,24,13,3,13,8,5,11,45.5,6,13,0,13,4,28,18,0,"https://fbref.com/en/players/04bb2b06/Ibrahima-Kone"
"12604","Julien Laporte_2023",2023,"Lorient","Ligue 1","Julien Laporte","FRA","DF","28",1993,18.4,22,16,18,3,1,16,22,72.7,6,33,27,6,18,40,108,2,"https://fbref.com/en/players/f066022d/Julien-Laporte"
"12605","Armand Lauriente_2023",2023,"Lorient","Ligue 1","Armand Lauriente","FRA","FW","23",1998,3,8,7,3,4,1,3,7,42.9,4,5,1,4,4,12,1,0,"https://fbref.com/en/players/2d22cea7/Armand-Lauriente"
"12606","Théo Le Bris_2023",2023,"Lorient","Ligue 1","Théo Le Bris","FRA","MF,DF","19",2002,16.1,31,19,17,11,3,15,33,45.5,18,21,2,19,18,49,31,0,"https://fbref.com/en/players/afe39ca8/Theo-Le-Bris"
"12607","Enzo Le Fée_2023",2023,"Lorient","Ligue 1","Enzo Le Fée","FRA","MF","22",2000,33.6,108,64,52,40,16,43,113,38.1,70,50,5,45,34,142,38,1,"https://fbref.com/en/players/6f806d99/Enzo-Le-Fee"
"12608","Vincent Le Goff_2023",2023,"Lorient","Ligue 1","Vincent Le Goff","FRA","DF","32",1989,37,75,32,56,16,3,45,62,72.6,17,29,9,20,41,116,105,1,"https://fbref.com/en/players/2321ea6e/Vincent-Le-Goff"
"12609","Jean-Victor Makengo_2023",2023,"Lorient","Ligue 1","Jean-Victor Makengo","FRA","MF","24",1998,11.8,16,8,5,10,1,6,20,30,14,8,5,3,10,26,13,1,"https://fbref.com/en/players/22bfb57e/Jean-Victor-Makengo"
"12610","Vito Mannone_2023",2023,"Lorient","Ligue 1","Vito Mannone","ITA","GK","34",1988,17.9,0,0,0,0,0,0,0,NA,0,0,0,0,0,0,4,3,"https://fbref.com/en/players/c4173f1a/Vito-Mannone"
"12611","Chrislain Matsima_2023",2023,"Lorient","Ligue 1","Chrislain Matsima","FRA","DF,MF","20",2002,2.5,0,0,0,0,0,0,0,NA,0,3,3,0,2,2,7,0,"https://fbref.com/en/players/cf1ef7ec/Chrislain-Matsima"
"12612","Bamo Meïté_2023",2023,"Lorient","Ligue 1","Bamo Meïté","CIV","DF","21",2001,16.7,18,8,13,4,1,7,16,43.8,9,33,23,10,16,34,70,0,"https://fbref.com/en/players/04ac78d2/Bamo-Meite"
"12613","Terem Moffi_2023",2023,"Lorient","Ligue 1","Terem Moffi","NGA","FW","23",1999,15.4,8,5,1,4,3,3,5,60,2,11,3,8,3,11,10,0,"https://fbref.com/en/players/065dc209/Terem-Moffi"
"12614","Yvon Mvogo_2023",2023,"Lorient","Ligue 1","Yvon Mvogo","SUI","GK","28",1994,20.1,0,0,0,0,0,0,0,NA,0,0,0,0,2,2,6,3,"https://fbref.com/en/players/dc29b608/Yvon-Mvogo"
"12615","Dango Ouattara_2023",2023,"Lorient","Ligue 1","Dango Ouattara","BFA","FW,MF","20",2002,17.2,41,26,20,11,10,15,28,53.6,13,24,6,18,19,60,21,0,"https://fbref.com/en/players/2f9e4435/Dango-Ouattara"
"12616","Julien Ponceau_2023",2023,"Lorient","Ligue 1","Julien Ponceau","FRA","MF","21",2000,18.4,28,19,10,14,4,10,32,31.3,22,27,3,24,14,42,12,0,"https://fbref.com/en/players/e546b2e3/Julien-Ponceau"
"12617","Montassar Talbi_2023",2023,"Lorient","Ligue 1","Montassar Talbi","TUN","DF","24",1998,38,53,25,40,13,0,22,35,62.9,13,55,34,21,40,93,190,3,"https://fbref.com/en/players/a4a44eb0/Montassar-Talbi"
"12618","Darlin Yongwa_2023",2023,"Lorient","Ligue 1","Darlin Yongwa","CMR","DF","21",2000,8.7,13,11,7,5,1,4,15,26.7,11,13,1,12,5,18,11,0,"https://fbref.com/en/players/061266cd/Darlin-Yongwa"
"12619","Houssem Aouar_2023",2023,"Lyon","Ligue 1","Houssem Aouar","ALG","MF","24",1998,5.8,12,5,5,5,2,3,9,33.3,6,12,2,10,8,20,3,0,"https://fbref.com/en/players/a5db0bec/Houssem-Aouar"
"12620","Mohamed El Arouch_2023",2023,"Lyon","Ligue 1","Mohamed El Arouch","FRA","MF","18",2004,0,1,1,1,0,0,0,0,NA,0,0,0,0,0,1,0,0,"https://fbref.com/en/players/508a9011/Mohamed-El-Arouch"
"12621","Bradley Barcola_2023",2023,"Lyon","Ligue 1","Bradley Barcola","FRA","FW,MF","19",2002,16,25,16,8,10,7,8,39,20.5,31,29,0,29,19,44,10,0,"https://fbref.com/en/players/a0d55a09/Bradley-Barcola"
"12622","Jérôme Boateng_2023",2023,"Lyon","Ligue 1","Jérôme Boateng","GER","DF","33",1988,4.8,3,0,2,1,0,2,6,33.3,4,8,5,3,6,9,16,0,"https://fbref.com/en/players/2db2fd7b/Jerome-Boateng"
"12623","Maxence Caqueret_2023",2023,"Lyon","Ligue 1","Maxence Caqueret","FRA","MF","22",2000,30.7,87,54,27,38,22,43,109,39.4,66,45,3,42,39,126,27,0,"https://fbref.com/en/players/f81ef10d/Maxence-Caqueret"
"12624","Rayan Cherki_2023",2023,"Lyon","Ligue 1","Rayan Cherki","FRA","MF,FW","18",2003,20.8,14,8,2,5,7,8,23,34.8,15,6,0,6,5,19,1,0,"https://fbref.com/en/players/b34c63a5/Rayan-Cherki"
"12625","Damien Da Silva_2023",2023,"Lyon","Ligue 1","Damien Da Silva","FRA","DF","34",1988,3.8,8,7,5,3,0,3,3,100,0,4,3,1,5,13,12,0,"https://fbref.com/en/players/1ec7e1c5/Damien-Da-Silva"
"12626","Moussa Dembélé_2023",2023,"Lyon","Ligue 1","Moussa Dembélé","FRA","FW,MF","26",1996,9.7,8,4,3,3,2,4,7,57.1,3,5,0,5,2,10,6,0,"https://fbref.com/en/players/e7986081/Moussa-Dembele"
"12627","Sinaly Diomande_2023",2023,"Lyon","Ligue 1","Sinaly Diomande","CIV","DF","21",2001,21.7,42,24,26,15,1,31,49,63.3,18,26,13,13,49,91,75,1,"https://fbref.com/en/players/6de23ab0/Sinaly-Diomande"
"12628","Romain Faivre_2023",2023,"Lyon","Ligue 1","Romain Faivre","FRA","MF","24",1998,3.3,6,3,2,2,2,1,3,33.3,2,3,0,3,0,6,0,0,"https://fbref.com/en/players/745ca0a3/Romain-Faivre"
"12629","Malo Gusto_2023",2023,"Lyon","Ligue 1","Malo Gusto","FRA","DF","19",2003,17.7,42,26,23,11,8,21,43,48.8,22,22,5,17,28,70,23,1,"https://fbref.com/en/players/d56b9520/Malo-Gusto"
"12630","Henrique_2023",2023,"Lyon","Ligue 1","Henrique","BRA","DF,FW","28",1994,4,9,4,3,2,4,6,13,46.2,7,3,1,2,5,14,8,0,"https://fbref.com/en/players/f28474a4/Henrique"
"12631","Jefferson_2023",2023,"Lyon","Ligue 1","Jefferson","BRA","FW","22",1999,5,17,4,4,9,4,6,15,40,9,6,0,6,1,18,0,0,"https://fbref.com/en/players/45cce300/Jefferson"
"12632","Sael Kumbedi_2023",2023,"Lyon","Ligue 1","Sael Kumbedi","FRA","DF","17",2005,14.7,47,27,27,13,7,20,38,52.6,18,23,7,16,10,57,16,0,"https://fbref.com/en/players/c385bf49/Sael-Kumbedi"
"12633","Alexandre Lacazette_2023",2023,"Lyon","Ligue 1","Alexandre Lacazette","FRA","FW","31",1991,32.5,43,23,7,17,19,10,29,34.5,19,23,3,20,15,58,4,0,"https://fbref.com/en/players/9dbb75ca/Alexandre-Lacazette"
"12634","Johann Lepenant_2023",2023,"Lyon","Ligue 1","Johann Lepenant","FRA","MF","19",2002,21.5,58,34,24,27,7,32,86,37.2,54,29,5,24,28,86,17,3,"https://fbref.com/en/players/1e52971c/Johann-Lepenant"
"12635","Anthony Lopes_2023",2023,"Lyon","Ligue 1","Anthony Lopes","POR","GK","31",1990,31.3,1,0,1,0,0,1,4,25,3,0,0,0,3,4,10,0,"https://fbref.com/en/players/f00de885/Anthony-Lopes"
"12636","Dejan Lovren_2023",2023,"Lyon","Ligue 1","Dejan Lovren","CRO","DF","33",1989,16.2,25,19,20,5,0,20,29,69,9,20,10,10,26,51,70,1,"https://fbref.com/en/players/1a2935f6/Dejan-Lovren"
"12637","Castello Lukeba_2023",2023,"Lyon","Ligue 1","Castello Lukeba","FRA","DF","19",2002,33.2,39,23,27,8,4,21,31,67.7,10,42,24,18,75,114,105,1,"https://fbref.com/en/players/5b9512c5/Castello-Lukeba"
"12638","Thiago Mendes_2023",2023,"Lyon","Ligue 1","Thiago Mendes","BRA","MF,DF","30",1992,22.9,48,27,24,21,3,30,40,75,10,28,8,20,47,95,51,4,"https://fbref.com/en/players/c6e5d20f/Thiago-Mendes"
"12639","Lucas Paquetá_2023",2023,"Lyon","Ligue 1","Lucas Paquetá","BRA","MF","24",1997,1.8,5,4,0,5,0,1,3,33.3,2,2,0,2,1,6,3,0,"https://fbref.com/en/players/9b6f7fd5/Lucas-Paqueta"
"12640","Jeff Reine-Adélaïde_2023",2023,"Lyon","Ligue 1","Jeff Reine-Adélaïde","FRA","MF","24",1998,3.7,8,5,1,5,2,5,9,55.6,4,4,0,4,6,14,0,0,"https://fbref.com/en/players/d504b3e1/Jeff-Reine-Adelaide"
"12641","Rémy Riou_2023",2023,"Lyon","Ligue 1","Rémy Riou","FRA","GK","34",1987,6.7,1,0,1,0,0,1,1,100,0,0,0,0,0,1,3,0,"https://fbref.com/en/players/7f41ee30/Remy-Riou"
"12642","Amin Sarr_2023",2023,"Lyon","Ligue 1","Amin Sarr","SWE","FW","21",2001,6,9,6,1,4,4,1,4,25,3,2,0,2,0,9,4,0,"https://fbref.com/en/players/d5326924/Amin-Sarr"
"12643","Mamadou Sarr_2023",2023,"Lyon","Ligue 1","Mamadou Sarr","FRA","MF","16",2005,0.1,0,0,0,0,0,0,0,NA,0,0,0,0,0,0,0,0,"https://fbref.com/en/players/61f80c89/Mamadou-Sarr"
"12644","Nicolás Tagliafico_2023",2023,"Lyon","Ligue 1","Nicolás Tagliafico","ARG","DF","29",1992,33.2,91,53,36,41,14,50,78,64.1,28,45,11,34,57,148,47,0,"https://fbref.com/en/players/f0661424/Nicolas-Tagliafico"
"12645","Tetê_2023",2023,"Lyon","Ligue 1","Tetê","BRA","FW,MF","22",2000,12.3,21,10,8,5,8,10,19,52.6,9,9,0,9,13,34,2,0,"https://fbref.com/en/players/7120a04d/Tete"
"12646","Karl Toko Ekambi_2023",2023,"Lyon","Ligue 1","Karl Toko Ekambi","CMR","FW,MF","29",1992,15,9,9,2,4,3,4,15,26.7,11,12,2,10,9,18,6,0,"https://fbref.com/en/players/5ceba7fc/Karl-Toko-Ekambi"
"12647","Corentin Tolisso_2023",2023,"Lyon","Ligue 1","Corentin Tolisso","FRA","MF","27",1994,22.6,44,27,16,23,5,25,66,37.9,41,25,5,20,24,68,23,1,"https://fbref.com/en/players/652d4c37/Corentin-Tolisso"
"12648","Ramy Bensebaini_2023",2023,"M'Gladbach","Bundesliga","Ramy Bensebaini","ALG","DF","27",1995,27.6,34,21,21,10,3,26,39,66.7,13,44,14,30,36,70,98,1,"https://fbref.com/en/players/378825c7/Ramy-Bensebaini"
"12649","Yvandro Borges Sanches_2023",2023,"M'Gladbach","Bundesliga","Yvandro Borges Sanches","LUX","FW,MF","18",2004,0.3,2,2,0,2,0,2,2,100,0,0,0,0,0,2,0,0,"https://fbref.com/en/players/36578017/Yvandro-Borges-Sanches"
"12650","Nico Elvedi_2023",2023,"M'Gladbach","Bundesliga","Nico Elvedi","SUI","DF","25",1996,31.4,46,24,32,12,2,27,41,65.9,14,31,16,15,35,81,149,3,"https://fbref.com/en/players/48035304/Nico-Elvedi"
"12651","Oscar Fraulo_2023",2023,"M'Gladbach","Bundesliga","Oscar Fraulo","DEN","FW,MF","18",2003,0.1,0,0,0,0,0,0,0,NA,0,0,0,0,0,0,0,0,"https://fbref.com/en/players/458e3479/Oscar-Fraulo"
"12652","Marvin Friedrich_2023",2023,"M'Gladbach","Bundesliga","Marvin Friedrich","GER","DF","26",1995,13.9,17,11,13,3,1,10,13,76.9,3,14,6,8,11,28,52,0,"https://fbref.com/en/players/b77f44a4/Marvin-Friedrich"
"12653","Patrick Herrmann_2023",2023,"M'Gladbach","Bundesliga","Patrick Herrmann","GER","FW,MF","31",1991,1.8,6,2,4,1,1,2,4,50,2,2,0,2,2,8,1,0,"https://fbref.com/en/players/dfb6490a/Patrick-Herrmann"
"12654","Jonas Hofmann_2023",2023,"M'Gladbach","Bundesliga","Jonas Hofmann","GER","FW,MF","30",1992,29.8,31,16,17,8,6,15,52,28.8,37,36,2,34,16,47,21,0,"https://fbref.com/en/players/2903a856/Jonas-Hofmann"
"12655","Ko Itakura_2023",2023,"M'Gladbach","Bundesliga","Ko Itakura","JPN","DF","25",1997,22,29,17,18,7,4,16,30,53.3,14,41,25,16,27,56,95,0,"https://fbref.com/en/players/97d545ae/Ko-Itakura"
"12656","Jan Jakob Olschowsky_2023",2023,"M'Gladbach","Bundesliga","Jan Jakob Olschowsky","GER","GK","20",2001,4,0,0,0,0,0,0,1,0,1,1,0,1,0,0,1,0,"https://fbref.com/en/players/fa4cabd1/Jan-Jakob-Olschowsky"
"12657","Tony Jantschke_2023",2023,"M'Gladbach","Bundesliga","Tony Jantschke","GER","DF,MF","32",1990,1.1,2,1,1,1,0,1,1,100,0,5,3,2,0,2,5,0,"https://fbref.com/en/players/34b54da7/Tony-Jantschke"
"12658","Kouadio Koné_2023",2023,"M'Gladbach","Bundesliga","Kouadio Koné","FRA","MF","21",2001,29,74,39,37,33,4,24,47,51.1,23,44,12,32,32,106,21,0,"https://fbref.com/en/players/86574238/Kouadio-Kone"
"12659","Christoph Kramer_2023",2023,"M'Gladbach","Bundesliga","Christoph Kramer","GER","MF","31",1991,24.7,44,33,24,15,5,22,55,40,33,34,2,32,17,61,40,0,"https://fbref.com/en/players/496aeede/Christoph-Kramer"
"12660","Stefan Lainer_2023",2023,"M'Gladbach","Bundesliga","Stefan Lainer","AUT","DF","29",1992,9.1,16,8,10,5,1,10,23,43.5,13,8,1,7,14,30,34,1,"https://fbref.com/en/players/4aea5077/Stefan-Lainer"
"12661","Nathan N'Goumou_2023",2023,"M'Gladbach","Bundesliga","Nathan N'Goumou","FRA","FW","22",2000,7.7,11,5,5,5,1,7,13,53.8,6,9,0,9,1,12,4,0,"https://fbref.com/en/players/e110ea4b/Nathan-NGoumou"
"12662","Luca Netz_2023",2023,"M'Gladbach","Bundesliga","Luca Netz","GER","DF","19",2003,7.8,25,13,19,3,3,19,32,59.4,13,5,1,4,6,31,27,0,"https://fbref.com/en/players/e79269bd/Luca-Netz"
"12663","Florian Neuhaus_2023",2023,"M'Gladbach","Bundesliga","Florian Neuhaus","GER","MF","25",1997,15.6,19,9,9,5,5,8,27,29.6,19,20,3,17,12,31,5,0,"https://fbref.com/en/players/36a59ba4/Florian-Neuhaus"
"12664","Jonas Omlin_2023",2023,"M'Gladbach","Bundesliga","Jonas Omlin","SUI","GK","28",1994,14.3,1,1,1,0,0,1,3,33.3,2,1,0,1,0,1,9,1,"https://fbref.com/en/players/c631f952/Jonas-Omlin"
"12665","Alassane Pléa_2023",2023,"M'Gladbach","Bundesliga","Alassane Pléa","FRA","FW","29",1993,19.7,16,8,5,7,4,8,26,30.8,18,23,3,20,12,28,14,0,"https://fbref.com/en/players/bc6bd723/Alassane-Plea"
"12666","Rocco Reitz_2023",2023,"M'Gladbach","Bundesliga","Rocco Reitz","GER","MF","20",2002,0,0,0,0,0,0,0,0,NA,0,0,0,0,0,0,0,0,"https://fbref.com/en/players/cc971106/Rocco-Reitz"
"12667","Joe Scally_2023",2023,"M'Gladbach","Bundesliga","Joe Scally","USA","DF","19",2002,24.5,31,20,25,5,1,24,31,77.4,7,17,6,11,8,39,61,0,"https://fbref.com/en/players/236f02cd/Joe-Scally"
"12668","Tobias Sippel_2023",2023,"M'Gladbach","Bundesliga","Tobias Sippel","GER","GK","34",1988,5.7,0,0,0,0,0,0,0,NA,0,0,0,0,0,0,1,1,"https://fbref.com/en/players/0d8a37c2/Tobias-Sippel"
"12669","Yann Sommer_2023",2023,"M'Gladbach","Bundesliga","Yann Sommer","SUI","GK","33",1988,10,1,0,1,0,0,1,1,100,0,0,0,0,0,1,8,0,"https://fbref.com/en/players/420c18a1/Yann-Sommer"
"12670","Lars Stindl_2023",2023,"M'Gladbach","Bundesliga","Lars Stindl","GER","FW,MF","33",1988,19.3,24,14,4,17,3,10,28,35.7,18,24,5,19,11,35,19,0,"https://fbref.com/en/players/7cd6badb/Lars-Stindl"
"12671","Semir Telalovic_2023",2023,"M'Gladbach","Bundesliga","Semir Telalovic","GER","MF,FW","22",1999,0.1,0,0,0,0,0,0,0,NA,0,0,0,0,0,0,0,0,"https://fbref.com/en/players/0b45a8d7/Semir-Telalovic"
"12672","Marcus Thuram_2023",2023,"M'Gladbach","Bundesliga","Marcus Thuram","FRA","FW","24",1997,27.9,14,7,3,6,5,6,13,46.2,7,20,3,17,6,20,22,0,"https://fbref.com/en/players/6f8cd6d0/Marcus-Thuram"
"12673","Julian Weigl_2023",2023,"M'Gladbach","Bundesliga","Julian Weigl","GER","MF","26",1995,21,43,16,21,21,1,23,41,56.1,18,23,2,21,18,61,32,0,"https://fbref.com/en/players/346d51d9/Julian-Weigl"
"12674","Hannes Wolf_2023",2023,"M'Gladbach","Bundesliga","Hannes Wolf","AUT","FW","23",1999,5,11,8,4,5,2,5,13,38.5,8,3,0,3,3,14,9,0,"https://fbref.com/en/players/be42a291/Hannes-Wolf"
"12675","Ludovic Ajorque_2023",2023,"Mainz 05","Bundesliga","Ludovic Ajorque","FRA","FW,MF","28",1994,13.5,6,5,1,4,1,1,9,11.1,8,8,2,6,1,7,8,0,"https://fbref.com/en/players/462475ed/Ludovic-Ajorque"
"12676","Aymen Barkok_2023",2023,"Mainz 05","Bundesliga","Aymen Barkok","MAR","MF","24",1998,6.5,18,8,10,5,3,5,10,50,5,7,0,7,3,21,9,0,"https://fbref.com/en/players/a2a85828/Aymen-Barkok"
"12677","Leandro Barreiro Martins_2023",2023,"Mainz 05","Bundesliga","Leandro Barreiro Martins","LUX","MF","22",2000,23.8,60,38,19,28,13,22,49,44.9,27,38,13,25,41,101,39,1,"https://fbref.com/en/players/00242b75/Leandro-Barreiro-Martins"
"12678","Stefan Bell_2023",2023,"Mainz 05","Bundesliga","Stefan Bell","GER","DF","30",1991,26.6,43,28,32,10,1,22,44,50,22,42,15,27,44,87,133,0,"https://fbref.com/en/players/857a5abe/Stefan-Bell"
"12679","Delano Burgzorg_2023",2023,"Mainz 05","Bundesliga","Delano Burgzorg","NED","FW,MF","23",1998,2.7,3,3,1,1,1,2,3,66.7,1,2,0,2,0,3,2,0,"https://fbref.com/en/players/05e2d5ea/Delano-Burgzorg"
"12680","Jonathan Burkardt_2023",2023,"Mainz 05","Bundesliga","Jonathan Burkardt","GER","MF,FW","22",2000,5.9,3,1,0,1,2,1,4,25,3,6,1,5,1,4,1,0,"https://fbref.com/en/players/05f99a4a/Jonathan-Burkardt"
"12681","Anthony Caci_2023",2023,"Mainz 05","Bundesliga","Anthony Caci","FRA","DF","25",1997,22.6,58,33,32,20,6,28,42,66.7,14,28,4,24,54,112,40,0,"https://fbref.com/en/players/0118c54c/Anthony-Caci"
"12682","Danny da Costa_2023",2023,"Mainz 05","Bundesliga","Danny da Costa","GER","DF","29",1993,13.7,20,16,7,8,5,12,20,60,8,22,3,19,9,29,26,0,"https://fbref.com/en/players/5ddb8f9f/Danny-da-Costa"
"12683","Finn Dahmen_2023",2023,"Mainz 05","Bundesliga","Finn Dahmen","GER","GK","24",1998,8,0,0,0,0,0,0,0,NA,0,0,0,0,0,0,3,0,"https://fbref.com/en/players/dee3013b/Finn-Dahmen"
"12684","Edimilson Fernandes_2023",2023,"Mainz 05","Bundesliga","Edimilson Fernandes","SUI","DF","26",1996,27.1,35,25,26,5,4,18,34,52.9,16,37,16,21,54,89,87,2,"https://fbref.com/en/players/3bb625ac/Edimilson-Fernandes"
"12685","Angelo Fulgini_2023",2023,"Mainz 05","Bundesliga","Angelo Fulgini","FRA","MF","25",1996,5.8,6,5,2,3,1,5,12,41.7,7,5,0,5,5,11,7,0,"https://fbref.com/en/players/4b96c347/Angelo-Fulgini"
"12686","Brajan Gruda_2023",2023,"Mainz 05","Bundesliga","Brajan Gruda","GER","MF","18",2004,0,0,0,0,0,0,0,0,NA,0,0,0,0,0,0,0,0,"https://fbref.com/en/players/ae9b998d/Brajan-Gruda"
"12687","Alexander Hack_2023",2023,"Mainz 05","Bundesliga","Alexander Hack","GER","DF","28",1993,12.6,30,18,21,9,0,19,33,57.6,14,18,5,13,24,54,45,1,"https://fbref.com/en/players/a5ec3ede/Alexander-Hack"
"12688","Andreas Hanche-Olsen_2023",2023,"Mainz 05","Bundesliga","Andreas Hanche-Olsen","NOR","DF","25",1997,16.6,35,23,24,7,4,22,39,56.4,17,16,8,8,33,68,77,2,"https://fbref.com/en/players/2e77d607/Andreas-Hanche-Olsen"
"12689","Marcus Ingvartsen_2023",2023,"Mainz 05","Bundesliga","Marcus Ingvartsen","DEN","FW,MF","26",1996,14.6,4,1,0,2,2,1,10,10,9,9,1,8,4,8,10,0,"https://fbref.com/en/players/271b8617/Marcus-Ingvartsen"
"12690","Lee Jae-sung_2023",2023,"Mainz 05","Bundesliga","Lee Jae-sung","KOR","MF","29",1992,21,38,17,9,21,8,16,36,44.4,20,29,5,24,17,55,21,0,"https://fbref.com/en/players/34b0387f/Lee-Jae-sung"
"12691","Dominik Kohr_2023",2023,"Mainz 05","Bundesliga","Dominik Kohr","GER","MF","28",1994,25.5,59,33,23,31,5,29,61,47.5,32,46,9,37,34,93,26,1,"https://fbref.com/en/players/0fbecd11/Dominik-Kohr"
"12692","Maxim Leitsch_2023",2023,"Mainz 05","Bundesliga","Maxim Leitsch","GER","DF","24",1998,7.4,9,7,6,3,0,4,5,80,1,7,4,3,18,27,26,1,"https://fbref.com/en/players/7e12a98d/Maxim-Leitsch"
"12693","Aarón Martín_2023",2023,"Mainz 05","Bundesliga","Aarón Martín","ESP","DF","25",1997,20.5,42,27,25,11,6,21,40,52.5,19,22,1,21,15,57,31,0,"https://fbref.com/en/players/2f3e911a/Aaron-Martin"
"12694","Suliman Mustapha_2023",2023,"Mainz 05","Bundesliga","Suliman Mustapha","AUT","FW,MF","21",2001,0.8,2,2,0,2,0,0,0,NA,0,4,0,4,0,2,0,0,"https://fbref.com/en/players/9ff8ec4a/Suliman-Mustapha"
"12695","Karim Onisiwo_2023",2023,"Mainz 05","Bundesliga","Karim Onisiwo","AUT","FW,MF","30",1992,28.2,19,12,3,10,6,4,21,19,17,19,0,19,2,21,7,0,"https://fbref.com/en/players/f26834c7/Karim-Onisiwo"
"12696","Eniss Shabani_2023",2023,"Mainz 05","Bundesliga","Eniss Shabani","GER","MF","19",2003,0.1,0,0,0,0,0,0,0,NA,0,0,0,0,0,0,0,0,"https://fbref.com/en/players/0c88efca/Eniss-Shabani"
"12697","Anton Stach_2023",2023,"Mainz 05","Bundesliga","Anton Stach","GER","MF","23",1998,23,27,21,10,15,2,16,38,42.1,22,28,2,26,41,68,25,0,"https://fbref.com/en/players/0f59a7bf/Anton-Stach"
"12698","Niklas Tauer_2023",2023,"Mainz 05","Bundesliga","Niklas Tauer","GER","DF,MF","21",2001,1,2,1,2,0,0,1,3,33.3,2,2,1,1,2,4,4,0,"https://fbref.com/en/players/27270af4/Niklas-Tauer"
"12699","Nelson Weiper_2023",2023,"Mainz 05","Bundesliga","Nelson Weiper","GER","FW,DF","17",2005,1.1,2,0,0,0,2,1,3,33.3,2,2,0,2,0,2,1,0,"https://fbref.com/en/players/231c67ff/Nelson-Weiper"
"12700","Silvan Widmer_2023",2023,"Mainz 05","Bundesliga","Silvan Widmer","SUI","DF","29",1993,18.8,26,17,15,10,1,20,39,51.3,19,22,8,14,31,57,28,0,"https://fbref.com/en/players/f68b64fc/Silvan-Widmer"
"12701","Robin Zentner_2023",2023,"Mainz 05","Bundesliga","Robin Zentner","GER","GK","27",1994,26,0,0,0,0,0,0,4,0,4,0,0,0,0,0,17,1,"https://fbref.com/en/players/5c4bf6ba/Robin-Zentner"
"12702","Amath_2023",2023,"Mallorca","La Liga","Amath","SEN","MF,FW","26",1996,13.6,29,19,14,8,7,14,22,63.6,8,13,1,12,5,34,5,0,"https://fbref.com/en/players/f3b1d9a2/Amath"
"12703","Josep Antoni Gayá_2023",2023,"Mallorca","La Liga","Josep Antoni Gayá","ESP","DF,MF","22",2000,1.1,0,0,0,0,0,0,0,NA,0,4,2,2,1,1,6,0,"https://fbref.com/en/players/4a5f2032/Josep-Antoni-Gaya"
"12704","Ludwig Augustinsson_2023",2023,"Mallorca","La Liga","Ludwig Augustinsson","SWE","DF","28",1994,1.5,2,1,2,0,0,1,3,33.3,2,1,0,1,1,3,3,0,"https://fbref.com/en/players/9fec8860/Ludwig-Augustinsson"
"12705","Iddrisu Baba_2023",2023,"Mallorca","La Liga","Iddrisu Baba","GHA","MF,DF","26",1996,18.9,31,17,15,16,0,15,32,46.9,17,18,8,10,11,42,39,0,"https://fbref.com/en/players/bfd381b3/Iddrisu-Baba"
"12706","Rodrigo Battaglia_2023",2023,"Mallorca","La Liga","Rodrigo Battaglia","ARG","MF","31",1991,7.6,12,5,7,5,0,6,14,42.9,8,16,7,9,5,17,18,0,"https://fbref.com/en/players/d637fc22/Rodrigo-Battaglia"
"12707","Copete_2023",2023,"Mallorca","La Liga","Copete","ESP","DF","22",1999,24.5,53,28,35,16,2,26,36,72.2,10,38,17,21,44,97,111,2,"https://fbref.com/en/players/0f26ffd7/Copete"
"12708","Jaume Costa_2023",2023,"Mallorca","La Liga","Jaume Costa","ESP","DF","34",1988,28.9,50,34,26,17,7,29,51,56.9,22,13,5,8,22,72,44,1,"https://fbref.com/en/players/808d48f3/Jaume-Costa"
"12709","Braian Cufré_2023",2023,"Mallorca","La Liga","Braian Cufré","ARG","DF","25",1996,2.4,5,2,2,1,2,2,5,40,3,2,1,1,2,7,1,0,"https://fbref.com/en/players/192c89a6/Braian-Cufre"
"12710","Iñigo Ruiz de Galarreta_2023",2023,"Mallorca","La Liga","Iñigo Ruiz de Galarreta","ESP","MF","28",1993,27.2,54,38,27,23,4,20,52,38.5,32,26,9,17,30,84,19,0,"https://fbref.com/en/players/91f7631f/Inigo-Ruiz-de-Galarreta"
"12711","Giovanni González_2023",2023,"Mallorca","La Liga","Giovanni González","URU","DF","27",1994,10.3,16,8,11,2,3,9,22,40.9,13,8,2,6,7,23,22,0,"https://fbref.com/en/players/1fc474ae/Giovanni-Gonzalez"
"12712","Dominik Greif_2023",2023,"Mallorca","La Liga","Dominik Greif","SVK","GK","25",1997,1,0,0,0,0,0,0,0,NA,0,0,0,0,0,0,0,0,"https://fbref.com/en/players/30061f53/Dominik-Greif"
"12713","Clément Grenier_2023",2023,"Mallorca","La Liga","Clément Grenier","FRA","MF","31",1991,8,20,8,6,12,2,10,20,50,10,9,1,8,6,26,7,0,"https://fbref.com/en/players/8b298f56/Clement-Grenier"
"12714","Dennis Hadzikadunic_2023",2023,"Mallorca","La Liga","Dennis Hadzikadunic","BIH","DF","24",1998,6.8,9,6,4,5,0,4,4,100,0,5,4,1,3,12,27,0,"https://fbref.com/en/players/82cfae2a/Dennis-Hadzikadunic"
"12715","Lago Junior_2023",2023,"Mallorca","La Liga","Lago Junior","CIV","FW,MF","31",1990,0.6,1,0,0,1,0,1,1,100,0,0,0,0,0,1,0,0,"https://fbref.com/en/players/360d70f8/Lago-Junior"
"12716","Tino Kadewere_2023",2023,"Mallorca","La Liga","Tino Kadewere","ZIM","FW,MF","26",1996,6,6,3,3,3,0,4,9,44.4,5,6,2,4,2,8,1,0,"https://fbref.com/en/players/7d08063d/Tino-Kadewere"
"12717","Lee Kangin_2023",2023,"Mallorca","La Liga","Lee Kangin","KOR","MF,FW","21",2001,31.4,42,24,10,22,10,18,61,29.5,43,25,2,23,11,53,7,0,"https://fbref.com/en/players/8455ad90/Lee-Kangin"
"12718","Javier Llabrés_2023",2023,"Mallorca","La Liga","Javier Llabrés","ESP","FW","19",2002,0.2,0,0,0,0,0,0,0,NA,0,0,0,0,0,0,1,0,"https://fbref.com/en/players/38b0cf42/Javier-Llabres"
"12719","Pablo Maffeo_2023",2023,"Mallorca","La Liga","Pablo Maffeo","ESP","DF","25",1997,33.1,75,46,54,16,5,45,78,57.7,33,38,11,27,26,101,76,0,"https://fbref.com/en/players/5db04597/Pablo-Maffeo"
"12720","Manu Morlanes_2023",2023,"Mallorca","La Liga","Manu Morlanes","ESP","MF","23",1999,7.8,22,9,12,8,2,13,24,54.2,11,10,5,5,5,27,9,0,"https://fbref.com/en/players/a0255c67/Manu-Morlanes"
"12721","Vedat Muriqi_2023",2023,"Mallorca","La Liga","Vedat Muriqi","KVX","FW","28",1994,32.6,12,7,4,7,1,3,13,23.1,10,19,7,12,12,24,73,0,"https://fbref.com/en/players/0cadc46d/Vedat-Muriqi"
"12722","Matija Nastasić_2023",2023,"Mallorca","La Liga","Matija Nastasić","SRB","DF","29",1993,10.1,10,8,7,1,2,3,6,50,3,11,4,7,18,28,43,1,"https://fbref.com/en/players/f35430a4/Matija-Nastasic"
"12723","Abdón Prats_2023",2023,"Mallorca","La Liga","Abdón Prats","ESP","FW,MF","29",1992,4.6,1,0,1,0,0,0,0,NA,0,5,0,5,0,1,2,0,"https://fbref.com/en/players/d1b060e2/Abdon-Prats"
"12724","Rubén Quintanilla_2023",2023,"Mallorca","La Liga","Rubén Quintanilla","ESP","DF","20",2002,0,0,0,0,0,0,0,0,NA,0,1,0,1,0,0,0,0,"https://fbref.com/en/players/2f456b86/Ruben-Quintanilla"
"12725","Antonio Raillo_2023",2023,"Mallorca","La Liga","Antonio Raillo","ESP","DF","30",1991,30.7,34,21,23,11,0,10,15,66.7,5,38,29,9,31,65,158,1,"https://fbref.com/en/players/b857bd29/Antonio-Raillo"
"12726","Predrag Rajković_2023",2023,"Mallorca","La Liga","Predrag Rajković","SRB","GK","26",1995,36,0,0,0,0,0,0,2,0,2,0,0,0,0,0,16,1,"https://fbref.com/en/players/58ad9383/Predrag-Rajkovic"
"12727","Ángel Rodríguez_2023",2023,"Mallorca","La Liga","Ángel Rodríguez","ESP","FW,MF","35",1987,4.4,1,1,0,1,0,0,2,0,2,3,0,3,1,2,1,0,"https://fbref.com/en/players/8cfc2f69/Angel-Rodriguez"
"12728","Dani Rodríguez_2023",2023,"Mallorca","La Liga","Dani Rodríguez","ESP","MF","34",1988,23.3,42,23,18,22,2,21,46,45.7,25,31,8,23,21,63,14,0,"https://fbref.com/en/players/70f8e0bd/Dani-Rodriguez"
"12729","Leonardo Román_2023",2023,"Mallorca","La Liga","Leonardo Román","ESP","GK","22",2000,1,0,0,0,0,0,0,0,NA,0,0,0,0,0,0,0,0,"https://fbref.com/en/players/924ff27e/Leonardo-Roman"
"12730","Franco Russo_2023",2023,"Mallorca","La Liga","Franco Russo","ARG","DF","27",1994,1.6,2,1,2,0,0,0,1,0,1,5,0,5,3,5,5,0,"https://fbref.com/en/players/b75ac54b/Franco-Russo"
"12731","Antonio Sánchez_2023",2023,"Mallorca","La Liga","Antonio Sánchez","ESP","MF,DF","25",1997,12,19,8,13,4,2,10,34,29.4,24,18,0,18,22,41,14,1,"https://fbref.com/en/players/a254bbe0/Antonio-Sanchez"
"12732","Martin Valjent_2023",2023,"Mallorca","La Liga","Martin Valjent","SVK","DF","26",1995,29.5,35,27,22,12,1,19,28,67.9,9,39,21,18,29,64,137,0,"https://fbref.com/en/players/f2c6ac01/Martin-Valjent"
"12733","Manuel Akanji_2023",2023,"Manchester City","Premier League","Manuel Akanji","SUI","DF","27",1995,25.4,36,25,15,18,3,23,36,63.9,13,27,9,18,16,52,33,0,"https://fbref.com/en/players/89ac64a6/Manuel-Akanji"
"12734","Nathan Aké_2023",2023,"Manchester City","Premier League","Nathan Aké","NED","DF","27",1995,20.8,26,12,15,9,2,11,15,73.3,4,20,10,10,20,46,48,0,"https://fbref.com/en/players/eaeca114/Nathan-Ake"
"12735","Julián Álvarez_2023",2023,"Manchester City","Premier League","Julián Álvarez","ARG","FW,MF","22",2000,16.3,26,16,3,13,10,9,29,31,20,13,0,13,2,28,6,0,"https://fbref.com/en/players/15ab5a2b/Julian-Alvarez"
"12736","João Cancelo_2023",2023,"Manchester City","Premier League","João Cancelo","POR","DF","28",1994,14.2,29,21,16,9,4,17,24,70.8,7,7,1,6,19,48,9,1,"https://fbref.com/en/players/bd6351cd/Joao-Cancelo"
"12737","Shea Charles_2023",2023,"Manchester City","Premier League","Shea Charles","NIR","DF","18",2003,0.3,4,0,4,0,0,1,1,100,0,0,0,0,1,5,2,0,"https://fbref.com/en/players/5cc3ce65/Shea-Charles"
"12738","Kevin De Bruyne_2023",2023,"Manchester City","Premier League","Kevin De Bruyne","BEL","MF","31",1991,26.9,28,12,3,12,13,14,39,35.9,25,27,2,25,9,37,10,0,"https://fbref.com/en/players/e46012d4/Kevin-De-Bruyne"
"12739","Rúben Dias_2023",2023,"Manchester City","Premier League","Rúben Dias","POR","DF","25",1997,22.2,21,13,10,10,1,11,18,61.1,7,21,13,8,18,39,56,1,"https://fbref.com/en/players/31c69ef1/Ruben-Dias"
"12740","Ederson_2023",2023,"Manchester City","Premier League","Ederson","BRA","GK","28",1993,35,3,1,3,0,0,1,2,50,1,0,0,0,1,4,10,2,"https://fbref.com/en/players/3bb7b8b4/Ederson"
"12741","Phil Foden_2023",2023,"Manchester City","Premier League","Phil Foden","ENG","FW","22",2000,20.5,16,10,9,5,2,8,19,42.1,11,25,2,23,5,21,12,0,"https://fbref.com/en/players/ed1e53f3/Phil-Foden"
"12742","Sergio Gómez_2023",2023,"Manchester City","Premier League","Sergio Gómez","ESP","DF,MF","21",2000,3.9,9,4,6,1,2,5,8,62.5,3,5,3,2,2,11,9,1,"https://fbref.com/en/players/01e5f06e/Sergio-Gomez"
"12743","Jack Grealish_2023",2023,"Manchester City","Premier League","Jack Grealish","ENG","FW","26",1995,22.8,25,16,10,12,3,13,22,59.1,9,17,3,14,7,32,9,0,"https://fbref.com/en/players/b0b4fd3e/Jack-Grealish"
"12744","İlkay Gündoğan_2023",2023,"Manchester City","Premier League","İlkay Gündoğan","GER","MF","31",1990,26.1,30,18,7,13,10,12,33,36.4,21,18,3,15,20,50,13,0,"https://fbref.com/en/players/819b3158/Ilkay-Gundogan"
"12745","Erling Haaland_2023",2023,"Manchester City","Premier League","Erling Haaland","NOR","FW","22",2000,30.8,3,2,0,2,1,1,5,20,4,12,4,8,3,6,14,0,"https://fbref.com/en/players/1f44ac21/Erling-Haaland"
"12746","Aymeric Laporte_2023",2023,"Manchester City","Premier League","Aymeric Laporte","ESP","DF","28",1994,11,11,8,6,4,1,7,11,63.6,4,10,4,6,3,14,30,1,"https://fbref.com/en/players/119b9a8e/Aymeric-Laporte"
"12747","Rico Lewis_2023",2023,"Manchester City","Premier League","Rico Lewis","ENG","DF,MF","17",2004,10,16,9,9,5,2,6,11,54.5,5,8,4,4,6,22,13,1,"https://fbref.com/en/players/b57e066e/Rico-Lewis"
"12748","Riyad Mahrez_2023",2023,"Manchester City","Premier League","Riyad Mahrez","ALG","FW,MF","31",1991,21.3,30,14,8,13,9,13,38,34.2,25,27,1,26,9,39,5,0,"https://fbref.com/en/players/892d5bb1/Riyad-Mahrez"
"12749","Stefan Ortega_2023",2023,"Manchester City","Premier League","Stefan Ortega","GER","GK","29",1992,3,0,0,0,0,0,0,0,NA,0,0,0,0,0,0,0,0,"https://fbref.com/en/players/c1242d4e/Stefan-Ortega"
"12750","Cole Palmer_2023",2023,"Manchester City","Premier League","Cole Palmer","ENG","MF,FW","20",2002,4.1,5,1,0,3,2,3,5,60,2,2,1,1,1,6,2,0,"https://fbref.com/en/players/dc7f8a28/Cole-Palmer"
"12751","Máximo Perrone_2023",2023,"Manchester City","Premier League","Máximo Perrone","ARG","MF","19",2003,0.2,0,0,0,0,0,0,0,NA,0,1,0,1,0,0,0,0,"https://fbref.com/en/players/53552942/Maximo-Perrone"
"12752","Kalvin Phillips_2023",2023,"Manchester City","Premier League","Kalvin Phillips","ENG","MF","26",1995,3.3,6,4,3,3,0,2,9,22.2,7,7,3,4,5,11,10,0,"https://fbref.com/en/players/4f565d77/Kalvin-Phillips"
"12753","Rodri_2023",2023,"Manchester City","Premier League","Rodri","ESP","MF","26",1996,32.3,67,41,28,28,11,26,52,50,26,40,14,26,33,100,43,1,"https://fbref.com/en/players/6434f10d/Rodri"
"12754","Bernardo Silva_2023",2023,"Manchester City","Premier League","Bernardo Silva","POR","MF,FW","27",1994,24.5,44,23,11,25,8,18,44,40.9,26,23,6,17,16,60,6,0,"https://fbref.com/en/players/3eb22ec9/Bernardo-Silva"
"12755","John Stones_2023",2023,"Manchester City","Premier League","John Stones","ENG","DF,MF","28",1994,20.5,23,13,11,8,4,7,10,70,3,17,10,7,9,32,40,0,"https://fbref.com/en/players/5eecec3d/John-Stones"
"12756","Kyle Walker_2023",2023,"Manchester City","Premier League","Kyle Walker","ENG","DF","32",1990,21.8,13,9,8,5,0,4,24,16.7,20,12,2,10,18,31,22,0,"https://fbref.com/en/players/86dd77d1/Kyle-Walker"
"12757","Antony_2023",2023,"Manchester Utd","Premier League","Antony","BRA","FW","22",2000,20,22,9,9,9,4,8,28,28.6,20,18,0,18,11,33,6,0,"https://fbref.com/en/players/99127249/Antony"
"12758","Donny van de Beek_2023",2023,"Manchester Utd","Premier League","Donny van de Beek","NED","MF","25",1997,1.9,0,0,0,0,0,0,1,0,1,2,1,1,1,1,1,0,"https://fbref.com/en/players/50dc94ce/Donny-van-de-Beek"
"12759","Casemiro_2023",2023,"Manchester Utd","Premier League","Casemiro","BRA","MF","30",1992,23.6,89,46,43,35,11,48,92,52.2,44,49,11,38,34,123,64,0,"https://fbref.com/en/players/4d224fe8/Casemiro"
"12760","Diogo Dalot_2023",2023,"Manchester Utd","Premier League","Diogo Dalot","POR","DF","23",1999,23.9,54,41,40,13,1,33,45,73.3,12,25,7,18,37,91,55,2,"https://fbref.com/en/players/d9565625/Diogo-Dalot"
"12761","Anthony Elanga_2023",2023,"Manchester Utd","Premier League","Anthony Elanga","SWE","FW","20",2002,4.7,3,0,0,2,1,1,2,50,1,4,0,4,2,5,4,0,"https://fbref.com/en/players/2fba6108/Anthony-Elanga"
"12762","Christian Eriksen_2023",2023,"Manchester Utd","Premier League","Christian Eriksen","DEN","MF","30",1992,22.8,22,18,10,7,5,10,32,31.3,22,23,9,14,11,33,20,1,"https://fbref.com/en/players/980522ec/Christian-Eriksen"
"12763","Bruno Fernandes_2023",2023,"Manchester Utd","Premier League","Bruno Fernandes","POR","MF,FW","27",1994,36.8,68,42,24,25,19,30,71,42.3,41,37,5,32,25,93,40,1,"https://fbref.com/en/players/507c7bdf/Bruno-Fernandes"
"12764","Fred_2023",2023,"Manchester Utd","Premier League","Fred","BRA","MF","29",1993,13.9,47,30,24,20,3,15,38,39.5,23,38,2,36,19,66,19,0,"https://fbref.com/en/players/b853e0ad/Fred"
"12765","Alejandro Garnacho_2023",2023,"Manchester Utd","Premier League","Alejandro Garnacho","ARG","FW,MF","18",2004,6.3,5,2,2,0,3,1,11,9.1,10,5,0,5,5,10,3,0,"https://fbref.com/en/players/7aa8adfe/Alejandro-Garnacho"
"12766","David de Gea_2023",2023,"Manchester Utd","Premier League","David de Gea","ESP","GK","31",1990,38,0,0,0,0,0,0,1,0,1,0,0,0,1,1,15,3,"https://fbref.com/en/players/7ba6d84e/David-de-Gea"
"12767","Victor Lindelöf_2023",2023,"Manchester Utd","Premier League","Victor Lindelöf","SWE","DF","28",1994,15.2,22,17,10,9,3,9,17,52.9,8,18,9,9,21,43,63,1,"https://fbref.com/en/players/f5deef4c/Victor-Lindelof"
"12768","Harry Maguire_2023",2023,"Manchester Utd","Premier League","Harry Maguire","ENG","DF","29",1993,8.5,8,6,6,1,1,4,5,80,1,18,11,7,13,21,41,0,"https://fbref.com/en/players/d8931174/Harry-Maguire"
"12769","Kobbie Mainoo_2023",2023,"Manchester Utd","Premier League","Kobbie Mainoo","ENG","MF","17",2005,0.1,0,0,0,0,0,0,0,NA,0,1,1,0,0,0,0,0,"https://fbref.com/en/players/c6220452/Kobbie-Mainoo"
"12770","Tyrell Malacia_2023",2023,"Manchester Utd","Premier League","Tyrell Malacia","NED","DF","22",1999,15.5,46,33,33,12,1,14,25,56,11,13,3,10,25,71,49,0,"https://fbref.com/en/players/6b6c793c/Tyrell-Malacia"
"12771","Anthony Martial_2023",2023,"Manchester Utd","Premier League","Anthony Martial","FRA","FW","26",1995,10.9,5,3,0,2,3,1,4,25,3,11,2,9,1,6,4,0,"https://fbref.com/en/players/8b788c01/Anthony-Martial"
"12772","Lisandro Martínez_2023",2023,"Manchester Utd","Premier League","Lisandro Martínez","ARG","DF","24",1998,23.5,54,28,33,18,3,30,43,69.8,13,51,27,24,33,87,103,0,"https://fbref.com/en/players/bac46a10/Lisandro-Martinez"
"12773","Scott McTominay_2023",2023,"Manchester Utd","Premier League","Scott McTominay","SCO","MF","25",1996,12.9,32,19,16,10,6,13,22,59.1,9,15,6,9,14,46,45,0,"https://fbref.com/en/players/d93c2511/Scott-McTominay"
"12774","Facundo Pellistri_2023",2023,"Manchester Utd","Premier League","Facundo Pellistri","URU","FW,MF","20",2001,0.7,1,1,0,1,0,0,0,NA,0,0,0,0,0,1,3,0,"https://fbref.com/en/players/ac7e7b1c/Facundo-Pellistri"
"12775","Marcus Rashford_2023",2023,"Manchester Utd","Premier League","Marcus Rashford","ENG","FW","24",1997,32,20,10,7,8,5,9,24,37.5,15,31,4,27,7,27,14,0,"https://fbref.com/en/players/a1d5bd30/Marcus-Rashford"
"12776","Cristiano Ronaldo_2023",2023,"Manchester Utd","Premier League","Cristiano Ronaldo","POR","FW","37",1985,5.8,2,2,1,0,1,1,2,50,1,0,0,0,1,3,9,0,"https://fbref.com/en/players/dea698d9/Cristiano-Ronaldo"
"12777","Marcel Sabitzer_2023",2023,"Manchester Utd","Premier League","Marcel Sabitzer","AUT","MF","28",1994,7,12,8,3,8,1,2,11,18.2,9,6,2,4,8,20,11,0,"https://fbref.com/en/players/e280527c/Marcel-Sabitzer"
"12778","Jadon Sancho_2023",2023,"Manchester Utd","Premier League","Jadon Sancho","ENG","FW,MF","22",2000,18.7,16,10,7,5,4,8,28,28.6,20,25,2,23,7,23,6,0,"https://fbref.com/en/players/dbf053da/Jadon-Sancho"
"12779","Luke Shaw_2023",2023,"Manchester Utd","Premier League","Luke Shaw","ENG","DF","27",1995,28.4,55,36,31,22,2,32,45,71.1,13,51,17,34,36,91,55,2,"https://fbref.com/en/players/9c94165b/Luke-Shaw"
"12780","Raphaël Varane_2023",2023,"Manchester Utd","Premier League","Raphaël Varane","FRA","DF","29",1993,21.2,24,9,18,6,0,7,17,41.2,10,24,17,7,11,35,91,0,"https://fbref.com/en/players/9f8e9423/Raphael-Varane"
"12781","Aaron Wan-Bissaka_2023",2023,"Manchester Utd","Premier League","Aaron Wan-Bissaka","ENG","DF","24",1997,15.9,40,25,20,17,3,23,25,92,2,24,8,16,22,62,41,0,"https://fbref.com/en/players/9e525177/Aaron-Wan-Bissaka"
"12782","Wout Weghorst_2023",2023,"Manchester Utd","Premier League","Wout Weghorst","NED","FW,MF","29",1992,8.9,11,5,6,1,4,2,9,22.2,7,7,2,5,7,18,9,0,"https://fbref.com/en/players/c4e87b8b/Wout-Weghorst"
"12783","Eric Bailly_2023",2023,"Marseille","Ligue 1","Eric Bailly","CIV","DF","28",1994,6,13,10,6,6,1,7,7,100,0,15,12,3,12,25,18,1,"https://fbref.com/en/players/a1232f4e/Eric-Bailly"
"12784","Cédric Bakambu_2023",2023,"Marseille","Ligue 1","Cédric Bakambu","COD","MF","31",1991,0.7,2,1,2,0,0,2,2,100,0,0,0,0,0,2,0,0,"https://fbref.com/en/players/0af4dcf0/Cedric-Bakambu"
"12785","Leonardo Balerdi_2023",2023,"Marseille","Ligue 1","Leonardo Balerdi","ARG","DF","23",1999,29.3,57,37,43,12,2,32,45,71.1,13,48,29,19,63,120,91,1,"https://fbref.com/en/players/7c3ed041/Leonardo-Balerdi"
"12786","Salim Ben Seghir_2023",2023,"Marseille","Ligue 1","Salim Ben Seghir","FRA","MF","19",2003,0,0,0,0,0,0,0,0,NA,0,1,0,1,0,0,0,0,"https://fbref.com/en/players/1f6298f2/Salim-Ben-Seghir"
"12787","Rubén Blanco_2023",2023,"Marseille","Ligue 1","Rubén Blanco","ESP","GK","27",1995,5.5,0,0,0,0,0,0,0,NA,0,0,0,0,0,0,1,0,"https://fbref.com/en/players/967f34d3/Ruben-Blanco"
"12788","Duje Ćaleta-Car_2023",2023,"Marseille","Ligue 1","Duje Ćaleta-Car","CRO","DF","25",1996,0.1,0,0,0,0,0,0,0,NA,0,0,0,0,0,0,1,0,"https://fbref.com/en/players/94f8d10c/Duje-Caleta-Car"
"12789","Jonathan Clauss_2023",2023,"Marseille","Ligue 1","Jonathan Clauss","FRA","DF","29",1992,28.8,46,28,21,16,9,23,52,44.2,29,29,4,25,31,77,40,2,"https://fbref.com/en/players/5219ab4a/Jonathan-Clauss"
"12790","Bamba Dieng_2023",2023,"Marseille","Ligue 1","Bamba Dieng","SEN","FW,MF","22",2000,2.2,4,4,2,1,1,3,4,75,1,5,1,4,0,4,0,0,"https://fbref.com/en/players/40774c6b/Bamba-Dieng"
"12791","Gerson_2023",2023,"Marseille","Ligue 1","Gerson","BRA","MF","25",1997,4.6,6,4,1,4,1,3,5,60,2,5,0,5,2,8,4,0,"https://fbref.com/en/players/8827bf46/Gerson"
"12792","Samuel Gigot_2023",2023,"Marseille","Ligue 1","Samuel Gigot","FRA","DF","28",1993,20.9,46,24,22,21,3,12,15,80,3,24,7,17,45,91,85,1,"https://fbref.com/en/players/41eebdf5/Samuel-Gigot"
"12793","Mattéo Guendouzi_2023",2023,"Marseille","Ligue 1","Mattéo Guendouzi","FRA","MF","23",1999,23.4,39,18,9,21,9,14,38,36.8,24,12,5,7,21,60,18,0,"https://fbref.com/en/players/5ea8ef20/Matteo-Guendouzi"
"12794","Pape Gueye_2023",2023,"Marseille","Ligue 1","Pape Gueye","SEN","MF,DF","23",1999,5.5,18,7,10,7,1,7,15,46.7,8,9,2,7,9,27,2,0,"https://fbref.com/en/players/7155e3e1/Pape-Gueye"
"12795","Amine Harit_2023",2023,"Marseille","Ligue 1","Amine Harit","MAR","MF,FW","25",1997,5.7,6,4,0,3,3,3,8,37.5,5,4,1,3,4,10,6,0,"https://fbref.com/en/players/e7d59f4f/Amine-Harit"
"12796","Luis Javier Suárez_2023",2023,"Marseille","Ligue 1","Luis Javier Suárez","COL","FW","24",1997,3.3,4,1,1,2,1,1,4,25,3,1,0,1,3,7,6,0,"https://fbref.com/en/players/eeba07f8/Luis-Javier-Suarez"
"12797","Issa Kaboré_2023",2023,"Marseille","Ligue 1","Issa Kaboré","BFA","DF","21",2001,11.4,33,19,10,18,5,21,32,65.6,11,11,1,10,12,45,21,1,"https://fbref.com/en/players/c066d1a5/Issa-Kabore"
"12798","Sead Kolašinac_2023",2023,"Marseille","Ligue 1","Sead Kolašinac","BIH","DF","29",1993,24.6,52,36,24,22,6,24,37,64.9,13,19,2,17,43,95,35,1,"https://fbref.com/en/players/3935e52e/Sead-Kolasinac"
"12799","Pau López_2023",2023,"Marseille","Ligue 1","Pau López","ESP","GK","27",1994,32.5,0,0,0,0,0,0,1,0,1,0,0,0,0,0,5,1,"https://fbref.com/en/players/20b9f052/Pau-Lopez"
"12800","Ruslan Malinovskyi_2023",2023,"Marseille","Ligue 1","Ruslan Malinovskyi","UKR","MF,FW","29",1993,13.6,21,11,3,12,6,10,26,38.5,16,13,1,12,3,24,9,0,"https://fbref.com/en/players/48d5bd33/Ruslan-Malinovskyi"
"12801","Chancel Mbemba_2023",2023,"Marseille","Ligue 1","Chancel Mbemba","COD","DF","27",1994,31.7,43,26,24,17,2,22,31,71,9,25,12,13,42,85,89,0,"https://fbref.com/en/players/e76cb9cc/Chancel-Mbemba"
"12802","Arkadiusz Milik_2023",2023,"Marseille","Ligue 1","Arkadiusz Milik","POL","FW","28",1994,1.4,1,1,0,0,1,0,1,0,1,0,0,0,0,1,2,0,"https://fbref.com/en/players/85613cf0/Arkadiusz-Milik"
"12803","François Mughe_2023",2023,"Marseille","Ligue 1","François Mughe","CMR","MF","18",2004,0.1,0,0,0,0,0,0,0,NA,0,0,0,0,0,0,0,0,"https://fbref.com/en/players/7af655fe/Francois-Mughe"
"12804","Azzedine Ounahi_2023",2023,"Marseille","Ligue 1","Azzedine Ounahi","MAR","MF,FW","22",2000,1.3,2,1,1,1,0,0,2,0,2,1,0,1,0,2,0,0,"https://fbref.com/en/players/83299cc0/Azzedine-Ounahi"
"12805","Dimitri Payet_2023",2023,"Marseille","Ligue 1","Dimitri Payet","FRA","MF,FW","35",1987,9.3,6,4,2,2,2,3,10,30,7,4,0,4,0,6,4,0,"https://fbref.com/en/players/58ae47b2/Dimitri-Payet"
"12806","Valentin Rongier_2023",2023,"Marseille","Ligue 1","Valentin Rongier","FRA","MF","27",1994,33.7,93,59,33,47,13,41,77,53.2,36,50,11,39,54,147,38,1,"https://fbref.com/en/players/ed45c4a5/Valentin-Rongier"
"12807","Alexis Sánchez_2023",2023,"Marseille","Ligue 1","Alexis Sánchez","CHI","FW,MF","33",1988,29.8,27,17,5,16,6,3,24,12.5,21,14,0,14,5,32,6,0,"https://fbref.com/en/players/2c0f8e9e/Alexis-Sanchez"
"12808","Nuno Tavares_2023",2023,"Marseille","Ligue 1","Nuno Tavares","POR","DF,MF","22",2000,26.1,56,30,19,24,13,28,55,50.9,27,32,4,28,15,71,25,0,"https://fbref.com/en/players/a65c844b/Nuno-Tavares"
"12809","Souleymane Touré_2023",2023,"Marseille","Ligue 1","Souleymane Touré","FRA","DF","19",2003,0.8,2,1,1,1,0,1,2,50,1,1,0,1,0,2,5,0,"https://fbref.com/en/players/01fd01e8/Souleymane-Toure"
"12810","Cengiz Ünder_2023",2023,"Marseille","Ligue 1","Cengiz Ünder","TUR","MF,DF","25",1997,27.7,37,19,15,13,9,13,34,38.2,21,18,2,16,18,55,13,0,"https://fbref.com/en/players/1880614f/Cengiz-Under"
"12811","Jordan Veretout_2023",2023,"Marseille","Ligue 1","Jordan Veretout","FRA","MF","29",1993,31.8,56,35,17,32,7,25,53,47.2,28,22,7,15,36,92,40,2,"https://fbref.com/en/players/4a56052c/Jordan-Veretout"
"12812","Vitinha_2023",2023,"Marseille","Ligue 1","Vitinha","POR","FW","22",2000,5.2,15,7,0,6,9,3,11,27.3,8,3,0,3,2,17,6,0,"https://fbref.com/en/players/74d4cec6/Vitinha"
"12813","Yacine Adli_2023",2023,"Milan","Serie A","Yacine Adli","FRA","MF,FW","22",2000,1.6,6,3,2,4,0,2,2,100,0,2,0,2,1,7,1,0,"https://fbref.com/en/players/26777636/Yacine-Adli"
"12814","Tiemoué Bakayoko_2023",2023,"Milan","Serie A","Tiemoué Bakayoko","FRA","MF","27",1994,0.5,5,5,4,1,0,3,3,100,0,0,0,0,0,5,0,1,"https://fbref.com/en/players/59bf127b/Tiemoue-Bakayoko"
"12815","Fodé Ballo-Touré_2023",2023,"Milan","Serie A","Fodé Ballo-Touré","SEN","DF","25",1997,5.8,14,9,7,6,1,7,10,70,3,11,3,8,2,16,3,0,"https://fbref.com/en/players/f449640d/Fode-Ballo-Toure"
"12816","Ismaël Bennacer_2023",2023,"Milan","Serie A","Ismaël Bennacer","ALG","MF","24",1997,22.3,59,33,26,31,2,30,51,58.8,21,25,7,18,26,85,16,1,"https://fbref.com/en/players/db092d3b/Ismael-Bennacer"
"12817","Davide Calabria_2023",2023,"Milan","Serie A","Davide Calabria","ITA","DF","25",1996,18.8,71,44,31,32,8,38,61,62.3,23,22,7,15,25,96,34,0,"https://fbref.com/en/players/2146785a/Davide-Calabria"
"12818","Charles De Ketelaere_2023",2023,"Milan","Serie A","Charles De Ketelaere","BEL","MF,FW","21",2001,12.4,26,12,7,14,5,13,30,43.3,17,14,2,12,4,30,9,0,"https://fbref.com/en/players/2ef7c612/Charles-De-Ketelaere"
"12819","Sergiño Dest_2023",2023,"Milan","Serie A","Sergiño Dest","USA","DF","21",2000,3.7,12,6,3,5,4,3,4,75,1,1,0,1,4,16,2,0,"https://fbref.com/en/players/5976f83e/Sergino-Dest"
"12820","Brahim Díaz_2023",2023,"Milan","Serie A","Brahim Díaz","ESP","MF,FW","22",1999,21.4,32,15,5,22,5,5,15,33.3,10,11,0,11,7,39,6,0,"https://fbref.com/en/players/407feb71/Brahim-Diaz"
"12821","Alessandro Florenzi_2023",2023,"Milan","Serie A","Alessandro Florenzi","ITA","DF","31",1991,2.3,6,4,3,2,1,4,7,57.1,3,1,0,1,4,10,2,0,"https://fbref.com/en/players/e288d4b3/Alessandro-Florenzi"
"12822","Matteo Gabbia_2023",2023,"Milan","Serie A","Matteo Gabbia","ITA","DF","22",1999,6.8,17,10,12,5,0,6,8,75,2,8,3,5,5,22,29,0,"https://fbref.com/en/players/c235e803/Matteo-Gabbia"
"12823","Olivier Giroud_2023",2023,"Milan","Serie A","Olivier Giroud","FRA","FW","35",1986,23.8,8,5,2,4,2,2,10,20,8,11,3,8,3,11,23,0,"https://fbref.com/en/players/16ceb862/Olivier-Giroud"
"12824","Theo Hernández_2023",2023,"Milan","Serie A","Theo Hernández","FRA","DF","24",1997,30.8,43,24,27,15,1,22,38,57.9,16,34,7,27,21,64,35,1,"https://fbref.com/en/players/d4c9725f/Theo-Hernandez"
"12825","Zlatan Ibrahimović_2023",2023,"Milan","Serie A","Zlatan Ibrahimović","SWE","FW","40",1981,1.6,0,0,0,0,0,0,0,NA,0,1,1,0,0,0,2,0,"https://fbref.com/en/players/4cde5509/Zlatan-Ibrahimovic"
"12826","Pierre Kalulu_2023",2023,"Milan","Serie A","Pierre Kalulu","FRA","DF","22",2000,28.3,57,39,33,21,3,28,42,66.7,14,41,17,24,41,98,56,1,"https://fbref.com/en/players/85f7d1be/Pierre-Kalulu"
"12827","Simon Kjær_2023",2023,"Milan","Serie A","Simon Kjær","DEN","DF","33",1989,11.2,15,8,9,6,0,7,11,63.6,4,14,11,3,9,24,35,1,"https://fbref.com/en/players/8b8a56ce/Simon-Kjaer"
"12828","Rade Krunić_2023",2023,"Milan","Serie A","Rade Krunić","BIH","MF","28",1993,18.4,40,28,18,18,4,16,50,32,34,31,11,20,16,56,21,0,"https://fbref.com/en/players/817c6964/Rade-Krunic"
"12829","Marko Lazetić_2023",2023,"Milan","Serie A","Marko Lazetić","SRB","FW","18",2004,0.1,0,0,0,0,0,0,0,NA,0,0,0,0,0,0,0,0,"https://fbref.com/en/players/93088fbb/Marko-Lazetic"
"12830","Rafael Leão_2023",2023,"Milan","Serie A","Rafael Leão","POR","FW,MF","23",1999,26.9,8,7,2,3,3,6,14,42.9,8,9,2,7,15,23,8,0,"https://fbref.com/en/players/20730eae/Rafael-Leao"
"12831","Mike Maignan_2023",2023,"Milan","Serie A","Mike Maignan","FRA","GK","27",1995,22,1,0,1,0,0,1,1,100,0,0,0,0,1,2,10,1,"https://fbref.com/en/players/fcb38f57/Mike-Maignan"
"12832","Junior Messias_2023",2023,"Milan","Serie A","Junior Messias","BRA","FW,DF","31",1991,16.6,24,18,9,9,6,5,19,26.3,14,20,4,16,7,31,28,0,"https://fbref.com/en/players/f49c4ae9/Junior-Messias"
"12833","Antonio Mirante_2023",2023,"Milan","Serie A","Antonio Mirante","ITA","GK","39",1983,0,0,0,0,0,0,0,0,NA,0,0,0,0,0,0,0,0,"https://fbref.com/en/players/30223b33/Antonio-Mirante"
"12834","Divock Origi_2023",2023,"Milan","Serie A","Divock Origi","BEL","FW","27",1995,11.4,10,5,4,3,3,5,10,50,5,6,2,4,0,10,13,0,"https://fbref.com/en/players/43a166b4/Divock-Origi"
"12835","Tommaso Pobega_2023",2023,"Milan","Serie A","Tommaso Pobega","ITA","MF","23",1999,9.8,27,16,8,15,4,13,20,65,7,12,4,8,9,36,11,0,"https://fbref.com/en/players/55a1cac2/Tommaso-Pobega"
"12836","Ante Rebić_2023",2023,"Milan","Serie A","Ante Rebić","CRO","FW,MF","28",1993,10.9,10,8,1,3,6,3,11,27.3,8,6,1,5,1,11,5,0,"https://fbref.com/en/players/536cebe5/Ante-Rebic"
"12837","Alexis Saelemaekers_2023",2023,"Milan","Serie A","Alexis Saelemaekers","BEL","FW,DF","23",1999,15.6,31,20,12,16,3,19,41,46.3,22,13,1,12,19,50,11,0,"https://fbref.com/en/players/ee251371/Alexis-Saelemaekers"
"12838","Ciprian Tătărușanu_2023",2023,"Milan","Serie A","Ciprian Tătărușanu","ROU","GK","36",1986,16,0,0,0,0,0,0,0,NA,0,0,0,0,1,1,2,0,"https://fbref.com/en/players/b056e3da/Ciprian-Tatarusanu"
"12839","Malick Thiaw_2023",2023,"Milan","Serie A","Malick Thiaw","GER","DF","20",2001,15.1,31,26,22,9,0,11,20,55,9,11,5,6,12,43,65,1,"https://fbref.com/en/players/ff5ea0bf/Malick-Thiaw"
"12840","Fikayo Tomori_2023",2023,"Milan","Serie A","Fikayo Tomori","ENG","DF","24",1997,30.7,70,34,44,25,1,22,34,64.7,12,46,25,21,29,99,88,1,"https://fbref.com/en/players/7edfbb8a/Fikayo-Tomori"
"12841","Sandro Tonali_2023",2023,"Milan","Serie A","Sandro Tonali","ITA","MF","22",2000,30.1,64,41,35,24,5,27,44,61.4,17,34,9,25,25,89,26,1,"https://fbref.com/en/players/0db169ae/Sandro-Tonali"
"12842","Aster Vranckx_2023",2023,"Milan","Serie A","Aster Vranckx","BEL","MF","19",2002,2.7,3,2,0,2,1,2,7,28.6,5,3,1,2,2,5,1,0,"https://fbref.com/en/players/f86cd5df/Aster-Vranckx"
"12843","Ruben Aguilar_2023",2023,"Monaco","Ligue 1","Ruben Aguilar","FRA","DF","29",1993,13,19,9,7,7,5,8,22,36.4,14,13,1,12,18,37,28,1,"https://fbref.com/en/players/3dd738a1/Ruben-Aguilar"
"12844","Maghnes Akliouche_2023",2023,"Monaco","Ligue 1","Maghnes Akliouche","FRA","MF,FW","20",2002,4.5,7,4,4,3,0,2,8,25,6,2,0,2,3,10,2,0,"https://fbref.com/en/players/b625b241/Maghnes-Akliouche"
"12845","Benoît Badiashile_2023",2023,"Monaco","Ligue 1","Benoît Badiashile","FRA","DF","21",2001,9.3,10,8,6,4,0,5,10,50,5,9,6,3,17,27,40,1,"https://fbref.com/en/players/06df8256/Benoit-Badiashile"
"12846","Eliesse Ben Seghir_2023",2023,"Monaco","Ligue 1","Eliesse Ben Seghir","FRA","FW,MF","17",2005,11.7,18,10,4,12,2,4,12,33.3,8,18,1,17,4,22,1,0,"https://fbref.com/en/players/3bd65247/Eliesse-Ben-Seghir"
"12847","Wissam Ben Yedder_2023",2023,"Monaco","Ligue 1","Wissam Ben Yedder","FRA","FW","31",1990,23.5,16,9,2,5,9,4,13,30.8,9,15,0,15,4,20,0,0,"https://fbref.com/en/players/942b4f90/Wissam-Ben-Yedder"
"12848","Myron Boadu_2023",2023,"Monaco","Ligue 1","Myron Boadu","NED","FW","21",2001,3.3,3,3,0,2,1,1,7,14.3,6,1,0,1,0,3,1,0,"https://fbref.com/en/players/5b479568/Myron-Boadu"
"12849","Mohamed Camara_2023",2023,"Monaco","Ligue 1","Mohamed Camara","MLI","MF","22",2000,24.4,83,45,38,39,6,48,92,52.2,44,45,6,39,27,110,14,1,"https://fbref.com/en/players/489e80e3/Mohamed-Camara"
"12850","Krépin Diatta_2023",2023,"Monaco","Ligue 1","Krépin Diatta","SEN","MF,FW","23",1999,23,30,21,4,17,9,13,32,40.6,19,29,1,28,17,47,12,0,"https://fbref.com/en/players/8104e41e/Krepin-Diatta"
"12851","Edan Diop_2023",2023,"Monaco","Ligue 1","Edan Diop","FRA","DF,FW","17",2004,2.5,13,8,3,3,7,7,15,46.7,8,7,1,6,4,17,1,0,"https://fbref.com/en/players/37143438/Edan-Diop"
"12852","Sofiane Diop_2023",2023,"Monaco","Ligue 1","Sofiane Diop","FRA","MF","22",2000,0.7,0,0,0,0,0,0,0,NA,0,0,0,0,1,1,0,0,"https://fbref.com/en/players/19053e31/Sofiane-Diop"
"12853","Axel Disasi_2023",2023,"Monaco","Ligue 1","Axel Disasi","FRA","DF","24",1998,37,30,20,13,13,4,13,27,48.1,14,51,31,20,56,86,112,2,"https://fbref.com/en/players/ad82197c/Axel-Disasi"
"12854","Breel Embolo_2023",2023,"Monaco","Ligue 1","Breel Embolo","SUI","FW","25",1997,20.7,15,9,2,7,6,5,10,50,5,14,3,11,5,20,12,0,"https://fbref.com/en/players/0b4f388a/Breel-Embolo"
"12855","Youssouf Fofana_2023",2023,"Monaco","Ligue 1","Youssouf Fofana","FRA","MF","23",1999,34.3,81,41,31,42,8,38,74,51.4,36,50,6,44,56,137,32,1,"https://fbref.com/en/players/822d51d7/Youssouf-Fofana"
"12856","Aleksandr Golovin_2023",2023,"Monaco","Ligue 1","Aleksandr Golovin","RUS","MF,FW","26",1996,27.4,62,36,19,32,11,28,72,38.9,44,28,1,27,37,99,10,0,"https://fbref.com/en/players/3708e9fa/Aleksandr-Golovin"
"12857","Ismail Jakobs_2023",2023,"Monaco","Ligue 1","Ismail Jakobs","SEN","DF,FW","22",1999,12.4,11,5,7,3,1,5,12,41.7,7,9,1,8,9,20,18,0,"https://fbref.com/en/players/a0415710/Ismail-Jakobs"
"12858","Jean Lucas_2023",2023,"Monaco","Ligue 1","Jean Lucas","BRA","MF","24",1998,3.2,9,5,3,5,1,6,12,50,6,2,1,1,4,13,2,0,"https://fbref.com/en/players/a99138af/Jean-Lucas"
"12859","Soungoutou Magassa_2023",2023,"Monaco","Ligue 1","Soungoutou Magassa","FRA","MF","18",2003,0.9,4,1,2,2,0,2,4,50,2,3,0,3,1,5,1,0,"https://fbref.com/en/players/dfc5d4fa/Soungoutou-Magassa"
"12860","Guillermo Maripán_2023",2023,"Monaco","Ligue 1","Guillermo Maripán","CHI","DF","28",1994,24,46,26,26,20,0,17,33,51.5,16,39,27,12,38,84,87,0,"https://fbref.com/en/players/d9764034/Guillermo-Maripan"
"12861","Gelson Martins_2023",2023,"Monaco","Ligue 1","Gelson Martins","POR","MF,FW","27",1995,3.8,15,8,6,4,5,4,13,30.8,9,4,1,3,3,18,2,0,"https://fbref.com/en/players/3ef0fa48/Gelson-Martins"
"12862","Eliot Matazo_2023",2023,"Monaco","Ligue 1","Eliot Matazo","BEL","MF","20",2002,13.1,26,12,11,13,2,11,26,42.3,15,18,4,14,15,41,11,1,"https://fbref.com/en/players/15944afd/Eliot-Matazo"
"12863","Chrislain Matsima_2023",2023,"Monaco","Ligue 1","Chrislain Matsima","FRA","DF","20",2002,5,11,6,7,2,2,4,7,57.1,3,5,5,0,9,20,16,0,"https://fbref.com/en/players/cf1ef7ec/Chrislain-Matsima"
"12864","Takumi Minamino_2023",2023,"Monaco","Ligue 1","Takumi Minamino","JPN","MF,FW","27",1995,8,15,8,5,7,3,7,35,20,28,14,0,14,6,21,4,0,"https://fbref.com/en/players/f833a830/Takumi-Minamino"
"12865","Alexander Nübel_2023",2023,"Monaco","Ligue 1","Alexander Nübel","GER","GK","25",1996,38,0,0,0,0,0,0,1,0,1,0,0,0,1,1,10,3,"https://fbref.com/en/players/afb0c500/Alexander-Nubel"
"12866","Malang Sarr_2023",2023,"Monaco","Ligue 1","Malang Sarr","FRA","DF","23",1999,8,6,3,5,1,0,1,5,20,4,11,7,4,15,21,29,2,"https://fbref.com/en/players/4315f30d/Malang-Sarr"
"12867","Caio Henrique Oliveira Silva_2023",2023,"Monaco","Ligue 1","Caio Henrique Oliveira Silva","BRA","DF","25",1997,32.2,74,51,42,28,4,44,76,57.9,32,28,8,20,26,100,68,1,"https://fbref.com/en/players/30af8b93/Caio-Henrique-Oliveira-Silva"
"12868","Vanderson_2023",2023,"Monaco","Ligue 1","Vanderson","BRA","DF,MF","21",2001,24.6,84,48,36,34,14,44,75,58.7,31,36,9,27,48,132,36,1,"https://fbref.com/en/players/ee45fd85/Vanderson"
"12869","Kevin Volland_2023",2023,"Monaco","Ligue 1","Kevin Volland","GER","FW,MF","30",1992,7.1,8,4,1,5,2,2,8,25,6,8,0,8,2,10,0,0,"https://fbref.com/en/players/64f69877/Kevin-Volland"
"12870","Matis Carvalho_2023",2023,"Montpellier","Ligue 1","Matis Carvalho","POR","GK","23",1999,1.5,0,0,0,0,0,0,0,NA,0,0,0,0,1,1,0,0,"https://fbref.com/en/players/8608f269/Matis-Carvalho"
"12871","Joris Chotard_2023",2023,"Montpellier","Ligue 1","Joris Chotard","FRA","MF","20",2001,27.3,64,34,37,23,4,40,78,51.3,38,40,11,29,40,104,42,1,"https://fbref.com/en/players/7909ffa4/Joris-Chotard"
"12872","Nicolas Cozza_2023",2023,"Montpellier","Ligue 1","Nicolas Cozza","FRA","DF","23",1999,14.2,38,21,27,9,2,26,38,68.4,12,11,5,6,21,59,35,1,"https://fbref.com/en/players/8f325097/Nicolas-Cozza"
"12873","Sacha Delaye_2023",2023,"Montpellier","Ligue 1","Sacha Delaye","FRA","FW,MF","20",2002,0.2,1,0,0,0,1,1,1,100,0,0,0,0,0,1,0,0,"https://fbref.com/en/players/e4448c8c/Sacha-Delaye"
"12874","Maxime Estève_2023",2023,"Montpellier","Ligue 1","Maxime Estève","FRA","DF","20",2002,18.3,24,13,17,5,2,12,17,70.6,5,28,17,11,34,58,90,0,"https://fbref.com/en/players/1a066e69/Maxime-Esteve"
"12875","Khalil Fayad_2023",2023,"Montpellier","Ligue 1","Khalil Fayad","FRA","MF","18",2004,8,30,14,12,16,2,12,21,57.1,9,8,1,7,9,39,4,0,"https://fbref.com/en/players/faf00ab8/Khalil-Fayad"
"12876","Cheikh Faye_2023",2023,"Montpellier","Ligue 1","Cheikh Faye","SEN","FW","23",1999,0.4,0,0,0,0,0,0,0,NA,0,0,0,0,1,1,0,0,"https://fbref.com/en/players/4b792f35/Cheikh-Faye"
"12877","Jordan Ferri_2023",2023,"Montpellier","Ligue 1","Jordan Ferri","FRA","MF","30",1992,30.4,55,35,32,19,4,30,89,33.7,59,22,6,16,26,81,21,0,"https://fbref.com/en/players/375622c5/Jordan-Ferri"
"12878","Valère Germain_2023",2023,"Montpellier","Ligue 1","Valère Germain","FRA","FW,MF","32",1990,7.6,13,11,3,5,5,4,12,33.3,8,8,0,8,6,19,12,0,"https://fbref.com/en/players/ea0ff634/Valere-Germain"
"12879","Axel Gueguin_2023",2023,"Montpellier","Ligue 1","Axel Gueguin","FRA","FW,MF","17",2005,0.3,0,0,0,0,0,0,0,NA,0,1,0,1,0,0,0,0,"https://fbref.com/en/players/f6857b4f/Axel-Gueguin"
"12880","Christopher Jullien_2023",2023,"Montpellier","Ligue 1","Christopher Jullien","FRA","DF","29",1993,29.9,46,28,29,14,3,28,51,54.9,23,35,18,17,43,89,114,1,"https://fbref.com/en/players/f323d995/Christopher-Jullien"
"12881","Bingourou Kamara_2023",2023,"Montpellier","Ligue 1","Bingourou Kamara","SEN","GK","25",1996,4.5,0,0,0,0,0,0,0,NA,0,0,0,0,0,0,2,0,"https://fbref.com/en/players/3814120d/Bingourou-Kamara"
"12882","Wahbi Khazri_2023",2023,"Montpellier","Ligue 1","Wahbi Khazri","TUN","FW,MF","31",1991,18.2,26,13,13,7,6,6,25,24,19,17,1,16,9,35,20,0,"https://fbref.com/en/players/2677a1de/Wahbi-Khazri"
"12883","Boubakar Kouyaté_2023",2023,"Montpellier","Ligue 1","Boubakar Kouyaté","MLI","DF","25",1997,14,31,18,18,11,2,19,35,54.3,16,24,14,10,34,65,73,1,"https://fbref.com/en/players/562a4799/Boubakar-Kouyate"
"12884","Benjamin Lecomte_2023",2023,"Montpellier","Ligue 1","Benjamin Lecomte","FRA","GK","31",1991,19,0,0,0,0,0,0,2,0,2,0,0,0,0,0,6,0,"https://fbref.com/en/players/2fa2a875/Benjamin-Lecomte"
"12885","Léo Leroy_2023",2023,"Montpellier","Ligue 1","Léo Leroy","FRA","MF","22",2000,13.2,53,38,24,26,3,31,57,54.4,26,25,2,23,14,67,8,0,"https://fbref.com/en/players/fcc84a07/Leo-Leroy"
"12886","Béni Makouana_2023",2023,"Montpellier","Ligue 1","Béni Makouana","CGO","FW,MF","19",2002,2.2,1,0,0,1,0,0,2,0,2,3,1,2,0,1,1,0,"https://fbref.com/en/players/654f49ca/Beni-Makouana"
"12887","Faitout Maouassa_2023",2023,"Montpellier","Ligue 1","Faitout Maouassa","FRA","FW,DF","24",1998,21.4,52,32,26,20,6,18,41,43.9,23,31,3,28,20,72,23,0,"https://fbref.com/en/players/e54a9890/Faitout-Maouassa"
"12888","Stephy Mavididi_2023",2023,"Montpellier","Ligue 1","Stephy Mavididi","ENG","FW","24",1998,14.3,24,19,12,8,4,13,27,48.1,14,21,1,20,4,28,10,0,"https://fbref.com/en/players/30144daa/Stephy-Mavididi"
"12889","Pedro Mendes_2023",2023,"Montpellier","Ligue 1","Pedro Mendes","POR","DF","31",1990,0.1,0,0,0,0,0,0,0,NA,0,0,0,0,0,0,0,1,"https://fbref.com/en/players/6690ef25/Pedro-Mendes"
"12890","Arnaud Nordin_2023",2023,"Montpellier","Ligue 1","Arnaud Nordin","FRA","FW","24",1998,26.7,26,14,10,12,4,12,28,42.9,16,19,1,18,14,40,7,0,"https://fbref.com/en/players/7b9a9e25/Arnaud-Nordin"
"12891","Jonas Omlin_2023",2023,"Montpellier","Ligue 1","Jonas Omlin","SUI","GK","28",1994,13,1,0,1,0,0,0,0,NA,0,0,0,0,0,1,8,1,"https://fbref.com/en/players/c631f952/Jonas-Omlin"
"12892","Falaye Sacko_2023",2023,"Montpellier","Ligue 1","Falaye Sacko","MLI","DF","27",1995,28.7,46,25,25,15,6,32,51,62.7,19,43,14,29,33,79,75,1,"https://fbref.com/en/players/6388e356/Falaye-Sacko"
"12893","Théo Sainte-Luce_2023",2023,"Montpellier","Ligue 1","Théo Sainte-Luce","FRA","DF","23",1998,5.9,13,11,8,5,0,7,14,50,7,7,2,5,10,23,11,0,"https://fbref.com/en/players/93c942fb/Theo-Sainte-Luce"
"12894","Mamadou Sakho_2023",2023,"Montpellier","Ligue 1","Mamadou Sakho","FRA","DF","32",1990,8.5,9,5,4,5,0,3,5,60,2,17,12,5,8,17,35,1,"https://fbref.com/en/players/87935cf3/Mamadou-Sakho"
"12895","Téji Savanier_2023",2023,"Montpellier","Ligue 1","Téji Savanier","FRA","MF","30",1991,28.3,46,30,16,19,11,23,70,32.9,47,30,2,28,30,76,12,1,"https://fbref.com/en/players/6bde367b/Teji-Savanier"
"12896","Arnaud Souquet_2023",2023,"Montpellier","Ligue 1","Arnaud Souquet","FRA","DF,FW","30",1992,4,22,16,13,7,2,11,14,78.6,3,8,3,5,4,26,4,0,"https://fbref.com/en/players/4e0afc5d/Arnaud-Souquet"
"12897","Issiaga Sylla_2023",2023,"Montpellier","Ligue 1","Issiaga Sylla","GUI","DF","28",1994,14.5,28,16,19,8,1,15,31,48.4,16,19,3,16,32,60,35,0,"https://fbref.com/en/players/b99bec05/Issiaga-Sylla"
"12898","Thibault Tamas_2023",2023,"Montpellier","Ligue 1","Thibault Tamas","FRA","DF","21",2001,0.1,0,0,0,0,0,0,0,NA,0,0,0,0,1,1,0,0,"https://fbref.com/en/players/4a0c6555/Thibault-Tamas"
"12899","Enzo Tchato_2023",2023,"Montpellier","Ligue 1","Enzo Tchato","CMR","DF","19",2002,12.2,26,17,14,11,1,13,22,59.1,9,17,2,15,7,33,33,0,"https://fbref.com/en/players/7f783431/Enzo-Tchato"
"12900","Elye Wahi_2023",2023,"Montpellier","Ligue 1","Elye Wahi","FRA","FW","19",2003,27.9,9,3,2,3,4,5,14,35.7,9,14,2,12,3,12,5,0,"https://fbref.com/en/players/0d7b6576/Elye-Wahi"
"12901","Valentin Antov_2023",2023,"Monza","Serie A","Valentin Antov","BUL","DF","21",2000,3.4,6,5,3,3,0,1,5,20,4,5,4,1,4,10,14,1,"https://fbref.com/en/players/8f68aa41/Valentin-Antov"
"12902","Andrea Barberis_2023",2023,"Monza","Serie A","Andrea Barberis","ITA","MF","28",1993,3.8,7,2,4,3,0,5,11,45.5,6,0,0,0,8,15,1,0,"https://fbref.com/en/players/32ebfe1e/Andrea-Barberis"
"12903","Samuele Birindelli_2023",2023,"Monza","Serie A","Samuele Birindelli","ITA","DF","23",1999,15.6,35,19,21,10,4,18,29,62.1,11,28,8,20,16,51,30,0,"https://fbref.com/en/players/204ac005/Samuele-Birindelli"
"12904","Warren Bondo_2023",2023,"Monza","Serie A","Warren Bondo","FRA","MF","18",2003,0.7,1,0,1,0,0,0,0,NA,0,1,0,1,0,1,0,0,"https://fbref.com/en/players/0def2376/Warren-Bondo"
"12905","Luca Caldirola_2023",2023,"Monza","Serie A","Luca Caldirola","ITA","DF","31",1991,26.1,26,14,19,4,3,13,26,50,13,32,18,14,25,51,66,1,"https://fbref.com/en/players/226008f1/Luca-Caldirola"
"12906","Gianluca Caprari_2023",2023,"Monza","Serie A","Gianluca Caprari","ITA","MF,FW","29",1993,27.1,16,6,3,11,2,8,26,30.8,18,22,1,21,8,24,3,0,"https://fbref.com/en/players/54e53b7e/Gianluca-Caprari"
"12907","Andrea Carboni_2023",2023,"Monza","Serie A","Andrea Carboni","ITA","DF","21",2001,1.9,3,2,2,0,1,2,5,40,3,3,2,1,3,6,2,1,"https://fbref.com/en/players/f7e2af2c/Andrea-Carboni"
"12908","Franco Carboni_2023",2023,"Monza","Serie A","Franco Carboni","ITA","DF,FW","19",2003,0.7,1,1,1,0,0,0,2,0,2,3,0,3,1,2,0,0,"https://fbref.com/en/players/b033f803/Franco-Carboni"
"12909","Carlos_2023",2023,"Monza","Serie A","Carlos","BRA","DF","23",1999,34.3,73,38,42,23,8,33,54,61.1,21,24,6,18,24,97,85,1,"https://fbref.com/en/players/8d3cd59d/Carlos"
"12910","Patrick Ciurria_2023",2023,"Monza","Serie A","Patrick Ciurria","ITA","DF,MF","27",1995,30.6,31,18,20,10,1,17,33,51.5,16,24,2,22,7,38,32,0,"https://fbref.com/en/players/5de3866c/Patrick-Ciurria"
"12911","Andrea Colpani_2023",2023,"Monza","Serie A","Andrea Colpani","ITA","MF","23",1999,10.5,14,9,6,5,3,8,12,66.7,4,14,2,12,3,17,6,0,"https://fbref.com/en/players/6499048c/Andrea-Colpani"
"12912","Alessio Cragno_2023",2023,"Monza","Serie A","Alessio Cragno","ITA","GK","28",1994,1,0,0,0,0,0,0,1,0,1,0,0,0,0,0,0,0,"https://fbref.com/en/players/f554e29b/Alessio-Cragno"
"12913","Marco D'Alessandro_2023",2023,"Monza","Serie A","Marco D'Alessandro","ITA","DF,FW","31",1991,3.2,4,4,3,1,0,2,5,40,3,2,0,2,1,5,3,0,"https://fbref.com/en/players/060606ec/Marco-DAlessandro"
"12914","Michele Di Gregorio_2023",2023,"Monza","Serie A","Michele Di Gregorio","ITA","GK","25",1997,37,0,0,0,0,0,0,3,0,3,1,0,1,4,4,18,3,"https://fbref.com/en/players/4e0c8d66/Michele-Di-Gregorio"
"12915","Giulio Donati_2023",2023,"Monza","Serie A","Giulio Donati","ITA","DF","32",1990,4.7,4,1,1,1,2,3,6,50,3,3,1,2,4,8,11,0,"https://fbref.com/en/players/22051fbe/Giulio-Donati"
"12916","Christian Gytkjær_2023",2023,"Monza","Serie A","Christian Gytkjær","DEN","FW,MF","32",1990,6.2,6,2,1,4,1,2,5,40,3,6,1,5,0,6,2,0,"https://fbref.com/en/players/9250bcff/Christian-Gytkjaer"
"12917","Armando Izzo_2023",2023,"Monza","Serie A","Armando Izzo","ITA","DF","30",1992,27.4,73,50,44,27,2,29,45,64.4,16,29,17,12,50,123,87,1,"https://fbref.com/en/players/89976232/Armando-Izzo"
"12918","Pablo Marí_2023",2023,"Monza","Serie A","Pablo Marí","ESP","DF","28",1993,27.6,37,19,29,7,1,17,26,65.4,9,22,14,8,31,68,111,3,"https://fbref.com/en/players/aa54ec6f/Pablo-Mari"
"12919","Marlon_2023",2023,"Monza","Serie A","Marlon","BRA","DF","26",1995,17.7,35,21,20,14,1,15,29,51.7,14,13,4,9,18,53,50,0,"https://fbref.com/en/players/cdf65d12/Marlon"
"12920","Luca Marrone_2023",2023,"Monza","Serie A","Luca Marrone","ITA","DF","32",1990,1.5,0,0,0,0,0,0,2,0,2,2,2,0,0,0,4,1,"https://fbref.com/en/players/ea468ea8/Luca-Marrone"
"12921","Salvatore Molina_2023",2023,"Monza","Serie A","Salvatore Molina","ITA","DF","30",1992,2.5,6,5,2,4,0,4,5,80,1,4,2,2,1,7,2,0,"https://fbref.com/en/players/54ab971f/Salvatore-Molina"
"12922","Dany Mota_2023",2023,"Monza","Serie A","Dany Mota","POR","FW,MF","24",1998,21.2,8,7,1,3,4,2,10,20,8,5,1,4,6,14,25,0,"https://fbref.com/en/players/efc9e31f/Dany-Mota"
"12923","Pepín_2023",2023,"Monza","Serie A","Pepín","EQG","MF","25",1996,12.5,28,19,10,11,7,9,27,33.3,18,14,3,11,13,41,17,0,"https://fbref.com/en/players/7afb1573/Pepin"
"12924","Matteo Pessina_2023",2023,"Monza","Serie A","Matteo Pessina","ITA","MF","25",1997,32.6,57,36,28,21,8,26,62,41.9,36,50,15,35,37,94,33,1,"https://fbref.com/en/players/780e3631/Matteo-Pessina"
"12925","Andrea Petagna_2023",2023,"Monza","Serie A","Andrea Petagna","ITA","FW","27",1995,18.5,7,5,2,3,2,3,6,50,3,16,4,12,3,10,18,0,"https://fbref.com/en/players/03f946ed/Andrea-Petagna"
"12926","Andrea Ranocchia_2023",2023,"Monza","Serie A","Andrea Ranocchia","ITA","DF","34",1988,0.5,3,1,1,2,0,3,4,75,1,5,5,0,0,3,7,0,"https://fbref.com/en/players/539230cf/Andrea-Ranocchia"
"12927","Filippo Ranocchia_2023",2023,"Monza","Serie A","Filippo Ranocchia","ITA","MF","21",2001,5.9,11,6,5,4,2,4,12,33.3,8,5,1,4,4,15,7,0,"https://fbref.com/en/players/d9ebed1c/Filippo-Ranocchia"
"12928","Nicolò Rovella_2023",2023,"Monza","Serie A","Nicolò Rovella","ITA","MF","20",2001,19.3,45,29,22,21,2,13,36,36.1,23,20,1,19,40,85,17,0,"https://fbref.com/en/players/e58cbfd5/Nicolo-Rovella"
"12929","Stefano Sensi_2023",2023,"Monza","Serie A","Stefano Sensi","ITA","MF","26",1995,18,41,26,25,13,3,18,48,37.5,30,13,3,10,20,61,4,0,"https://fbref.com/en/players/b70bde8f/Stefano-Sensi"
"12930","Mattia Valoti_2023",2023,"Monza","Serie A","Mattia Valoti","ITA","MF,FW","28",1993,5,17,10,7,9,1,5,16,31.3,11,13,3,10,3,20,6,0,"https://fbref.com/en/players/c414df9d/Mattia-Valoti"
"12931","Samuele Vignato_2023",2023,"Monza","Serie A","Samuele Vignato","ITA","MF,FW","18",2004,0.7,0,0,0,0,0,0,0,NA,0,1,0,1,0,0,0,0,"https://fbref.com/en/players/a14d0ab0/Samuele-Vignato"
"12932","Mohamed Achi_2023",2023,"Nantes","Ligue 1","Mohamed Achi","FRA","FW","20",2002,0.4,1,1,1,0,0,1,1,100,0,0,0,0,0,1,0,0,"https://fbref.com/en/players/1e93fc5d/Mohamed-Achi"
"12933","Dennis Appiah_2023",2023,"Nantes","Ligue 1","Dennis Appiah","FRA","DF,MF","30",1992,8.8,21,11,14,7,0,10,27,37,17,13,5,8,10,31,16,0,"https://fbref.com/en/players/feb5d3ab/Dennis-Appiah"
"12934","Stredair Appuah_2023",2023,"Nantes","Ligue 1","Stredair Appuah","FRA","DF,MF","18",2004,0.7,2,1,0,2,0,0,0,NA,0,2,0,2,1,3,0,0,"https://fbref.com/en/players/42f0113f/Stredair-Appuah"
"12935","Ludovic Blas_2023",2023,"Nantes","Ligue 1","Ludovic Blas","FRA","MF,FW","24",1997,31.3,47,30,17,19,11,17,49,34.7,32,26,1,25,19,66,8,0,"https://fbref.com/en/players/6191093d/Ludovic-Blas"
"12936","Jean-Charles Castelletto_2023",2023,"Nantes","Ligue 1","Jean-Charles Castelletto","CMR","DF","27",1995,28.5,43,26,29,12,2,22,36,61.1,14,35,22,13,58,101,90,0,"https://fbref.com/en/players/e0f3a1f6/Jean-Charles-Castelletto"
"12937","Fabien Centonze_2023",2023,"Nantes","Ligue 1","Fabien Centonze","FRA","DF","26",1996,18.8,58,37,30,22,6,30,42,71.4,12,24,7,17,44,102,55,1,"https://fbref.com/en/players/3c6bbbab/Fabien-Centonze"
"12938","Pedro Chirivella_2023",2023,"Nantes","Ligue 1","Pedro Chirivella","ESP","MF","25",1997,22.5,33,22,12,15,6,17,44,38.6,27,24,1,23,20,53,7,0,"https://fbref.com/en/players/68a26d51/Pedro-Chirivella"
"12939","Marcus Coco_2023",2023,"Nantes","Ligue 1","Marcus Coco","FRA","FW,MF","26",1996,7.1,24,15,11,9,4,11,23,47.8,12,13,3,10,14,38,7,0,"https://fbref.com/en/players/3010aefb/Marcus-Coco"
"12940","Sébastien Corchia_2023",2023,"Nantes","Ligue 1","Sébastien Corchia","FRA","DF","31",1990,8.7,16,6,10,2,4,11,22,50,11,9,3,6,14,30,21,0,"https://fbref.com/en/players/0e7ccfc4/Sebastien-Corchia"
"12941","Andy Delort_2023",2023,"Nantes","Ligue 1","Andy Delort","ALG","FW","30",1991,5.2,5,4,1,2,2,2,6,33.3,4,3,0,3,0,5,2,0,"https://fbref.com/en/players/d33c706e/Andy-Delort"
"12942","Rémy Descamps_2023",2023,"Nantes","Ligue 1","Rémy Descamps","FRA","GK","26",1996,1,0,0,0,0,0,0,0,NA,0,0,0,0,0,0,0,0,"https://fbref.com/en/players/477e50ce/Remy-Descamps"
"12943","Lohann Doucet_2023",2023,"Nantes","Ligue 1","Lohann Doucet","FRA","MF,FW","19",2002,1,3,0,2,0,1,3,4,75,1,2,0,2,2,5,4,0,"https://fbref.com/en/players/dff0c299/Lohann-Doucet"
"12944","Fábio_2023",2023,"Nantes","Ligue 1","Fábio","BRA","DF,MF","32",1990,2.5,4,2,1,2,1,4,6,66.7,2,2,0,2,3,7,11,0,"https://fbref.com/en/players/bc7b4580/Fabio"
"12945","Ignatius Ganago_2023",2023,"Nantes","Ligue 1","Ignatius Ganago","CMR","FW,MF","23",1999,16.9,9,7,2,3,4,4,7,57.1,3,13,1,12,2,11,12,0,"https://fbref.com/en/players/23c63b7f/Ignatius-Ganago"
"12946","Andrei Girotto_2023",2023,"Nantes","Ligue 1","Andrei Girotto","BRA","DF,MF","30",1992,35,122,73,71,45,6,74,132,56.1,58,55,24,31,73,195,176,1,"https://fbref.com/en/players/3befc2b6/Andrei-Girotto"
"12947","Evann Guessand_2023",2023,"Nantes","Ligue 1","Evann Guessand","FRA","FW,MF","21",2001,14,24,16,8,13,3,6,12,50,6,17,1,16,9,33,6,0,"https://fbref.com/en/players/b73f17f8/Evann-Guessand"
"12948","Jaouen Hadjam_2023",2023,"Nantes","Ligue 1","Jaouen Hadjam","ALG","DF","19",2003,8.9,27,21,13,9,5,16,25,64,9,10,3,7,12,39,12,0,"https://fbref.com/en/players/576817b7/Jaouen-Hadjam"
"12949","Abdoul Kader Bamba_2023",2023,"Nantes","Ligue 1","Abdoul Kader Bamba","FRA","FW,MF","28",1994,0.9,0,0,0,0,0,0,2,0,2,3,1,2,0,0,1,0,"https://fbref.com/en/players/32f3d97e/Abdoul-Kader-Bamba"
"12950","Alban Lafont_2023",2023,"Nantes","Ligue 1","Alban Lafont","FRA","GK","23",1999,37,0,0,0,0,0,0,1,0,1,0,0,0,0,0,20,4,"https://fbref.com/en/players/4e7db402/Alban-Lafont"
"12951","Quentin Merlin_2023",2023,"Nantes","Ligue 1","Quentin Merlin","FRA","DF","20",2002,19.9,31,19,19,8,4,18,38,47.4,20,27,4,23,24,55,30,0,"https://fbref.com/en/players/0bfca6a1/Quentin-Merlin"
"12952","Mostafa Mohamed_2023",2023,"Nantes","Ligue 1","Mostafa Mohamed","EGY","FW","24",1997,21.5,18,13,5,7,6,9,20,45,11,23,1,22,10,28,33,0,"https://fbref.com/en/players/595e6f3e/Mostafa-Mohamed"
"12953","Florent Mollet_2023",2023,"Nantes","Ligue 1","Florent Mollet","FRA","MF","30",1991,12.1,14,6,5,4,5,7,24,29.2,17,12,1,11,10,24,11,0,"https://fbref.com/en/players/7e82a78f/Florent-Mollet"
"12954","Samuel Moutoussamy_2023",2023,"Nantes","Ligue 1","Samuel Moutoussamy","COD","MF","25",1996,26.7,64,34,27,28,9,26,76,34.2,50,23,2,21,24,88,15,0,"https://fbref.com/en/players/af0c835b/Samuel-Moutoussamy"
"12955","Nicolas Pallois_2023",2023,"Nantes","Ligue 1","Nicolas Pallois","FRA","DF","34",1987,24.6,69,44,51,16,2,42,70,60,28,35,18,17,30,99,131,2,"https://fbref.com/en/players/779847d6/Nicolas-Pallois"
"12956","Moses Simon_2023",2023,"Nantes","Ligue 1","Moses Simon","NGA","FW,MF","27",1995,26.1,18,9,6,7,5,7,15,46.7,8,14,1,13,11,29,3,0,"https://fbref.com/en/players/5f3eaaf5/Moses-Simon"
"12957","Moussa Sissoko_2023",2023,"Nantes","Ligue 1","Moussa Sissoko","FRA","MF","32",1989,21.3,26,16,16,7,3,12,18,66.7,6,22,5,17,16,42,17,0,"https://fbref.com/en/players/2acd49b9/Moussa-Sissoko"
"12958","Charles Traore_2023",2023,"Nantes","Ligue 1","Charles Traore","MLI","DF","30",1992,5.4,8,5,5,2,1,5,7,71.4,2,9,2,7,10,18,12,0,"https://fbref.com/en/players/de488e56/Charles-Traore"
"12959","João Victor_2023",2023,"Nantes","Ligue 1","João Victor","BRA","DF","24",1998,9.4,19,11,9,7,3,12,22,54.5,10,11,1,10,15,34,30,0,"https://fbref.com/en/players/d60cf08d/Joao-Victor"
"12960","Nathan Zeze_2023",2023,"Nantes","Ligue 1","Nathan Zeze","FRA","DF","17",2005,0.7,3,2,2,1,0,1,1,100,0,0,0,0,0,3,1,0,"https://fbref.com/en/players/fb4c5b6e/Nathan-Zeze"
"12961","Bartosz Bereszyński_2023",2023,"Napoli","Serie A","Bartosz Bereszyński","POL","DF","30",1992,1.8,3,2,1,1,1,2,2,100,0,4,0,4,3,6,3,0,"https://fbref.com/en/players/61b3978f/Bartosz-Bereszynski"
"12962","Diego Demme_2023",2023,"Napoli","Serie A","Diego Demme","GER","MF","30",1991,1.6,1,0,1,0,0,0,4,0,4,2,0,2,0,1,1,0,"https://fbref.com/en/players/dc3fa3b5/Diego-Demme"
"12963","Giovanni Di Lorenzo_2023",2023,"Napoli","Serie A","Giovanni Di Lorenzo","ITA","DF","28",1993,36.2,60,29,33,19,8,25,49,51,24,30,9,21,30,90,60,0,"https://fbref.com/en/players/230a2fac/Giovanni-Di-Lorenzo"
"12964","Elif Elmas_2023",2023,"Napoli","Serie A","Elif Elmas","MKD","FW,MF","22",1999,18.1,24,13,8,12,4,11,23,47.8,12,18,2,16,11,35,5,0,"https://fbref.com/en/players/cf007308/Elif-Elmas"
"12965","Gianluca Gaetano_2023",2023,"Napoli","Serie A","Gianluca Gaetano","ITA","MF","22",2000,0.8,5,3,1,3,1,0,0,NA,0,1,0,1,1,6,0,0,"https://fbref.com/en/players/3b387cc7/Gianluca-Gaetano"
"12966","Pierluigi Gollini_2023",2023,"Napoli","Serie A","Pierluigi Gollini","ITA","GK","27",1995,4,0,0,0,0,0,0,0,NA,0,0,0,0,0,0,1,0,"https://fbref.com/en/players/f0f7f62f/Pierluigi-Gollini"
"12967","Juan Jesus_2023",2023,"Napoli","Serie A","Juan Jesus","BRA","DF","31",1991,10.4,16,11,9,6,1,9,12,75,3,18,11,7,10,26,29,0,"https://fbref.com/en/players/79083382/Juan-Jesus"
"12968","Khvicha Kvaratskhelia_2023",2023,"Napoli","Serie A","Khvicha Kvaratskhelia","GEO","FW","21",2001,28,43,23,12,8,23,17,43,39.5,26,20,0,20,5,48,6,1,"https://fbref.com/en/players/dea88efd/Khvicha-Kvaratskhelia"
"12969","Stanislav Lobotka_2023",2023,"Napoli","Serie A","Stanislav Lobotka","SVK","MF","27",1994,34.5,83,44,35,35,13,43,73,58.9,30,29,7,22,23,106,16,0,"https://fbref.com/en/players/e1cbb531/Stanislav-Lobotka"
"12970","Hirving Lozano_2023",2023,"Napoli","Serie A","Hirving Lozano","MEX","FW","27",1995,17.8,24,13,10,6,8,9,21,42.9,12,31,0,31,15,39,6,0,"https://fbref.com/en/players/a69e4806/Hirving-Lozano"
"12971","Alex Meret_2023",2023,"Napoli","Serie A","Alex Meret","ITA","GK","25",1997,34,0,0,0,0,0,0,0,NA,0,0,0,0,0,0,6,1,"https://fbref.com/en/players/9413b19f/Alex-Meret"
"12972","Kim Min-jae_2023",2023,"Napoli","Serie A","Kim Min-jae","KOR","DF","25",1996,33.9,55,30,32,22,1,25,29,86.2,4,36,26,10,41,96,123,1,"https://fbref.com/en/players/e0f8151c/Kim-Min-jae"
"12973","Tanguy Ndombele_2023",2023,"Napoli","Serie A","Tanguy Ndombele","FRA","MF","25",1996,9,14,8,4,8,2,4,7,57.1,3,10,1,9,7,21,7,1,"https://fbref.com/en/players/5cdddffa/Tanguy-Ndombele"
"12974","Mathías Olivera_2023",2023,"Napoli","Serie A","Mathías Olivera","URU","DF","24",1997,18.3,39,23,16,16,7,22,43,51.2,21,28,2,26,22,61,26,0,"https://fbref.com/en/players/41c12f75/Mathias-Olivera"
"12975","Victor Osimhen_2023",2023,"Napoli","Serie A","Victor Osimhen","NGA","FW","23",1998,28.5,10,6,1,2,7,0,7,0,7,6,1,5,6,16,29,0,"https://fbref.com/en/players/8c90fd7a/Victor-Osimhen"
"12976","Adam Ounas_2023",2023,"Napoli","Serie A","Adam Ounas","ALG","FW","25",1996,0.2,0,0,0,0,0,0,0,NA,0,0,0,0,1,1,0,0,"https://fbref.com/en/players/ed90babd/Adam-Ounas"
"12977","Matteo Politano_2023",2023,"Napoli","Serie A","Matteo Politano","ITA","FW","28",1993,13,18,9,9,5,4,11,25,44,14,6,0,6,7,25,7,0,"https://fbref.com/en/players/5e861944/Matteo-Politano"
"12978","Giacomo Raspadori_2023",2023,"Napoli","Serie A","Giacomo Raspadori","ITA","FW,MF","22",2000,10.1,10,8,0,6,4,4,10,40,6,9,0,9,4,14,4,0,"https://fbref.com/en/players/6e058f06/Giacomo-Raspadori"
"12979","Amir Rrahmani_2023",2023,"Napoli","Serie A","Amir Rrahmani","KVX","DF","28",1994,27.2,33,18,20,13,0,17,26,65.4,9,36,20,16,14,47,79,1,"https://fbref.com/en/players/4b3e1a38/Amir-Rrahmani"
"12980","Mário Rui_2023",2023,"Napoli","Serie A","Mário Rui","POR","DF","31",1991,19.4,34,22,17,13,4,20,41,48.8,21,17,4,13,15,49,24,1,"https://fbref.com/en/players/0b5a292a/Mario-Rui"
"12981","Giovanni Simeone_2023",2023,"Napoli","Serie A","Giovanni Simeone","ARG","FW","27",1995,4.5,12,3,3,5,4,3,8,37.5,5,2,1,1,1,13,4,0,"https://fbref.com/en/players/343c0d52/Giovanni-Simeone"
"12982","Leo Skiri Østigård_2023",2023,"Napoli","Serie A","Leo Skiri Østigård","NOR","DF","22",1999,4.7,4,1,3,1,0,1,1,100,0,3,3,0,6,10,18,1,"https://fbref.com/en/players/b35a7399/Leo-Skiri-Ostigard"
"12983","Andre-Frank Zambo Anguissa_2023",2023,"Napoli","Serie A","Andre-Frank Zambo Anguissa","CMR","MF","26",1995,33.9,53,32,16,29,8,16,64,25,48,50,4,46,49,102,25,0,"https://fbref.com/en/players/6bb2c084/Andre-Frank-Zambo-Anguissa"
"12984","Alessandro Zanoli_2023",2023,"Napoli","Serie A","Alessandro Zanoli","ITA","DF","21",2000,0.1,1,0,0,1,0,0,0,NA,0,0,0,0,0,1,1,0,"https://fbref.com/en/players/3b12b11f/Alessandro-Zanoli"
"12985","Karim Zedadka_2023",2023,"Napoli","Serie A","Karim Zedadka","FRA","FW","22",2000,0.2,0,0,0,0,0,0,0,NA,0,0,0,0,0,0,1,0,"https://fbref.com/en/players/2f45300d/Karim-Zedadka"
"12986","Alessio Zerbin_2023",2023,"Napoli","Serie A","Alessio Zerbin","ITA","FW","23",1999,2.2,10,5,4,5,1,4,8,50,4,2,0,2,2,12,2,0,"https://fbref.com/en/players/d19ef4ef/Alessio-Zerbin"
"12987","Piotr Zieliński_2023",2023,"Napoli","Serie A","Piotr Zieliński","POL","MF","28",1994,25.4,17,10,1,11,5,12,25,48,13,16,5,11,14,31,7,0,"https://fbref.com/en/players/a5296e55/Piotr-Zielinski"
"12988","Miguel Almirón_2023",2023,"Newcastle Utd","Premier League","Miguel Almirón","PAR","FW","28",1994,27.7,46,30,16,19,11,18,42,42.9,24,25,2,23,10,56,17,0,"https://fbref.com/en/players/862a1c15/Miguel-Almiron"
"12989","Elliot Anderson_2023",2023,"Newcastle Utd","Premier League","Elliot Anderson","SCO","MF,FW","19",2002,4.6,11,5,5,3,3,6,12,50,6,11,2,9,6,17,2,0,"https://fbref.com/en/players/de31038e/Elliot-Anderson"
"12990","Sven Botman_2023",2023,"Newcastle Utd","Premier League","Sven Botman","NED","DF","22",2000,34.7,38,24,31,7,0,22,28,78.6,6,44,24,20,34,72,126,2,"https://fbref.com/en/players/ccce7025/Sven-Botman"
"12991","Dan Burn_2023",2023,"Newcastle Utd","Premier League","Dan Burn","ENG","DF","30",1992,34.6,60,38,29,23,8,34,67,50.7,33,42,16,26,32,92,120,2,"https://fbref.com/en/players/b2d31e83/Dan-Burn"
"12992","Martin Dúbravka_2023",2023,"Newcastle Utd","Premier League","Martin Dúbravka","SVK","GK","33",1989,1.7,0,0,0,0,0,0,1,0,1,0,0,0,0,0,1,0,"https://fbref.com/en/players/3a949a25/Martin-Dubravka"
"12993","Ryan Fraser_2023",2023,"Newcastle Utd","Premier League","Ryan Fraser","SCO","FW","28",1994,3.5,2,2,0,0,2,2,5,40,3,3,1,2,0,2,3,0,"https://fbref.com/en/players/d56543a0/Ryan-Fraser"
"12994","Anthony Gordon_2023",2023,"Newcastle Utd","Premier League","Anthony Gordon","ENG","FW,MF","21",2001,5.4,14,12,5,7,2,9,20,45,11,9,1,8,2,16,1,1,"https://fbref.com/en/players/2bd83368/Anthony-Gordon"
"12995","Bruno Guimarães_2023",2023,"Newcastle Utd","Premier League","Bruno Guimarães","BRA","MF","24",1997,30.3,78,40,27,46,5,38,65,58.5,27,28,4,24,36,114,22,1,"https://fbref.com/en/players/82518f62/Bruno-Guimaraes"
"12996","Alexander Isak_2023",2023,"Newcastle Utd","Premier League","Alexander Isak","SWE","FW","22",1999,16.9,18,8,4,7,7,10,28,35.7,18,21,2,19,4,22,8,0,"https://fbref.com/en/players/8e92be30/Alexander-Isak"
"12997","Joelinton_2023",2023,"Newcastle Utd","Premier League","Joelinton","BRA","MF,FW","25",1996,29.6,70,49,36,26,8,26,62,41.9,36,52,7,45,48,118,39,0,"https://fbref.com/en/players/c17bfb65/Joelinton"
"12998","Emil Krafth_2023",2023,"Newcastle Utd","Premier League","Emil Krafth","SWE","DF","27",1994,0,0,0,0,0,0,0,0,NA,0,0,0,0,0,0,0,0,"https://fbref.com/en/players/77cf6852/Emil-Krafth"
"12999","Jamaal Lascelles_2023",2023,"Newcastle Utd","Premier League","Jamaal Lascelles","ENG","DF","28",1993,2.4,1,0,1,0,0,1,1,100,0,3,2,1,0,1,17,0,"https://fbref.com/en/players/450ab6fc/Jamaal-Lascelles"
"13000","Jamal Lewis_2023",2023,"Newcastle Utd","Premier League","Jamal Lewis","NIR","DF,FW","24",1998,0.1,0,0,0,0,0,0,0,NA,0,0,0,0,0,0,0,0,"https://fbref.com/en/players/efb9215a/Jamal-Lewis"
"13001","Sean Longstaff_2023",2023,"Newcastle Utd","Premier League","Sean Longstaff","ENG","MF","24",1997,28,42,21,16,20,6,20,52,38.5,32,35,8,27,16,58,23,0,"https://fbref.com/en/players/a2b105e0/Sean-Longstaff"
"13002","Javier Manquillo_2023",2023,"Newcastle Utd","Premier League","Javier Manquillo","ESP","DF","28",1994,0.4,3,2,2,1,0,2,2,100,0,1,0,1,1,4,1,0,"https://fbref.com/en/players/758dd7f0/Javier-Manquillo"
"13003","Lewis Miley_2023",2023,"Newcastle Utd","Premier League","Lewis Miley","ENG","MF","16",2006,0.2,0,0,0,0,0,0,0,NA,0,1,0,1,0,0,0,0,"https://fbref.com/en/players/2c6835e5/Lewis-Miley"
"13004","Jacob Murphy_2023",2023,"Newcastle Utd","Premier League","Jacob Murphy","ENG","FW","27",1995,13.9,15,7,3,8,4,8,20,40,12,17,0,17,7,22,3,0,"https://fbref.com/en/players/de112b84/Jacob-Murphy"
"13005","Nick Pope_2023",2023,"Newcastle Utd","Premier League","Nick Pope","ENG","GK","30",1992,36.2,1,0,1,0,0,1,3,33.3,2,0,0,0,0,1,27,2,"https://fbref.com/en/players/4b40d9ca/Nick-Pope"
"13006","Matt Ritchie_2023",2023,"Newcastle Utd","Premier League","Matt Ritchie","SCO","FW,MF","32",1989,0.4,1,1,0,1,0,1,3,33.3,2,0,0,0,1,2,0,0,"https://fbref.com/en/players/71ef519e/Matt-Ritchie"
"13007","Allan Saint-Maximin_2023",2023,"Newcastle Utd","Premier League","Allan Saint-Maximin","FRA","FW","25",1997,12.4,10,3,3,6,1,2,11,18.2,9,4,0,4,5,15,2,0,"https://fbref.com/en/players/2b16cb1a/Allan-Saint-Maximin"
"13008","Fabian Schär_2023",2023,"Newcastle Utd","Premier League","Fabian Schär","SUI","DF","30",1991,35.6,47,22,31,13,3,24,39,61.5,15,34,19,15,52,99,139,0,"https://fbref.com/en/players/c8aa95da/Fabian-Schar"
"13009","Jonjo Shelvey_2023",2023,"Newcastle Utd","Premier League","Jonjo Shelvey","ENG","MF","30",1992,0.4,1,0,1,0,0,0,1,0,1,1,0,1,0,1,0,0,"https://fbref.com/en/players/3727dd3c/Jonjo-Shelvey"
"13010","Matt Targett_2023",2023,"Newcastle Utd","Premier League","Matt Targett","ENG","DF","26",1995,6.8,13,10,8,3,2,9,24,37.5,15,8,3,5,9,22,16,0,"https://fbref.com/en/players/e514ab62/Matt-Targett"
"13011","Kieran Trippier_2023",2023,"Newcastle Utd","Premier League","Kieran Trippier","ENG","DF","31",1990,37.1,71,49,36,27,8,46,90,51.1,44,45,15,30,43,114,84,2,"https://fbref.com/en/players/21512407/Kieran-Trippier"
"13012","Joe Willock_2023",2023,"Newcastle Utd","Premier League","Joe Willock","ENG","MF","22",1999,28.4,51,30,13,26,12,25,58,43.1,33,54,8,46,25,76,17,0,"https://fbref.com/en/players/a3b03921/Joe-Willock"
"13013","Callum Wilson_2023",2023,"Newcastle Utd","Premier League","Callum Wilson","ENG","FW","30",1992,20.9,9,3,0,8,1,0,3,0,3,8,0,8,1,10,5,0,"https://fbref.com/en/players/c596fcb0/Callum-Wilson"
"13014","Chris Wood_2023",2023,"Newcastle Utd","Premier League","Chris Wood","NZL","FW","30",1991,5,5,4,0,3,2,3,5,60,2,2,2,0,1,6,7,0,"https://fbref.com/en/players/4e9a0555/Chris-Wood"
"13015","Ayoub Amraoui_2023",2023,"Nice","Ligue 1","Ayoub Amraoui","MAR","DF,FW","18",2004,3.3,6,5,3,3,0,2,5,40,3,1,0,1,4,10,4,0,"https://fbref.com/en/players/ae11ba3d/Ayoub-Amraoui"
"13016","Youcef Atal_2023",2023,"Nice","Ligue 1","Youcef Atal","ALG","DF,MF","26",1996,8.7,38,22,18,15,5,23,32,71.9,9,9,0,9,14,52,13,0,"https://fbref.com/en/players/6a827d8e/Youcef-Atal"
"13017","Melvin Bard_2023",2023,"Nice","Ligue 1","Melvin Bard","FRA","DF","21",2000,27.3,96,60,61,29,6,59,89,66.3,30,35,4,31,64,160,40,1,"https://fbref.com/en/players/1ddbc7ca/Melvin-Bard"
"13018","Ross Barkley_2023",2023,"Nice","Ligue 1","Ross Barkley","ENG","MF,FW","28",1993,10.7,16,9,7,4,5,7,13,53.8,6,7,2,5,8,24,6,0,"https://fbref.com/en/players/3a24769f/Ross-Barkley"
"13019","Alexis Beka Beka_2023",2023,"Nice","Ligue 1","Alexis Beka Beka","FRA","MF,DF","21",2001,6.1,16,5,6,9,1,4,15,26.7,11,9,1,8,12,28,6,0,"https://fbref.com/en/players/4a5e83ad/Alexis-Beka-Beka"
"13020","Reda Belahyane_2023",2023,"Nice","Ligue 1","Reda Belahyane","FRA","MF","18",2004,2,8,6,5,3,0,3,5,60,2,5,1,4,2,10,0,0,"https://fbref.com/en/players/705a1642/Reda-Belahyane"
"13021","Badredine Bouanani_2023",2023,"Nice","Ligue 1","Badredine Bouanani","ALG","FW,MF","17",2004,9.6,13,9,2,7,4,7,14,50,7,4,0,4,1,14,2,0,"https://fbref.com/en/players/0400dd2f/Badredine-Bouanani"
"13022","Hicham Boudaoui_2023",2023,"Nice","Ligue 1","Hicham Boudaoui","ALG","MF","22",1999,20.8,67,32,31,30,6,35,53,66,18,34,5,29,36,103,16,0,"https://fbref.com/en/players/f9d5908e/Hicham-Boudaoui"
"13023","Bilal Brahimi_2023",2023,"Nice","Ligue 1","Bilal Brahimi","ALG","FW,MF","22",2000,8.9,8,5,2,5,1,1,7,14.3,6,4,0,4,4,12,0,0,"https://fbref.com/en/players/02bcaf8e/Bilal-Brahimi"
"13024","Joe Bryan_2023",2023,"Nice","Ligue 1","Joe Bryan","ENG","MF,DF","28",1993,2,5,4,3,2,0,4,4,100,0,2,0,2,1,6,1,0,"https://fbref.com/en/players/af69e7f0/Joe-Bryan"
"13025","Marcin Bułka_2023",2023,"Nice","Ligue 1","Marcin Bułka","POL","GK","22",1999,2,0,0,0,0,0,0,1,0,1,0,0,0,1,1,0,0,"https://fbref.com/en/players/db87a2c4/Marcin-Bulka"
"13026","Alexis Claude-Maurice_2023",2023,"Nice","Ligue 1","Alexis Claude-Maurice","FRA","FW","24",1998,0.7,3,2,2,1,0,3,3,100,0,0,0,0,2,5,1,0,"https://fbref.com/en/players/741418c3/Alexis-Claude-Maurice"
"13027","Andréa Dacourt_2023",2023,"Nice","Ligue 1","Andréa Dacourt","FRA","MF","17",2005,0,0,0,0,0,0,0,0,NA,0,0,0,0,0,0,0,0,"https://fbref.com/en/players/4a021593/Andrea-Dacourt"
"13028","Flavius Daniliuc_2023",2023,"Nice","Ligue 1","Flavius Daniliuc","AUT","DF","21",2001,1,2,0,2,0,0,1,1,100,0,4,1,3,0,2,1,0,"https://fbref.com/en/players/7ef972c3/Flavius-Daniliuc"
"13029","Dante_2023",2023,"Nice","Ligue 1","Dante","BRA","DF","38",1983,36.7,70,40,45,21,4,36,59,61,23,52,31,21,47,117,125,2,"https://fbref.com/en/players/fd2bc67d/Dante"
"13030","Andy Delort_2023",2023,"Nice","Ligue 1","Andy Delort","ALG","FW","30",1991,8.7,2,0,1,1,0,1,2,50,1,0,0,0,1,3,7,0,"https://fbref.com/en/players/d33c706e/Andy-Delort"
"13031","Sofiane Diop_2023",2023,"Nice","Ligue 1","Sofiane Diop","FRA","MF,FW","22",2000,13.6,23,11,12,6,5,7,20,35,13,14,2,12,16,39,5,0,"https://fbref.com/en/players/19053e31/Sofiane-Diop"
"13032","Amine Gouiri_2023",2023,"Nice","Ligue 1","Amine Gouiri","FRA","FW,MF","22",2000,2.5,1,1,1,0,0,0,1,0,1,1,0,1,0,1,3,0,"https://fbref.com/en/players/aad56ca3/Amine-Gouiri"
"13033","Rareş Ilie_2023",2023,"Nice","Ligue 1","Rareş Ilie","ROU","MF,FW","19",2003,1.6,3,3,0,1,2,2,4,50,2,2,0,2,1,4,1,0,"https://fbref.com/en/players/c9f49454/Rares-Ilie"
"13034","Gaëtan Laborde_2023",2023,"Nice","Ligue 1","Gaëtan Laborde","FRA","FW","28",1994,27.8,45,25,13,17,15,18,40,45,22,27,2,25,9,54,13,0,"https://fbref.com/en/players/7cdda3bf/Gaetan-Laborde"
"13035","Mario Lemina_2023",2023,"Nice","Ligue 1","Mario Lemina","GAB","MF,DF","28",1993,9.3,32,21,11,14,7,12,18,66.7,6,13,5,8,11,43,20,0,"https://fbref.com/en/players/2b471f99/Mario-Lemina"
"13036","Jordan Lotomba_2023",2023,"Nice","Ligue 1","Jordan Lotomba","SUI","DF","23",1998,27.3,65,38,33,24,8,31,48,64.6,17,38,11,27,32,97,53,0,"https://fbref.com/en/players/fc4cf6a7/Jordan-Lotomba"
"13037","Antoine Mendy_2023",2023,"Nice","Ligue 1","Antoine Mendy","FRA","DF","18",2004,5.8,22,13,16,5,1,9,15,60,6,6,1,5,2,24,16,0,"https://fbref.com/en/players/3322e296/Antoine-Mendy"
"13038","Terem Moffi_2023",2023,"Nice","Ligue 1","Terem Moffi","NGA","FW","23",1999,14.8,12,6,0,6,6,2,12,16.7,10,3,0,3,2,14,5,0,"https://fbref.com/en/players/065dc209/Terem-Moffi"
"13039","Youssouf Ndayishimiye_2023",2023,"Nice","Ligue 1","Youssouf Ndayishimiye","BDI","MF,DF","23",1998,6.3,13,9,8,5,0,6,11,54.5,5,8,5,3,12,25,22,1,"https://fbref.com/en/players/65c55288/Youssouf-Ndayishimiye"
"13040","Nicolas Pépé_2023",2023,"Nice","Ligue 1","Nicolas Pépé","CIV","FW,MF","27",1995,16.6,25,13,14,5,6,11,25,44,14,17,0,17,3,28,1,0,"https://fbref.com/en/players/57e3f0c7/Nicolas-Pepe"
"13041","Aaron Ramsey_2023",2023,"Nice","Ligue 1","Aaron Ramsey","WAL","MF","31",1990,17.6,47,25,18,19,10,16,39,41,23,25,4,21,17,64,18,1,"https://fbref.com/en/players/ef619b0b/Aaron-Ramsey"
"13042","Pablo Rosario_2023",2023,"Nice","Ligue 1","Pablo Rosario","NED","MF,DF","25",1997,19.6,46,26,22,20,4,18,34,52.9,16,15,5,10,23,69,32,1,"https://fbref.com/en/players/1a6b7ea4/Pablo-Rosario"
"13043","Kasper Schmeichel_2023",2023,"Nice","Ligue 1","Kasper Schmeichel","DEN","GK","35",1986,36,1,0,1,0,0,1,4,25,3,1,0,1,1,2,11,1,"https://fbref.com/en/players/53af52f3/Kasper-Schmeichel"
"13044","Calvin Stengs_2023",2023,"Nice","Ligue 1","Calvin Stengs","NED","FW","23",1998,2.4,2,2,1,0,1,1,2,50,1,0,0,0,0,2,0,0,"https://fbref.com/en/players/8f7e6783/Calvin-Stengs"
"13045","Khéphren Thuram_2023",2023,"Nice","Ligue 1","Khéphren Thuram","FRA","MF","21",2001,28.3,51,25,22,23,6,19,43,44.2,24,33,13,20,38,89,34,0,"https://fbref.com/en/players/7d9397f8/Khephren-Thuram"
"13046","Jean-Clair Todibo_2023",2023,"Nice","Ligue 1","Jean-Clair Todibo","FRA","DF","22",1999,31.9,76,48,54,19,3,41,56,73.2,15,41,19,22,41,117,110,2,"https://fbref.com/en/players/88f130ed/Jean-Clair-Todibo"
"13047","Théo Trinker_2023",2023,"Nice","Ligue 1","Théo Trinker","FRA","MF","21",2001,0,0,0,0,0,0,0,0,NA,0,0,0,0,0,0,0,0,"https://fbref.com/en/players/7a3f8712/Theo-Trinker"
"13048","Mattia Viti_2023",2023,"Nice","Ligue 1","Mattia Viti","ITA","DF","20",2002,7,4,2,1,1,2,2,5,40,3,9,3,6,8,12,22,0,"https://fbref.com/en/players/75438a9a/Mattia-Viti"
"13049","Serge Aurier_2023",2023,"Nott'ham Forest","Premier League","Serge Aurier","CIV","DF","29",1992,21.6,64,41,41,18,5,23,33,69.7,10,34,11,23,29,93,75,0,"https://fbref.com/en/players/5c2b4f07/Serge-Aurier"
"13050","Taiwo Awoniyi_2023",2023,"Nott'ham Forest","Premier League","Taiwo Awoniyi","NGA","FW","24",1997,15.6,17,10,2,10,5,6,10,60,4,18,4,14,4,21,20,0,"https://fbref.com/en/players/e5478b87/Taiwo-Awoniyi"
"13051","André Ayew_2023",2023,"Nott'ham Forest","Premier League","André Ayew","GHA","FW,MF","32",1989,3.5,5,3,0,4,1,2,4,50,2,6,1,5,0,5,7,0,"https://fbref.com/en/players/5dbefa9d/Andre-Ayew"
"13052","Giulian Biancone_2023",2023,"Nott'ham Forest","Premier League","Giulian Biancone","FRA","DF","22",2000,0.2,2,1,2,0,0,1,1,100,0,0,0,0,1,3,0,0,"https://fbref.com/en/players/de40e38c/Giulian-Biancone"
"13053","Willy Boly_2023",2023,"Nott'ham Forest","Premier League","Willy Boly","CIV","DF","31",1991,7.6,13,6,8,3,2,8,13,61.5,5,13,4,9,12,25,45,0,"https://fbref.com/en/players/a4ac4b8f/Willy-Boly"
"13054","Cafú_2023",2023,"Nott'ham Forest","Premier League","Cafú","POR","MF","29",1993,0.1,0,0,0,0,0,0,0,NA,0,0,0,0,0,0,1,0,"https://fbref.com/en/players/85322440/Cafu"
"13055","Jack Colback_2023",2023,"Nott'ham Forest","Premier League","Jack Colback","ENG","MF","32",1989,5.5,18,13,12,6,0,5,8,62.5,3,3,0,3,3,21,9,0,"https://fbref.com/en/players/963a9201/Jack-Colback"
"13056","Steve Cook_2023",2023,"Nott'ham Forest","Premier League","Steve Cook","ENG","DF","31",1991,10.6,8,4,4,4,0,5,7,71.4,2,16,11,5,12,20,51,0,"https://fbref.com/en/players/3e5e4e63/Steve-Cook"
"13057","Danilo_2023",2023,"Nott'ham Forest","Premier League","Danilo","BRA","MF","21",2001,10.8,18,7,7,9,2,6,25,24,19,26,6,20,9,27,19,0,"https://fbref.com/en/players/a816dbfb/Danilo"
"13058","Emmanuel Dennis_2023",2023,"Nott'ham Forest","Premier League","Emmanuel Dennis","NGA","FW,MF","24",1997,8,17,11,5,5,7,8,17,47.1,9,13,1,12,2,19,6,0,"https://fbref.com/en/players/2c44a35d/Emmanuel-Dennis"
"13059","Felipe_2023",2023,"Nott'ham Forest","Premier League","Felipe","BRA","DF","33",1989,15.8,42,23,29,13,0,24,41,58.5,17,34,13,21,36,78,90,0,"https://fbref.com/en/players/51a3c4c8/Felipe"
"13060","Remo Freuler_2023",2023,"Nott'ham Forest","Premier League","Remo Freuler","SUI","MF","30",1992,24,43,23,23,15,5,19,43,44.2,24,36,9,27,29,72,45,0,"https://fbref.com/en/players/98d2c2c4/Remo-Freuler"
"13061","Morgan Gibbs-White_2023",2023,"Nott'ham Forest","Premier League","Morgan Gibbs-White","ENG","MF,FW","22",2000,33,26,14,7,7,12,11,32,34.4,21,23,4,19,14,40,15,0,"https://fbref.com/en/players/32f60ed8/Morgan-Gibbs-White"
"13062","Dean Henderson_2023",2023,"Nott'ham Forest","Premier League","Dean Henderson","ENG","GK","25",1997,18,0,0,0,0,0,0,0,NA,0,0,0,0,0,0,12,1,"https://fbref.com/en/players/e5a76dfe/Dean-Henderson"
"13063","Wayne Hennessey_2023",2023,"Nott'ham Forest","Premier League","Wayne Hennessey","WAL","GK","35",1987,3,1,0,1,0,0,1,1,100,0,0,0,0,0,1,2,0,"https://fbref.com/en/players/76eca7e2/Wayne-Hennessey"
"13064","Brennan Johnson_2023",2023,"Nott'ham Forest","Premier League","Brennan Johnson","WAL","FW,MF","21",2001,32.6,34,20,18,8,8,8,28,28.6,20,30,1,29,5,39,7,1,"https://fbref.com/en/players/0cd31129/Brennan-Johnson"
"13065","Cheikhou Kouyaté_2023",2023,"Nott'ham Forest","Premier League","Cheikhou Kouyaté","SEN","MF","32",1989,9.8,29,21,18,8,3,9,13,69.2,4,14,2,12,10,39,24,0,"https://fbref.com/en/players/8d3c902d/Cheikhou-Kouyate"
"13066","Jesse Lingard_2023",2023,"Nott'ham Forest","Premier League","Jesse Lingard","ENG","FW,MF","29",1992,10.3,4,4,2,2,0,1,7,14.3,6,11,0,11,5,9,4,0,"https://fbref.com/en/players/810e3c74/Jesse-Lingard"
"13067","Renan Lodi_2023",2023,"Nott'ham Forest","Premier League","Renan Lodi","BRA","DF","24",1998,24.6,52,39,38,8,6,33,66,50,33,25,6,19,33,85,74,0,"https://fbref.com/en/players/ed9f7cfe/Renan-Lodi"
"13068","Orel Mangala_2023",2023,"Nott'ham Forest","Premier League","Orel Mangala","BEL","MF","24",1998,17.2,28,20,16,10,2,12,29,41.4,17,21,7,14,23,51,15,0,"https://fbref.com/en/players/a572e291/Orel-Mangala"
"13069","Scott McKenna_2023",2023,"Nott'ham Forest","Premier League","Scott McKenna","SCO","DF","25",1996,17.5,12,7,7,3,2,6,10,60,4,20,14,6,12,24,85,1,"https://fbref.com/en/players/4e5a4cbc/Scott-McKenna"
"13070","Alexander Mighten_2023",2023,"Nott'ham Forest","Premier League","Alexander Mighten","ENG","FW","20",2002,0.1,0,0,0,0,0,0,1,0,1,0,0,0,0,0,0,0,"https://fbref.com/en/players/10ec4169/Alexander-Mighten"
"13071","Keylor Navas_2023",2023,"Nott'ham Forest","Premier League","Keylor Navas","CRC","GK","35",1986,17,0,0,0,0,0,0,0,NA,0,0,0,0,1,1,11,1,"https://fbref.com/en/players/ecada4fc/Keylor-Navas"
"13072","Moussa Niakhate_2023",2023,"Nott'ham Forest","Premier League","Moussa Niakhate","SEN","DF","26",1996,12.9,18,9,15,3,0,11,22,50,11,18,8,10,19,37,60,0,"https://fbref.com/en/players/00242715/Moussa-Niakhate"
"13073","Lewis O'Brien_2023",2023,"Nott'ham Forest","Premier League","Lewis O'Brien","ENG","MF","23",1998,6.5,16,9,4,11,1,6,12,50,6,13,2,11,5,21,9,0,"https://fbref.com/en/players/089667a5/Lewis-OBrien"
"13074","Gustavo Scarpa_2023",2023,"Nott'ham Forest","Premier League","Gustavo Scarpa","BRA","MF,FW","28",1994,2,5,2,3,1,1,2,5,40,3,4,0,4,0,5,3,0,"https://fbref.com/en/players/2964fd20/Gustavo-Scarpa"
"13075","Jonjo Shelvey_2023",2023,"Nott'ham Forest","Premier League","Jonjo Shelvey","ENG","MF","30",1992,6,2,1,0,1,1,1,9,11.1,8,7,2,5,5,7,10,1,"https://fbref.com/en/players/3727dd3c/Jonjo-Shelvey"
"13076","Sam Surridge_2023",2023,"Nott'ham Forest","Premier League","Sam Surridge","ENG","FW","24",1998,3.6,5,0,1,3,1,1,4,25,3,5,2,3,0,5,7,0,"https://fbref.com/en/players/b017b770/Sam-Surridge"
"13077","Harry Toffolo_2023",2023,"Nott'ham Forest","Premier League","Harry Toffolo","ENG","DF","26",1995,10.4,17,8,10,4,3,10,14,71.4,4,16,8,8,10,27,33,0,"https://fbref.com/en/players/a105d46a/Harry-Toffolo"
"13078","Neco Williams_2023",2023,"Nott'ham Forest","Premier League","Neco Williams","WAL","DF","21",2001,20.9,72,47,49,17,6,38,71,53.5,33,33,8,25,33,105,48,0,"https://fbref.com/en/players/dd323728/Neco-Williams"
"13079","Chris Wood_2023",2023,"Nott'ham Forest","Premier League","Chris Wood","NZL","FW","30",1991,4.1,0,0,0,0,0,0,1,0,1,2,1,1,1,1,2,0,"https://fbref.com/en/players/4e9a0555/Chris-Wood"
"13080","Joe Worrall_2023",2023,"Nott'ham Forest","Premier League","Joe Worrall","ENG","DF","25",1997,24.7,53,25,39,12,2,25,35,71.4,10,33,23,10,26,79,111,1,"https://fbref.com/en/players/a5212312/Joe-Worrall"
"13081","Ryan Yates_2023",2023,"Nott'ham Forest","Premier League","Ryan Yates","ENG","MF","24",1997,20.4,38,19,19,16,3,14,22,63.6,8,26,8,18,10,48,44,0,"https://fbref.com/en/players/c1fe2a48/Ryan-Yates"
"13082","Ezequiel Ávila_2023",2023,"Osasuna","La Liga","Ezequiel Ávila","ARG","FW,MF","28",1994,19,8,5,2,4,2,6,23,26.1,17,12,1,11,8,16,16,0,"https://fbref.com/en/players/253a06b9/Ezequiel-Avila"
"13083","Kike Barja_2023",2023,"Osasuna","La Liga","Kike Barja","ESP","FW,MF","25",1997,14.6,15,9,6,5,4,8,24,33.3,16,7,0,7,4,19,3,0,"https://fbref.com/en/players/aad53e64/Kike-Barja"
"13084","Iker Benito_2023",2023,"Osasuna","La Liga","Iker Benito","ESP","FW,MF","19",2002,2,4,3,0,3,1,2,4,50,2,0,0,0,2,6,4,0,"https://fbref.com/en/players/50cbc806/Iker-Benito"
"13085","Darko Brašanac_2023",2023,"Osasuna","La Liga","Darko Brašanac","SRB","MF","30",1992,11.6,29,20,12,10,7,12,23,52.2,11,14,2,12,12,41,9,0,"https://fbref.com/en/players/4accb7e0/Darko-Brasanac"
"13086","Ante Budimir_2023",2023,"Osasuna","La Liga","Ante Budimir","CRO","FW","31",1991,20,19,9,0,12,7,2,10,20,8,10,0,10,5,24,19,0,"https://fbref.com/en/players/8f3565b3/Ante-Budimir"
"13087","Juan Cruz Armada_2023",2023,"Osasuna","La Liga","Juan Cruz Armada","ESP","DF","30",1992,22.9,24,14,17,4,3,13,23,56.5,10,21,8,13,13,37,58,0,"https://fbref.com/en/players/a56da3ba/Juan-Cruz-Armada"
"13088","Abdessamad Ezzalzouli_2023",2023,"Osasuna","La Liga","Abdessamad Ezzalzouli","MAR","FW,MF","20",2001,16.7,29,19,13,12,4,13,23,56.5,10,20,0,20,4,33,6,0,"https://fbref.com/en/players/bed68338/Abdessamad-Ezzalzouli"
"13089","Aitor Fernández_2023",2023,"Osasuna","La Liga","Aitor Fernández","ESP","GK","31",1991,21,1,1,1,0,0,0,1,0,1,0,0,0,2,3,17,0,"https://fbref.com/en/players/a01c3d54/Aitor-Fernandez"
"13090","David García_2023",2023,"Osasuna","La Liga","David García","ESP","DF","28",1994,29.8,34,20,22,12,0,19,22,86.4,3,28,13,15,45,79,151,0,"https://fbref.com/en/players/3e42f707/David-Garcia"
"13091","Rubén García_2023",2023,"Osasuna","La Liga","Rubén García","ESP","FW,MF","29",1993,12.9,20,11,12,4,4,7,24,29.2,17,14,1,13,12,32,13,0,"https://fbref.com/en/players/5c96b017/Ruben-Garcia"
"13092","Unai García_2023",2023,"Osasuna","La Liga","Unai García","ESP","DF","30",1992,19,23,13,13,8,2,12,17,70.6,5,23,14,9,19,42,60,2,"https://fbref.com/en/players/4a633cfe/Unai-Garcia"
"13093","Moi Gómez_2023",2023,"Osasuna","La Liga","Moi Gómez","ESP","MF,FW","28",1994,27.3,26,17,9,14,3,15,32,46.9,17,15,3,12,10,36,5,1,"https://fbref.com/en/players/5a626448/Moi-Gomez"
"13094","Aridane Hernández_2023",2023,"Osasuna","La Liga","Aridane Hernández","ESP","DF","33",1989,19.9,21,15,17,4,0,12,25,48,13,34,21,13,28,49,96,1,"https://fbref.com/en/players/132ac341/Aridane-Hernandez"
"13095","Jorge Herrando_2023",2023,"Osasuna","La Liga","Jorge Herrando","ESP","DF","21",2001,0.3,0,0,0,0,0,0,0,NA,0,1,0,1,0,0,3,0,"https://fbref.com/en/players/e19c989c/Jorge-Herrando"
"13096","Sergio Herrera_2023",2023,"Osasuna","La Liga","Sergio Herrera","ESP","GK","29",1993,17,2,0,2,0,0,2,2,100,0,1,0,1,1,3,6,2,"https://fbref.com/en/players/a4995f48/Sergio-Herrera"
"13097","Pablo Ibáñez_2023",2023,"Osasuna","La Liga","Pablo Ibáñez","ESP","MF","23",1998,11.8,29,13,7,17,5,12,35,34.3,23,19,2,17,8,37,24,0,"https://fbref.com/en/players/3701906c/Pablo-Ibanez"
"13098","Kike_2023",2023,"Osasuna","La Liga","Kike","ESP","FW","32",1989,11.3,6,3,0,4,2,2,5,40,3,6,1,5,1,7,13,0,"https://fbref.com/en/players/e897d8ba/Kike"
"13099","Jon Moncayola_2023",2023,"Osasuna","La Liga","Jon Moncayola","ESP","MF,DF","24",1998,27.2,55,39,24,22,9,30,76,39.5,46,37,5,32,17,72,32,2,"https://fbref.com/en/players/9939e168/Jon-Moncayola"
"13100","Diego Moreno_2023",2023,"Osasuna","La Liga","Diego Moreno","ESP","DF","21",2001,7.1,4,4,2,2,0,3,8,37.5,5,7,4,3,5,9,21,0,"https://fbref.com/en/players/a21417e2/Diego-Moreno"
"13101","Iker Muñoz_2023",2023,"Osasuna","La Liga","Iker Muñoz","ESP","MF","19",2002,2.8,1,0,0,1,0,0,3,0,3,2,1,1,3,4,8,0,"https://fbref.com/en/players/175ece4c/Iker-Munoz"
"13102","Aimar Oroz_2023",2023,"Osasuna","La Liga","Aimar Oroz","ESP","MF,FW","20",2001,22.4,26,14,8,10,8,8,30,26.7,22,24,1,23,24,50,6,0,"https://fbref.com/en/players/7c363088/Aimar-Oroz"
"13103","Rubén Peña_2023",2023,"Osasuna","La Liga","Rubén Peña","ESP","DF,MF","31",1991,14.2,32,18,10,18,4,20,41,48.8,21,23,8,15,17,49,31,0,"https://fbref.com/en/players/1f079188/Ruben-Pena"
"13104","Manu Sánchez_2023",2023,"Osasuna","La Liga","Manu Sánchez","ESP","DF","21",2000,23.6,51,35,35,9,7,33,63,52.4,30,33,5,28,14,65,51,0,"https://fbref.com/en/players/ffacd3d5/Manu-Sanchez"
"13105","Roberto Torres_2023",2023,"Osasuna","La Liga","Roberto Torres","ESP","FW,MF","33",1989,0.1,0,0,0,0,0,0,0,NA,0,0,0,0,0,0,0,0,"https://fbref.com/en/players/d733aa38/Roberto-Torres"
"13106","Lucas Torró_2023",2023,"Osasuna","La Liga","Lucas Torró","ESP","MF","28",1994,27.5,48,32,28,15,5,18,42,42.9,24,24,3,21,42,90,64,1,"https://fbref.com/en/players/0e4fef6e/Lucas-Torro"
"13107","Nacho Vidal_2023",2023,"Osasuna","La Liga","Nacho Vidal","ESP","DF","27",1995,13.9,27,14,16,6,5,17,32,53.1,15,17,4,13,19,46,33,1,"https://fbref.com/en/players/3a9c4b7b/Nacho-Vidal"
"13108","Juan Bernat_2023",2023,"Paris S-G","Ligue 1","Juan Bernat","ESP","DF,MF","29",1993,18.3,32,16,18,9,5,21,39,53.8,18,11,2,9,9,41,22,1,"https://fbref.com/en/players/433dc9a2/Juan-Bernat"
"13109","El Chadaille Bitshiabu_2023",2023,"Paris S-G","Ligue 1","El Chadaille Bitshiabu","FRA","DF","17",2005,6.5,10,7,7,2,1,3,12,25,9,9,7,2,9,19,13,3,"https://fbref.com/en/players/2180c761/El-Chadaille-Bitshiabu"
"13110","Gianluigi Donnarumma_2023",2023,"Paris S-G","Ligue 1","Gianluigi Donnarumma","ITA","GK","23",1999,37.9,1,0,1,0,0,1,2,50,1,0,0,0,0,1,12,4,"https://fbref.com/en/players/08f5afaa/Gianluigi-Donnarumma"
"13111","Hugo Ekitike_2023",2023,"Paris S-G","Ligue 1","Hugo Ekitike","FRA","FW","20",2002,12.8,12,4,1,10,1,4,12,33.3,8,12,0,12,9,21,3,0,"https://fbref.com/en/players/5b92d896/Hugo-Ekitike"
"13112","Ismaël Gharbi_2023",2023,"Paris S-G","Ligue 1","Ismaël Gharbi","ESP","MF,FW","18",2004,0.6,0,0,0,0,0,0,2,0,2,2,0,2,3,3,0,0,"https://fbref.com/en/players/5b3cfa12/Ismael-Gharbi"
"13113","Achraf Hakimi_2023",2023,"Paris S-G","Ligue 1","Achraf Hakimi","MAR","DF,MF","23",1998,22.8,54,34,19,20,15,31,59,52.5,28,34,2,32,16,70,19,0,"https://fbref.com/en/players/e42d61c7/Achraf-Hakimi"
"13114","Ilyes Housni_2023",2023,"Paris S-G","Ligue 1","Ilyes Housni","FRA","FW","17",2005,0.1,1,1,1,0,0,1,1,100,0,0,0,0,0,1,0,0,"https://fbref.com/en/players/910e3cad/Ilyes-Housni"
"13115","Presnel Kimpembe_2023",2023,"Paris S-G","Ligue 1","Presnel Kimpembe","FRA","DF","26",1995,8.1,17,8,9,6,2,9,13,69.2,4,12,7,5,13,30,9,1,"https://fbref.com/en/players/aef6e670/Presnel-Kimpembe"
"13116","Alexandre Letellier_2023",2023,"Paris S-G","Ligue 1","Alexandre Letellier","FRA","GK","31",1990,0.1,0,0,0,0,0,0,0,NA,0,0,0,0,0,0,0,0,"https://fbref.com/en/players/96fcd380/Alexandre-Letellier"
"13117","Marquinhos_2023",2023,"Paris S-G","Ligue 1","Marquinhos","BRA","DF","28",1994,30.2,33,25,18,12,3,18,26,69.2,8,43,27,16,23,56,83,2,"https://fbref.com/en/players/d5f2f82b/Marquinhos"
"13118","Kylian Mbappé_2023",2023,"Paris S-G","Ligue 1","Kylian Mbappé","FRA","FW","23",1998,31.3,10,4,0,5,5,5,16,31.3,11,5,0,5,5,15,6,0,"https://fbref.com/en/players/42fd9c7f/Kylian-Mbappe"
"13119","Nuno Mendes_2023",2023,"Paris S-G","Ligue 1","Nuno Mendes","POR","DF","20",2002,17.2,45,30,29,12,4,30,41,73.2,11,19,3,16,17,62,18,0,"https://fbref.com/en/players/f20e4cc9/Nuno-Mendes"
"13120","Lionel Messi_2023",2023,"Paris S-G","Ligue 1","Lionel Messi","ARG","FW,MF","35",1987,31.5,26,18,1,13,12,11,27,40.7,16,11,0,11,2,28,0,0,"https://fbref.com/en/players/d70ce98e/Lionel-Messi"
"13121","Nordi Mukiele_2023",2023,"Paris S-G","Ligue 1","Nordi Mukiele","FRA","DF","24",1997,12.6,31,23,16,6,9,19,29,65.5,10,22,9,13,14,45,16,0,"https://fbref.com/en/players/ac73ec79/Nordi-Mukiele"
"13122","Neymar_2023",2023,"Paris S-G","Ligue 1","Neymar","BRA","MF,FW","30",1992,17.2,22,14,6,9,7,9,19,47.4,10,7,1,6,4,26,1,1,"https://fbref.com/en/players/69384e5d/Neymar"
"13123","Leandro Paredes_2023",2023,"Paris S-G","Ligue 1","Leandro Paredes","ARG","MF","28",1994,0.6,1,1,1,0,0,1,1,100,0,2,1,1,1,2,0,0,"https://fbref.com/en/players/dff153a4/Leandro-Paredes"
"13124","Timothee Pembele_2023",2023,"Paris S-G","Ligue 1","Timothee Pembele","FRA","DF","19",2002,2.9,5,5,3,1,1,2,4,50,2,2,0,2,4,9,2,0,"https://fbref.com/en/players/f8ce97ca/Timothee-Pembele"
"13125","Danilo Pereira_2023",2023,"Paris S-G","Ligue 1","Danilo Pereira","POR","DF,MF","30",1991,26.8,32,17,15,14,3,19,26,73.1,7,26,19,7,36,68,59,1,"https://fbref.com/en/players/8fd9996f/Danilo-Pereira"
"13126","Sergio Ramos_2023",2023,"Paris S-G","Ligue 1","Sergio Ramos","ESP","DF","36",1986,30,34,26,14,18,2,23,44,52.3,21,29,13,16,34,68,93,3,"https://fbref.com/en/players/08511d65/Sergio-Ramos"
"13127","Fabián Ruiz Peña_2023",2023,"Paris S-G","Ligue 1","Fabián Ruiz Peña","ESP","MF","26",1996,21,62,28,25,30,7,43,79,54.4,36,24,1,23,18,80,23,1,"https://fbref.com/en/players/c0c7ff58/Fabian-Ruiz-Pena"
"13128","Renato Sanches_2023",2023,"Paris S-G","Ligue 1","Renato Sanches","POR","MF","24",1997,8,8,1,1,3,4,5,14,35.7,9,13,3,10,9,17,4,0,"https://fbref.com/en/players/032f894e/Renato-Sanches"
"13129","Pablo Sarabia_2023",2023,"Paris S-G","Ligue 1","Pablo Sarabia","ESP","FW,MF","30",1992,4.1,5,4,2,2,1,1,7,14.3,6,3,0,3,2,7,0,0,"https://fbref.com/en/players/9744ff80/Pablo-Sarabia"
"13130","Carlos Soler_2023",2023,"Paris S-G","Ligue 1","Carlos Soler","ESP","MF","25",1997,13.2,20,12,6,10,4,10,19,52.6,9,12,4,8,4,24,6,0,"https://fbref.com/en/players/fed17f5a/Carlos-Soler"
"13131","Marco Verratti_2023",2023,"Paris S-G","Ligue 1","Marco Verratti","ITA","MF","29",1992,24.4,76,49,34,36,6,38,89,42.7,51,42,6,36,27,103,11,3,"https://fbref.com/en/players/1467af0d/Marco-Verratti"
"13132","Vitinha_2023",2023,"Paris S-G","Ligue 1","Vitinha","POR","MF","22",2000,27.2,58,25,21,27,10,27,83,32.5,56,27,4,23,25,83,15,0,"https://fbref.com/en/players/3b029691/Vitinha"
"13133","Warren Zaire-Emery_2023",2023,"Paris S-G","Ligue 1","Warren Zaire-Emery","FRA","MF,DF","16",2006,10.3,17,10,5,10,2,8,29,27.6,21,11,0,11,12,29,17,0,"https://fbref.com/en/players/6b9960cf/Warren-Zaire-Emery"
"13134","Sanoussy Ba_2023",2023,"RB Leipzig","Bundesliga","Sanoussy Ba","GER","DF","18",2004,0,0,0,0,0,0,0,0,NA,0,0,0,0,0,0,0,0,"https://fbref.com/en/players/f582d5c1/Sanoussy-Ba"
"13135","Janis Blaswich_2023",2023,"RB Leipzig","Bundesliga","Janis Blaswich","GER","GK","31",1991,26,0,0,0,0,0,0,0,NA,0,0,0,0,0,0,10,0,"https://fbref.com/en/players/663e080e/Janis-Blaswich"
"13136","Abdou Diallo_2023",2023,"RB Leipzig","Bundesliga","Abdou Diallo","SEN","DF,MF","26",1996,5.3,6,5,5,1,0,1,3,33.3,2,8,5,3,8,14,22,0,"https://fbref.com/en/players/fc62f087/Abdou-Diallo"
"13137","Emil Forsberg_2023",2023,"RB Leipzig","Bundesliga","Emil Forsberg","SWE","MF,FW","30",1991,16.5,16,11,1,8,7,6,20,30,14,25,2,23,3,19,7,0,"https://fbref.com/en/players/9a2e0ccc/Emil-Forsberg"
"13138","Péter Gulácsi_2023",2023,"RB Leipzig","Bundesliga","Péter Gulácsi","HUN","GK","32",1990,6,0,0,0,0,0,0,0,NA,0,0,0,0,0,0,2,0,"https://fbref.com/en/players/bcb2ccd8/Peter-Gulacsi"
"13139","Joško Gvardiol_2023",2023,"RB Leipzig","Bundesliga","Joško Gvardiol","CRO","DF","20",2002,24.1,23,17,15,8,0,9,22,40.9,13,34,17,17,34,57,76,1,"https://fbref.com/en/players/5ad50391/Josko-Gvardiol"
"13140","Amadou Haidara_2023",2023,"RB Leipzig","Bundesliga","Amadou Haidara","MLI","MF","24",1998,15.9,25,11,15,10,0,13,34,38.2,21,26,6,20,26,51,20,0,"https://fbref.com/en/players/92432bc6/Amadou-Haidara"
"13141","Marcel Halstenberg_2023",2023,"RB Leipzig","Bundesliga","Marcel Halstenberg","GER","DF","30",1991,17.3,40,21,20,15,5,23,41,56.1,18,22,1,21,21,61,29,0,"https://fbref.com/en/players/8ff2354e/Marcel-Halstenberg"
"13142","Benjamin Henrichs_2023",2023,"RB Leipzig","Bundesliga","Benjamin Henrichs","GER","DF,MF","25",1997,24.3,73,46,41,29,3,43,66,65.2,23,48,4,44,35,108,46,0,"https://fbref.com/en/players/0a89e877/Benjamin-Henrichs"
"13143","Kevin Kampl_2023",2023,"RB Leipzig","Bundesliga","Kevin Kampl","SVN","MF","31",1990,15.2,21,11,6,14,1,6,27,22.2,21,26,9,17,22,43,11,0,"https://fbref.com/en/players/b825a650/Kevin-Kampl"
"13144","Lukas Klostermann_2023",2023,"RB Leipzig","Bundesliga","Lukas Klostermann","GER","DF","26",1996,10.1,16,8,7,9,0,8,15,53.3,7,6,3,3,13,29,31,0,"https://fbref.com/en/players/ca8033cb/Lukas-Klostermann"
"13145","Konrad Laimer_2023",2023,"RB Leipzig","Bundesliga","Konrad Laimer","AUT","MF","25",1997,16.3,60,31,23,30,7,30,54,55.6,24,31,4,27,18,78,8,0,"https://fbref.com/en/players/c1b7847c/Konrad-Laimer"
"13146","Christopher Nkunku_2023",2023,"RB Leipzig","Bundesliga","Christopher Nkunku","FRA","FW,MF","24",1997,21.1,6,4,2,1,3,1,6,16.7,5,8,3,5,8,14,11,0,"https://fbref.com/en/players/7c56da38/Christopher-Nkunku"
"13147","Hugo Novoa_2023",2023,"RB Leipzig","Bundesliga","Hugo Novoa","ESP","DF,FW","19",2003,2,8,2,1,3,4,4,7,57.1,3,4,0,4,1,9,0,0,"https://fbref.com/en/players/5458f670/Hugo-Novoa"
"13148","Ørjan Nyland_2023",2023,"RB Leipzig","Bundesliga","Ørjan Nyland","NOR","GK","31",1990,2,0,0,0,0,0,0,0,NA,0,0,0,0,0,0,0,0,"https://fbref.com/en/players/bdedffac/Orjan-Nyland"
"13149","Dani Olmo_2023",2023,"RB Leipzig","Bundesliga","Dani Olmo","ESP","MF,FW","24",1998,14.2,15,9,1,10,4,6,14,42.9,8,15,0,15,6,21,6,0,"https://fbref.com/en/players/ae44e8e2/Dani-Olmo"
"13150","Willi Orban_2023",2023,"RB Leipzig","Bundesliga","Willi Orban","HUN","DF","29",1992,32.8,51,30,33,18,0,26,43,60.5,17,42,24,18,39,90,129,1,"https://fbref.com/en/players/20030c06/Willi-Orban"
"13151","Yussuf Poulsen_2023",2023,"RB Leipzig","Bundesliga","Yussuf Poulsen","DEN","FW","28",1994,4.6,6,4,1,4,1,2,5,40,3,3,1,2,0,6,5,0,"https://fbref.com/en/players/d2416c2e/Yussuf-Poulsen"
"13152","David Raum_2023",2023,"RB Leipzig","Bundesliga","David Raum","GER","DF,MF","24",1998,18.7,39,25,23,12,4,17,29,58.6,12,24,6,18,16,55,26,1,"https://fbref.com/en/players/7d450ed3/David-Raum"
"13153","Xaver Schlager_2023",2023,"RB Leipzig","Bundesliga","Xaver Schlager","AUT","MF","24",1997,16.7,41,24,13,26,2,20,43,46.5,23,19,2,17,17,58,23,0,"https://fbref.com/en/players/8f056768/Xaver-Schlager"
"13154","André Silva_2023",2023,"RB Leipzig","Bundesliga","André Silva","POR","FW","26",1995,19.3,12,6,2,5,5,3,8,37.5,5,11,1,10,3,15,3,0,"https://fbref.com/en/players/3effaa34/Andre-Silva"
"13155","Mohamed Simakan_2023",2023,"RB Leipzig","Bundesliga","Mohamed Simakan","FRA","DF","22",2000,16.2,21,14,12,5,4,14,21,66.7,7,21,4,17,16,37,55,0,"https://fbref.com/en/players/fcb27134/Mohamed-Simakan"
"13156","Dominik Szoboszlai_2023",2023,"RB Leipzig","Bundesliga","Dominik Szoboszlai","HUN","MF,FW","21",2000,27.2,45,28,12,20,13,17,42,40.5,25,43,2,41,17,62,27,0,"https://fbref.com/en/players/934e1968/Dominik-Szoboszlai"
"13157","Alexander Sørloth_2023",2023,"RB Leipzig","Bundesliga","Alexander Sørloth","NOR","FW","26",1995,0.1,0,0,0,0,0,0,0,NA,0,0,0,0,0,0,0,0,"https://fbref.com/en/players/e92cd3f7/Alexander-Sorloth"
"13158","Timo Werner_2023",2023,"RB Leipzig","Bundesliga","Timo Werner","GER","FW,MF","26",1996,21.5,10,5,4,3,3,4,12,33.3,8,12,0,12,7,17,5,0,"https://fbref.com/en/players/49fe9070/Timo-Werner"
"13159","Iván Balliu_2023",2023,"Rayo Vallecano","La Liga","Iván Balliu","ALB","DF","30",1992,35.9,52,29,26,20,6,18,30,60,12,26,3,23,25,77,72,1,"https://fbref.com/en/players/cee88597/Ivan-Balliu"
"13160","Bebé_2023",2023,"Rayo Vallecano","La Liga","Bebé","CPV","FW","32",1990,0.7,0,0,0,0,0,0,2,0,2,1,0,1,0,0,0,0,"https://fbref.com/en/players/d8712bf9/Bebe"
"13161","Sergio Camello_2023",2023,"Rayo Vallecano","La Liga","Sergio Camello","ESP","FW","21",2001,26.7,16,10,3,9,4,5,17,29.4,12,9,1,8,2,18,26,0,"https://fbref.com/en/players/873619c6/Sergio-Camello"
"13162","Catena_2023",2023,"Rayo Vallecano","La Liga","Catena","ESP","DF","27",1994,34.5,29,14,23,4,2,13,27,48.1,14,32,25,7,28,57,159,1,"https://fbref.com/en/players/274ab13c/Catena"
"13163","Pep Chavarría_2023",2023,"Rayo Vallecano","La Liga","Pep Chavarría","ESP","FW,MF","24",1998,4.1,6,4,2,1,3,1,5,20,4,8,0,8,2,8,8,0,"https://fbref.com/en/players/63c5e56b/Pep-Chavarria"
"13164","Pathé Ciss_2023",2023,"Rayo Vallecano","La Liga","Pathé Ciss","SEN","MF,DF","28",1994,14.2,39,29,11,23,5,15,34,44.1,19,23,10,13,22,61,34,0,"https://fbref.com/en/players/9a0408b6/Pathe-Ciss"
"13165","Santi Comesaña_2023",2023,"Rayo Vallecano","La Liga","Santi Comesaña","ESP","MF","25",1996,27.2,71,44,24,41,6,38,82,46.3,44,39,3,36,32,103,17,0,"https://fbref.com/en/players/5ae499d0/Santi-Comesana"
"13166","Stole Dimitrievski_2023",2023,"Rayo Vallecano","La Liga","Stole Dimitrievski","MKD","GK","28",1993,36.9,1,0,1,0,0,1,2,50,1,2,0,2,1,2,17,3,"https://fbref.com/en/players/fc70e345/Stole-Dimitrievski"
"13167","Radamel Falcao_2023",2023,"Rayo Vallecano","La Liga","Radamel Falcao","COL","FW,MF","36",1986,6.8,4,4,1,3,0,1,8,12.5,7,5,1,4,2,6,10,0,"https://fbref.com/en/players/66116290/Radamel-Falcao"
"13168","Álvaro García_2023",2023,"Rayo Vallecano","La Liga","Álvaro García","ESP","FW,MF","29",1992,31.9,49,28,21,13,15,11,33,33.3,22,41,4,37,34,83,24,1,"https://fbref.com/en/players/90bbd822/Alvaro-Garcia"
"13169","Fran Garcia_2023",2023,"Rayo Vallecano","La Liga","Fran Garcia","ESP","DF","22",1999,37.9,84,54,53,23,8,55,96,57.3,41,49,8,41,44,128,66,0,"https://fbref.com/en/players/7226539b/Fran-Garcia"
"13170","Mario Hernández_2023",2023,"Rayo Vallecano","La Liga","Mario Hernández","ESP","DF","23",1999,1.1,3,2,2,1,0,3,7,42.9,4,2,0,2,2,5,0,0,"https://fbref.com/en/players/90162357/Mario-Hernandez"
"13171","Florian Lejeune_2023",2023,"Rayo Vallecano","La Liga","Florian Lejeune","FRA","DF","31",1991,28.5,28,17,19,8,1,17,25,68,8,24,16,8,15,43,123,0,"https://fbref.com/en/players/6eaed4eb/Florian-Lejeune"
"13172","Diego López_2023",2023,"Rayo Vallecano","La Liga","Diego López","ESP","GK","40",1981,1.1,0,0,0,0,0,0,0,NA,0,0,0,0,0,0,0,1,"https://fbref.com/en/players/73683fa9/Diego-Lopez"
"13173","Unai López_2023",2023,"Rayo Vallecano","La Liga","Unai López","ESP","MF","26",1995,13.9,32,20,10,17,5,13,37,35.1,24,12,1,11,15,47,6,1,"https://fbref.com/en/players/88050721/Unai-Lopez"
"13174","Andrés Martín_2023",2023,"Rayo Vallecano","La Liga","Andrés Martín","ESP","FW,MF","23",1999,2.3,4,2,2,1,1,3,5,60,2,2,0,2,1,5,2,0,"https://fbref.com/en/players/2ae30661/Andres-Martin"
"13175","Diego Méndez_2023",2023,"Rayo Vallecano","La Liga","Diego Méndez","ESP","MF","18",2003,0,0,0,0,0,0,0,0,NA,0,0,0,0,1,1,0,0,"https://fbref.com/en/players/b151a3f2/Diego-Mendez"
"13176","Abdul Mumin_2023",2023,"Rayo Vallecano","La Liga","Abdul Mumin","GHA","DF","24",1998,10.2,11,9,5,6,0,3,7,42.9,4,13,5,8,9,20,36,2,"https://fbref.com/en/players/5487adcd/Abdul-Mumin"
"13177","Pablo Muñoz_2023",2023,"Rayo Vallecano","La Liga","Pablo Muñoz","ESP","MF","18",2003,0.1,0,0,0,0,0,0,1,0,1,0,0,0,0,0,0,0,"https://fbref.com/en/players/44e8521b/Pablo-Munoz"
"13178","Randy Ntekja_2023",2023,"Rayo Vallecano","La Liga","Randy Ntekja","FRA","FW,MF","24",1997,1.3,4,2,2,2,0,1,1,100,0,2,0,2,2,6,3,0,"https://fbref.com/en/players/a6103274/Randy-Ntekja"
"13179","Isaac Palazón Camacho_2023",2023,"Rayo Vallecano","La Liga","Isaac Palazón Camacho","ESP","FW,MF","27",1994,32.9,45,30,11,23,11,24,66,36.4,42,42,3,39,17,62,30,0,"https://fbref.com/en/players/49dbab27/Isaac-Palazon-Camacho"
"13180","José Pozo_2023",2023,"Rayo Vallecano","La Liga","José Pozo","ESP","MF,FW","26",1996,1,2,2,0,2,0,0,0,NA,0,0,0,0,1,3,1,0,"https://fbref.com/en/players/fc8b614b/Jose-Pozo"
"13181","Salvi_2023",2023,"Rayo Vallecano","La Liga","Salvi","ESP","FW,MF","31",1991,5.4,13,8,5,5,3,2,8,25,6,0,0,0,2,15,2,0,"https://fbref.com/en/players/405f267a/Salvi"
"13182","Esteban Saveljich_2023",2023,"Rayo Vallecano","La Liga","Esteban Saveljich","MNE","FW","31",1991,0,0,0,0,0,0,0,0,NA,0,0,0,0,0,0,0,0,"https://fbref.com/en/players/79f2a5f5/Esteban-Saveljich"
"13183","Mario Suárez_2023",2023,"Rayo Vallecano","La Liga","Mario Suárez","ESP","MF,DF","35",1987,0.1,0,0,0,0,0,0,0,NA,0,1,0,1,0,0,0,0,"https://fbref.com/en/players/7106f0a0/Mario-Suarez"
"13184","Raúl de Tomás_2023",2023,"Rayo Vallecano","La Liga","Raúl de Tomás","ESP","FW","27",1994,8.9,3,2,0,1,2,2,6,33.3,4,4,0,4,0,3,6,0,"https://fbref.com/en/players/02ef8778/Raul-de-Tomas"
"13185","Óscar Trejo_2023",2023,"Rayo Vallecano","La Liga","Óscar Trejo","ARG","MF,FW","34",1988,23.8,48,32,12,23,13,9,44,20.5,35,31,3,28,8,56,8,1,"https://fbref.com/en/players/fc647b34/Oscar-Trejo"
"13186","Óscar Valentín_2023",2023,"Rayo Vallecano","La Liga","Óscar Valentín","ESP","MF","27",1994,28.4,92,51,29,50,13,46,121,38,75,60,9,51,44,136,30,0,"https://fbref.com/en/players/592f3158/Oscar-Valentin"
"13187","David Alaba_2023",2023,"Real Madrid","La Liga","David Alaba","AUT","DF","30",1992,20.4,15,11,8,4,3,9,15,60,6,18,9,9,14,29,37,1,"https://fbref.com/en/players/05439de2/David-Alaba"
"13188","Sergio Arribas_2023",2023,"Real Madrid","La Liga","Sergio Arribas","ESP","MF,FW","20",2001,0.2,0,0,0,0,0,0,0,NA,0,1,0,1,0,0,0,0,"https://fbref.com/en/players/1e465e70/Sergio-Arribas"
"13189","Marco Asensio_2023",2023,"Real Madrid","La Liga","Marco Asensio","ESP","FW,MF","26",1996,16,16,10,8,6,2,8,19,42.1,11,8,3,5,5,21,4,0,"https://fbref.com/en/players/45af8a54/Marco-Asensio"
"13190","Karim Benzema_2023",2023,"Real Madrid","La Liga","Karim Benzema","FRA","FW","34",1987,22.6,9,5,2,4,3,2,11,18.2,9,11,0,11,2,11,5,0,"https://fbref.com/en/players/70d74ece/Karim-Benzema"
"13191","Eduardo Camavinga_2023",2023,"Real Madrid","La Liga","Eduardo Camavinga","FRA","MF,DF","19",2002,22.3,68,48,32,21,15,24,64,37.5,40,24,5,19,17,85,25,0,"https://fbref.com/en/players/7b9c2d84/Eduardo-Camavinga"
"13192","Dani Carvajal_2023",2023,"Real Madrid","La Liga","Dani Carvajal","ESP","DF","30",1992,19.8,32,18,15,12,5,18,35,51.4,17,24,6,18,15,47,49,0,"https://fbref.com/en/players/4958bfb2/Dani-Carvajal"
"13193","Casemiro_2023",2023,"Real Madrid","La Liga","Casemiro","BRA","MF","30",1992,0.1,0,0,0,0,0,0,0,NA,0,0,0,0,0,0,1,0,"https://fbref.com/en/players/4d224fe8/Casemiro"
"13194","Dani Ceballos_2023",2023,"Real Madrid","La Liga","Dani Ceballos","ESP","MF","25",1996,17.4,43,29,13,15,15,25,64,39.1,39,23,2,21,25,68,6,1,"https://fbref.com/en/players/c0617e2b/Dani-Ceballos"
"13195","Thibaut Courtois_2023",2023,"Real Madrid","La Liga","Thibaut Courtois","BEL","GK","30",1992,31,1,0,1,0,0,1,1,100,0,0,0,0,3,4,7,1,"https://fbref.com/en/players/1840e36d/Thibaut-Courtois"
"13196","Eden Hazard_2023",2023,"Real Madrid","La Liga","Eden Hazard","BEL","FW","31",1991,2.2,0,0,0,0,0,0,2,0,2,1,0,1,1,1,0,0,"https://fbref.com/en/players/a39bb753/Eden-Hazard"
"13197","Vinicius Júnior_2023",2023,"Real Madrid","La Liga","Vinicius Júnior","BRA","FW","22",2000,31.4,30,21,10,12,8,14,39,35.9,25,24,1,23,6,36,1,0,"https://fbref.com/en/players/7111d552/Vinicius-Junior"
"13198","Toni Kroos_2023",2023,"Real Madrid","La Liga","Toni Kroos","GER","MF","32",1990,23.9,51,32,16,33,2,23,69,33.3,46,23,4,19,24,75,11,0,"https://fbref.com/en/players/6ce1f46f/Toni-Kroos"
"13199","Andriy Lunin_2023",2023,"Real Madrid","La Liga","Andriy Lunin","UKR","GK","23",1999,7,0,0,0,0,0,0,0,NA,0,0,0,0,0,0,1,0,"https://fbref.com/en/players/3061e1ec/Andriy-Lunin"
"13200","Mariano_2023",2023,"Real Madrid","La Liga","Mariano","DOM","FW","28",1993,1.7,1,0,0,1,0,0,0,NA,0,1,0,1,0,1,0,0,"https://fbref.com/en/players/5c4dc0ff/Mariano"
"13201","Ferland Mendy_2023",2023,"Real Madrid","La Liga","Ferland Mendy","FRA","DF","27",1995,15,21,12,14,6,1,12,20,60,8,7,2,5,14,35,16,0,"https://fbref.com/en/players/3cefcaef/Ferland-Mendy"
"13202","Éder Militão_2023",2023,"Real Madrid","La Liga","Éder Militão","BRA","DF","24",1998,30,46,32,25,18,3,26,33,78.8,7,67,39,28,42,88,104,2,"https://fbref.com/en/players/2784f898/Eder-Militao"
"13203","Luka Modrić_2023",2023,"Real Madrid","La Liga","Luka Modrić","CRO","MF","36",1985,19.4,19,9,6,6,7,10,25,40,15,15,5,10,10,29,7,0,"https://fbref.com/en/players/6025fab1/Luka-Modric"
"13204","Álvaro Muñoz_2023",2023,"Real Madrid","La Liga","Álvaro Muñoz","URU","FW","18",2004,0.9,2,1,1,0,1,1,1,100,0,0,0,0,0,2,1,0,"https://fbref.com/en/players/49a6ecbb/Alvaro-Munoz"
"13205","Nacho_2023",2023,"Real Madrid","La Liga","Nacho","ESP","DF","32",1990,18.2,24,16,17,5,2,12,29,41.4,17,11,6,5,18,42,37,0,"https://fbref.com/en/players/2946f9a1/Nacho"
"13206","Álvaro Odriozola_2023",2023,"Real Madrid","La Liga","Álvaro Odriozola","ESP","DF","26",1995,0.4,0,0,0,0,0,0,0,NA,0,0,0,0,0,0,0,0,"https://fbref.com/en/players/1d1691ad/Alvaro-Odriozola"
"13207","Rodrygo_2023",2023,"Real Madrid","La Liga","Rodrygo","BRA","FW,MF","21",2001,26.4,17,10,3,7,7,4,23,17.4,19,23,0,23,8,25,5,0,"https://fbref.com/en/players/8f5e92a6/Rodrygo"
"13208","Antonio Rüdiger_2023",2023,"Real Madrid","La Liga","Antonio Rüdiger","GER","DF","29",1993,26.8,18,16,12,5,1,14,23,60.9,9,23,13,10,19,37,74,0,"https://fbref.com/en/players/18b896d6/Antonio-Rudiger"
"13209","Aurélien Tchouaméni_2023",2023,"Real Madrid","La Liga","Aurélien Tchouaméni","FRA","MF","22",2000,23.5,64,40,23,36,5,23,38,60.5,15,20,6,14,49,113,50,0,"https://fbref.com/en/players/4f255115/Aurelien-Tchouameni"
"13210","Jesús Vallejo_2023",2023,"Real Madrid","La Liga","Jesús Vallejo","ESP","DF","25",1997,0.2,0,0,0,0,0,0,0,NA,0,0,0,0,0,0,0,0,"https://fbref.com/en/players/c2111b45/Jesus-Vallejo"
"13211","Federico Valverde_2023",2023,"Real Madrid","La Liga","Federico Valverde","URU","MF,FW","24",1998,27.8,31,20,14,11,6,13,26,50,13,31,4,27,17,48,15,0,"https://fbref.com/en/players/0959c2a2/Federico-Valverde"
"13212","Lucas Vázquez_2023",2023,"Real Madrid","La Liga","Lucas Vázquez","ESP","DF","31",1991,12.7,34,23,22,10,2,20,28,71.4,8,10,0,10,7,41,13,0,"https://fbref.com/en/players/fd51b456/Lucas-Vazquez"
"13213","Mohamed Ali Cho_2023",2023,"Real Sociedad","La Liga","Mohamed Ali Cho","FRA","FW,MF","18",2004,6.5,13,10,6,5,2,4,10,40,6,9,0,9,2,15,2,0,"https://fbref.com/en/players/f8405304/Mohamed-Ali-Cho"
"13214","Ander Barrenetxea_2023",2023,"Real Sociedad","La Liga","Ander Barrenetxea","ESP","FW,DF","20",2001,9.8,21,15,15,6,0,12,28,42.9,16,15,1,14,5,26,7,0,"https://fbref.com/en/players/200e89e1/Ander-Barrenetxea"
"13215","Aritz Elustondo_2023",2023,"Real Sociedad","La Liga","Aritz Elustondo","ESP","DF","28",1994,16.1,26,17,15,10,1,14,26,53.8,12,15,6,9,20,46,43,1,"https://fbref.com/en/players/f7dc2ae5/Aritz-Elustondo"
"13216","Carlos Fernández_2023",2023,"Real Sociedad","La Liga","Carlos Fernández","ESP","FW","26",1996,7,6,4,1,3,2,1,15,6.7,14,1,0,1,1,7,4,0,"https://fbref.com/en/players/e08647d6/Carlos-Fernandez"
"13217","Andoni Gorosabel_2023",2023,"Real Sociedad","La Liga","Andoni Gorosabel","ESP","DF","25",1996,19,41,25,23,9,9,26,43,60.5,17,21,2,19,17,58,23,0,"https://fbref.com/en/players/6f5f82c0/Andoni-Gorosabel"
"13218","Ander Guevara_2023",2023,"Real Sociedad","La Liga","Ander Guevara","ESP","MF","25",1997,2.5,5,2,2,2,1,1,4,25,3,6,1,5,2,7,3,0,"https://fbref.com/en/players/8e48dc61/Ander-Guevara"
"13219","Asier Illarramendi_2023",2023,"Real Sociedad","La Liga","Asier Illarramendi","ESP","MF","32",1990,12,36,18,10,22,4,16,44,36.4,28,27,8,19,18,54,20,0,"https://fbref.com/en/players/5ce0b5ba/Asier-Illarramendi"
"13220","Alexander Isak_2023",2023,"Real Sociedad","La Liga","Alexander Isak","SWE","FW","22",1999,1.7,1,1,0,0,1,0,0,NA,0,0,0,0,0,1,2,0,"https://fbref.com/en/players/8e92be30/Alexander-Isak"
"13221","Jon Karrikaburu_2023",2023,"Real Sociedad","La Liga","Jon Karrikaburu","ESP","FW","19",2002,1,1,0,0,1,0,0,0,NA,0,2,0,2,0,1,0,0,"https://fbref.com/en/players/211589b8/Jon-Karrikaburu"
"13222","Takefusa Kubo_2023",2023,"Real Sociedad","La Liga","Takefusa Kubo","JPN","FW,MF","21",2001,27.1,44,26,18,16,10,16,38,42.1,22,29,1,28,9,53,4,0,"https://fbref.com/en/players/16aa3654/Takefusa-Kubo"
"13223","Robin Le Normand_2023",2023,"Real Sociedad","La Liga","Robin Le Normand","ESP","DF","25",1996,31.1,36,23,25,9,2,14,27,51.9,13,22,14,8,33,69,93,0,"https://fbref.com/en/players/9a64e67e/Robin-Le-Normand"
"13224","Jon Magunacelaya_2023",2023,"Real Sociedad","La Liga","Jon Magunacelaya","ESP","MF,FW","22",2000,0.7,1,0,0,0,1,0,2,0,2,0,0,0,0,1,1,0,"https://fbref.com/en/players/d4808594/Jon-Magunacelaya"
"13225","Pablo Marín_2023",2023,"Real Sociedad","La Liga","Pablo Marín","ESP","MF,FW","19",2003,4,10,5,5,4,1,2,7,28.6,5,1,0,1,4,14,2,0,"https://fbref.com/en/players/a83c19cf/Pablo-Marin"
"13226","Ander Martin_2023",2023,"Real Sociedad","La Liga","Ander Martin","ESP","MF,FW","21",2000,0.5,2,2,1,1,0,1,4,25,3,0,0,0,0,2,1,0,"https://fbref.com/en/players/e1e75690/Ander-Martin"
"13227","Brais Méndez_2023",2023,"Real Sociedad","La Liga","Brais Méndez","ESP","MF","25",1997,26.7,58,34,18,30,10,24,64,37.5,40,27,3,24,12,70,14,1,"https://fbref.com/en/players/c9e39d91/Brais-Mendez"
"13228","Mikel Merino_2023",2023,"Real Sociedad","La Liga","Mikel Merino","ESP","MF","26",1996,27.7,77,49,28,33,16,31,62,50,31,38,8,30,20,97,51,1,"https://fbref.com/en/players/d080ed5e/Mikel-Merino"
"13229","Aihen Muñoz_2023",2023,"Real Sociedad","La Liga","Aihen Muñoz","ESP","DF","24",1997,19.5,38,23,17,17,4,22,47,46.8,25,26,5,21,9,47,38,0,"https://fbref.com/en/players/228b0d9d/Aihen-Munoz"
"13230","Roberto Navarro_2023",2023,"Real Sociedad","La Liga","Roberto Navarro","ESP","MF,FW","20",2002,3.9,5,4,4,0,1,1,2,50,1,7,0,7,2,7,2,0,"https://fbref.com/en/players/c997b942/Roberto-Navarro"
"13231","Olasagasti_2023",2023,"Real Sociedad","La Liga","Olasagasti","ESP","MF,DF","21",2000,0.7,4,4,1,2,1,1,2,50,1,2,0,2,0,4,1,0,"https://fbref.com/en/players/3d99999d/Olasagasti"
"13232","Mikel Oyarzabal_2023",2023,"Real Sociedad","La Liga","Mikel Oyarzabal","ESP","FW,MF","25",1997,13.5,13,7,5,3,5,5,19,26.3,14,14,4,10,3,16,5,0,"https://fbref.com/en/players/8c3c640c/Mikel-Oyarzabal"
"13233","Jon Pacheco_2023",2023,"Real Sociedad","La Liga","Jon Pacheco","ESP","DF","21",2001,13.3,16,10,10,6,0,6,10,60,4,9,6,3,12,28,37,1,"https://fbref.com/en/players/44150beb/Jon-Pacheco"
"13234","Álex Remiro_2023",2023,"Real Sociedad","La Liga","Álex Remiro","ESP","GK","27",1995,38,1,1,1,0,0,1,3,33.3,2,0,0,0,0,1,17,3,"https://fbref.com/en/players/374ee424/Alex-Remiro"
"13235","Diego Rico_2023",2023,"Real Sociedad","La Liga","Diego Rico","ESP","DF","29",1993,18.3,35,21,17,11,7,12,27,44.4,15,18,5,13,20,55,51,1,"https://fbref.com/en/players/d9ba39fc/Diego-Rico"
"13236","Umar Sadiq_2023",2023,"Real Sociedad","La Liga","Umar Sadiq","NGA","FW","25",1997,0.9,1,1,0,0,1,0,1,0,1,2,0,2,0,1,0,0,"https://fbref.com/en/players/686cbe7d/Umar-Sadiq"
"13237","David Silva_2023",2023,"Real Sociedad","La Liga","David Silva","ESP","MF","36",1986,21.5,36,21,11,18,7,11,19,57.9,8,17,2,15,15,51,16,0,"https://fbref.com/en/players/e2716bd0/David-Silva"
"13238","Alex Sola_2023",2023,"Real Sociedad","La Liga","Alex Sola","ESP","DF","23",1999,3.9,18,9,14,3,1,7,10,70,3,7,2,5,7,25,10,0,"https://fbref.com/en/players/5fa714d5/Alex-Sola"
"13239","Alexander Sørloth_2023",2023,"Real Sociedad","La Liga","Alexander Sørloth","NOR","FW","26",1995,26.5,18,9,3,6,9,7,14,50,7,15,1,14,2,20,26,1,"https://fbref.com/en/players/e92cd3f7/Alexander-Sorloth"
"13240","Beñat Turrientes_2023",2023,"Real Sociedad","La Liga","Beñat Turrientes","ESP","MF,FW","20",2002,1.2,3,3,3,0,0,1,5,20,4,2,0,2,0,3,3,0,"https://fbref.com/en/players/068f4dec/Benat-Turrientes"
"13241","Igor Zubeldia_2023",2023,"Real Sociedad","La Liga","Igor Zubeldia","ESP","DF","25",1997,28.2,35,18,28,7,0,25,35,71.4,10,23,17,6,21,56,93,0,"https://fbref.com/en/players/5c7845f6/Igor-Zubeldia"
"13242","Martín Zubimendi_2023",2023,"Real Sociedad","La Liga","Martín Zubimendi","ESP","MF","23",1999,34.5,59,33,23,30,6,24,45,53.3,21,44,17,27,37,96,55,4,"https://fbref.com/en/players/3ee0dd59/Martin-Zubimendi"
"13243","Yunis Abdelhamid_2023",2023,"Reims","Ligue 1","Yunis Abdelhamid","MAR","DF","34",1987,37,82,50,47,33,2,39,52,75,13,65,27,38,64,146,116,1,"https://fbref.com/en/players/32c2d95f/Yunis-Abdelhamid"
"13244","Martin Adeline_2023",2023,"Reims","Ligue 1","Martin Adeline","FRA","MF,FW","18",2003,1.2,3,3,2,1,0,3,4,75,1,3,1,2,3,6,3,0,"https://fbref.com/en/players/7587446d/Martin-Adeline"
"13245","Emmanuel Agbadou_2023",2023,"Reims","Ligue 1","Emmanuel Agbadou","CIV","DF","25",1997,26.5,71,49,53,16,2,42,65,64.6,23,30,14,16,32,103,107,3,"https://fbref.com/en/players/75f1ed80/Emmanuel-Agbadou"
"13246","Valentin Atangana Edoa_2023",2023,"Reims","Ligue 1","Valentin Atangana Edoa","FRA","MF","16",2005,1.9,8,3,4,2,2,3,6,50,3,2,1,1,0,8,1,0,"https://fbref.com/en/players/6b5edd5d/Valentin-Atangana-Edoa"
"13247","Folarin Balogun_2023",2023,"Reims","Ligue 1","Folarin Balogun","USA","FW","21",2001,33.3,9,5,1,5,3,2,20,10,18,20,1,19,3,12,15,0,"https://fbref.com/en/players/31822f8c/Folarin-Balogun"
"13248","Mitchell van Bergen_2023",2023,"Reims","Ligue 1","Mitchell van Bergen","NED","FW,DF","22",1999,10.1,18,8,6,7,5,8,20,40,12,8,2,6,6,24,11,0,"https://fbref.com/en/players/0b2c9aec/Mitchell-van-Bergen"
"13249","El Bilal Touré_2023",2023,"Reims","Ligue 1","El Bilal Touré","MLI","FW","20",2001,1,0,0,0,0,0,0,0,NA,0,2,0,2,0,0,1,0,"https://fbref.com/en/players/47c609d5/El-Bilal-Toure"
"13250","Maxime Busi_2023",2023,"Reims","Ligue 1","Maxime Busi","BEL","DF","22",1999,11.6,21,16,9,11,1,13,29,44.8,16,14,6,8,14,35,24,0,"https://fbref.com/en/players/7b082ec2/Maxime-Busi"
"13251","Jens Cajuste_2023",2023,"Reims","Ligue 1","Jens Cajuste","SWE","MF","22",1999,17,46,25,25,14,7,25,48,52.1,23,30,6,24,18,64,22,0,"https://fbref.com/en/players/928a4a61/Jens-Cajuste"
"13252","Thibault De Smet_2023",2023,"Reims","Ligue 1","Thibault De Smet","BEL","DF","24",1998,19.5,24,17,10,14,0,11,37,29.7,26,28,5,23,20,44,40,1,"https://fbref.com/en/players/5fdcb075/Thibault-De-Smet"
"13253","Mamadou Diakhon_2023",2023,"Reims","Ligue 1","Mamadou Diakhon","FRA","FW","16",2005,0.2,2,0,2,0,0,0,1,0,1,1,0,1,1,3,0,0,"https://fbref.com/en/players/331c5a98/Mamadou-Diakhon"
"13254","Ibrahim Diakité_2023",2023,"Reims","Ligue 1","Ibrahim Diakité","GUI","DF","18",2003,1.5,3,3,3,0,0,2,3,66.7,1,0,0,0,5,8,6,0,"https://fbref.com/en/players/d8c19a60/Ibrahim-Diakite"
"13255","Yehvann Diouf_2023",2023,"Reims","Ligue 1","Yehvann Diouf","FRA","GK","22",1999,31,2,0,2,0,0,1,3,33.3,2,0,0,0,1,3,13,5,"https://fbref.com/en/players/eedea60b/Yehvann-Diouf"
"13256","Kamory Doumbia_2023",2023,"Reims","Ligue 1","Kamory Doumbia","MLI","MF","19",2003,12.8,31,16,9,14,8,12,37,32.4,25,17,1,16,13,44,3,0,"https://fbref.com/en/players/9226aa22/Kamory-Doumbia"
"13257","Wout Faes_2023",2023,"Reims","Ligue 1","Wout Faes","BEL","DF","24",1998,3,1,1,1,0,0,1,2,50,1,6,3,3,7,8,19,0,"https://fbref.com/en/players/9c221d14/Wout-Faes"
"13258","Fallou Fall_2023",2023,"Reims","Ligue 1","Fallou Fall","SEN","DF","18",2004,0.4,0,0,0,0,0,0,1,0,1,3,3,0,0,0,4,0,"https://fbref.com/en/players/2c8a91b9/Fallou-Fall"
"13259","Alexis Flips_2023",2023,"Reims","Ligue 1","Alexis Flips","FRA","FW,MF","22",2000,22,51,30,18,17,16,27,64,42.2,37,35,5,30,24,75,12,0,"https://fbref.com/en/players/caef7840/Alexis-Flips"
"13260","Thomas Foket_2023",2023,"Reims","Ligue 1","Thomas Foket","BEL","DF","27",1994,22,35,22,18,11,6,17,46,37,29,21,7,14,33,68,29,2,"https://fbref.com/en/players/90eb507d/Thomas-Foket"
"13261","Andrew Gravillon_2023",2023,"Reims","Ligue 1","Andrew Gravillon","GLP","DF","24",1998,11.5,16,8,9,6,1,8,13,61.5,5,18,9,9,21,37,36,0,"https://fbref.com/en/players/49136c42/Andrew-Gravillon"
"13262","Rafik Guitane_2023",2023,"Reims","Ligue 1","Rafik Guitane","FRA","FW","23",1999,0,0,0,0,0,0,0,0,NA,0,0,0,0,0,0,1,0,"https://fbref.com/en/players/7091324a/Rafik-Guitane"
"13263","Noah Holm_2023",2023,"Reims","Ligue 1","Noah Holm","NOR","FW,MF","21",2001,2.2,6,4,2,2,2,2,5,40,3,0,0,0,0,6,5,0,"https://fbref.com/en/players/61b77d0a/Noah-Holm"
"13264","Junya Ito_2023",2023,"Reims","Ligue 1","Junya Ito","JPN","FW","29",1993,32.4,40,20,14,15,11,13,53,24.5,40,29,1,28,8,48,4,1,"https://fbref.com/en/players/dbd3a428/Junya-Ito"
"13265","Check Keita_2023",2023,"Reims","Ligue 1","Check Keita","FRA","DF","19",2003,7.6,12,9,9,3,0,4,9,44.4,5,6,5,1,5,17,24,1,"https://fbref.com/en/players/c9f2f83a/Check-Keita"
"13266","Samuel Koeberlé_2023",2023,"Reims","Ligue 1","Samuel Koeberlé","FRA","MF","17",2004,0,0,0,0,0,0,0,0,NA,0,0,0,0,0,0,0,0,"https://fbref.com/en/players/6751b938/Samuel-Koeberle"
"13267","Banzouzi Locko_2023",2023,"Reims","Ligue 1","Banzouzi Locko","FRA","DF","20",2002,11.8,31,16,21,4,6,15,27,55.6,12,17,4,13,20,51,21,0,"https://fbref.com/en/players/40221fa7/Banzouzi-Locko"
"13268","Dion Lopy_2023",2023,"Reims","Ligue 1","Dion Lopy","SEN","MF","20",2002,15.3,45,24,22,16,7,23,62,37.1,39,27,3,24,22,67,18,0,"https://fbref.com/en/players/64c14d49/Dion-Lopy"
"13269","Myziane Maolida_2023",2023,"Reims","Ligue 1","Myziane Maolida","FRA","MF,FW","23",1999,2.6,8,3,2,5,1,5,12,41.7,7,1,0,1,2,10,0,0,"https://fbref.com/en/players/706a60e1/Myziane-Maolida"
"13270","Azor Matusiwa_2023",2023,"Reims","Ligue 1","Azor Matusiwa","NED","MF","24",1998,27.6,66,41,30,29,7,36,61,59,25,37,11,26,46,112,52,0,"https://fbref.com/en/players/a17a94d6/Azor-Matusiwa"
"13271","Nathanael Mbuku_2023",2023,"Reims","Ligue 1","Nathanael Mbuku","FRA","FW,MF","20",2002,0.7,2,1,2,0,0,2,2,100,0,0,0,0,0,2,0,0,"https://fbref.com/en/players/46750e9c/Nathanael-Mbuku"
"13272","Marshall Munetsi_2023",2023,"Reims","Ligue 1","Marshall Munetsi","ZIM","MF","26",1996,30,58,27,13,31,14,20,48,41.7,28,37,11,26,26,84,41,1,"https://fbref.com/en/players/2acf0cd7/Marshall-Munetsi"
"13273","Patrick Pentz_2023",2023,"Reims","Ligue 1","Patrick Pentz","AUT","GK","25",1997,7,0,0,0,0,0,0,0,NA,0,0,0,0,0,0,1,0,"https://fbref.com/en/players/0810b6df/Patrick-Pentz"
"13274","Kaj Sierhuis_2023",2023,"Reims","Ligue 1","Kaj Sierhuis","NED","FW,MF","24",1998,2.4,3,3,1,0,2,0,5,0,5,3,1,2,1,4,2,0,"https://fbref.com/en/players/9c2b1f11/Kaj-Sierhuis"
"13275","Mohamed Toure_2023",2023,"Reims","Ligue 1","Mohamed Toure","AUS","FW,MF","18",2004,0.3,0,0,0,0,0,0,0,NA,0,0,0,0,0,0,0,0,"https://fbref.com/en/players/8ac64b4e/Mohamed-Toure"
"13276","Arber Zeneli_2023",2023,"Reims","Ligue 1","Arber Zeneli","KVX","FW,MF","27",1995,11.1,9,3,3,3,3,5,12,41.7,7,8,0,8,2,11,2,0,"https://fbref.com/en/players/095e4199/Arber-Zeneli"
"13277","Matthis Abline_2023",2023,"Rennes","Ligue 1","Matthis Abline","FRA","FW,MF","19",2003,1.2,1,1,0,0,1,1,1,100,0,1,0,1,2,3,1,0,"https://fbref.com/en/players/0e46fa2f/Matthis-Abline"
"13278","Doğan Alemdar_2023",2023,"Rennes","Ligue 1","Doğan Alemdar","TUR","GK","19",2002,4.5,0,0,0,0,0,0,0,NA,0,0,0,0,0,0,1,1,"https://fbref.com/en/players/9e17ccff/Dogan-Alemdar"
"13279","Lorenz Assignon_2023",2023,"Rennes","Ligue 1","Lorenz Assignon","TOG","DF","22",2000,2.9,6,2,4,2,0,2,4,50,2,6,0,6,2,8,9,0,"https://fbref.com/en/players/b026bbf6/Lorenz-Assignon"
"13280","Loïc Bade_2023",2023,"Rennes","Ligue 1","Loïc Bade","FRA","DF","22",2000,1,1,1,1,0,0,0,0,NA,0,0,0,0,1,2,3,0,"https://fbref.com/en/players/114bbdee/Loic-Bade"
"13281","Jeanöel Belocian_2023",2023,"Rennes","Ligue 1","Jeanöel Belocian","FRA","DF","17",2005,5.6,10,7,3,5,2,5,9,55.6,4,6,3,3,6,16,11,0,"https://fbref.com/en/players/c678ddd7/Jeanoel-Belocian"
"13282","Benjamin Bourigeaud_2023",2023,"Rennes","Ligue 1","Benjamin Bourigeaud","FRA","MF,FW","28",1994,34.1,45,29,16,23,6,21,65,32.3,44,38,3,35,31,76,32,0,"https://fbref.com/en/players/20e73fac/Benjamin-Bourigeaud"
"13283","Alan Do Marcolino_2023",2023,"Rennes","Ligue 1","Alan Do Marcolino","GAB","FW","20",2002,0.2,0,0,0,0,0,0,0,NA,0,0,0,0,0,0,1,0,"https://fbref.com/en/players/1bd5bdc4/Alan-Do-Marcolino"
"13284","Jeremy Doku_2023",2023,"Rennes","Ligue 1","Jeremy Doku","BEL","MF,FW","20",2002,14.3,25,16,6,13,6,12,24,50,12,10,0,10,5,30,2,0,"https://fbref.com/en/players/fffea3e5/Jeremy-Doku"
"13285","Désiré Doué_2023",2023,"Rennes","Ligue 1","Désiré Doué","FRA","MF,FW","17",2005,12.4,37,18,10,23,4,13,32,40.6,19,17,1,16,13,50,3,0,"https://fbref.com/en/players/9e7483ff/Desire-Doue"
"13286","Guela Doué_2023",2023,"Rennes","Ligue 1","Guela Doué","FRA","FW,MF","19",2002,0.1,0,0,0,0,0,0,0,NA,0,0,0,0,0,0,0,0,"https://fbref.com/en/players/b4ef3fb5/Guela-Doue"
"13287","Amine Gouiri_2023",2023,"Rennes","Ligue 1","Amine Gouiri","FRA","FW,MF","22",2000,28,42,25,14,16,12,14,33,42.4,19,21,0,21,12,54,10,0,"https://fbref.com/en/players/aad56ca3/Amine-Gouiri"
"13288","Sehrou Guirassy_2023",2023,"Rennes","Ligue 1","Sehrou Guirassy","GUI","MF","26",1996,0.3,0,0,0,0,0,0,0,NA,0,0,0,0,0,0,0,0,"https://fbref.com/en/players/923f4dda/Sehrou-Guirassy"
"13289","Arnaud Kalimuendo_2023",2023,"Rennes","Ligue 1","Arnaud Kalimuendo","FRA","FW","20",2002,20.5,15,8,3,6,6,5,20,25,15,15,2,13,2,17,9,0,"https://fbref.com/en/players/bf4c41f9/Arnaud-Kalimuendo"
"13290","Gaëtan Laborde_2023",2023,"Rennes","Ligue 1","Gaëtan Laborde","FRA","FW","28",1994,2.8,1,1,1,0,0,0,1,0,1,1,0,1,0,1,1,0,"https://fbref.com/en/players/7cdda3bf/Gaetan-Laborde"
"13291","Lovro Majer_2023",2023,"Rennes","Ligue 1","Lovro Majer","CRO","MF,FW","24",1998,18.5,34,23,16,13,5,8,29,27.6,21,21,1,20,21,55,5,1,"https://fbref.com/en/players/fc46aab1/Lovro-Majer"
"13292","Steve Mandanda_2023",2023,"Rennes","Ligue 1","Steve Mandanda","FRA","GK","37",1985,33.5,0,0,0,0,0,0,2,0,2,0,0,0,0,0,9,3,"https://fbref.com/en/players/1d2d5cc8/Steve-Mandanda"
"13293","Birger Meling_2023",2023,"Rennes","Ligue 1","Birger Meling","NOR","DF","27",1994,13.4,24,15,9,12,3,12,25,48,13,18,2,16,23,47,26,0,"https://fbref.com/en/players/70c52749/Birger-Meling"
"13294","Warmed Omari_2023",2023,"Rennes","Ligue 1","Warmed Omari","FRA","DF","22",2000,15.1,20,11,14,6,0,14,28,50,14,13,7,6,17,37,43,1,"https://fbref.com/en/players/4534a352/Warmed-Omari"
"13295","Joe Rodon_2023",2023,"Rennes","Ligue 1","Joe Rodon","WAL","DF","24",1997,15.7,11,7,9,2,0,4,10,40,6,16,12,4,9,20,54,1,"https://fbref.com/en/players/8d62d31a/Joe-Rodon"
"13296","Ibrahim Salah_2023",2023,"Rennes","Ligue 1","Ibrahim Salah","MAR","FW,MF","20",2001,2.5,8,1,5,3,0,2,15,13.3,13,3,0,3,2,10,0,0,"https://fbref.com/en/players/cad3fd4d/Ibrahim-Salah"
"13297","Baptiste Santamaria_2023",2023,"Rennes","Ligue 1","Baptiste Santamaria","FRA","MF","27",1995,20.1,41,22,13,23,5,21,41,51.2,20,21,5,16,21,62,23,0,"https://fbref.com/en/players/5e22e2a4/Baptiste-Santamaria"
"13298","Djed Spence_2023",2023,"Rennes","Ligue 1","Djed Spence","ENG","DF","21",2000,6.4,14,6,8,2,4,11,18,61.1,7,10,3,7,4,18,15,0,"https://fbref.com/en/players/9bc9a519/Djed-Spence"
"13299","Kamaldeen Sulemana_2023",2023,"Rennes","Ligue 1","Kamaldeen Sulemana","GHA","FW,MF","20",2002,3.6,6,3,1,4,1,1,5,20,4,2,0,2,4,10,2,0,"https://fbref.com/en/players/a62f8bf1/Kamaldeen-Sulemana"
"13300","Flavien Tait_2023",2023,"Rennes","Ligue 1","Flavien Tait","FRA","MF","29",1993,18.7,30,15,8,17,5,19,42,45.2,23,16,4,12,20,50,12,0,"https://fbref.com/en/players/a0f9b535/Flavien-Tait"
"13301","Martin Terrier_2023",2023,"Rennes","Ligue 1","Martin Terrier","FRA","FW,MF","25",1997,14.7,25,11,7,9,9,13,24,54.2,11,15,2,13,14,39,6,0,"https://fbref.com/en/players/5148dcc5/Martin-Terrier"
"13302","Arthur Theate_2023",2023,"Rennes","Ligue 1","Arthur Theate","BEL","DF","22",2000,34.7,29,19,17,8,4,17,30,56.7,13,26,14,12,30,59,114,3,"https://fbref.com/en/players/df8d6029/Arthur-Theate"
"13303","Karl Toko Ekambi_2023",2023,"Rennes","Ligue 1","Karl Toko Ekambi","CMR","FW,MF","29",1992,10.8,3,1,1,1,1,3,9,33.3,6,5,0,5,9,12,3,0,"https://fbref.com/en/players/5ceba7fc/Karl-Toko-Ekambi"
"13304","Hamari Traoré_2023",2023,"Rennes","Ligue 1","Hamari Traoré","MLI","DF","30",1992,28.1,48,32,26,15,7,28,52,53.8,24,33,7,26,38,86,64,0,"https://fbref.com/en/players/a4b1028a/Hamari-Traore"
"13305","Adrien Truffert_2023",2023,"Rennes","Ligue 1","Adrien Truffert","FRA","DF","20",2001,21.7,62,32,36,17,9,31,46,67.4,15,32,8,24,22,84,55,0,"https://fbref.com/en/players/5d0e0a1f/Adrien-Truffert"
"13306","Chimuanya Ugochukwu_2023",2023,"Rennes","Ligue 1","Chimuanya Ugochukwu","FRA","MF","18",2004,14.8,36,19,13,20,3,16,24,66.7,8,24,10,14,21,57,16,0,"https://fbref.com/en/players/1df4a109/Chimuanya-Ugochukwu"
"13307","Christopher Wooh_2023",2023,"Rennes","Ligue 1","Christopher Wooh","CMR","DF","20",2001,11.2,16,7,8,8,0,9,11,81.8,2,11,5,6,6,22,49,0,"https://fbref.com/en/players/b003239d/Christopher-Wooh"
"13308","Xeka_2023",2023,"Rennes","Ligue 1","Xeka","POR","MF","27",1994,6.1,10,3,6,3,1,7,16,43.8,9,11,2,9,6,16,8,0,"https://fbref.com/en/players/f3600c02/Xeka"
"13309","Tammy Abraham_2023",2023,"Roma","Serie A","Tammy Abraham","ENG","FW","24",1997,24.3,17,10,4,8,5,3,16,18.8,13,10,4,6,3,20,14,0,"https://fbref.com/en/players/f586779e/Tammy-Abraham"
"13310","Andrea Belotti_2023",2023,"Roma","Serie A","Andrea Belotti","ITA","FW","28",1993,12.7,12,5,3,5,4,5,11,45.5,6,11,1,10,3,15,5,0,"https://fbref.com/en/players/d705ba44/Andrea-Belotti"
"13311","Edoardo Bove_2023",2023,"Roma","Serie A","Edoardo Bove","ITA","MF","20",2002,11,35,18,12,15,8,16,39,41,23,15,1,14,10,45,11,0,"https://fbref.com/en/players/ae94a6c5/Edoardo-Bove"
"13312","Mohamed Camara_2023",2023,"Roma","Serie A","Mohamed Camara","GUI","MF","25",1997,7.7,13,10,3,7,3,5,15,33.3,10,5,1,4,10,23,8,0,"https://fbref.com/en/players/13ea2544/Mohamed-Camara"
"13313","Zeki Çelik_2023",2023,"Roma","Serie A","Zeki Çelik","TUR","DF","25",1997,16.7,42,21,19,21,2,24,41,58.5,17,33,6,27,14,56,36,2,"https://fbref.com/en/players/31a62dc7/Zeki-Celik"
"13314","Bryan Cristante_2023",2023,"Roma","Serie A","Bryan Cristante","ITA","MF,DF","27",1995,32.6,113,62,55,49,9,55,90,61.1,35,39,10,29,18,131,53,0,"https://fbref.com/en/players/16657b95/Bryan-Cristante"
"13315","Paulo Dybala_2023",2023,"Roma","Serie A","Paulo Dybala","ARG","MF,FW","28",1993,19.3,14,4,1,8,5,8,26,30.8,18,12,1,11,8,22,4,0,"https://fbref.com/en/players/e0921a4f/Paulo-Dybala"
"13316","Roger Ibanez_2023",2023,"Roma","Serie A","Roger Ibanez","BRA","DF","23",1998,31.1,67,33,38,26,3,32,48,66.7,16,30,11,19,66,133,95,2,"https://fbref.com/en/players/82efe6fa/Roger-Ibanez"
"13317","Rick Karsdorp_2023",2023,"Roma","Serie A","Rick Karsdorp","NED","DF","27",1995,7.9,21,13,11,7,3,13,22,59.1,9,0,0,0,7,28,15,1,"https://fbref.com/en/players/9f84febe/Rick-Karsdorp"
"13318","Marash Kumbulla_2023",2023,"Roma","Serie A","Marash Kumbulla","ALB","DF","22",2000,2.9,4,4,2,2,0,2,3,66.7,1,2,1,1,4,8,6,0,"https://fbref.com/en/players/a40819d9/Marash-Kumbulla"
"13319","Diego Llorente_2023",2023,"Roma","Serie A","Diego Llorente","ESP","DF","28",1993,6.4,10,5,6,4,0,5,12,41.7,7,4,2,2,11,21,20,0,"https://fbref.com/en/players/bba30585/Diego-Llorente"
"13320","Jordan Majchrzak_2023",2023,"Roma","Serie A","Jordan Majchrzak","POL","FW","17",2004,0.2,0,0,0,0,0,0,0,NA,0,0,0,0,0,0,0,0,"https://fbref.com/en/players/2e7dafe5/Jordan-Majchrzak"
"13321","Gianluca Mancini_2023",2023,"Roma","Serie A","Gianluca Mancini","ITA","DF","26",1996,31.8,37,19,27,9,1,18,34,52.9,16,38,17,21,46,83,67,0,"https://fbref.com/en/players/5aa53281/Gianluca-Mancini"
"13322","Nemanja Matić_2023",2023,"Roma","Serie A","Nemanja Matić","SRB","MF","33",1988,20.6,47,27,24,19,4,19,33,57.6,14,27,7,20,25,72,21,1,"https://fbref.com/en/players/eb7822d7/Nemanja-Matic"
"13323","Filippo Missori_2023",2023,"Roma","Serie A","Filippo Missori","ITA","DF","18",2004,2,4,3,3,0,1,3,6,50,3,0,0,0,3,7,5,0,"https://fbref.com/en/players/2d3d7c0d/Filippo-Missori"
"13324","Rui Patrício_2023",2023,"Roma","Serie A","Rui Patrício","POR","GK","34",1988,35,1,1,1,0,0,1,1,100,0,0,0,0,2,3,6,3,"https://fbref.com/en/players/79b0d6a0/Rui-Patricio"
"13325","Lorenzo Pellegrini_2023",2023,"Roma","Serie A","Lorenzo Pellegrini","ITA","MF","26",1996,28.3,52,29,24,24,4,22,48,45.8,26,27,4,23,26,78,22,0,"https://fbref.com/en/players/4a5a45c7/Lorenzo-Pellegrini"
"13326","Niccolò Pisilli_2023",2023,"Roma","Serie A","Niccolò Pisilli","ITA","MF","17",2004,0,0,0,0,0,0,0,0,NA,0,0,0,0,0,0,0,0,"https://fbref.com/en/players/c84dcc88/Niccolo-Pisilli"
"13327","Stephan El Shaarawy_2023",2023,"Roma","Serie A","Stephan El Shaarawy","ITA","DF,MF","29",1992,16.9,21,9,8,10,3,6,22,27.3,16,11,1,10,15,36,11,0,"https://fbref.com/en/players/d3aaad90/Stephan-El-Shaarawy"
"13328","Eldor Shomurodov_2023",2023,"Roma","Serie A","Eldor Shomurodov","UZB","FW","27",1995,1.3,1,0,1,0,0,0,2,0,2,1,0,1,1,2,0,0,"https://fbref.com/en/players/57469b2d/Eldor-Shomurodov"
"13329","Chris Smalling_2023",2023,"Roma","Serie A","Chris Smalling","ENG","DF","32",1989,31.2,26,15,16,10,0,13,21,61.9,8,51,36,15,43,69,123,0,"https://fbref.com/en/players/b6964eb6/Chris-Smalling"
"13330","Ola Solbakken_2023",2023,"Roma","Serie A","Ola Solbakken","NOR","MF,FW","23",1998,5.6,2,2,1,1,0,2,7,28.6,5,2,0,2,2,4,8,0,"https://fbref.com/en/players/78f13530/Ola-Solbakken"
"13331","Leonardo Spinazzola_2023",2023,"Roma","Serie A","Leonardo Spinazzola","ITA","DF","29",1993,18.4,15,8,7,6,2,8,23,34.8,15,13,3,10,9,24,25,0,"https://fbref.com/en/players/3626daea/Leonardo-Spinazzola"
"13332","Mile Svilar_2023",2023,"Roma","Serie A","Mile Svilar","SRB","GK","22",1999,3,0,0,0,0,0,0,0,NA,0,0,0,0,0,0,1,0,"https://fbref.com/en/players/bcf5058a/Mile-Svilar"
"13333","Benjamin Tahirovic_2023",2023,"Roma","Serie A","Benjamin Tahirovic","BIH","MF","19",2003,3.9,8,5,5,2,1,4,12,33.3,8,9,4,5,3,11,3,0,"https://fbref.com/en/players/eb3022c3/Benjamin-Tahirovic"
"13334","Matías Viña_2023",2023,"Roma","Serie A","Matías Viña","URU","DF","24",1997,0.6,3,1,1,1,1,1,3,33.3,2,5,1,4,2,5,5,0,"https://fbref.com/en/players/08eb3b58/Matias-Vina"
"13335","Cristian Volpato_2023",2023,"Roma","Serie A","Cristian Volpato","ITA","MF","18",2003,2.5,3,2,1,1,1,0,2,0,2,2,0,2,2,5,0,0,"https://fbref.com/en/players/72f87f25/Cristian-Volpato"
"13336","Georginio Wijnaldum_2023",2023,"Roma","Serie A","Georginio Wijnaldum","NED","MF","31",1990,8.5,4,3,1,3,0,0,2,0,2,7,1,6,2,6,3,0,"https://fbref.com/en/players/eb58eef0/Georginio-Wijnaldum"
"13337","Nicola Zalewski_2023",2023,"Roma","Serie A","Nicola Zalewski","POL","DF","20",2002,24.4,45,26,25,15,5,22,71,31,49,27,1,26,31,76,23,0,"https://fbref.com/en/players/45191c29/Nicola-Zalewski"
"13338","Nicolò Zaniolo_2023",2023,"Roma","Serie A","Nicolò Zaniolo","ITA","MF,FW","23",1999,9.9,7,5,2,4,1,2,7,28.6,5,11,0,11,2,9,0,0,"https://fbref.com/en/players/9907b1c8/Nicolo-Zaniolo"
"13339","Emil Bohinen_2023",2023,"Salernitana","Serie A","Emil Bohinen","NOR","MF","23",1999,9.2,25,13,15,8,2,12,23,52.2,11,25,7,18,17,42,21,0,"https://fbref.com/en/players/c83c203f/Emil-Bohinen"
"13340","Federico Bonazzoli_2023",2023,"Salernitana","Serie A","Federico Bonazzoli","ITA","FW,MF","25",1997,12.4,5,3,0,3,2,0,9,0,9,9,1,8,3,8,0,0,"https://fbref.com/en/players/bf57eaab/Federico-Bonazzoli"
"13341","Erik Botheim_2023",2023,"Salernitana","Serie A","Erik Botheim","NOR","MF,FW","22",2000,9.6,11,7,3,4,4,6,13,46.2,7,3,0,3,0,11,4,0,"https://fbref.com/en/players/3d13d9e4/Erik-Botheim"
"13342","Domagoj Bradarić_2023",2023,"Salernitana","Serie A","Domagoj Bradarić","CRO","DF","22",1999,25,26,19,14,8,4,7,16,43.8,9,20,5,15,21,47,44,0,"https://fbref.com/en/players/8bbe2df5/Domagoj-Bradaric"
"13343","Dylan Bronn_2023",2023,"Salernitana","Serie A","Dylan Bronn","TUN","DF","27",1995,18.7,34,18,17,16,1,20,30,66.7,10,32,20,12,20,54,58,1,"https://fbref.com/en/players/edd81e2a/Dylan-Bronn"
"13344","Antonio Candreva_2023",2023,"Salernitana","Serie A","Antonio Candreva","ITA","MF,DF","35",1987,30.3,17,7,13,2,2,11,38,28.9,27,7,3,4,17,34,32,0,"https://fbref.com/en/players/356c9002/Antonio-Candreva"
"13345","Lassana Coulibaly_2023",2023,"Salernitana","Serie A","Lassana Coulibaly","MLI","MF","26",1996,32.1,84,50,42,35,7,30,73,41.1,43,35,7,28,25,109,33,2,"https://fbref.com/en/players/85a44ecc/Lassana-Coulibaly"
"13346","Domen Črnigoj_2023",2023,"Salernitana","Serie A","Domen Črnigoj","SVN","MF","26",1995,3.3,8,3,0,7,1,1,2,50,1,9,1,8,9,17,6,0,"https://fbref.com/en/players/22cd43d2/Domen-Crnigoj"
"13347","Flavius Daniliuc_2023",2023,"Salernitana","Serie A","Flavius Daniliuc","AUT","DF","21",2001,24.4,57,29,37,17,3,26,47,55.3,21,30,13,17,29,86,76,0,"https://fbref.com/en/players/7ef972c3/Flavius-Daniliuc"
"13348","Boulaye Dia_2023",2023,"Salernitana","Serie A","Boulaye Dia","SEN","FW,MF","25",1996,28,12,5,3,6,3,2,7,28.6,5,10,0,10,7,19,27,1,"https://fbref.com/en/players/244bc2c8/Boulaye-Dia"
"13349","Federico Fazio_2023",2023,"Salernitana","Serie A","Federico Fazio","ARG","DF","35",1987,11.9,15,12,8,7,0,4,11,36.4,7,9,4,5,28,43,61,0,"https://fbref.com/en/players/4e358a2d/Federico-Fazio"
"13350","Vincenzo Fiorillo_2023",2023,"Salernitana","Serie A","Vincenzo Fiorillo","ITA","GK","32",1990,1,0,0,0,0,0,0,0,NA,0,0,0,0,0,0,0,0,"https://fbref.com/en/players/a2565f79/Vincenzo-Fiorillo"
"13351","Norbert Gyömbér_2023",2023,"Salernitana","Serie A","Norbert Gyömbér","SVK","DF","30",1992,19.3,32,23,25,6,1,16,24,66.7,8,33,22,11,35,67,92,0,"https://fbref.com/en/players/0be276c6/Norbert-Gyomber"
"13352","Antonio Iervolino_2023",2023,"Salernitana","Serie A","Antonio Iervolino","ITA","MF","19",2003,0.1,0,0,0,0,0,0,1,0,1,0,0,0,0,0,0,0,"https://fbref.com/en/players/daa4c94c/Antonio-Iervolino"
"13353","Grigoris Kastanos_2023",2023,"Salernitana","Serie A","Grigoris Kastanos","CYP","MF,DF","24",1998,14.3,39,23,18,19,2,16,40,40,24,20,6,14,8,47,8,0,"https://fbref.com/en/players/2a82aa85/Grigoris-Kastanos"
"13354","Julian Kristoffersen_2023",2023,"Salernitana","Serie A","Julian Kristoffersen","NOR","FW","25",1997,0.2,0,0,0,0,0,0,0,NA,0,1,0,1,0,0,0,0,"https://fbref.com/en/players/b804c280/Julian-Kristoffersen"
"13355","Matteo Lovato_2023",2023,"Salernitana","Serie A","Matteo Lovato","ITA","DF","22",2000,9,17,14,14,3,0,10,25,40,15,8,5,3,13,30,33,2,"https://fbref.com/en/players/5fa57166/Matteo-Lovato"
"13356","Giulio Maggiore_2023",2023,"Salernitana","Serie A","Giulio Maggiore","ITA","MF","24",1998,9.9,20,8,11,6,3,10,21,47.6,11,19,4,15,8,28,10,0,"https://fbref.com/en/players/957e4c87/Giulio-Maggiore"
"13357","Pasquale Mazzocchi_2023",2023,"Salernitana","Serie A","Pasquale Mazzocchi","ITA","DF","27",1995,21.8,32,18,21,5,6,17,37,45.9,20,10,2,8,10,42,37,2,"https://fbref.com/en/players/eb0ec070/Pasquale-Mazzocchi"
"13358","Hans Nicolussi Caviglia_2023",2023,"Salernitana","Serie A","Hans Nicolussi Caviglia","ITA","MF","22",2000,6.5,15,6,5,8,2,9,15,60,6,9,0,9,7,22,7,1,"https://fbref.com/en/players/b136c945/Hans-Nicolussi-Caviglia"
"13359","Guillermo Ochoa_2023",2023,"Salernitana","Serie A","Guillermo Ochoa","MEX","GK","37",1985,20,0,0,0,0,0,0,2,0,2,0,0,0,0,0,9,1,"https://fbref.com/en/players/1e9bde92/Guillermo-Ochoa"
"13360","Krzysztof Piątek_2023",2023,"Salernitana","Serie A","Krzysztof Piątek","POL","FW","27",1995,23.8,18,11,3,9,6,5,21,23.8,16,17,4,13,2,20,39,0,"https://fbref.com/en/players/17f3620a/Krzysztof-Piatek"
"13361","Lorenzo Pirola_2023",2023,"Salernitana","Serie A","Lorenzo Pirola","ITA","DF","20",2002,21.6,33,29,18,14,1,19,27,70.4,8,50,35,15,30,63,85,1,"https://fbref.com/en/players/caec77da/Lorenzo-Pirola"
"13362","Ivan Radovanović_2023",2023,"Salernitana","Serie A","Ivan Radovanović","SRB","MF,DF","33",1988,7.5,12,4,8,4,0,4,10,40,6,9,3,6,7,19,9,1,"https://fbref.com/en/players/023937a9/Ivan-Radovanovic"
"13363","Franck Ribéry_2023",2023,"Salernitana","Serie A","Franck Ribéry","FRA","MF","39",1983,0.4,0,0,0,0,0,0,0,NA,0,1,0,1,0,0,0,0,"https://fbref.com/en/players/f61c7c4e/Franck-Ribery"
"13364","Junior Sambia_2023",2023,"Salernitana","Serie A","Junior Sambia","FRA","DF","25",1996,7.7,12,5,7,4,1,6,10,60,4,9,3,6,8,20,16,1,"https://fbref.com/en/players/24eb7ed6/Junior-Sambia"
"13365","Luigi Sepe_2023",2023,"Salernitana","Serie A","Luigi Sepe","ITA","GK","31",1991,17,0,0,0,0,0,0,1,0,1,0,0,0,0,0,0,0,"https://fbref.com/en/players/343f753a/Luigi-Sepe"
"13366","William Troost-Ekong_2023",2023,"Salernitana","Serie A","William Troost-Ekong","NGA","DF","28",1993,4.9,11,3,7,4,0,6,7,85.7,1,7,4,3,6,17,10,0,"https://fbref.com/en/players/7ed4921e/William-Troost-Ekong"
"13367","Diego Valencia_2023",2023,"Salernitana","Serie A","Diego Valencia","CHI","MF,FW","22",2000,2.6,8,5,4,2,2,2,9,22.2,7,10,1,9,1,9,2,0,"https://fbref.com/en/players/71005acd/Diego-Valencia"
"13368","Tonny Vilhena_2023",2023,"Salernitana","Serie A","Tonny Vilhena","NED","MF","27",1995,25.2,44,22,16,23,5,20,50,40,30,17,7,10,18,62,21,0,"https://fbref.com/en/players/c7069d87/Tonny-Vilhena"
"13369","Bruno Amione_2023",2023,"Sampdoria","Serie A","Bruno Amione","ARG","DF","20",2002,23.2,50,33,36,14,0,19,43,44.2,24,26,11,15,25,75,62,1,"https://fbref.com/en/players/2df7cc43/Bruno-Amione"
"13370","Emil Audero_2023",2023,"Sampdoria","Serie A","Emil Audero","ITA","GK","25",1997,25,0,0,0,0,0,0,2,0,2,0,0,0,0,0,7,1,"https://fbref.com/en/players/649b01d8/Emil-Audero"
"13371","Tommaso Augello_2023",2023,"Sampdoria","Serie A","Tommaso Augello","ITA","DF","27",1994,34,17,14,13,2,2,9,20,45,11,23,7,16,17,34,61,1,"https://fbref.com/en/players/3cd3b384/Tommaso-Augello"
"13372","Bartosz Bereszyński_2023",2023,"Sampdoria","Serie A","Bartosz Bereszyński","POL","DF","30",1992,13.3,28,18,15,11,2,17,26,65.4,9,18,4,14,21,49,25,0,"https://fbref.com/en/players/61b3978f/Bartosz-Bereszynski"
"13373","Francesco Caputo_2023",2023,"Sampdoria","Serie A","Francesco Caputo","ITA","FW","34",1987,12.2,3,1,0,0,3,0,3,0,3,0,0,0,1,4,3,0,"https://fbref.com/en/players/5bd72174/Francesco-Caputo"
"13374","Omar Colley_2023",2023,"Sampdoria","Serie A","Omar Colley","GAM","DF","29",1992,15.4,17,10,10,7,0,9,12,75,3,9,5,4,22,39,69,1,"https://fbref.com/en/players/8b95acda/Omar-Colley"
"13375","Andrea Conti_2023",2023,"Sampdoria","Serie A","Andrea Conti","ITA","DF","28",1994,0.3,0,0,0,0,0,0,0,NA,0,0,0,0,0,0,0,0,"https://fbref.com/en/players/8fef5412/Andrea-Conti"
"13376","Mickaël Cuisance_2023",2023,"Sampdoria","Serie A","Mickaël Cuisance","FRA","MF","22",1999,6.9,13,10,7,5,1,5,23,21.7,18,10,0,10,5,18,4,0,"https://fbref.com/en/players/5722eced/Mickael-Cuisance"
"13377","Manuel De Luca_2023",2023,"Sampdoria","Serie A","Manuel De Luca","ITA","FW,MF","24",1998,0.5,0,0,0,0,0,0,0,NA,0,0,0,0,0,0,0,0,"https://fbref.com/en/players/60e3603d/Manuel-De-Luca"
"13378","Fabio Depaoli_2023",2023,"Sampdoria","Serie A","Fabio Depaoli","ITA","DF,MF","25",1997,1.5,5,3,2,3,0,3,4,75,1,1,0,1,1,6,4,0,"https://fbref.com/en/players/d97f2e8d/Fabio-Depaoli"
"13379","Alex Ferrari_2023",2023,"Sampdoria","Serie A","Alex Ferrari","ITA","DF","28",1994,9.6,9,5,7,2,0,4,8,50,4,21,10,11,19,28,25,0,"https://fbref.com/en/players/d0dbca9f/Alex-Ferrari"
"13380","Manolo Gabbiadini_2023",2023,"Sampdoria","Serie A","Manolo Gabbiadini","ITA","FW,MF","30",1991,26.2,23,15,8,9,6,9,23,39.1,14,16,2,14,6,29,25,0,"https://fbref.com/en/players/8f866fe8/Manolo-Gabbiadini"
"13381","Koray Günter_2023",2023,"Sampdoria","Serie A","Koray Günter","GER","DF","27",1994,8.6,10,8,6,4,0,6,9,66.7,3,10,5,5,11,21,46,0,"https://fbref.com/en/players/f1f1f238/Koray-Gunter"
"13382","Emirhan İlkhan_2023",2023,"Sampdoria","Serie A","Emirhan İlkhan","TUR","MF","18",2004,1.3,6,3,2,2,2,2,3,66.7,1,5,1,4,0,6,3,0,"https://fbref.com/en/players/a47c6309/Emirhan-Ilkhan"
"13383","Mihailo Ivanović_2023",2023,"Sampdoria","Serie A","Mihailo Ivanović","SRB","FW","17",2004,0,0,0,0,0,0,0,0,NA,0,0,0,0,0,0,0,0,"https://fbref.com/en/players/71c620d7/Mihailo-Ivanovic"
"13384","Jesé_2023",2023,"Sampdoria","Serie A","Jesé","ESP","FW","29",1993,2.3,2,0,0,2,0,0,1,0,1,3,1,2,1,3,2,0,"https://fbref.com/en/players/4a537185/Jese"
"13385","Sam Lammers_2023",2023,"Sampdoria","Serie A","Sam Lammers","NED","FW","25",1997,12.2,12,5,2,7,3,6,15,40,9,10,3,7,6,18,11,0,"https://fbref.com/en/players/c283ddef/Sam-Lammers"
"13386","Mehdi Léris_2023",2023,"Sampdoria","Serie A","Mehdi Léris","ALG","MF,DF","24",1998,27.3,63,46,30,24,9,23,55,41.8,32,38,6,32,27,90,34,0,"https://fbref.com/en/players/7d3cbc67/Mehdi-Leris"
"13387","Lorenzo Malagrida_2023",2023,"Sampdoria","Serie A","Lorenzo Malagrida","ITA","MF,DF","18",2003,1.2,1,0,0,0,1,1,3,33.3,2,1,0,1,0,1,1,0,"https://fbref.com/en/players/2bffcbf2/Lorenzo-Malagrida"
"13388","Daniele Montevago_2023",2023,"Sampdoria","Serie A","Daniele Montevago","ITA","FW","19",2003,2.6,1,0,0,0,1,0,1,0,1,2,1,1,0,1,1,0,"https://fbref.com/en/players/ca73910d/Daniele-Montevago"
"13389","Jeison Murillo_2023",2023,"Sampdoria","Serie A","Jeison Murillo","COL","DF","30",1992,11.7,22,11,16,6,0,17,26,65.4,9,22,14,8,8,30,39,0,"https://fbref.com/en/players/b233e8e4/Jeison-Murillo"
"13390","Nicola Murru_2023",2023,"Sampdoria","Serie A","Nicola Murru","ITA","DF","27",1994,8.7,24,14,15,8,1,7,13,53.8,6,17,7,10,10,34,21,0,"https://fbref.com/en/players/d183e9d6/Nicola-Murru"
"13391","Samuel Ntanda_2023",2023,"Sampdoria","Serie A","Samuel Ntanda","BEL","MF","17",2005,0,0,0,0,0,0,0,0,NA,0,0,0,0,0,0,0,0,"https://fbref.com/en/players/48329ff8/Samuel-Ntanda"
"13392","Bram Nuytinck_2023",2023,"Sampdoria","Serie A","Bram Nuytinck","NED","DF","32",1990,16.6,54,38,33,21,0,23,34,67.6,11,36,21,15,23,77,84,0,"https://fbref.com/en/players/e33f36d5/Bram-Nuytinck"
"13393","Marios Oikonomou_2023",2023,"Sampdoria","Serie A","Marios Oikonomou","GRE","DF","29",1992,2.4,3,2,3,0,0,1,3,33.3,2,5,4,1,4,7,13,0,"https://fbref.com/en/players/3b9858f5/Marios-Oikonomou"
"13394","Flavio Paoletti_2023",2023,"Sampdoria","Serie A","Flavio Paoletti","ITA","MF","19",2003,3.2,2,2,0,2,0,1,5,20,4,1,0,1,5,7,9,0,"https://fbref.com/en/players/3d6cee81/Flavio-Paoletti"
"13395","Ignacio Pussetto_2023",2023,"Sampdoria","Serie A","Ignacio Pussetto","ARG","MF,DF","26",1995,1.7,6,3,2,3,1,3,4,75,1,4,0,4,0,6,3,0,"https://fbref.com/en/players/62437b4f/Ignacio-Pussetto"
"13396","Fabio Quagliarella_2023",2023,"Sampdoria","Serie A","Fabio Quagliarella","ITA","FW","39",1983,8.9,2,1,1,1,0,1,7,14.3,6,5,1,4,0,2,9,0,"https://fbref.com/en/players/ee4f2f3b/Fabio-Quagliarella"
"13397","Nicola Ravaglia_2023",2023,"Sampdoria","Serie A","Nicola Ravaglia","ITA","GK","33",1988,9,0,0,0,0,0,0,1,0,1,0,0,0,0,0,7,0,"https://fbref.com/en/players/d7a35008/Nicola-Ravaglia"
"13398","Tomás Rincón_2023",2023,"Sampdoria","Serie A","Tomás Rincón","VEN","MF","34",1988,28.4,56,27,22,26,8,29,61,47.5,32,37,7,30,30,86,18,0,"https://fbref.com/en/players/f1cfc209/Tomas-Rincon"
"13399","Abdelhamid Sabiri_2023",2023,"Sampdoria","Serie A","Abdelhamid Sabiri","MAR","MF,FW","25",1996,11.9,18,7,5,9,4,4,13,30.8,9,18,4,14,2,20,5,0,"https://fbref.com/en/players/4830e0af/Abdelhamid-Sabiri"
"13400","Telasco Segovia_2023",2023,"Sampdoria","Serie A","Telasco Segovia","VEN","MF","19",2003,0,0,0,0,0,0,0,0,NA,0,0,0,0,0,0,0,0,"https://fbref.com/en/players/9142b22f/Telasco-Segovia"
"13401","Martin Turk_2023",2023,"Sampdoria","Serie A","Martin Turk","SVN","GK","18",2003,4,0,0,0,0,0,0,0,NA,0,0,0,0,0,0,1,0,"https://fbref.com/en/players/14ae023f/Martin-Turk"
"13402","Valerio Verre_2023",2023,"Sampdoria","Serie A","Valerio Verre","ITA","MF","28",1994,7.5,14,7,6,5,3,8,17,47.1,9,9,1,8,9,23,3,0,"https://fbref.com/en/players/33ecf462/Valerio-Verre"
"13403","Ronaldo Vieira_2023",2023,"Sampdoria","Serie A","Ronaldo Vieira","GNB","MF","24",1998,9.1,NA,10,NA,NA,NA,NA,NA,NA,NA,NA,NA,NA,13,NA,NA,NA,"https://fbref.com/en/players/75e60d75/Ronaldo-Vieira"
"13404","Gonzalo Villar_2023",2023,"Sampdoria","Serie A","Gonzalo Villar","ESP","MF","24",1998,7.7,13,7,4,8,1,7,15,46.7,8,11,3,8,4,17,9,1,"https://fbref.com/en/players/bdc74a8f/Gonzalo-Villar"
"13405","Harry Winks_2023",2023,"Sampdoria","Serie A","Harry Winks","ENG","MF","26",1996,19.1,27,12,7,18,2,14,43,32.6,29,14,8,6,24,51,24,0,"https://fbref.com/en/players/2f7acede/Harry-Winks"
"13406","Gerard Yepes_2023",2023,"Sampdoria","Serie A","Gerard Yepes","ESP","MF","19",2002,2.2,5,3,2,3,0,1,3,33.3,2,3,0,3,4,9,3,0,"https://fbref.com/en/players/ee9040b4/Gerard-Yepes"
"13407","Alessandro Zanoli_2023",2023,"Sampdoria","Serie A","Alessandro Zanoli","ITA","DF","21",2000,17.1,22,14,14,6,2,8,17,47.1,9,19,15,4,12,34,39,0,"https://fbref.com/en/players/3b12b11f/Alessandro-Zanoli"
"13408","Filip Đuričić_2023",2023,"Sampdoria","Serie A","Filip Đuričić","SRB","MF,FW","30",1992,24.1,43,22,18,20,5,14,32,43.8,18,19,6,13,7,50,8,0,"https://fbref.com/en/players/eccbe56a/Filip-Djuricic"
"13409","Agustín Álvarez Martínez_2023",2023,"Sassuolo","Serie A","Agustín Álvarez Martínez","URU","FW,MF","21",2001,4.1,6,3,0,5,1,1,4,25,3,5,1,4,3,9,3,0,"https://fbref.com/en/players/ab472696/Agustin-Alvarez-Martinez"
"13410","Janis Antiste_2023",2023,"Sassuolo","Serie A","Janis Antiste","FRA","FW","19",2002,0.6,1,0,1,0,0,1,1,100,0,0,0,0,0,1,0,0,"https://fbref.com/en/players/38d9ce53/Janis-Antiste"
"13411","Kaan Ayhan_2023",2023,"Sassuolo","Serie A","Kaan Ayhan","TUR","DF","27",1994,6.1,10,4,6,4,0,7,7,100,0,5,4,1,5,15,26,1,"https://fbref.com/en/players/2200181e/Kaan-Ayhan"
"13412","Nedim Bajrami_2023",2023,"Sassuolo","Serie A","Nedim Bajrami","ALB","FW,MF","23",1999,9.1,12,7,6,2,4,5,11,45.5,6,9,1,8,7,19,6,0,"https://fbref.com/en/players/f42d6c13/Nedim-Bajrami"
"13413","Domenico Berardi_2023",2023,"Sassuolo","Serie A","Domenico Berardi","ITA","FW","27",1994,20.7,23,14,8,10,5,9,40,22.5,31,13,0,13,19,42,18,0,"https://fbref.com/en/players/53a0e358/Domenico-Berardi"
"13414","Emil Ceide_2023",2023,"Sassuolo","Serie A","Emil Ceide","NOR","FW","20",2001,5.7,5,2,5,0,0,3,5,60,2,3,1,2,1,6,0,0,"https://fbref.com/en/players/98a84572/Emil-Ceide"
"13415","Andrea Consigli_2023",2023,"Sassuolo","Serie A","Andrea Consigli","ITA","GK","35",1987,35,1,0,1,0,0,0,1,0,1,0,0,0,0,1,13,3,"https://fbref.com/en/players/8cabdc1e/Andrea-Consigli"
"13416","Luca D'Andrea_2023",2023,"Sassuolo","Serie A","Luca D'Andrea","ITA","FW","17",2004,3.5,4,0,2,1,1,1,4,25,3,2,0,2,1,5,1,0,"https://fbref.com/en/players/f778fe3f/Luca-DAndrea"
"13417","Grégoire Defrel_2023",2023,"Sassuolo","Serie A","Grégoire Defrel","MTQ","FW","31",1991,13,9,7,5,2,2,4,13,30.8,9,11,0,11,2,11,5,0,"https://fbref.com/en/players/854ee61a/Gregoire-Defrel"
"13418","Martin Erlic_2023",2023,"Sassuolo","Serie A","Martin Erlic","CRO","DF","24",1998,25.9,27,16,18,8,1,10,23,43.5,13,36,23,13,31,58,120,1,"https://fbref.com/en/players/0fee6bda/Martin-Erlic"
"13419","Davide Frattesi_2023",2023,"Sassuolo","Serie A","Davide Frattesi","ITA","MF","22",1999,31.9,63,36,24,29,10,25,44,56.8,19,27,6,21,16,79,42,0,"https://fbref.com/en/players/2a7d27c1/Davide-Frattesi"
"13420","Abdou Harroui_2023",2023,"Sassuolo","Serie A","Abdou Harroui","NED","MF","24",1998,7.2,17,6,6,7,4,2,7,28.6,5,6,1,5,2,19,10,0,"https://fbref.com/en/players/65fd099c/Abdou-Harroui"
"13421","Matheus Henrique_2023",2023,"Sassuolo","Serie A","Matheus Henrique","BRA","MF","24",1997,21.6,26,12,9,11,6,12,24,50,12,15,4,11,12,38,10,0,"https://fbref.com/en/players/a2d9f138/Matheus-Henrique"
"13422","Hamed Junior Traorè_2023",2023,"Sassuolo","Serie A","Hamed Junior Traorè","CIV","MF,FW","22",2000,6.6,11,6,4,6,1,4,11,36.4,7,4,0,4,2,13,0,1,"https://fbref.com/en/players/570bb4b9/Hamed-Junior-Traore"
"13423","Giorgos Kyriakopoulos_2023",2023,"Sassuolo","Serie A","Giorgos Kyriakopoulos","GRE","FW,DF","26",1996,8.5,21,8,7,9,5,10,14,71.4,4,7,1,6,11,32,12,1,"https://fbref.com/en/players/0a483542/Giorgos-Kyriakopoulos"
"13424","Armand Lauriente_2023",2023,"Sassuolo","Serie A","Armand Lauriente","FRA","FW","23",1998,24.2,21,15,5,7,9,8,21,38.1,13,20,0,20,12,33,8,0,"https://fbref.com/en/players/2d22cea7/Armand-Lauriente"
"13425","Maxime Lopez_2023",2023,"Sassuolo","Serie A","Maxime Lopez","FRA","MF","24",1997,25.5,42,18,26,12,4,16,56,28.6,40,24,6,18,22,64,21,0,"https://fbref.com/en/players/20094685/Maxime-Lopez"
"13426","Riccardo Marchizza_2023",2023,"Sassuolo","Serie A","Riccardo Marchizza","ITA","DF","24",1998,3.1,2,2,1,1,0,2,4,50,2,2,0,2,2,4,8,0,"https://fbref.com/en/players/91d0fabf/Riccardo-Marchizza"
"13427","Gian Marco Ferrari_2023",2023,"Sassuolo","Serie A","Gian Marco Ferrari","ITA","DF","30",1992,24.7,23,16,11,10,2,10,17,58.8,7,29,20,9,23,46,81,4,"https://fbref.com/en/players/8650af85/Gian-Marco-Ferrari"
"13428","Mert Müldür_2023",2023,"Sassuolo","Serie A","Mert Müldür","TUR","FW,DF","23",1999,0.1,0,0,0,0,0,0,0,NA,0,0,0,0,0,0,0,0,"https://fbref.com/en/players/1295552e/Mert-Muldur"
"13429","Pedro Obiang_2023",2023,"Sassuolo","Serie A","Pedro Obiang","EQG","MF","30",1992,9.7,26,17,12,12,2,10,18,55.6,8,12,2,10,8,34,15,0,"https://fbref.com/en/players/ba1e04b3/Pedro-Obiang"
"13430","Gianluca Pegolo_2023",2023,"Sassuolo","Serie A","Gianluca Pegolo","ITA","GK","41",1981,2,0,0,0,0,0,0,1,0,1,0,0,0,0,0,1,0,"https://fbref.com/en/players/f058ed1f/Gianluca-Pegolo"
"13431","Andrea Pinamonti_2023",2023,"Sassuolo","Serie A","Andrea Pinamonti","ITA","FW","23",1999,24,10,7,0,5,5,3,7,42.9,4,19,2,17,2,12,11,0,"https://fbref.com/en/players/08aa9cd1/Andrea-Pinamonti"
"13432","Giacomo Raspadori_2023",2023,"Sassuolo","Serie A","Giacomo Raspadori","ITA","FW","22",2000,0.5,0,0,0,0,0,0,0,NA,0,0,0,0,0,0,0,0,"https://fbref.com/en/players/6e058f06/Giacomo-Raspadori"
"13433","Rogério_2023",2023,"Sassuolo","Serie A","Rogério","BRA","DF","24",1998,33.3,37,21,22,8,7,17,35,48.6,18,32,9,23,37,74,70,0,"https://fbref.com/en/players/10e7f486/Rogerio"
"13434","Filippo Romagna_2023",2023,"Sassuolo","Serie A","Filippo Romagna","ITA","DF","25",1997,0.5,0,0,0,0,0,0,0,NA,0,1,1,0,0,0,2,0,"https://fbref.com/en/players/84594618/Filippo-Romagna"
"13435","Ruan_2023",2023,"Sassuolo","Serie A","Ruan","BRA","DF","23",1999,19,38,26,25,12,1,19,29,65.5,10,29,17,12,24,62,80,3,"https://fbref.com/en/players/a378a02a/Ruan"
"13436","Alessandro Russo_2023",2023,"Sassuolo","Serie A","Alessandro Russo","ITA","GK","21",2001,1,0,0,0,0,0,0,0,NA,0,0,0,0,0,0,1,1,"https://fbref.com/en/players/3945ac70/Alessandro-Russo"
"13437","Kristian Thorstvedt_2023",2023,"Sassuolo","Serie A","Kristian Thorstvedt","NOR","MF","23",1999,12.6,16,7,4,9,3,6,17,35.3,11,19,5,14,14,30,13,0,"https://fbref.com/en/players/76ff8d0d/Kristian-Thorstvedt"
"13438","Jeremy Toljan_2023",2023,"Sassuolo","Serie A","Jeremy Toljan","GER","DF","27",1994,29.7,36,23,17,14,5,22,33,66.7,11,31,14,17,18,54,60,1,"https://fbref.com/en/players/a96e5dc0/Jeremy-Toljan"
"13439","Nadir Zortea_2023",2023,"Sassuolo","Serie A","Nadir Zortea","ITA","DF","23",1999,7.3,15,8,12,2,1,9,14,64.3,5,10,4,6,4,19,21,0,"https://fbref.com/en/players/82598b71/Nadir-Zortea"
"13440","Éder Álvarez Balanta_2023",2023,"Schalke 04","Bundesliga","Éder Álvarez Balanta","COL","MF,FW","29",1993,2.6,5,4,2,3,0,2,6,33.3,4,0,0,0,3,8,4,0,"https://fbref.com/en/players/8ce30c57/Eder-Alvarez-Balanta"
"13441","Mehmet Aydin_2023",2023,"Schalke 04","Bundesliga","Mehmet Aydin","GER","DF,FW","20",2002,6.3,25,18,14,9,2,11,24,45.8,13,11,0,11,10,35,15,0,"https://fbref.com/en/players/fe46e261/Mehmet-Aydin"
"13442","Cédric Brunner_2023",2023,"Schalke 04","Bundesliga","Cédric Brunner","SUI","DF","28",1994,25.7,39,27,26,11,2,30,45,66.7,15,24,7,17,43,82,79,0,"https://fbref.com/en/players/f0a37d36/Cedric-Brunner"
"13443","Marius Bülter_2023",2023,"Schalke 04","Bundesliga","Marius Bülter","GER","FW,MF","29",1993,28.9,22,11,8,7,7,12,32,37.5,20,34,1,33,10,32,20,0,"https://fbref.com/en/players/ab5b7dc1/Marius-Bulter"
"13444","Kerim Calhanoglu_2023",2023,"Schalke 04","Bundesliga","Kerim Calhanoglu","GER","DF","19",2002,0.7,2,1,2,0,0,2,2,100,0,1,0,1,0,2,3,0,"https://fbref.com/en/players/d1db4b83/Kerim-Calhanoglu"
"13445","Sepp van den Berg_2023",2023,"Schalke 04","Bundesliga","Sepp van den Berg","NED","DF","20",2001,7.7,5,4,2,2,1,1,4,25,3,8,5,3,13,18,33,2,"https://fbref.com/en/players/7bf9400b/Sepp-van-den-Berg"
"13446","Dominick Drexler_2023",2023,"Schalke 04","Bundesliga","Dominick Drexler","GER","MF,FW","32",1990,15.2,25,17,12,10,3,9,22,40.9,13,18,2,16,8,33,12,0,"https://fbref.com/en/players/809940aa/Dominick-Drexler"
"13447","Ralf Fährmann_2023",2023,"Schalke 04","Bundesliga","Ralf Fährmann","GER","GK","33",1988,11.4,1,0,1,0,0,1,1,100,0,0,0,0,0,1,10,2,"https://fbref.com/en/players/1e43fad8/Ralf-Fahrmann"
"13448","Florian Flick_2023",2023,"Schalke 04","Bundesliga","Florian Flick","GER","MF","22",2000,5.7,12,3,7,5,0,4,14,28.6,10,9,3,6,4,16,18,0,"https://fbref.com/en/players/9642c929/Florian-Flick"
"13449","Michael Frey_2023",2023,"Schalke 04","Bundesliga","Michael Frey","SUI","FW","28",1994,9.6,13,5,2,8,3,4,13,30.8,9,6,0,6,2,15,1,0,"https://fbref.com/en/players/33182cb8/Michael-Frey"
"13450","Leo Greiml_2023",2023,"Schalke 04","Bundesliga","Leo Greiml","AUT","DF","21",2001,4,10,5,4,5,1,5,12,41.7,7,7,3,4,3,13,16,0,"https://fbref.com/en/players/f9dfb7ae/Leo-Greiml"
"13451","Andreas Ivan_2023",2023,"Schalke 04","Bundesliga","Andreas Ivan","ROU","MF","27",1995,0.5,0,0,0,0,0,0,1,0,1,0,0,0,0,0,1,0,"https://fbref.com/en/players/8bf58a80/Andreas-Ivan"
"13452","Moritz Jenz_2023",2023,"Schalke 04","Bundesliga","Moritz Jenz","GER","DF","23",1999,10.5,14,11,8,5,1,5,8,62.5,3,16,10,6,8,22,53,1,"https://fbref.com/en/players/ee644761/Moritz-Jenz"
"13453","Marcin Kamiński_2023",2023,"Schalke 04","Bundesliga","Marcin Kamiński","POL","DF","30",1992,7,6,4,4,0,2,2,4,50,2,8,7,1,9,15,28,0,"https://fbref.com/en/players/463503e2/Marcin-Kaminski"
"13454","Kenan Karaman_2023",2023,"Schalke 04","Bundesliga","Kenan Karaman","TUR","FW","28",1994,10.8,11,8,3,5,3,3,12,25,9,9,1,8,3,14,9,0,"https://fbref.com/en/players/8f0f2230/Kenan-Karaman"
"13455","Timothée Kolodziejczak_2023",2023,"Schalke 04","Bundesliga","Timothée Kolodziejczak","FRA","DF","30",1991,0.3,0,0,0,0,0,0,1,0,1,0,0,0,1,1,1,0,"https://fbref.com/en/players/ab096c6f/Timothee-Kolodziejczak"
"13456","Soichiro Kozuki_2023",2023,"Schalke 04","Bundesliga","Soichiro Kozuki","JPN","FW,MF","21",2000,4.2,6,4,3,3,0,4,6,66.7,2,5,0,5,3,9,3,0,"https://fbref.com/en/players/f1e855eb/Soichiro-Kozuki"
"13457","Alex Král_2023",2023,"Schalke 04","Bundesliga","Alex Král","CZE","MF","24",1998,26.2,34,24,10,22,2,17,37,45.9,20,31,6,25,17,51,53,0,"https://fbref.com/en/players/e717705a/Alex-Kral"
"13458","Tom Krauß_2023",2023,"Schalke 04","Bundesliga","Tom Krauß","GER","MF","21",2001,27.9,112,68,39,62,11,51,100,51,49,39,6,33,36,148,35,0,"https://fbref.com/en/players/9f77012e/Tom-Krauss"
"13459","Jordan Larsson_2023",2023,"Schalke 04","Bundesliga","Jordan Larsson","SWE","FW,MF","25",1997,5.1,8,5,1,7,0,2,9,22.2,7,9,0,9,4,12,3,0,"https://fbref.com/en/players/72984eee/Jordan-Larsson"
"13460","Danny Latza_2023",2023,"Schalke 04","Bundesliga","Danny Latza","GER","MF","32",1989,9.5,17,13,8,8,1,5,17,29.4,12,16,1,15,5,22,15,0,"https://fbref.com/en/players/33b554b7/Danny-Latza"
"13461","Henning Matriciani_2023",2023,"Schalke 04","Bundesliga","Henning Matriciani","GER","DF","22",2000,20.7,43,23,28,12,3,26,60,43.3,34,28,11,17,23,66,57,1,"https://fbref.com/en/players/ab3f1bdf/Henning-Matriciani"
"13462","Keke Maximilian Topp_2023",2023,"Schalke 04","Bundesliga","Keke Maximilian Topp","GER","FW","18",2004,0.2,0,0,0,0,0,0,0,NA,0,0,0,0,1,1,0,0,"https://fbref.com/en/players/ebb32f3a/Keke-Maximilian-Topp"
"13463","Tobias Mohr_2023",2023,"Schalke 04","Bundesliga","Tobias Mohr","GER","DF,MF","26",1995,9.3,8,5,3,5,0,2,7,28.6,5,14,5,9,8,16,19,0,"https://fbref.com/en/players/9ec9c8b6/Tobias-Mohr"
"13464","Florent Mollet_2023",2023,"Schalke 04","Bundesliga","Florent Mollet","FRA","MF","30",1991,4.6,4,1,0,4,0,2,7,28.6,5,7,1,6,1,5,1,0,"https://fbref.com/en/players/7e82a78f/Florent-Mollet"
"13465","Thomas Ouwejan_2023",2023,"Schalke 04","Bundesliga","Thomas Ouwejan","NED","DF","25",1996,10,20,8,13,5,2,6,10,60,4,17,4,13,13,33,27,0,"https://fbref.com/en/players/36d9dabe/Thomas-Ouwejan"
"13466","Sebastian Polter_2023",2023,"Schalke 04","Bundesliga","Sebastian Polter","GER","FW","31",1991,7,4,3,0,4,0,1,4,25,3,4,0,4,1,5,6,0,"https://fbref.com/en/players/3745e8bd/Sebastian-Polter"
"13467","Sidi Sané_2023",2023,"Schalke 04","Bundesliga","Sidi Sané","GER","FW","19",2003,0.3,1,1,1,0,0,1,1,100,0,0,0,0,0,1,0,0,"https://fbref.com/en/players/6a52a6c6/Sidi-Sane"
"13468","Alexander Schwolow_2023",2023,"Schalke 04","Bundesliga","Alexander Schwolow","GER","GK","30",1992,22.6,0,0,0,0,0,0,2,0,2,0,0,0,1,1,6,3,"https://fbref.com/en/players/0d55d942/Alexander-Schwolow"
"13469","Tim Skarke_2023",2023,"Schalke 04","Bundesliga","Tim Skarke","GER","FW,MF","25",1996,4.9,13,7,3,8,2,8,11,72.7,3,5,0,5,0,13,4,0,"https://fbref.com/en/players/65857fdf/Tim-Skarke"
"13470","Simon Terodde_2023",2023,"Schalke 04","Bundesliga","Simon Terodde","GER","FW","34",1988,20.3,15,8,4,7,4,3,14,21.4,11,6,2,4,6,21,9,0,"https://fbref.com/en/players/863ff1ee/Simon-Terodde"
"13471","Malick Thiaw_2023",2023,"Schalke 04","Bundesliga","Malick Thiaw","GER","DF","20",2001,3,3,1,2,1,0,1,2,50,1,4,3,1,9,12,24,1,"https://fbref.com/en/players/ff5ea0bf/Malick-Thiaw"
"13472","Jere Uronen_2023",2023,"Schalke 04","Bundesliga","Jere Uronen","FIN","DF","28",1994,7.5,14,10,6,6,2,6,10,60,4,5,2,3,8,22,13,0,"https://fbref.com/en/players/d75f3980/Jere-Uronen"
"13473","Maya Yoshida_2023",2023,"Schalke 04","Bundesliga","Maya Yoshida","JPN","DF","33",1988,28.4,34,22,19,13,2,18,29,62.1,11,40,29,11,46,80,132,2,"https://fbref.com/en/players/caffaf5a/Maya-Yoshida"
"13474","Rodrigo Zalazar_2023",2023,"Schalke 04","Bundesliga","Rodrigo Zalazar","URU","MF,FW","22",1999,14.7,16,8,5,9,2,9,24,37.5,15,16,1,15,7,23,13,0,"https://fbref.com/en/players/fc3697dd/Rodrigo-Zalazar"
"13475","Marcos Acuña_2023",2023,"Sevilla","La Liga","Marcos Acuña","ARG","DF","30",1991,21.2,57,36,34,17,6,30,42,71.4,12,16,5,11,23,80,36,0,"https://fbref.com/en/players/81442ecb/Marcos-Acuna"
"13476","Carlos Álvarez_2023",2023,"Sevilla","La Liga","Carlos Álvarez","ESP","FW","18",2003,0.1,NA,1,NA,NA,NA,NA,NA,NA,NA,NA,NA,NA,0,NA,NA,NA,"https://fbref.com/en/players/629081bd/Carlos-Alvarez"
"13477","Loïc Bade_2023",2023,"Sevilla","La Liga","Loïc Bade","FRA","DF","22",2000,16.1,27,20,23,3,1,17,30,56.7,13,21,13,8,23,50,77,0,"https://fbref.com/en/players/114bbdee/Loic-Bade"
"13478","Yassine Bounou_2023",2023,"Sevilla","La Liga","Yassine Bounou","MAR","GK","31",1991,23.9,2,1,2,0,0,1,4,25,3,0,0,0,2,4,11,1,"https://fbref.com/en/players/f6798fc3/Yassine-Bounou"
"13479","Carmona_2023",2023,"Sevilla","La Liga","Carmona","ESP","DF","20",2002,5.9,13,11,5,3,5,9,16,56.3,7,10,6,4,7,20,17,1,"https://fbref.com/en/players/2dce876a/Carmona"
"13480","Jesús Corona_2023",2023,"Sevilla","La Liga","Jesús Corona","MEX","FW","29",1993,1.2,1,0,1,0,0,0,1,0,1,0,0,0,1,2,1,0,"https://fbref.com/en/players/fb938d24/Jesus-Corona"
"13481","Thomas Delaney_2023",2023,"Sevilla","La Liga","Thomas Delaney","DEN","MF","30",1991,3.4,4,2,0,4,0,3,5,60,2,3,2,1,4,8,3,0,"https://fbref.com/en/players/fe641c1a/Thomas-Delaney"
"13482","Marko Dmitrović_2023",2023,"Sevilla","La Liga","Marko Dmitrović","SRB","GK","30",1992,14.1,0,0,0,0,0,0,0,NA,0,0,0,0,0,0,6,0,"https://fbref.com/en/players/ac295d9e/Marko-Dmitrovic"
"13483","Kasper Dolberg_2023",2023,"Sevilla","La Liga","Kasper Dolberg","DEN","FW","24",1997,2.2,1,0,0,1,0,1,3,33.3,2,0,0,0,0,1,5,0,"https://fbref.com/en/players/cc83b74d/Kasper-Dolberg"
"13484","Youssef En-Nesyri_2023",2023,"Sevilla","La Liga","Youssef En-Nesyri","MAR","FW","25",1997,18.5,16,8,3,7,6,4,14,28.6,10,6,2,4,4,20,16,0,"https://fbref.com/en/players/04e17fd5/Youssef-En-Nesyri"
"13485","Fernando_2023",2023,"Sevilla","La Liga","Fernando","BRA","MF,DF","35",1987,17.5,34,23,14,17,3,18,30,60,12,21,10,11,24,58,29,0,"https://fbref.com/en/players/41f32541/Fernando"
"13486","Bryan Gil_2023",2023,"Sevilla","La Liga","Bryan Gil","ESP","FW,DF","21",2001,10.2,22,11,11,7,4,10,23,43.5,13,10,0,10,8,30,10,0,"https://fbref.com/en/players/7b5ab7f2/Bryan-Gil"
"13487","Papu Gómez_2023",2023,"Sevilla","La Liga","Papu Gómez","ARG","FW,MF","34",1988,11.8,6,4,3,3,0,2,10,20,8,8,1,7,4,10,5,0,"https://fbref.com/en/players/6e4df551/Papu-Gomez"
"13488","Nemanja Gudelj_2023",2023,"Sevilla","La Liga","Nemanja Gudelj","SRB","DF,MF","30",1991,30.9,43,33,22,18,3,20,33,60.6,13,39,29,10,34,77,102,1,"https://fbref.com/en/players/0076ab7f/Nemanja-Gudelj"
"13489","Pape Gueye_2023",2023,"Sevilla","La Liga","Pape Gueye","SEN","MF","23",1999,13,37,22,13,21,3,16,33,48.5,17,21,5,16,22,59,10,0,"https://fbref.com/en/players/7155e3e1/Pape-Gueye"
"13490","Isco_2023",2023,"Sevilla","La Liga","Isco","ESP","MF,FW","30",1992,8.9,15,9,6,5,4,8,14,57.1,6,3,0,3,10,25,3,0,"https://fbref.com/en/players/a0b4bb3e/Isco"
"13491","Diego Iturralde_2023",2023,"Sevilla","La Liga","Diego Iturralde","ESP","DF","19",2003,0.5,1,0,1,0,0,0,2,0,2,0,0,0,0,1,1,0,"https://fbref.com/en/players/9d33c71a/Diego-Iturralde"
"13492","Adnan Januzaj_2023",2023,"Sevilla","La Liga","Adnan Januzaj","BEL","FW","27",1995,0.5,0,0,0,0,0,0,1,0,1,0,0,0,1,1,0,0,"https://fbref.com/en/players/4737cebe/Adnan-Januzaj"
"13493","Joan Jordán_2023",2023,"Sevilla","La Liga","Joan Jordán","ESP","MF","28",1994,17.7,32,17,13,17,2,16,38,42.1,22,14,7,7,16,48,14,2,"https://fbref.com/en/players/2a0c8ba4/Joan-Jordan"
"13494","Érik Lamela_2023",2023,"Sevilla","La Liga","Érik Lamela","ARG","FW,MF","30",1992,20.5,46,27,14,16,16,12,34,35.3,22,26,2,24,7,53,3,0,"https://fbref.com/en/players/abe66106/Erik-Lamela"
"13495","Marcão_2023",2023,"Sevilla","La Liga","Marcão","BRA","DF","26",1996,4.2,2,2,1,1,0,1,1,100,0,3,3,0,6,8,14,0,"https://fbref.com/en/players/133faa84/Marcao"
"13496","Rafa Mir_2023",2023,"Sevilla","La Liga","Rafa Mir","ESP","FW","25",1997,14.4,8,2,2,4,2,2,5,40,3,5,1,4,4,12,11,0,"https://fbref.com/en/players/bbf5c11b/Rafa-Mir"
"13497","Gonzalo Montiel_2023",2023,"Sevilla","La Liga","Gonzalo Montiel","ARG","DF","25",1997,16.9,26,15,12,14,0,15,29,51.7,14,25,7,18,19,45,38,0,"https://fbref.com/en/players/374d5158/Gonzalo-Montiel"
"13498","Jesús Navas_2023",2023,"Sevilla","La Liga","Jesús Navas","ESP","DF,FW","36",1985,22,19,12,8,3,8,11,22,50,11,18,7,11,22,41,52,1,"https://fbref.com/en/players/3f10bd22/Jesus-Navas"
"13499","Tanguy Nianzou_2023",2023,"Sevilla","La Liga","Tanguy Nianzou","FRA","DF","20",2002,15.2,20,15,10,9,1,8,11,72.7,3,8,5,3,16,36,44,3,"https://fbref.com/en/players/5853ac44/Tanguy-Nianzou"
"13500","Lucas Ocampos_2023",2023,"Sevilla","La Liga","Lucas Ocampos","ARG","FW,MF","28",1994,12.9,22,14,9,9,4,8,31,25.8,23,17,2,15,8,30,5,0,"https://fbref.com/en/players/a08b974a/Lucas-Ocampos"
"13501","Pedro Ortiz_2023",2023,"Sevilla","La Liga","Pedro Ortiz","ESP","MF","21",2000,0,0,0,0,0,0,0,0,NA,0,0,0,0,0,0,0,0,"https://fbref.com/en/players/f9358b61/Pedro-Ortiz"
"13502","Ivan Rakitić_2023",2023,"Sevilla","La Liga","Ivan Rakitić","CRO","MF","34",1988,19.9,37,26,10,18,9,19,40,47.5,21,21,1,20,27,64,20,0,"https://fbref.com/en/players/89f951b5/Ivan-Rakitic"
"13503","Karim Rekik_2023",2023,"Sevilla","La Liga","Karim Rekik","NED","DF","27",1994,13.1,11,5,8,3,0,4,5,80,1,12,5,7,10,21,24,0,"https://fbref.com/en/players/3376a776/Karim-Rekik"
"13504","Iván Romero_2023",2023,"Sevilla","La Liga","Iván Romero","ESP","MF","21",2001,0.1,0,0,0,0,0,0,0,NA,0,0,0,0,0,0,0,0,"https://fbref.com/en/players/2fbe6af0/Ivan-Romero"
"13505","Manuel Sebastián_2023",2023,"Sevilla","La Liga","Manuel Sebastián","ESP","MF","18",2004,1.7,7,4,3,3,1,5,8,62.5,3,0,0,0,0,7,2,0,"https://fbref.com/en/players/c5642098/Manuel-Sebastian"
"13506","Suso_2023",2023,"Sevilla","La Liga","Suso","ESP","MF,FW","28",1993,11.8,16,10,5,7,4,10,22,45.5,12,7,1,6,2,18,3,0,"https://fbref.com/en/players/4e219ad2/Suso"
"13507","Alex Telles_2023",2023,"Sevilla","La Liga","Alex Telles","BRA","DF","29",1992,15.9,21,13,15,6,0,13,25,52,12,17,5,12,20,41,38,0,"https://fbref.com/en/players/e73c9bb2/Alex-Telles"
"13508","Óliver Torres_2023",2023,"Sevilla","La Liga","Óliver Torres","ESP","MF,FW","27",1994,23.7,39,23,12,13,14,18,59,30.5,41,26,5,21,10,49,10,0,"https://fbref.com/en/players/58a9a4d9/Oliver-Torres"
"13509","Enrique Valiente_2023",2023,"Sevilla","La Liga","Enrique Valiente","ESP","DF","20",2002,4.1,1,1,1,0,0,0,0,NA,0,4,3,1,5,6,23,0,"https://fbref.com/en/players/0a69de7b/Enrique-Valiente"
"13510","Che Adams_2023",2023,"Southampton","Premier League","Che Adams","SCO","FW","26",1996,22.1,17,13,7,8,2,7,12,58.3,5,13,4,9,4,21,22,0,"https://fbref.com/en/players/f2bf1b0f/Che-Adams"
"13511","Carlos Alcaraz_2023",2023,"Southampton","Premier League","Carlos Alcaraz","ARG","MF,FW","19",2002,11.4,10,5,2,7,1,6,22,27.3,16,14,5,9,1,11,11,0,"https://fbref.com/en/players/4abac767/Carlos-Alcaraz"
"13512","Samuel Amo-Ameyaw_2023",2023,"Southampton","Premier League","Samuel Amo-Ameyaw","ENG","MF","16",2006,0,0,0,0,0,0,0,1,0,1,0,0,0,0,0,0,0,"https://fbref.com/en/players/9eedf0e0/Samuel-Amo-Ameyaw"
"13513","Joe Aribo_2023",2023,"Southampton","Premier League","Joe Aribo","NGA","MF,FW","26",1996,13.6,31,20,15,12,4,11,20,55,9,14,1,13,10,41,11,0,"https://fbref.com/en/players/328f7d51/Joe-Aribo"
"13514","Adam Armstrong_2023",2023,"Southampton","Premier League","Adam Armstrong","ENG","FW,MF","25",1997,14.8,14,9,6,5,3,3,10,30,7,15,3,12,5,19,6,0,"https://fbref.com/en/players/68c720b5/Adam-Armstrong"
"13515","Stuart Armstrong_2023",2023,"Southampton","Premier League","Stuart Armstrong","SCO","MF,FW","30",1992,15.6,32,21,15,13,4,14,39,35.9,25,18,0,18,10,42,9,1,"https://fbref.com/en/players/97333cf5/Stuart-Armstrong"
"13516","Dominic Ballard_2023",2023,"Southampton","Premier League","Dominic Ballard","ENG","FW,MF","17",2005,0.3,0,0,0,0,0,0,0,NA,0,0,0,0,1,1,0,0,"https://fbref.com/en/players/ed8d597c/Dominic-Ballard"
"13517","Gavin Bazunu_2023",2023,"Southampton","Premier League","Gavin Bazunu","IRL","GK","20",2002,32,1,0,1,0,0,1,1,100,0,0,0,0,1,2,24,2,"https://fbref.com/en/players/c91441dc/Gavin-Bazunu"
"13518","Jan Bednarek_2023",2023,"Southampton","Premier League","Jan Bednarek","POL","DF","26",1996,18.6,27,21,20,7,0,12,16,75,4,38,27,11,49,76,87,0,"https://fbref.com/en/players/4115ce4e/Jan-Bednarek"
"13519","Armel Bella Kotchap_2023",2023,"Southampton","Premier League","Armel Bella Kotchap","GER","DF","20",2001,20.9,37,17,28,9,0,15,20,75,5,29,12,17,44,81,110,0,"https://fbref.com/en/players/a39d11bc/Armel-Bella-Kotchap"
"13520","James Bree_2023",2023,"Southampton","Premier League","James Bree","ENG","DF","24",1997,4.1,5,3,4,1,0,3,4,75,1,3,1,2,6,11,11,0,"https://fbref.com/en/players/c07b7c5c/James-Bree"
"13521","Duje Ćaleta-Car_2023",2023,"Southampton","Premier League","Duje Ćaleta-Car","CRO","DF","25",1996,10.5,14,10,9,4,1,6,9,66.7,3,15,11,4,15,29,65,1,"https://fbref.com/en/players/94f8d10c/Duje-Caleta-Car"
"13522","Ibrahima Diallo_2023",2023,"Southampton","Premier League","Ibrahima Diallo","FRA","MF","23",1999,9.1,25,15,14,10,1,8,14,57.1,6,11,1,10,6,31,11,0,"https://fbref.com/en/players/11ff3d56/Ibrahima-Diallo"
"13523","Moussa Djenepo_2023",2023,"Southampton","Premier League","Moussa Djenepo","MLI","DF,FW","24",1998,7.9,19,11,13,5,1,11,26,42.3,15,19,2,17,11,30,7,0,"https://fbref.com/en/players/254147d4/Moussa-Djenepo"
"13524","Kami Doyle_2023",2023,"Southampton","Premier League","Kami Doyle","ENG","MF","16",2005,0.1,0,0,0,0,0,0,0,NA,0,0,0,0,0,0,0,0,"https://fbref.com/en/players/65983e4d/Kami-Doyle"
"13525","Samuel Edozie_2023",2023,"Southampton","Premier League","Samuel Edozie","ENG","FW,MF","19",2003,6.3,17,10,6,10,1,3,8,37.5,5,7,0,7,6,23,6,0,"https://fbref.com/en/players/007414dd/Samuel-Edozie"
"13526","Mohamed Elyounoussi_2023",2023,"Southampton","Premier League","Mohamed Elyounoussi","NOR","MF,FW","27",1994,24.1,46,28,22,20,4,19,43,44.2,24,40,3,37,27,73,37,0,"https://fbref.com/en/players/68dc0dac/Mohamed-Elyounoussi"
"13527","Juan Larios_2023",2023,"Southampton","Premier League","Juan Larios","ESP","DF","18",2004,1.7,7,6,6,1,0,5,5,100,0,2,0,2,3,10,4,0,"https://fbref.com/en/players/cf7fb13a/Juan-Larios"
"13528","Roméo Lavia_2023",2023,"Southampton","Premier League","Roméo Lavia","BEL","MF","18",2004,24.7,60,35,27,29,4,21,53,39.6,32,47,11,36,33,93,23,1,"https://fbref.com/en/players/ecad9aa5/Romeo-Lavia"
"13529","Valentino Livramento_2023",2023,"Southampton","Premier League","Valentino Livramento","ENG","DF,FW","19",2002,0.3,2,1,2,0,0,0,0,NA,0,0,0,0,2,4,3,0,"https://fbref.com/en/players/afed6722/Valentino-Livramento"
"13530","Lyanco_2023",2023,"Southampton","Premier League","Lyanco","BRA","DF","25",1997,13.1,24,16,15,9,0,12,18,66.7,6,30,25,5,20,44,65,2,"https://fbref.com/en/players/b5bf1770/Lyanco"
"13531","Ainsley Maitland-Niles_2023",2023,"Southampton","Premier League","Ainsley Maitland-Niles","ENG","DF,MF","24",1997,15.6,45,24,23,18,4,28,44,63.6,16,28,7,21,22,67,45,1,"https://fbref.com/en/players/e3a5814e/Ainsley-Maitland-Niles"
"13532","Sekou Mara_2023",2023,"Southampton","Premier League","Sekou Mara","FRA","FW,MF","20",2002,6.2,14,10,5,8,1,3,9,33.3,6,11,0,11,1,15,5,0,"https://fbref.com/en/players/3544641e/Sekou-Mara"
"13533","Alex McCarthy_2023",2023,"Southampton","Premier League","Alex McCarthy","ENG","GK","32",1989,6,0,0,0,0,0,0,1,0,1,0,0,0,1,1,3,1,"https://fbref.com/en/players/36c2ca73/Alex-McCarthy"
"13534","Paul Onuachu_2023",2023,"Southampton","Premier League","Paul Onuachu","NGA","FW","28",1994,4.5,3,2,1,1,1,1,3,33.3,2,4,1,3,0,3,4,0,"https://fbref.com/en/players/c06d1086/Paul-Onuachu"
"13535","Mislav Oršić_2023",2023,"Southampton","Premier League","Mislav Oršić","CRO","MF","29",1992,0.1,1,1,1,0,0,0,0,NA,0,0,0,0,0,1,0,0,"https://fbref.com/en/players/ee950928/Mislav-Orsic"
"13536","Romain Perraud_2023",2023,"Southampton","Premier League","Romain Perraud","FRA","DF","24",1997,20.4,54,33,23,23,8,28,52,53.8,24,24,6,18,20,74,42,0,"https://fbref.com/en/players/6dfd8f05/Romain-Perraud"
"13537","Nathan Redmond_2023",2023,"Southampton","Premier League","Nathan Redmond","ENG","DF","28",1994,0,0,0,0,0,0,0,0,NA,0,0,0,0,0,0,0,0,"https://fbref.com/en/players/ab651565/Nathan-Redmond"
"13538","Oriol Romeu_2023",2023,"Southampton","Premier League","Oriol Romeu","ESP","MF","30",1991,0.8,1,0,0,1,0,0,0,NA,0,1,0,1,1,2,1,0,"https://fbref.com/en/players/4b511457/Oriol-Romeu"
"13539","Mohammed Salisu_2023",2023,"Southampton","Premier League","Mohammed Salisu","GHA","DF","23",1999,21.9,51,29,33,16,2,24,34,70.6,10,56,25,31,31,82,122,1,"https://fbref.com/en/players/0b33f6ad/Mohammed-Salisu"
"13540","Jack Stephens_2023",2023,"Southampton","Premier League","Jack Stephens","ENG","DF","28",1994,0.5,2,2,2,0,0,1,1,100,0,1,1,0,1,3,2,0,"https://fbref.com/en/players/6adbc307/Jack-Stephens"
"13541","Kamaldeen Sulemana_2023",2023,"Southampton","Premier League","Kamaldeen Sulemana","GHA","FW,MF","20",2002,10.7,15,9,4,7,4,4,14,28.6,10,16,0,16,6,21,6,0,"https://fbref.com/en/players/a62f8bf1/Kamaldeen-Sulemana"
"13542","Yan Valery_2023",2023,"Southampton","Premier League","Yan Valery","TUN","DF","23",1999,0.5,0,0,0,0,0,0,0,NA,0,1,0,1,0,0,3,0,"https://fbref.com/en/players/531a4aa8/Yan-Valery"
"13543","Theo Walcott_2023",2023,"Southampton","Premier League","Theo Walcott","ENG","FW,MF","33",1989,12.5,13,6,8,4,1,8,27,29.6,19,8,1,7,9,22,7,0,"https://fbref.com/en/players/1ecb65be/Theo-Walcott"
"13544","Kyle Walker-Peters_2023",2023,"Southampton","Premier League","Kyle Walker-Peters","ENG","DF","25",1997,29.4,61,32,34,24,3,22,42,52.4,20,47,8,39,27,88,52,0,"https://fbref.com/en/players/984a5a64/Kyle-Walker-Peters"
"13545","James Ward-Prowse_2023",2023,"Southampton","Premier League","James Ward-Prowse","ENG","MF","27",1994,37.5,65,37,31,27,7,21,61,34.4,40,30,10,20,55,120,48,0,"https://fbref.com/en/players/3515d404/James-Ward-Prowse"
"13546","Kevin Agudelo_2023",2023,"Spezia","Serie A","Kevin Agudelo","COL","MF,FW","23",1998,23.7,71,38,22,30,19,25,59,42.4,34,39,5,34,10,81,6,0,"https://fbref.com/en/players/46fa7204/Kevin-Agudelo"
"13547","Kelvin Amian_2023",2023,"Spezia","Serie A","Kelvin Amian","FRA","DF","24",1998,26.4,54,32,33,12,9,24,31,77.4,7,34,12,22,22,76,87,1,"https://fbref.com/en/players/bcc81786/Kelvin-Amian"
"13548","Ethan Ampadu_2023",2023,"Spezia","Serie A","Ethan Ampadu","WAL","DF,MF","21",2000,29.3,66,37,33,28,5,17,41,41.5,24,48,23,25,36,102,98,0,"https://fbref.com/en/players/10b9fa99/Ethan-Ampadu"
"13549","Simone Bastoni_2023",2023,"Spezia","Serie A","Simone Bastoni","ITA","MF,DF","25",1996,13.2,47,24,23,19,5,15,33,45.5,18,20,5,15,8,55,14,0,"https://fbref.com/en/players/1ac232b8/Simone-Bastoni"
"13550","Julius Beck_2023",2023,"Spezia","Serie A","Julius Beck","DEN","MF","17",2005,0.1,2,1,1,1,0,0,0,NA,0,0,0,0,0,2,0,0,"https://fbref.com/en/players/e892c325/Julius-Beck"
"13551","Mehdi Bourabia_2023",2023,"Spezia","Serie A","Mehdi Bourabia","MAR","MF","30",1991,30.8,41,20,13,22,6,19,41,46.3,22,39,12,27,32,73,57,0,"https://fbref.com/en/players/0d077b88/Mehdi-Bourabia"
"13552","Mattia Caldara_2023",2023,"Spezia","Serie A","Mattia Caldara","ITA","DF","28",1994,13.9,23,14,10,11,2,9,20,45,11,23,16,7,17,40,88,2,"https://fbref.com/en/players/ac7e640b/Mattia-Caldara"
"13553","Tio Cipot_2023",2023,"Spezia","Serie A","Tio Cipot","SVN","FW,MF","19",2003,1.5,12,7,6,3,3,6,8,75,2,0,0,0,0,12,2,0,"https://fbref.com/en/players/039a4fb6/Tio-Cipot"
"13554","Bartłomiej Drągowski_2023",2023,"Spezia","Serie A","Bartłomiej Drągowski","POL","GK","24",1997,32.7,1,0,1,0,0,1,5,20,4,0,0,0,1,2,15,3,"https://fbref.com/en/players/085e71a7/Bartlomiej-Dragowski"
"13555","Albin Ekdal_2023",2023,"Spezia","Serie A","Albin Ekdal","SWE","MF","33",1989,19.3,37,20,14,20,3,19,45,42.2,26,24,2,22,26,63,36,0,"https://fbref.com/en/players/f503ea63/Albin-Ekdal"
"13556","Mikael Ellertsson_2023",2023,"Spezia","Serie A","Mikael Ellertsson","ISL","MF,DF","20",2002,1.9,4,2,1,3,0,0,3,0,3,2,1,1,2,6,0,0,"https://fbref.com/en/players/c55967eb/Mikael-Ellertsson"
"13557","Salvatore Esposito_2023",2023,"Spezia","Serie A","Salvatore Esposito","ITA","MF","21",2000,10.8,15,12,8,5,2,5,21,23.8,16,9,1,8,11,26,18,0,"https://fbref.com/en/players/5cf5c9ad/Salvatore-Esposito"
"13558","Salvador Ferrer_2023",2023,"Spezia","Serie A","Salvador Ferrer","ESP","DF","24",1998,1.5,4,2,2,2,0,1,3,33.3,2,3,1,2,1,5,4,0,"https://fbref.com/en/players/eb76987d/Salvador-Ferrer"
"13559","Emmanuel Gyasi_2023",2023,"Spezia","Serie A","Emmanuel Gyasi","GHA","FW,DF","28",1994,31.2,24,15,11,10,3,9,36,25,27,24,6,18,8,32,26,0,"https://fbref.com/en/players/f9758dae/Emmanuel-Gyasi"
"13560","Emil Holm_2023",2023,"Spezia","Serie A","Emil Holm","SWE","DF","22",2000,15.5,26,15,13,8,5,16,31,51.6,15,21,6,15,9,35,41,0,"https://fbref.com/en/players/c2357b65/Emil-Holm"
"13561","Petko Hristov_2023",2023,"Spezia","Serie A","Petko Hristov","BUL","DF","23",1999,4.1,6,4,2,4,0,5,8,62.5,3,4,2,2,4,10,12,0,"https://fbref.com/en/players/d8800a46/Petko-Hristov"
"13562","Jakub Kiwior_2023",2023,"Spezia","Serie A","Jakub Kiwior","POL","DF","22",2000,16,22,17,15,7,0,6,24,25,18,26,18,8,24,46,71,1,"https://fbref.com/en/players/dc3e663e/Jakub-Kiwior"
"13563","Viktor Kovalenko_2023",2023,"Spezia","Serie A","Viktor Kovalenko","UKR","MF","26",1996,6.1,9,5,1,6,2,5,8,62.5,3,11,2,9,4,13,7,0,"https://fbref.com/en/players/9d60028d/Viktor-Kovalenko"
"13564","Raimonds Krollis_2023",2023,"Spezia","Serie A","Raimonds Krollis","LVA","FW,DF","20",2001,0.4,1,1,0,0,1,0,1,0,1,0,0,0,0,1,0,0,"https://fbref.com/en/players/b4101c2e/Raimonds-Krollis"
"13565","Daniel Maldini_2023",2023,"Spezia","Serie A","Daniel Maldini","ITA","FW,MF","20",2001,7,12,5,3,4,5,4,11,36.4,7,9,0,9,1,13,8,0,"https://fbref.com/en/players/801831fe/Daniel-Maldini"
"13566","Federico Marchetti_2023",2023,"Spezia","Serie A","Federico Marchetti","ITA","GK","39",1983,0.7,0,0,0,0,0,0,0,NA,0,0,0,0,0,0,0,0,"https://fbref.com/en/players/f794b426/Federico-Marchetti"
"13567","João Moutinho_2023",2023,"Spezia","Serie A","João Moutinho","POR","DF,FW","24",1998,0.6,7,1,5,1,1,3,4,75,1,1,1,0,0,7,0,0,"https://fbref.com/en/players/a0aee24e/Joao-Moutinho"
"13568","Dimitris Nikolaou_2023",2023,"Spezia","Serie A","Dimitris Nikolaou","GRE","DF","23",1998,32.9,45,32,31,10,4,25,37,67.6,12,41,26,15,27,72,82,0,"https://fbref.com/en/players/cf961d8d/Dimitris-Nikolaou"
"13569","M'Bala Nzola_2023",2023,"Spezia","Serie A","M'Bala Nzola","ANG","FW","25",1996,29.5,12,5,0,6,6,3,9,33.3,6,20,6,14,7,19,21,0,"https://fbref.com/en/players/a4948e67/MBala-Nzola"
"13570","Arkadiusz Reca_2023",2023,"Spezia","Serie A","Arkadiusz Reca","POL","DF","27",1995,24.1,44,28,22,12,10,19,32,59.4,13,21,5,16,24,68,54,0,"https://fbref.com/en/players/6213fd82/Arkadiusz-Reca"
"13571","Jacopo Sala_2023",2023,"Spezia","Serie A","Jacopo Sala","ITA","MF","30",1991,1.2,1,0,1,0,0,0,2,0,2,2,0,2,1,2,2,0,"https://fbref.com/en/players/da5a981b/Jacopo-Sala"
"13572","Leandro Sanca_2023",2023,"Spezia","Serie A","Leandro Sanca","GNB","FW,MF","22",2000,0.4,1,1,0,0,1,1,1,100,0,0,0,0,0,1,0,0,"https://fbref.com/en/players/4295f19c/Leandro-Sanca"
"13573","Eldor Shomurodov_2023",2023,"Spezia","Serie A","Eldor Shomurodov","UZB","FW","27",1995,9,5,5,3,1,1,2,11,18.2,9,5,1,4,3,8,4,0,"https://fbref.com/en/players/57469b2d/Eldor-Shomurodov"
"13574","Dávid Strelec_2023",2023,"Spezia","Serie A","Dávid Strelec","SVK","FW","21",2001,1.9,2,2,0,1,1,2,2,100,0,0,0,0,0,2,0,0,"https://fbref.com/en/players/2cb9486d/David-Strelec"
"13575","Daniele Verde_2023",2023,"Spezia","Serie A","Daniele Verde","ITA","FW,MF","26",1996,11.1,4,4,3,0,1,3,7,42.9,4,6,0,6,8,12,4,0,"https://fbref.com/en/players/d3298c99/Daniele-Verde"
"13576","Przemysław Wiśniewski_2023",2023,"Spezia","Serie A","Przemysław Wiśniewski","POL","DF","24",1998,11.1,13,6,7,6,0,6,18,33.3,12,16,8,8,11,24,66,0,"https://fbref.com/en/players/1bfe5ac9/Przemyslaw-Wisniewski"
"13577","Jeroen Zoet_2023",2023,"Spezia","Serie A","Jeroen Zoet","NED","GK","31",1991,3.7,1,1,1,0,0,1,1,100,0,0,0,0,0,1,1,0,"https://fbref.com/en/players/cc1a0c57/Jeroen-Zoet"
"13578","Petar Zovko_2023",2023,"Spezia","Serie A","Petar Zovko","BIH","GK","20",2002,0.8,1,0,1,0,0,1,1,100,0,0,0,0,0,1,0,0,"https://fbref.com/en/players/54f6afe3/Petar-Zovko"
"13579","Szymon Żurkowski_2023",2023,"Spezia","Serie A","Szymon Żurkowski","POL","MF","24",1997,4.7,9,3,4,4,1,2,15,13.3,13,9,2,7,4,13,6,0,"https://fbref.com/en/players/4e1d5e59/Szymon-Zurkowski"
"13580","Jean-Eudes Aholou_2023",2023,"Strasbourg","Ligue 1","Jean-Eudes Aholou","CIV","MF","28",1994,14.4,34,20,10,20,4,12,31,38.7,19,25,0,25,24,58,15,0,"https://fbref.com/en/players/48b28bfd/Jean-Eudes-Aholou"
"13581","Ludovic Ajorque_2023",2023,"Strasbourg","Ligue 1","Ludovic Ajorque","FRA","FW","28",1994,8.6,5,4,1,4,0,3,9,33.3,6,3,1,2,2,7,7,0,"https://fbref.com/en/players/462475ed/Ludovic-Ajorque"
"13582","Jean-Ricner Bellegarde_2023",2023,"Strasbourg","Ligue 1","Jean-Ricner Bellegarde","FRA","MF,FW","24",1998,26.9,47,25,15,21,11,11,25,44,14,26,3,23,26,73,22,0,"https://fbref.com/en/players/10f0fdd3/Jean-Ricner-Bellegarde"
"13583","Franci Bouebari_2023",2023,"Strasbourg","Ligue 1","Franci Bouebari","FRA","DF","18",2003,0.8,3,0,1,2,0,3,5,60,2,0,0,0,2,5,2,0,"https://fbref.com/en/players/4fb18ca4/Franci-Bouebari"
"13584","Colin Dagba_2023",2023,"Strasbourg","Ligue 1","Colin Dagba","FRA","DF,MF","23",1998,10.6,32,20,17,10,5,19,26,73.1,7,18,2,16,17,49,19,0,"https://fbref.com/en/players/29c02c9f/Colin-Dagba"
"13585","Thomas Delaine_2023",2023,"Strasbourg","Ligue 1","Thomas Delaine","FRA","DF,MF","30",1992,11.9,28,14,16,6,6,13,26,50,13,8,3,5,16,44,9,0,"https://fbref.com/en/players/8332db56/Thomas-Delaine"
"13586","Habib Diallo_2023",2023,"Strasbourg","Ligue 1","Habib Diallo","SEN","FW","27",1995,32,18,10,8,7,3,6,16,37.5,10,19,4,15,12,30,26,0,"https://fbref.com/en/players/6605d143/Habib-Diallo"
"13587","Mouhamadou Diarra_2023",2023,"Strasbourg","Ligue 1","Mouhamadou Diarra","SEN","MF,FW","18",2004,18.1,24,16,10,11,3,15,29,51.7,14,17,1,16,11,35,13,0,"https://fbref.com/en/players/6d0fe035/Mouhamadou-Diarra"
"13588","Alexander Djiku_2023",2023,"Strasbourg","Ligue 1","Alexander Djiku","GHA","DF","27",1994,29.7,53,36,37,16,0,26,46,56.5,20,45,19,26,66,119,151,3,"https://fbref.com/en/players/43e7a164/Alexander-Djiku"
"13589","Ismaël Doukouré_2023",2023,"Strasbourg","Ligue 1","Ismaël Doukouré","FRA","DF,MF","19",2003,25.5,48,24,23,21,4,20,34,58.8,14,26,8,18,27,75,54,0,"https://fbref.com/en/players/0512a60a/Ismael-Doukoure"
"13590","Karol Fila_2023",2023,"Strasbourg","Ligue 1","Karol Fila","POL","DF","24",1998,0.5,0,0,0,0,0,0,0,NA,0,0,0,0,1,1,1,0,"https://fbref.com/en/players/50ac8941/Karol-Fila"
"13591","Kévin Gameiro_2023",2023,"Strasbourg","Ligue 1","Kévin Gameiro","FRA","FW","35",1987,23.3,20,10,6,10,4,8,28,28.6,20,10,1,9,9,29,0,0,"https://fbref.com/en/players/42276181/Kevin-Gameiro"
"13592","Frederic Guilbert_2023",2023,"Strasbourg","Ligue 1","Frederic Guilbert","FRA","DF","27",1994,16.2,47,29,18,23,6,25,43,58.1,18,24,3,21,43,90,33,1,"https://fbref.com/en/players/5d8d7454/Frederic-Guilbert"
"13593","Dany Jean_2023",2023,"Strasbourg","Ligue 1","Dany Jean","HAI","DF,MF","19",2002,0.1,0,0,0,0,0,0,1,0,1,1,0,1,0,0,0,0,"https://fbref.com/en/players/300ec91c/Dany-Jean"
"13594","Nordine Kandil_2023",2023,"Strasbourg","Ligue 1","Nordine Kandil","FRA","MF,FW","20",2001,1.1,3,2,1,2,0,0,3,0,3,2,0,2,1,4,1,0,"https://fbref.com/en/players/c5908bc4/Nordine-Kandil"
"13595","Maxime Le Marchand_2023",2023,"Strasbourg","Ligue 1","Maxime Le Marchand","FRA","DF","32",1989,22.4,39,24,23,14,2,19,31,61.3,12,22,14,8,37,76,74,0,"https://fbref.com/en/players/321a71a7/Maxime-Le-Marchand"
"13596","Dimitri Liénard_2023",2023,"Strasbourg","Ligue 1","Dimitri Liénard","FRA","DF,MF","34",1988,17.1,46,29,20,18,8,34,57,59.6,23,28,4,24,16,62,24,0,"https://fbref.com/en/players/f7691f63/Dimitri-Lienard"
"13597","Lebo Mothiba_2023",2023,"Strasbourg","Ligue 1","Lebo Mothiba","RSA","FW,MF","26",1996,4.8,1,0,1,0,0,0,1,0,1,6,1,5,0,1,4,0,"https://fbref.com/en/players/3eaf8817/Lebo-Mothiba"
"13598","Gerzino Nyamsi_2023",2023,"Strasbourg","Ligue 1","Gerzino Nyamsi","FRA","DF","25",1997,17.5,28,20,14,12,2,10,12,83.3,2,19,11,8,10,38,63,1,"https://fbref.com/en/players/6043997c/Gerzino-Nyamsi"
"13599","Lucas Perrin_2023",2023,"Strasbourg","Ligue 1","Lucas Perrin","FRA","DF","23",1998,19.6,44,27,28,14,2,25,49,51,24,13,5,8,36,80,53,0,"https://fbref.com/en/players/49070d66/Lucas-Perrin"
"13600","Ronaël Pierre-Gabriel_2023",2023,"Strasbourg","Ligue 1","Ronaël Pierre-Gabriel","FRA","DF","24",1998,7.3,25,18,11,12,2,15,17,88.2,2,16,3,13,9,34,22,0,"https://fbref.com/en/players/64ba07c0/Ronael-Pierre-Gabriel"
"13601","Sanjin Prcić_2023",2023,"Strasbourg","Ligue 1","Sanjin Prcić","BIH","MF","28",1993,18.1,27,12,6,16,5,19,31,61.3,12,22,7,15,25,52,22,0,"https://fbref.com/en/players/51c30111/Sanjin-Prcic"
"13602","Morgan Sanson_2023",2023,"Strasbourg","Ligue 1","Morgan Sanson","FRA","MF","27",1994,15.8,36,25,10,16,10,17,56,30.4,39,21,1,20,22,58,9,0,"https://fbref.com/en/players/6e7f1353/Morgan-Sanson"
"13603","Matz Sels_2023",2023,"Strasbourg","Ligue 1","Matz Sels","BEL","GK","30",1992,38,4,3,4,0,0,4,4,100,0,0,0,0,4,8,23,0,"https://fbref.com/en/players/834b5c4c/Matz-Sels"
"13604","Marvin Senaya_2023",2023,"Strasbourg","Ligue 1","Marvin Senaya","TOG","DF","21",2001,0.1,0,0,0,0,0,0,1,0,1,1,0,1,0,0,1,0,"https://fbref.com/en/players/1d383c10/Marvin-Senaya"
"13605","Ibrahima Sissoko_2023",2023,"Strasbourg","Ligue 1","Ibrahima Sissoko","FRA","MF","24",1997,14.6,40,22,18,17,5,22,42,52.4,20,20,6,14,10,50,19,0,"https://fbref.com/en/players/0f8418aa/Ibrahima-Sissoko"
"13606","Eduard Sobol_2023",2023,"Strasbourg","Ligue 1","Eduard Sobol","UKR","DF","27",1995,9.7,19,10,10,6,3,9,13,69.2,4,10,1,9,8,27,19,0,"https://fbref.com/en/players/2ccd89a3/Eduard-Sobol"
"13607","Yuito Suzuki_2023",2023,"Strasbourg","Ligue 1","Yuito Suzuki","JPN","FW,MF","20",2001,0.4,0,0,0,0,0,0,0,NA,0,3,0,3,0,0,0,0,"https://fbref.com/en/players/c25a7a2a/Yuito-Suzuki"
"13608","Adrien Thomasson_2023",2023,"Strasbourg","Ligue 1","Adrien Thomasson","FRA","MF","28",1993,10.4,19,9,8,6,5,9,30,30,21,18,0,18,3,22,2,0,"https://fbref.com/en/players/c76b7567/Adrien-Thomasson"
"13609","Naouirou Ahamada_2023",2023,"Stuttgart","Bundesliga","Naouirou Ahamada","FRA","MF","20",2002,15.5,17,11,7,7,3,8,20,40,12,16,5,11,8,25,7,0,"https://fbref.com/en/players/a6c58494/Naouirou-Ahamada"
"13610","Waldemar Anton_2023",2023,"Stuttgart","Bundesliga","Waldemar Anton","GER","DF","26",1996,32.6,49,27,27,19,3,27,51,52.9,24,44,16,28,38,87,123,2,"https://fbref.com/en/players/5e66fa06/Waldemar-Anton"
"13611","Gil Bastião Dias_2023",2023,"Stuttgart","Bundesliga","Gil Bastião Dias","POR","FW","25",1996,4.4,8,6,3,4,1,3,12,25,9,7,0,7,2,10,3,0,"https://fbref.com/en/players/e61bdd69/Gil-Bastiao-Dias"
"13612","Fabian Bredlow_2023",2023,"Stuttgart","Bundesliga","Fabian Bredlow","GER","GK","27",1995,15,1,1,1,0,0,1,1,100,0,0,0,0,0,1,4,2,"https://fbref.com/en/players/d28339cb/Fabian-Bredlow"
"13613","Darko Churlinov_2023",2023,"Stuttgart","Bundesliga","Darko Churlinov","MKD","FW","22",2000,0.3,3,2,2,1,0,2,3,66.7,1,1,0,1,0,3,0,0,"https://fbref.com/en/players/c6608135/Darko-Churlinov"
"13614","Tanguy Coulibaly_2023",2023,"Stuttgart","Bundesliga","Tanguy Coulibaly","FRA","FW,DF","21",2001,3.6,12,9,9,1,2,5,12,41.7,7,10,0,10,3,15,0,0,"https://fbref.com/en/players/05ba9d7c/Tanguy-Coulibaly"
"13615","Lilian Egloff_2023",2023,"Stuttgart","Bundesliga","Lilian Egloff","GER","MF,FW","19",2002,2.7,12,10,4,5,3,4,6,66.7,2,2,0,2,1,13,1,0,"https://fbref.com/en/players/2f7fec15/Lilian-Egloff"
"13616","Wataru Endo_2023",2023,"Stuttgart","Bundesliga","Wataru Endo","JPN","MF","29",1993,32.5,70,37,30,31,9,38,85,44.7,47,44,6,38,26,96,63,0,"https://fbref.com/en/players/c149016b/Wataru-Endo"
"13617","Chris Führich_2023",2023,"Stuttgart","Bundesliga","Chris Führich","GER","FW,MF","24",1998,20.9,36,14,15,14,7,24,44,54.5,20,29,2,27,7,43,13,0,"https://fbref.com/en/players/0cf778df/Chris-Fuhrich"
"13618","Sehrou Guirassy_2023",2023,"Stuttgart","Bundesliga","Sehrou Guirassy","GUI","FW","26",1996,18.3,4,1,2,2,0,1,2,50,1,7,2,5,0,4,14,0,"https://fbref.com/en/players/923f4dda/Sehrou-Guirassy"
"13619","Genki Haraguchi_2023",2023,"Stuttgart","Bundesliga","Genki Haraguchi","JPN","MF","31",1991,8.3,16,7,7,7,2,4,16,25,12,13,2,11,8,24,6,0,"https://fbref.com/en/players/f24ea523/Genki-Haraguchi"
"13620","Hiroki Ito_2023",2023,"Stuttgart","Bundesliga","Hiroki Ito","JPN","DF","23",1999,28.5,40,29,24,14,2,18,35,51.4,17,38,17,21,40,80,94,0,"https://fbref.com/en/players/204dded0/Hiroki-Ito"
"13621","Sasa Kalajdzic_2023",2023,"Stuttgart","Bundesliga","Sasa Kalajdzic","AUT","FW","25",1997,2.6,3,2,0,1,2,1,3,33.3,2,1,0,1,0,3,0,0,"https://fbref.com/en/players/15f24fe7/Sasa-Kalajdzic"
"13622","Atakan Karazor_2023",2023,"Stuttgart","Bundesliga","Atakan Karazor","GER","MF","25",1996,21.8,49,30,18,25,6,24,47,51.1,23,39,11,28,31,80,44,0,"https://fbref.com/en/players/5762be5c/Atakan-Karazor"
"13623","Thomas Kastanaras_2023",2023,"Stuttgart","Bundesliga","Thomas Kastanaras","GRE","FW,DF","19",2003,0.8,0,0,0,0,0,0,0,NA,0,1,0,1,0,0,0,0,"https://fbref.com/en/players/778ccc44/Thomas-Kastanaras"
"13624","Silas Katompa_2023",2023,"Stuttgart","Bundesliga","Silas Katompa","COD","FW,MF","23",1998,22.1,25,17,5,14,6,6,20,30,14,17,2,15,8,33,1,0,"https://fbref.com/en/players/de4cac2d/Silas-Katompa"
"13625","Alou Kuol_2023",2023,"Stuttgart","Bundesliga","Alou Kuol","AUS","FW","21",2000,0.1,0,0,0,0,0,0,0,NA,0,0,0,0,0,0,0,0,"https://fbref.com/en/players/f1bc3876/Alou-Kuol"
"13626","Konstantinos Mavropanos_2023",2023,"Stuttgart","Bundesliga","Konstantinos Mavropanos","GRE","DF","24",1997,25.4,50,27,32,15,3,28,38,73.7,10,39,18,21,63,113,99,0,"https://fbref.com/en/players/00963611/Konstantinos-Mavropanos"
"13627","Enzo Millot_2023",2023,"Stuttgart","Bundesliga","Enzo Millot","FRA","MF","20",2002,9.9,23,16,9,10,4,12,19,63.2,7,20,3,17,12,35,7,0,"https://fbref.com/en/players/f76022e7/Enzo-Millot"
"13628","Clinton Mola_2023",2023,"Stuttgart","Bundesliga","Clinton Mola","ENG","DF","21",2001,0.2,3,1,2,1,0,1,1,100,0,1,1,0,1,4,2,0,"https://fbref.com/en/players/29ddfb9c/Clinton-Mola"
"13629","Florian Müller_2023",2023,"Stuttgart","Bundesliga","Florian Müller","GER","GK","24",1997,19,0,0,0,0,0,0,0,NA,0,0,0,0,0,0,7,4,"https://fbref.com/en/players/cbac6ec9/Florian-Muller"
"13630","Nikolas Nartey_2023",2023,"Stuttgart","Bundesliga","Nikolas Nartey","DEN","DF,MF","22",2000,5.3,11,6,7,3,1,5,9,55.6,4,9,0,9,4,15,12,0,"https://fbref.com/en/players/30261ba1/Nikolas-Nartey"
"13631","Juan Perea_2023",2023,"Stuttgart","Bundesliga","Juan Perea","COL","FW","22",2000,4.6,5,4,0,2,3,2,4,50,2,2,1,1,1,6,3,0,"https://fbref.com/en/players/ff3d391c/Juan-Perea"
"13632","Luca Pfeiffer_2023",2023,"Stuttgart","Bundesliga","Luca Pfeiffer","GER","FW","25",1996,7.8,1,1,1,0,0,0,1,0,1,4,0,4,1,2,5,0,"https://fbref.com/en/players/83e1f40e/Luca-Pfeiffer"
"13633","Borna Sosa_2023",2023,"Stuttgart","Bundesliga","Borna Sosa","CRO","DF","24",1998,21.7,27,21,18,8,1,21,32,65.6,11,20,5,15,19,46,37,0,"https://fbref.com/en/players/af0d79a9/Borna-Sosa"
"13634","Pascal Stenzel_2023",2023,"Stuttgart","Bundesliga","Pascal Stenzel","GER","DF","26",1996,3.7,12,8,8,4,0,5,9,55.6,4,9,2,7,5,17,6,0,"https://fbref.com/en/players/99f7e9aa/Pascal-Stenzel"
"13635","Tiago Tomás_2023",2023,"Stuttgart","Bundesliga","Tiago Tomás","POR","FW,MF","20",2002,14.3,10,4,2,4,4,8,13,61.5,5,9,2,7,1,11,5,0,"https://fbref.com/en/players/b492126a/Tiago-Tomas"
"13636","Lauren Ulrich_2023",2023,"Stuttgart","Bundesliga","Lauren Ulrich","GER","MF","17",2005,0.1,1,1,0,0,1,0,0,NA,0,0,0,0,0,1,0,0,"https://fbref.com/en/players/cd61c7af/Lauren-Ulrich"
"13637","Josha Vagnoman_2023",2023,"Stuttgart","Bundesliga","Josha Vagnoman","GER","DF","21",2000,16.4,26,15,12,11,3,15,27,55.6,12,20,2,18,8,34,29,1,"https://fbref.com/en/players/fb377d11/Josha-Vagnoman"
"13638","Dan-Axel Zagadou_2023",2023,"Stuttgart","Bundesliga","Dan-Axel Zagadou","FRA","DF","23",1999,14.1,14,9,10,4,0,5,14,35.7,9,19,16,3,21,35,81,1,"https://fbref.com/en/players/a4effc55/Dan-Axel-Zagadou"
"13639","Ola Aina_2023",2023,"Torino","Serie A","Ola Aina","NGA","DF","25",1996,9.7,17,13,5,8,4,9,15,60,6,12,2,10,11,28,26,0,"https://fbref.com/en/players/246d153b/Ola-Aina"
"13640","Brian Bayeye_2023",2023,"Torino","Serie A","Brian Bayeye","FRA","DF","22",2000,0.7,3,0,3,0,0,1,1,100,0,1,1,0,1,4,2,0,"https://fbref.com/en/players/78e6bf2c/Brian-Bayeye"
"13641","Alessandro Buongiorno_2023",2023,"Torino","Serie A","Alessandro Buongiorno","ITA","DF","23",1999,30.2,38,25,22,16,0,16,31,51.6,15,38,19,19,60,98,105,2,"https://fbref.com/en/players/4ae67f27/Alessandro-Buongiorno"
"13642","Koffi Djidji_2023",2023,"Torino","Serie A","Koffi Djidji","CIV","DF","29",1992,26.9,50,25,32,17,1,18,32,56.3,14,29,14,15,34,84,72,0,"https://fbref.com/en/players/933d3b51/Koffi-Djidji"
"13643","Gvidas Gineitis_2023",2023,"Torino","Serie A","Gvidas Gineitis","LTU","MF","18",2004,1.5,3,1,0,2,1,1,2,50,1,0,0,0,0,3,1,0,"https://fbref.com/en/players/548bd0de/Gvidas-Gineitis"
"13644","Andrew Gravillon_2023",2023,"Torino","Serie A","Andrew Gravillon","GLP","DF","24",1998,3.5,3,3,0,3,0,0,0,NA,0,4,2,2,9,12,16,0,"https://fbref.com/en/players/49136c42/Andrew-Gravillon"
"13645","Ivan Ilić_2023",2023,"Torino","Serie A","Ivan Ilić","SRB","MF","21",2001,13.1,18,7,6,11,1,10,20,50,10,12,3,9,5,23,10,0,"https://fbref.com/en/players/bb376bed/Ivan-Ilic"
"13646","Emirhan İlkhan_2023",2023,"Torino","Serie A","Emirhan İlkhan","TUR","MF","18",2004,1,1,1,0,1,0,1,1,100,0,3,1,2,2,3,2,0,"https://fbref.com/en/players/a47c6309/Emirhan-Ilkhan"
"13647","Yann Karamoh_2023",2023,"Torino","Serie A","Yann Karamoh","FRA","MF,FW","24",1998,8,5,2,3,2,0,1,5,20,4,5,0,5,0,5,2,1,"https://fbref.com/en/players/8b66d9cc/Yann-Karamoh"
"13648","Valentino Lazaro_2023",2023,"Torino","Serie A","Valentino Lazaro","AUT","DF","26",1996,15.3,10,5,6,0,4,6,14,42.9,8,16,3,13,3,13,29,0,"https://fbref.com/en/players/016ff750/Valentino-Lazaro"
"13649","Karol Linetty_2023",2023,"Torino","Serie A","Karol Linetty","POL","MF","27",1995,21,32,17,7,22,3,13,25,52,12,28,8,20,19,51,25,0,"https://fbref.com/en/players/d023d70f/Karol-Linetty"
"13650","Saša Lukić_2023",2023,"Torino","Serie A","Saša Lukić","SRB","MF","25",1996,13.3,21,14,10,10,1,9,15,60,6,17,7,10,13,34,10,0,"https://fbref.com/en/players/c6e8cf1f/Sasa-Lukic"
"13651","Vanja Milinković-Savić_2023",2023,"Torino","Serie A","Vanja Milinković-Savić","SRB","GK","25",1997,38,2,1,2,0,0,2,2,100,0,0,0,0,1,3,19,1,"https://fbref.com/en/players/9fa26bc2/Vanja-Milinkovic-Savic"
"13652","Aleksei Miranchuk_2023",2023,"Torino","Serie A","Aleksei Miranchuk","RUS","MF","26",1995,23.2,11,5,3,4,4,3,11,27.3,8,11,0,11,2,13,5,0,"https://fbref.com/en/players/a9aa0d1d/Aleksei-Miranchuk"
"13653","Michel Ndary Adopo_2023",2023,"Torino","Serie A","Michel Ndary Adopo","FRA","MF,DF","22",2000,2.9,7,2,4,2,1,1,3,33.3,2,2,2,0,1,8,4,0,"https://fbref.com/en/players/599d91d0/Michel-Ndary-Adopo"
"13654","Pietro Pellegri_2023",2023,"Torino","Serie A","Pietro Pellegri","ITA","FW","21",2001,5.2,6,2,1,3,2,2,3,66.7,1,5,1,4,0,6,4,0,"https://fbref.com/en/players/a44d3a3c/Pietro-Pellegri"
"13655","Nemanja Radonjić_2023",2023,"Torino","Serie A","Nemanja Radonjić","SRB","MF,FW","26",1996,16.2,2,1,2,0,0,0,4,0,4,3,0,3,2,4,4,0,"https://fbref.com/en/players/0630eb63/Nemanja-Radonjic"
"13656","Samuele Ricci_2023",2023,"Torino","Serie A","Samuele Ricci","ITA","MF","20",2001,23,32,21,17,10,5,18,23,78.3,5,20,5,15,17,49,29,1,"https://fbref.com/en/players/9823be92/Samuele-Ricci"
"13657","Ricardo Rodríguez_2023",2023,"Torino","Serie A","Ricardo Rodríguez","SUI","DF","29",1992,29.7,54,33,30,17,7,28,42,66.7,14,30,15,15,38,92,61,0,"https://fbref.com/en/players/7f78ad23/Ricardo-Rodriguez"
"13658","Antonio Sanabria_2023",2023,"Torino","Serie A","Antonio Sanabria","PAR","FW","26",1996,27,11,5,3,3,5,1,7,14.3,6,9,2,7,4,15,7,0,"https://fbref.com/en/players/0a447501/Antonio-Sanabria"
"13659","Perr Schuurs_2023",2023,"Torino","Serie A","Perr Schuurs","NED","DF","22",1999,25.8,51,25,29,17,5,14,26,53.8,12,28,16,12,28,79,102,0,"https://fbref.com/en/players/e613313c/Perr-Schuurs"
"13660","Demba Seck_2023",2023,"Torino","Serie A","Demba Seck","SEN","MF,FW","21",2001,5.8,5,2,3,2,0,2,3,66.7,1,3,1,2,1,6,1,0,"https://fbref.com/en/players/16463a79/Demba-Seck"
"13661","Jacopo Segre_2023",2023,"Torino","Serie A","Jacopo Segre","ITA","DF","25",1997,0.2,0,0,0,0,0,0,0,NA,0,0,0,0,0,0,0,0,"https://fbref.com/en/players/3cb132e6/Jacopo-Segre"
"13662","Wilfried Singo_2023",2023,"Torino","Serie A","Wilfried Singo","CIV","DF","21",2000,22.7,27,17,14,10,3,12,19,63.2,7,15,2,13,12,39,33,1,"https://fbref.com/en/players/8b609c34/Wilfried-Singo"
"13663","Ronaldo Vieira_2023",2023,"Torino","Serie A","Ronaldo Vieira","GNB","MF","24",1998,0.2,NA,0,NA,NA,NA,NA,NA,NA,NA,NA,NA,NA,0,NA,NA,NA,"https://fbref.com/en/players/75e60d75/Ronaldo-Vieira"
"13664","Nikola Vlašić_2023",2023,"Torino","Serie A","Nikola Vlašić","CRO","MF,FW","24",1997,30.3,32,21,9,16,7,15,34,44.1,19,25,2,23,10,42,14,0,"https://fbref.com/en/players/aa8e289e/Nikola-Vlasic"
"13665","Mërgim Vojvoda_2023",2023,"Torino","Serie A","Mërgim Vojvoda","KVX","DF","27",1995,19.1,22,12,15,6,1,12,24,50,12,14,2,12,10,32,31,1,"https://fbref.com/en/players/be2706c0/Mergim-Vojvoda"
"13666","David Zima_2023",2023,"Torino","Serie A","David Zima","CZE","DF","21",2000,4.5,9,5,5,4,0,3,4,75,1,7,2,5,9,18,11,2,"https://fbref.com/en/players/acf7e795/David-Zima"
"13667","George Abbott_2023",2023,"Tottenham","Premier League","George Abbott","ENG","MF","16",2005,0,0,0,0,0,0,0,0,NA,0,0,0,0,1,1,0,0,"https://fbref.com/en/players/56628958/George-Abbott"
"13668","Rodrigo Bentancur_2023",2023,"Tottenham","Premier League","Rodrigo Bentancur","URU","MF","25",1997,16.7,45,28,15,21,9,16,28,57.1,12,28,15,13,20,65,22,0,"https://fbref.com/en/players/3b8674e6/Rodrigo-Bentancur"
"13669","Yves Bissouma_2023",2023,"Tottenham","Premier League","Yves Bissouma","MLI","MF","25",1996,11.2,16,13,6,6,4,2,7,28.6,5,15,6,9,12,28,10,0,"https://fbref.com/en/players/6c203af0/Yves-Bissouma"
"13670","Matthew Craig_2023",2023,"Tottenham","Premier League","Matthew Craig","SCO","MF","19",2003,0.2,4,1,2,2,0,0,0,NA,0,0,0,0,0,4,0,0,"https://fbref.com/en/players/bc914523/Matthew-Craig"
"13671","Arnaut Danjuma_2023",2023,"Tottenham","Premier League","Arnaut Danjuma","NED","FW,MF","25",1997,1.9,2,0,1,1,0,0,0,NA,0,1,0,1,0,2,0,0,"https://fbref.com/en/players/f08490a6/Arnaut-Danjuma"
"13672","Ben Davies_2023",2023,"Tottenham","Premier League","Ben Davies","WAL","DF","29",1993,25.4,28,11,13,13,2,14,26,53.8,12,17,8,9,18,46,72,0,"https://fbref.com/en/players/44781702/Ben-Davies"
"13673","Eric Dier_2023",2023,"Tottenham","Premier League","Eric Dier","ENG","DF","28",1994,31.3,30,19,16,12,2,9,19,47.4,10,41,24,17,35,65,112,2,"https://fbref.com/en/players/ac861941/Eric-Dier"
"13674","Matt Doherty_2023",2023,"Tottenham","Premier League","Matt Doherty","IRL","DF,MF","30",1992,7.4,16,10,12,3,1,8,10,80,2,11,6,5,8,24,14,1,"https://fbref.com/en/players/d557d734/Matt-Doherty"
"13675","Emerson_2023",2023,"Tottenham","Premier League","Emerson","BRA","DF","23",1999,19.3,54,33,38,12,4,27,40,67.5,13,17,3,14,18,72,75,0,"https://fbref.com/en/players/df8b52a5/Emerson"
"13676","Fraser Forster_2023",2023,"Tottenham","Premier League","Fraser Forster","ENG","GK","34",1988,13.5,1,0,1,0,0,0,0,NA,0,1,0,1,0,1,3,1,"https://fbref.com/en/players/c3e39f12/Fraser-Forster"
"13677","Bryan Gil_2023",2023,"Tottenham","Premier League","Bryan Gil","ESP","MF,FW","21",2001,1.6,3,1,3,0,0,0,3,0,3,3,0,3,1,4,1,0,"https://fbref.com/en/players/7b5ab7f2/Bryan-Gil"
"13678","Son Heung-min_2023",2023,"Tottenham","Premier League","Son Heung-min","KOR","MF,FW","30",1992,32.1,24,12,7,8,9,9,30,30,21,23,2,21,13,37,6,0,"https://fbref.com/en/players/92e7e919/Son-Heung-min"
"13679","Pierre Højbjerg_2023",2023,"Tottenham","Premier League","Pierre Højbjerg","DEN","MF","26",1995,34.8,56,30,28,22,6,26,67,38.8,41,46,17,29,49,105,64,1,"https://fbref.com/en/players/8b04d6c1/Pierre-Hojbjerg"
"13680","Harry Kane_2023",2023,"Tottenham","Premier League","Harry Kane","ENG","FW","29",1993,37.8,15,12,1,6,8,7,21,33.3,14,27,7,20,2,17,18,0,"https://fbref.com/en/players/21a66f6a/Harry-Kane"
"13681","Dejan Kulusevski_2023",2023,"Tottenham","Premier League","Dejan Kulusevski","SWE","MF,FW","22",2000,23,38,15,23,7,8,16,44,36.4,28,19,0,19,13,51,7,0,"https://fbref.com/en/players/df3cda47/Dejan-Kulusevski"
"13682","Clément Lenglet_2023",2023,"Tottenham","Premier League","Clément Lenglet","FRA","DF","27",1995,22.4,38,23,18,15,5,16,34,47.1,18,26,11,15,18,56,68,2,"https://fbref.com/en/players/4f28a6ff/Clement-Lenglet"
"13683","Hugo Lloris_2023",2023,"Tottenham","Premier League","Hugo Lloris","FRA","GK","35",1986,24.5,1,1,1,0,0,1,3,33.3,2,0,0,0,1,2,13,4,"https://fbref.com/en/players/8f62b6ee/Hugo-Lloris"
"13684","Pape Matar Sarr_2023",2023,"Tottenham","Premier League","Pape Matar Sarr","SEN","MF,FW","19",2002,2.4,7,6,4,2,1,4,8,50,4,3,2,1,6,13,6,0,"https://fbref.com/en/players/feb5d972/Pape-Matar-Sarr"
"13685","Lucas Moura_2023",2023,"Tottenham","Premier League","Lucas Moura","BRA","MF,DF","29",1992,1.7,8,5,1,3,4,1,4,25,3,0,0,0,2,10,1,1,"https://fbref.com/en/players/2b622f01/Lucas-Moura"
"13686","Ivan Perišić_2023",2023,"Tottenham","Premier League","Ivan Perišić","CRO","DF,MF","33",1989,23.4,42,24,25,10,7,27,47,57.4,20,29,7,22,22,64,49,1,"https://fbref.com/en/players/6fe90922/Ivan-Perisic"
"13687","Pedro Porro_2023",2023,"Tottenham","Premier League","Pedro Porro","ESP","DF,MF","22",1999,12.6,25,16,8,15,2,14,39,35.9,25,25,2,23,15,40,24,1,"https://fbref.com/en/players/27d0a506/Pedro-Porro"
"13688","Richarlison_2023",2023,"Tottenham","Premier League","Richarlison","BRA","MF,FW","25",1997,11.2,21,16,13,5,3,12,27,44.4,15,14,1,13,5,26,10,0,"https://fbref.com/en/players/fa031b34/Richarlison"
"13689","Cristian Romero_2023",2023,"Tottenham","Premier League","Cristian Romero","ARG","DF","24",1998,26.3,68,36,42,24,2,29,46,63,17,40,18,22,44,112,102,3,"https://fbref.com/en/players/a3d94a58/Cristian-Romero"
"13690","Davinson Sánchez_2023",2023,"Tottenham","Premier League","Davinson Sánchez","COL","DF","26",1996,9.5,24,11,17,6,1,14,20,70,6,16,10,6,12,36,41,0,"https://fbref.com/en/players/da7b447d/Davinson-Sanchez"
"13691","Ryan Sessegnon_2023",2023,"Tottenham","Premier League","Ryan Sessegnon","ENG","DF","22",2000,9,16,11,9,7,0,6,12,50,6,8,1,7,6,22,17,1,"https://fbref.com/en/players/6aa3e78b/Ryan-Sessegnon"
"13692","Oliver Skipp_2023",2023,"Tottenham","Premier League","Oliver Skipp","ENG","MF","21",2000,16.6,34,17,18,15,1,16,33,48.5,17,17,8,9,17,51,19,1,"https://fbref.com/en/players/6250083a/Oliver-Skipp"
"13693","Djed Spence_2023",2023,"Tottenham","Premier League","Djed Spence","ENG","FW,DF","21",2000,0.1,0,0,0,0,0,0,0,NA,0,0,0,0,0,0,0,0,"https://fbref.com/en/players/9bc9a519/Djed-Spence"
"13694","Japhet Tanganga_2023",2023,"Tottenham","Premier League","Japhet Tanganga","ENG","DF","23",1999,1.6,3,2,3,0,0,1,5,20,4,1,0,1,2,5,8,0,"https://fbref.com/en/players/e9971f2d/Japhet-Tanganga"
"13695","Harvey White_2023",2023,"Tottenham","Premier League","Harvey White","ENG","MF","20",2001,0.1,0,0,0,0,0,0,1,0,1,0,0,0,0,0,0,0,"https://fbref.com/en/players/4d90ce8c/Harvey-White"
"13696","Zakaria Aboukhlal_2023",2023,"Toulouse","Ligue 1","Zakaria Aboukhlal","MAR","FW,MF","22",2000,27.5,33,23,13,9,11,14,45,31.1,31,18,1,17,22,55,23,0,"https://fbref.com/en/players/c2a6033c/Zakaria-Aboukhlal"
"13697","Yanis Begraoui_2023",2023,"Toulouse","Ligue 1","Yanis Begraoui","MAR","FW,MF","21",2001,0.7,2,0,1,0,1,1,2,50,1,0,0,0,1,3,0,0,"https://fbref.com/en/players/5e6355f8/Yanis-Begraoui"
"13698","Veljko Birmančević_2023",2023,"Toulouse","Ligue 1","Veljko Birmančević","SRB","FW,MF","24",1998,4.9,13,7,5,4,4,7,21,33.3,14,12,2,10,7,20,1,0,"https://fbref.com/en/players/636247ca/Veljko-Birmancevic"
"13699","Fares Chaïbi_2023",2023,"Toulouse","Ligue 1","Fares Chaïbi","ALG","FW,MF","19",2002,26,31,18,8,15,8,17,50,34,33,38,5,33,19,50,36,1,"https://fbref.com/en/players/357103bd/Fares-Chaibi"
"13700","Logan Costa_2023",2023,"Toulouse","Ligue 1","Logan Costa","CPV","DF","21",2001,4.6,9,4,7,1,1,6,9,66.7,3,6,3,3,4,13,12,0,"https://fbref.com/en/players/bfb2056e/Logan-Costa"
"13701","Thijs Dallinga_2023",2023,"Toulouse","Ligue 1","Thijs Dallinga","NED","FW","21",2000,26.1,8,6,2,2,4,1,13,7.7,12,17,3,14,3,11,20,0,"https://fbref.com/en/players/b70afb45/Thijs-Dallinga"
"13702","Brecht Dejaegere_2023",2023,"Toulouse","Ligue 1","Brecht Dejaegere","BEL","MF","31",1991,20.1,40,23,10,20,10,15,51,29.4,36,25,5,20,14,54,11,0,"https://fbref.com/en/players/4ca4f601/Brecht-Dejaegere"
"13703","Branco van den Boomen_2023",2023,"Toulouse","Ligue 1","Branco van den Boomen","NED","MF","27",1995,32.1,71,36,26,32,13,36,89,40.4,53,27,4,23,10,81,27,2,"https://fbref.com/en/players/99d660b2/Branco-van-den-Boomen"
"13704","Mikkel Desler_2023",2023,"Toulouse","Ligue 1","Mikkel Desler","DEN","DF","27",1995,25.1,71,38,36,27,8,43,67,64.2,24,35,6,29,36,107,48,2,"https://fbref.com/en/players/1d5c96f8/Mikkel-Desler"
"13705","Moussa Diarra_2023",2023,"Toulouse","Ligue 1","Moussa Diarra","MLI","DF","21",2000,13.6,20,9,9,9,2,9,15,60,6,25,10,15,19,39,27,1,"https://fbref.com/en/players/698f11e3/Moussa-Diarra"
"13706","Maxime Dupé_2023",2023,"Toulouse","Ligue 1","Maxime Dupé","FRA","GK","29",1993,38,0,0,0,0,0,0,0,NA,0,0,0,0,0,0,9,3,"https://fbref.com/en/players/0e12089d/Maxime-Dupe"
"13707","Denis Genreau_2023",2023,"Toulouse","Ligue 1","Denis Genreau","AUS","MF","23",1999,7.3,35,13,16,12,7,13,31,41.9,18,16,1,15,8,43,9,0,"https://fbref.com/en/players/badcdcae/Denis-Genreau"
"13708","Saïd Hamulic_2023",2023,"Toulouse","Ligue 1","Saïd Hamulic","BIH","FW","21",2000,1.2,0,0,0,0,0,0,0,NA,0,0,0,0,0,0,0,0,"https://fbref.com/en/players/52cd0e88/Said-Hamulic"
"13709","Rhys Healey_2023",2023,"Toulouse","Ligue 1","Rhys Healey","WAL","FW","27",1994,0.7,0,0,0,0,0,0,0,NA,0,0,0,0,0,0,0,0,"https://fbref.com/en/players/07ace8c3/Rhys-Healey"
"13710","Waren Kamanzi_2023",2023,"Toulouse","Ligue 1","Waren Kamanzi","NOR","DF","21",2000,7.4,16,9,9,5,2,13,19,68.4,6,8,2,6,8,24,9,0,"https://fbref.com/en/players/a426a912/Waren-Kamanzi"
"13711","Kévin Keben Biakolo_2023",2023,"Toulouse","Ligue 1","Kévin Keben Biakolo","CMR","DF","18",2004,4,3,2,2,0,1,0,4,0,4,1,0,1,5,8,9,0,"https://fbref.com/en/players/c43a8336/Kevin-Keben-Biakolo"
"13712","Christian Mawissa_2023",2023,"Toulouse","Ligue 1","Christian Mawissa","FRA","DF","17",2005,1.1,2,0,1,1,0,1,3,33.3,2,0,0,0,3,5,1,0,"https://fbref.com/en/players/2c70d915/Christian-Mawissa"
"13713","Nathan N'Goumou_2023",2023,"Toulouse","Ligue 1","Nathan N'Goumou","FRA","FW","22",2000,1,3,2,2,1,0,1,1,100,0,2,0,2,2,5,0,0,"https://fbref.com/en/players/e110ea4b/Nathan-NGoumou"
"13714","Rasmus Nicolaisen_2023",2023,"Toulouse","Ligue 1","Rasmus Nicolaisen","DEN","DF","25",1997,33.3,48,21,34,14,0,29,46,63,17,58,45,13,50,98,152,0,"https://fbref.com/en/players/3f319bb9/Rasmus-Nicolaisen"
"13715","Ado Onaiwu_2023",2023,"Toulouse","Ligue 1","Ado Onaiwu","JPN","FW","26",1995,12,11,6,4,4,3,5,13,38.5,8,5,1,4,2,13,5,0,"https://fbref.com/en/players/ff4df82e/Ado-Onaiwu"
"13716","Rafael Ratão_2023",2023,"Toulouse","Ligue 1","Rafael Ratão","BRA","FW,MF","26",1995,20.6,52,36,29,16,7,27,73,37,46,34,0,34,21,73,7,0,"https://fbref.com/en/players/40ef7347/Rafael-Ratao"
"13717","Anthony Rouault_2023",2023,"Toulouse","Ligue 1","Anthony Rouault","FRA","DF","21",2001,36.8,66,37,54,10,2,30,58,51.7,28,52,26,26,56,122,126,4,"https://fbref.com/en/players/9b545925/Anthony-Rouault"
"13718","Vincent Sierro_2023",2023,"Toulouse","Ligue 1","Vincent Sierro","SUI","MF","26",1995,7.4,19,11,9,9,1,11,29,37.9,18,12,3,9,4,23,11,1,"https://fbref.com/en/players/92ffb8f9/Vincent-Sierro"
"13719","Naatan Skyttä_2023",2023,"Toulouse","Ligue 1","Naatan Skyttä","FIN","MF","20",2002,0.3,0,0,0,0,0,0,0,NA,0,0,0,0,1,1,0,0,"https://fbref.com/en/players/d7547531/Naatan-Skytta"
"13720","Stijn Spierings_2023",2023,"Toulouse","Ligue 1","Stijn Spierings","NED","MF","26",1996,34.7,95,67,37,49,9,43,101,42.6,58,49,11,38,53,148,44,0,"https://fbref.com/en/players/a08985b8/Stijn-Spierings"
"13721","Gabriel Suazo_2023",2023,"Toulouse","Ligue 1","Gabriel Suazo","CHI","DF","24",1997,14,38,22,20,15,3,29,63,46,34,21,5,16,22,60,24,1,"https://fbref.com/en/players/39b326ed/Gabriel-Suazo"
"13722","Issiaga Sylla_2023",2023,"Toulouse","Ligue 1","Issiaga Sylla","GUI","DF","28",1994,15.2,28,15,14,9,5,15,34,44.1,19,15,5,10,38,66,38,0,"https://fbref.com/en/players/b99bec05/Issiaga-Sylla"
"13723","Theocharis Tsingaras_2023",2023,"Toulouse","Ligue 1","Theocharis Tsingaras","GRE","MF","21",2000,0.1,0,0,0,0,0,0,0,NA,0,0,0,0,0,0,0,0,"https://fbref.com/en/players/906baf89/Theocharis-Tsingaras"
"13724","Oliver Zandén_2023",2023,"Toulouse","Ligue 1","Oliver Zandén","SWE","DF,MF","20",2001,1.6,2,1,1,0,1,2,5,40,3,0,0,0,1,3,7,0,"https://fbref.com/en/players/72d4922b/Oliver-Zanden"
"13725","Lucien Agoume_2023",2023,"Troyes","Ligue 1","Lucien Agoume","FRA","MF","20",2002,12.2,42,25,18,15,9,17,33,51.5,16,14,5,9,27,69,24,0,"https://fbref.com/en/players/8bc8829a/Lucien-Agoume"
"13726","Amar Ahmed_2023",2023,"Troyes","Ligue 1","Amar Ahmed","SWE","FW","18",2004,0.2,1,1,0,1,0,0,1,0,1,0,0,0,1,2,0,0,"https://fbref.com/en/players/22396615/Amar-Ahmed"
"13727","Thierno Balde_2023",2023,"Troyes","Ligue 1","Thierno Balde","FRA","DF,MF","20",2002,23.9,27,14,19,4,4,18,30,60,12,15,3,12,23,50,39,0,"https://fbref.com/en/players/3975195f/Thierno-Balde"
"13728","Andreas Bruus_2023",2023,"Troyes","Ligue 1","Andreas Bruus","DEN","DF,FW","23",1999,18.1,12,6,9,3,0,8,20,40,12,13,2,11,17,29,24,0,"https://fbref.com/en/players/b088d5d3/Andreas-Bruus"
"13729","Xavier Chavalerin_2023",2023,"Troyes","Ligue 1","Xavier Chavalerin","FRA","MF","31",1991,27,82,50,39,30,13,27,71,38,44,31,8,23,41,123,24,0,"https://fbref.com/en/players/279ddf6a/Xavier-Chavalerin"
"13730","Abdu Conté_2023",2023,"Troyes","Ligue 1","Abdu Conté","POR","DF","24",1998,14.6,25,17,14,8,3,12,22,54.5,10,13,6,7,6,31,25,0,"https://fbref.com/en/players/cfa49cc1/Abdu-Conte"
"13731","Tristan Dingomé_2023",2023,"Troyes","Ligue 1","Tristan Dingomé","CMR","MF","31",1991,1.1,1,1,0,1,0,0,2,0,2,0,0,0,0,1,0,0,"https://fbref.com/en/players/92b56413/Tristan-Dingome"
"13732","Kyliane Dong_2023",2023,"Troyes","Ligue 1","Kyliane Dong","FRA","MF,FW","17",2004,2.4,3,1,0,2,1,1,2,50,1,1,0,1,1,4,0,0,"https://fbref.com/en/players/836dc4a8/Kyliane-Dong"
"13733","Jordan Dongmo_2023",2023,"Troyes","Ligue 1","Jordan Dongmo","CMR","MF","21",2001,0.2,1,0,0,1,0,1,1,100,0,0,0,0,0,1,0,0,"https://fbref.com/en/players/1b5b32d2/Jordan-Dongmo"
"13734","Gauthier Gallon_2023",2023,"Troyes","Ligue 1","Gauthier Gallon","FRA","GK","29",1993,29.6,2,2,2,0,0,2,4,50,2,0,0,0,2,4,17,0,"https://fbref.com/en/players/db3164e1/Gauthier-Gallon"
"13735","Mathis Hamdi_2023",2023,"Troyes","Ligue 1","Mathis Hamdi","FRA","DF","18",2003,0.8,0,0,0,0,0,0,1,0,1,0,0,0,1,1,1,0,"https://fbref.com/en/players/a94571f6/Mathis-Hamdi"
"13736","Rudy Kohon_2023",2023,"Troyes","Ligue 1","Rudy Kohon","FRA","DF","18",2004,0.7,4,3,4,0,0,2,2,100,0,1,0,1,1,5,2,0,"https://fbref.com/en/players/9cd28348/Rudy-Kohon"
"13737","Rominigue Kouamé_2023",2023,"Troyes","Ligue 1","Rominigue Kouamé","MLI","MF","25",1996,29.6,44,27,28,14,2,17,41,41.5,24,32,11,21,49,93,46,1,"https://fbref.com/en/players/86a2ba20/Rominigue-Kouame"
"13738","Yasser Larouci_2023",2023,"Troyes","Ligue 1","Yasser Larouci","FRA","DF,MF","21",2001,20,23,13,13,8,2,15,24,62.5,9,15,1,14,26,49,46,0,"https://fbref.com/en/players/0ed063d6/Yasser-Larouci"
"13739","Mateusz Lis_2023",2023,"Troyes","Ligue 1","Mateusz Lis","POL","GK","25",1997,8.3,0,0,0,0,0,0,1,0,1,1,0,1,0,0,3,0,"https://fbref.com/en/players/fd78b105/Mateusz-Lis"
"13740","Rony Lopes_2023",2023,"Troyes","Ligue 1","Rony Lopes","POR","MF,FW","26",1995,26.1,24,12,6,15,3,7,31,22.6,24,14,2,12,9,33,10,0,"https://fbref.com/en/players/7c2965bb/Rony-Lopes"
"13741","Derek Mazou-Sacko_2023",2023,"Troyes","Ligue 1","Derek Mazou-Sacko","FRA","MF","17",2004,0.2,0,0,0,0,0,0,1,0,1,1,0,1,1,1,1,0,"https://fbref.com/en/players/810edef9/Derek-Mazou-Sacko"
"13742","Marlos Moreno_2023",2023,"Troyes","Ligue 1","Marlos Moreno","COL","MF,DF","25",1996,0.1,2,2,2,0,0,2,3,66.7,1,1,1,0,0,2,0,0,"https://fbref.com/en/players/8499c713/Marlos-Moreno"
"13743","Papa Ndiaga Yade_2023",2023,"Troyes","Ligue 1","Papa Ndiaga Yade","SEN","DF,MF","22",2000,6.3,10,6,6,2,2,7,22,31.8,15,10,2,8,8,18,10,0,"https://fbref.com/en/players/87e9c7cd/Papa-Ndiaga-Yade"
"13744","Wilson Odobert_2023",2023,"Troyes","Ligue 1","Wilson Odobert","FRA","MF,FW","17",2004,19.6,20,14,10,7,3,9,25,36,16,11,0,11,15,35,5,0,"https://fbref.com/en/players/35516eac/Wilson-Odobert"
"13745","Ante Palaversa_2023",2023,"Troyes","Ligue 1","Ante Palaversa","CRO","MF","22",2000,0.3,1,1,1,0,0,0,0,NA,0,0,0,0,1,2,0,0,"https://fbref.com/en/players/cd9b37a3/Ante-Palaversa"
"13746","Erik Palmer-Brown_2023",2023,"Troyes","Ligue 1","Erik Palmer-Brown","USA","DF","25",1997,35.5,42,27,31,10,1,18,33,54.5,15,56,29,27,26,68,166,1,"https://fbref.com/en/players/e5c1e0ca/Erik-Palmer-Brown"
"13747","Jackson Porozo_2023",2023,"Troyes","Ligue 1","Jackson Porozo","ECU","DF","21",2000,18,32,20,24,7,1,13,31,41.9,18,24,17,7,33,65,75,0,"https://fbref.com/en/players/7d704e92/Jackson-Porozo"
"13748","Adil Rami_2023",2023,"Troyes","Ligue 1","Adil Rami","FRA","DF","36",1985,17.7,19,14,13,5,1,17,32,53.1,15,23,16,7,25,44,75,3,"https://fbref.com/en/players/8dbff17c/Adil-Rami"
"13749","Jeff Reine-Adélaïde_2023",2023,"Troyes","Ligue 1","Jeff Reine-Adélaïde","FRA","MF","24",1998,2.6,3,2,2,1,0,1,2,50,1,2,0,2,2,5,1,0,"https://fbref.com/en/players/d504b3e1/Jeff-Reine-Adelaide"
"13750","Renaud Ripart_2023",2023,"Troyes","Ligue 1","Renaud Ripart","FRA","FW,MF","29",1993,14.7,40,23,14,20,6,19,52,36.5,33,29,2,27,7,47,5,0,"https://fbref.com/en/players/beae3a73/Renaud-Ripart"
"13751","Yoann Salmier_2023",2023,"Troyes","Ligue 1","Yoann Salmier","GUF","DF","29",1992,29.4,51,29,34,12,5,21,35,60,14,34,19,15,39,90,124,0,"https://fbref.com/en/players/c3725db2/Yoann-Salmier"
"13752","Mama Samba Baldé_2023",2023,"Troyes","Ligue 1","Mama Samba Baldé","GNB","FW","26",1995,29.6,46,21,14,21,11,13,28,46.4,15,30,3,27,10,56,13,0,"https://fbref.com/en/players/fb14aa28/Mama-Samba-Balde"
"13753","Florian Tardieu_2023",2023,"Troyes","Ligue 1","Florian Tardieu","FRA","MF","30",1992,11.2,31,20,19,12,0,12,31,38.7,19,19,4,15,23,54,15,0,"https://fbref.com/en/players/ed39121c/Florian-Tardieu"
"13754","Alexis Tibidi_2023",2023,"Troyes","Ligue 1","Alexis Tibidi","FRA","FW,MF","18",2003,0.8,1,1,1,0,0,0,0,NA,0,0,0,0,0,1,0,0,"https://fbref.com/en/players/ca6f4846/Alexis-Tibidi"
"13755","Ike Ugbo_2023",2023,"Troyes","Ligue 1","Ike Ugbo","CAN","FW,MF","23",1998,9.9,5,2,2,2,1,3,11,27.3,8,8,2,6,2,7,4,0,"https://fbref.com/en/players/8a53d24b/Ike-Ugbo"
"13756","Tanguy Zoukrou_2023",2023,"Troyes","Ligue 1","Tanguy Zoukrou","FRA","DF","19",2003,5.7,14,7,8,6,0,10,14,71.4,4,18,11,7,2,16,24,0,"https://fbref.com/en/players/aefa3050/Tanguy-Zoukrou"
"13757","James Abankwah_2023",2023,"Udinese","Serie A","James Abankwah","IRL","DF","18",2004,0.7,1,1,0,1,0,0,0,NA,0,4,2,2,0,1,5,0,"https://fbref.com/en/players/4b7a9fcc/James-Abankwah"
"13758","Tolgay Arslan_2023",2023,"Udinese","Serie A","Tolgay Arslan","GER","MF","31",1990,13.5,29,18,13,15,1,14,39,35.9,25,19,0,19,12,41,9,1,"https://fbref.com/en/players/963a328b/Tolgay-Arslan"
"13759","Rodrigo Becão_2023",2023,"Udinese","Serie A","Rodrigo Becão","BRA","DF","26",1996,27.6,70,36,50,17,3,40,53,75.5,13,44,24,20,26,96,68,2,"https://fbref.com/en/players/19e4eab9/Rodrigo-Becao"
"13760","Beto_2023",2023,"Udinese","Serie A","Beto","GNB","FW","24",1998,23.7,16,9,0,9,7,4,17,23.5,13,18,3,15,6,22,30,0,"https://fbref.com/en/players/ed5c0319/Beto"
"13761","Jaka Bijol_2023",2023,"Udinese","Serie A","Jaka Bijol","SVN","DF","23",1999,30.3,39,23,32,7,0,16,27,59.3,11,41,25,16,29,68,165,0,"https://fbref.com/en/players/6fdac234/Jaka-Bijol"
"13762","Leonardo Buta_2023",2023,"Udinese","Serie A","Leonardo Buta","POR","DF","20",2002,0.2,1,1,0,1,0,0,0,NA,0,0,0,0,0,1,0,0,"https://fbref.com/en/players/dee3d535/Leonardo-Buta"
"13763","Nicolò Cocetta_2023",2023,"Udinese","Serie A","Nicolò Cocetta","ITA","DF","18",2003,0.4,0,0,0,0,0,0,1,0,1,1,1,0,1,1,1,0,"https://fbref.com/en/players/1faa06d5/Nicolo-Cocetta"
"13764","Gerard Deulofeu_2023",2023,"Udinese","Serie A","Gerard Deulofeu","ESP","FW","28",1994,13.5,8,5,5,1,2,5,15,33.3,10,8,1,7,2,10,1,0,"https://fbref.com/en/players/39583cfd/Gerard-Deulofeu"
"13765","Festy Ebosele_2023",2023,"Udinese","Serie A","Festy Ebosele","IRL","DF","19",2002,4.6,15,10,8,7,0,4,10,40,6,5,0,5,2,17,5,0,"https://fbref.com/en/players/dbfa4f16/Festy-Ebosele"
"13766","Enzo Ebosse_2023",2023,"Udinese","Serie A","Enzo Ebosse","CMR","DF","23",1999,10.3,15,9,11,4,0,9,13,69.2,4,27,6,21,11,26,29,0,"https://fbref.com/en/players/9ba7b4fa/Enzo-Ebosse"
"13767","Kingsley Ehizibue_2023",2023,"Udinese","Serie A","Kingsley Ehizibue","NED","DF","27",1995,17.1,47,31,28,13,6,29,45,64.4,16,21,3,18,10,57,42,1,"https://fbref.com/en/players/76b2817e/Kingsley-Ehizibue"
"13768","Axel Guessand_2023",2023,"Udinese","Serie A","Axel Guessand","FRA","DF","17",2004,0.9,2,1,2,0,0,1,2,50,1,1,0,1,2,4,3,0,"https://fbref.com/en/players/e04dca4a/Axel-Guessand"
"13769","Mato Jajalo_2023",2023,"Udinese","Serie A","Mato Jajalo","BIH","MF","34",1988,0.7,0,0,0,0,0,0,1,0,1,0,0,0,0,0,2,0,"https://fbref.com/en/players/8c65eb5f/Mato-Jajalo"
"13770","Sandi Lovrić_2023",2023,"Udinese","Serie A","Sandi Lovrić","SVN","MF","24",1998,25.9,40,18,16,16,8,25,43,58.1,18,25,2,23,26,66,21,0,"https://fbref.com/en/players/966eea58/Sandi-Lovric"
"13771","Jean-Victor Makengo_2023",2023,"Udinese","Serie A","Jean-Victor Makengo","FRA","MF","24",1998,8.9,16,13,7,7,2,5,9,55.6,4,8,2,6,9,25,3,0,"https://fbref.com/en/players/22bfb57e/Jean-Victor-Makengo"
"13772","Adam Masina_2023",2023,"Udinese","Serie A","Adam Masina","MAR","DF","28",1994,8.8,10,7,7,3,0,6,15,40,9,11,4,7,10,20,28,1,"https://fbref.com/en/players/de0f152c/Adam-Masina"
"13773","Ilija Nestorovski_2023",2023,"Udinese","Serie A","Ilija Nestorovski","MKD","FW,MF","32",1990,7.1,7,3,2,1,4,5,11,45.5,6,6,1,5,2,9,10,0,"https://fbref.com/en/players/b1236c63/Ilija-Nestorovski"
"13774","Bram Nuytinck_2023",2023,"Udinese","Serie A","Bram Nuytinck","NED","DF","32",1990,4.3,7,4,3,4,0,4,8,50,4,6,6,0,5,12,22,0,"https://fbref.com/en/players/e33f36d5/Bram-Nuytinck"
"13775","Simone Pafundi_2023",2023,"Udinese","Serie A","Simone Pafundi","ITA","MF,FW","16",2006,0.9,8,5,1,5,2,2,4,50,2,0,0,0,1,9,0,0,"https://fbref.com/en/players/8daee720/Simone-Pafundi"
"13776","Roberto Pereyra_2023",2023,"Udinese","Serie A","Roberto Pereyra","ARG","DF,MF","31",1991,31.3,36,20,21,12,3,16,44,36.4,28,20,5,15,16,52,28,0,"https://fbref.com/en/players/75f2c59f/Roberto-Pereyra"
"13777","Nehuén Pérez_2023",2023,"Udinese","Serie A","Nehuén Pérez","ARG","DF","22",2000,31.3,77,40,54,20,3,39,55,70.9,16,53,23,30,35,112,106,1,"https://fbref.com/en/players/f7c491f1/Nehuen-Perez"
"13778","Lazar Samardzic_2023",2023,"Udinese","Serie A","Lazar Samardzic","SRB","MF","20",2002,20.5,33,16,9,20,4,17,43,39.5,26,13,0,13,11,44,16,0,"https://fbref.com/en/players/217c93a1/Lazar-Samardzic"
"13779","Vivaldo Semedo_2023",2023,"Udinese","Serie A","Vivaldo Semedo","POR","FW,MF","17",2005,0.4,0,0,0,0,0,0,0,NA,0,1,0,1,0,0,1,0,"https://fbref.com/en/players/b6baba31/Vivaldo-Semedo"
"13780","Marco Silvestri_2023",2023,"Udinese","Serie A","Marco Silvestri","ITA","GK","31",1991,38,2,1,2,0,0,2,3,66.7,1,0,0,0,1,3,15,1,"https://fbref.com/en/players/0d422df7/Marco-Silvestri"
"13781","Brandon Soppy_2023",2023,"Udinese","Serie A","Brandon Soppy","FRA","DF","20",2002,1,1,1,0,1,0,0,0,NA,0,4,0,4,1,2,1,0,"https://fbref.com/en/players/28f66c2e/Brandon-Soppy"
"13782","Isaac Success_2023",2023,"Udinese","Serie A","Isaac Success","NGA","FW","26",1996,20.2,8,4,2,5,1,3,8,37.5,5,13,2,11,4,12,18,0,"https://fbref.com/en/players/f573a8bf/Isaac-Success"
"13783","Florian Thauvin_2023",2023,"Udinese","Serie A","Florian Thauvin","FRA","FW,MF","29",1993,6.1,2,1,0,2,0,2,13,15.4,11,5,0,5,2,4,2,0,"https://fbref.com/en/players/2b9fdeea/Florian-Thauvin"
"13784","Iyenoma Udogie_2023",2023,"Udinese","Serie A","Iyenoma Udogie","ITA","DF","19",2002,30,71,45,42,24,5,34,59,57.6,25,34,6,28,36,107,25,0,"https://fbref.com/en/players/7cd520e8/Iyenoma-Udogie"
"13785","Walace_2023",2023,"Udinese","Serie A","Walace","BRA","MF","27",1995,35.4,82,39,42,31,9,41,90,45.6,49,47,12,35,51,133,51,1,"https://fbref.com/en/players/26db8853/Walace"
"13786","Marvin Zeegelaar_2023",2023,"Udinese","Serie A","Marvin Zeegelaar","NED","DF","31",1990,3.9,8,4,6,2,0,3,4,75,1,2,0,2,3,11,5,0,"https://fbref.com/en/players/8abd0c03/Marvin-Zeegelaar"
"13787","Timo Baumgartl_2023",2023,"Union Berlin","Bundesliga","Timo Baumgartl","GER","DF","26",1996,6.2,11,6,5,4,2,5,18,27.8,13,12,4,8,2,13,14,0,"https://fbref.com/en/players/bd7d2e6d/Timo-Baumgartl"
"13788","Sheraldo Becker_2023",2023,"Union Berlin","Bundesliga","Sheraldo Becker","SUR","FW","27",1995,28.4,15,5,1,7,7,2,11,18.2,9,13,1,12,3,18,7,1,"https://fbref.com/en/players/8eb55dbb/Sheraldo-Becker"
"13789","Kevin Behrens_2023",2023,"Union Berlin","Bundesliga","Kevin Behrens","GER","FW","31",1991,17.1,11,7,4,4,3,4,18,22.2,14,18,3,15,5,16,25,0,"https://fbref.com/en/players/30ae134d/Kevin-Behrens"
"13790","Danilho Doekhi_2023",2023,"Union Berlin","Bundesliga","Danilho Doekhi","NED","DF","24",1998,24.6,38,23,21,17,0,14,26,53.8,12,27,12,15,29,67,93,0,"https://fbref.com/en/players/f67c9d29/Danilho-Doekhi"
"13791","Niko Gießelmann_2023",2023,"Union Berlin","Bundesliga","Niko Gießelmann","GER","DF","30",1991,14.5,21,11,9,9,3,13,31,41.9,18,17,5,12,9,30,28,0,"https://fbref.com/en/players/7242b495/Niko-Giesselmann"
"13792","Lennart Grill_2023",2023,"Union Berlin","Bundesliga","Lennart Grill","GER","GK","23",1999,5,0,0,0,0,0,0,1,0,1,0,0,0,0,0,1,1,"https://fbref.com/en/players/37998008/Lennart-Grill"
"13793","Janik Haberer_2023",2023,"Union Berlin","Bundesliga","Janik Haberer","GER","MF","28",1994,24.3,29,17,8,18,3,17,48,35.4,31,35,2,33,14,43,25,0,"https://fbref.com/en/players/70dcf94d/Janik-Haberer"
"13794","Genki Haraguchi_2023",2023,"Union Berlin","Bundesliga","Genki Haraguchi","JPN","MF","31",1991,5.5,12,8,1,10,1,3,9,33.3,6,7,1,6,3,15,9,0,"https://fbref.com/en/players/f24ea523/Genki-Haraguchi"
"13795","Paul Jaeckel_2023",2023,"Union Berlin","Bundesliga","Paul Jaeckel","GER","DF","24",1998,13.3,24,18,11,11,2,17,35,48.6,18,11,5,6,19,43,44,1,"https://fbref.com/en/players/a93b6f4e/Paul-Jaeckel"
"13796","Josip Juranović_2023",2023,"Union Berlin","Bundesliga","Josip Juranović","CRO","DF","26",1995,10.4,9,7,5,2,2,7,18,38.9,11,9,3,6,6,15,22,1,"https://fbref.com/en/players/0a084b35/Josip-Juranovic"
"13797","Rani Khedira_2023",2023,"Union Berlin","Bundesliga","Rani Khedira","GER","MF","28",1994,32,60,33,21,32,7,25,50,50,25,33,10,23,40,100,33,0,"https://fbref.com/en/players/59e4b92e/Rani-Khedira"
"13798","Robin Knoche_2023",2023,"Union Berlin","Bundesliga","Robin Knoche","GER","DF","30",1992,31.9,45,29,29,12,4,24,47,51.1,23,35,18,17,38,83,140,0,"https://fbref.com/en/players/6bd5cd5d/Robin-Knoche"
"13799","Aïssa Laïdouni_2023",2023,"Union Berlin","Bundesliga","Aïssa Laïdouni","TUN","MF","25",1996,9.7,14,7,6,8,0,5,17,29.4,12,22,4,18,9,23,3,0,"https://fbref.com/en/players/22798128/Aissa-Laidouni"
"13800","Diogo Leite_2023",2023,"Union Berlin","Bundesliga","Diogo Leite","POR","DF","23",1999,25,35,20,21,14,0,21,34,61.8,13,23,14,9,26,61,99,1,"https://fbref.com/en/players/c4987edc/Diogo-Leite"
"13801","Jamie Leweling_2023",2023,"Union Berlin","Bundesliga","Jamie Leweling","GER","FW,MF","21",2001,2.9,5,3,2,2,1,3,5,60,2,3,0,3,1,6,0,0,"https://fbref.com/en/players/13fe7b69/Jamie-Leweling"
"13802","Sven Michel_2023",2023,"Union Berlin","Bundesliga","Sven Michel","GER","FW,MF","32",1990,5.5,9,5,1,5,3,4,8,50,4,5,1,4,0,9,4,0,"https://fbref.com/en/players/1e274a0a/Sven-Michel"
"13803","Levin Öztunalı_2023",2023,"Union Berlin","Bundesliga","Levin Öztunalı","GER","MF","26",1996,0.1,0,0,0,0,0,0,1,0,1,0,0,0,0,0,0,0,"https://fbref.com/en/players/66385c46/Levin-Oztunali"
"13804","Miloš Pantović_2023",2023,"Union Berlin","Bundesliga","Miloš Pantović","SRB","MF","26",1996,2.3,4,2,4,0,0,3,5,60,2,3,0,3,0,4,5,0,"https://fbref.com/en/players/5dc15574/Milos-Pantovic"
"13805","Jordan Pefok_2023",2023,"Union Berlin","Bundesliga","Jordan Pefok","USA","FW","26",1996,15.1,15,7,3,4,8,2,17,11.8,15,17,5,12,4,19,15,0,"https://fbref.com/en/players/b684a484/Jordan-Pefok"
"13806","Tymoteusz Puchacz_2023",2023,"Union Berlin","Bundesliga","Tymoteusz Puchacz","POL","DF","23",1999,0.6,1,0,1,0,0,0,0,NA,0,0,0,0,0,1,1,0,"https://fbref.com/en/players/c68b1b13/Tymoteusz-Puchacz"
"13807","Jérôme Roussillon_2023",2023,"Union Berlin","Bundesliga","Jérôme Roussillon","FRA","DF","29",1993,10.6,16,9,6,8,2,8,12,66.7,4,7,2,5,4,20,22,0,"https://fbref.com/en/players/13203c45/Jerome-Roussillon"
"13808","Julian Ryerson_2023",2023,"Union Berlin","Bundesliga","Julian Ryerson","NOR","DF","24",1997,11.5,28,17,17,10,1,15,25,60,10,15,3,12,12,40,19,0,"https://fbref.com/en/players/009a4f60/Julian-Ryerson"
"13809","Frederik Rønnow_2023",2023,"Union Berlin","Bundesliga","Frederik Rønnow","DEN","GK","29",1992,29,0,0,0,0,0,0,5,0,5,0,0,0,0,0,9,1,"https://fbref.com/en/players/a70b8345/Frederik-Ronnow"
"13810","András Schäfer_2023",2023,"Union Berlin","Bundesliga","András Schäfer","HUN","MF","23",1999,9.6,21,9,7,12,2,6,14,42.9,8,12,2,10,4,25,11,0,"https://fbref.com/en/players/049751d7/Andras-Schafer"
"13811","Paul Seguin_2023",2023,"Union Berlin","Bundesliga","Paul Seguin","GER","MF","27",1995,7.7,17,8,9,4,4,8,18,44.4,10,6,0,6,6,23,7,0,"https://fbref.com/en/players/8872ed17/Paul-Seguin"
"13812","Tim Skarke_2023",2023,"Union Berlin","Bundesliga","Tim Skarke","GER","DF,MF","25",1996,0.6,1,1,0,0,1,0,0,NA,0,1,0,1,0,1,0,0,"https://fbref.com/en/players/65857fdf/Tim-Skarke"
"13813","Morten Thorsby_2023",2023,"Union Berlin","Bundesliga","Morten Thorsby","NOR","MF","26",1996,9.3,22,10,9,11,2,13,21,61.9,8,11,5,6,3,25,20,0,"https://fbref.com/en/players/d1b49282/Morten-Thorsby"
"13814","Christopher Trimmel_2023",2023,"Union Berlin","Bundesliga","Christopher Trimmel","AUT","DF","35",1987,20.1,31,16,16,12,3,20,31,64.5,11,14,1,13,25,56,48,0,"https://fbref.com/en/players/056d2d95/Christopher-Trimmel"
"13815","Domingos André Ribeiro Almeida_2023",2023,"Valencia","La Liga","Domingos André Ribeiro Almeida","POR","MF","22",2000,28.2,66,42,23,32,11,26,57,45.6,31,26,0,26,20,86,16,1,"https://fbref.com/en/players/e6697917/Domingos-Andre-Ribeiro-Almeida"
"13816","Samu Castillejo_2023",2023,"Valencia","La Liga","Samu Castillejo","ESP","FW,MF","27",1995,15.1,21,12,8,9,4,8,40,20,32,21,2,19,9,30,2,0,"https://fbref.com/en/players/130a7a3f/Samu-Castillejo"
"13817","Edinson Cavani_2023",2023,"Valencia","La Liga","Edinson Cavani","URU","FW","35",1987,16.1,7,4,3,3,1,3,15,20,12,10,3,7,2,9,11,0,"https://fbref.com/en/players/527f063d/Edinson-Cavani"
"13818","Eray Cömert_2023",2023,"Valencia","La Liga","Eray Cömert","SUI","DF","24",1998,18.6,35,23,24,10,1,17,33,51.5,16,23,8,15,29,64,76,1,"https://fbref.com/en/players/15937e17/Eray-Comert"
"13819","Thierry Correia_2023",2023,"Valencia","La Liga","Thierry Correia","POR","DF","23",1999,22.3,71,52,46,22,3,31,54,57.4,23,25,2,23,24,95,54,2,"https://fbref.com/en/players/c78b352d/Thierry-Correia"
"13820","Mouctar Diakhaby_2023",2023,"Valencia","La Liga","Mouctar Diakhaby","GUI","DF","25",1996,27.2,30,16,19,11,0,13,20,65,7,30,17,13,20,50,111,2,"https://fbref.com/en/players/d2110326/Mouctar-Diakhaby"
"13821","Hugo Duro_2023",2023,"Valencia","La Liga","Hugo Duro","ESP","FW","22",1999,15.4,15,12,2,6,7,7,17,41.2,10,11,1,10,2,17,7,1,"https://fbref.com/en/players/37e103f8/Hugo-Duro"
"13822","Dimitri Foulquier_2023",2023,"Valencia","La Liga","Dimitri Foulquier","FRA","DF","29",1993,19.3,31,19,17,8,6,20,28,71.4,8,19,3,16,14,45,40,0,"https://fbref.com/en/players/45e17712/Dimitri-Foulquier"
"13823","Maxi Gómez_2023",2023,"Valencia","La Liga","Maxi Gómez","URU","FW","25",1996,1.2,0,0,0,0,0,0,0,NA,0,0,0,0,0,0,2,0,"https://fbref.com/en/players/4c2e9442/Maxi-Gomez"
"13824","Nicolás González_2023",2023,"Valencia","La Liga","Nicolás González","ESP","MF","20",2002,15.6,27,15,11,13,3,9,25,36,16,21,7,14,19,46,16,0,"https://fbref.com/en/players/2c56a792/Nicolas-Gonzalez"
"13825","Javier Guerra_2023",2023,"Valencia","La Liga","Javier Guerra","ESP","MF","19",2003,6.7,16,13,7,4,5,9,20,45,11,8,1,7,11,27,9,0,"https://fbref.com/en/players/3828f130/Javier-Guerra"
"13826","Hugo Guillamón_2023",2023,"Valencia","La Liga","Hugo Guillamón","ESP","MF","22",2000,18.1,20,12,10,8,2,8,24,33.3,16,14,2,12,19,39,30,2,"https://fbref.com/en/players/f7c12fbf/Hugo-Guillamon"
"13827","Justin Kluivert_2023",2023,"Valencia","La Liga","Justin Kluivert","NED","FW,MF","23",1999,16.1,17,14,7,4,6,6,12,50,6,4,0,4,7,24,4,0,"https://fbref.com/en/players/4c3a6744/Justin-Kluivert"
"13828","Toni Lato_2023",2023,"Valencia","La Liga","Toni Lato","ESP","DF,MF","24",1997,10.2,23,11,9,12,2,9,21,42.9,12,10,1,9,6,29,14,0,"https://fbref.com/en/players/8e088e04/Toni-Lato"
"13829","José Luis Gayà_2023",2023,"Valencia","La Liga","José Luis Gayà","ESP","DF","27",1995,30.1,80,46,61,16,3,43,74,58.1,31,28,9,19,23,103,48,0,"https://fbref.com/en/players/b05e2dbd/Jose-Luis-Gaya"
"13830","Giorgi Mamardashvili_2023",2023,"Valencia","La Liga","Giorgi Mamardashvili","GEO","GK","21",2000,38,0,0,0,0,0,0,0,NA,0,0,0,0,1,1,11,4,"https://fbref.com/en/players/d4b73232/Giorgi-Mamardashvili"
"13831","Maranhão_2023",2023,"Valencia","La Liga","Maranhão","BRA","FW,MF","25",1996,5,4,1,1,1,2,1,2,50,1,4,1,3,0,4,0,0,"https://fbref.com/en/players/ae86d473/Maranhao"
"13832","Alberto Marí_2023",2023,"Valencia","La Liga","Alberto Marí","ESP","FW,MF","21",2001,1,0,0,0,0,0,0,2,0,2,0,0,0,0,0,1,0,"https://fbref.com/en/players/44330c36/Alberto-Mari"
"13833","Ilaix Moriba_2023",2023,"Valencia","La Liga","Ilaix Moriba","GUI","MF","19",2003,11.2,35,16,14,17,4,14,24,58.3,10,11,1,10,4,39,12,0,"https://fbref.com/en/players/f4c69aa6/Ilaix-Moriba"
"13834","Cristhian Mosquera_2023",2023,"Valencia","La Liga","Cristhian Mosquera","COL","DF","18",2004,1.6,4,2,3,1,0,4,5,80,1,1,0,1,1,5,5,0,"https://fbref.com/en/players/dc1ce4f5/Cristhian-Mosquera"
"13835","Yunus Musah_2023",2023,"Valencia","La Liga","Yunus Musah","USA","MF","19",2002,23.4,48,35,17,23,8,20,30,66.7,10,20,1,19,11,59,16,2,"https://fbref.com/en/players/b51b1b9c/Yunus-Musah"
"13836","Diego Noguerol_2023",2023,"Valencia","La Liga","Diego Noguerol","ESP","FW,MF","20",2002,5,2,2,1,1,0,2,15,13.3,13,9,0,9,3,5,5,0,"https://fbref.com/en/players/c487901c/Diego-Noguerol"
"13837","Cenk Özkacar_2023",2023,"Valencia","La Liga","Cenk Özkacar","TUR","DF","21",2000,15.2,27,20,17,10,0,14,19,73.7,5,14,2,12,12,39,47,4,"https://fbref.com/en/players/9a93efc9/Cenk-Ozkacar"
"13838","Gabriel Paulista_2023",2023,"Valencia","La Liga","Gabriel Paulista","BRA","DF","31",1990,16.7,17,9,13,4,0,13,19,68.4,6,22,14,8,32,49,79,2,"https://fbref.com/en/players/b7ca5c51/Gabriel-Paulista"
"13839","Francisco Perez_2023",2023,"Valencia","La Liga","Francisco Perez","ESP","FW,MF","19",2002,1.6,1,1,1,0,0,0,3,0,3,0,0,0,0,1,1,0,"https://fbref.com/en/players/3d79a68c/Francisco-Perez"
"13840","Samuel_2023",2023,"Valencia","La Liga","Samuel","BRA","FW,MF","22",1999,32.1,66,43,17,37,12,26,72,36.1,46,34,0,34,18,84,16,0,"https://fbref.com/en/players/2a295d33/Samuel"
"13841","Carlos Soler_2023",2023,"Valencia","La Liga","Carlos Soler","ESP","MF","25",1997,2.7,2,0,0,1,1,2,3,66.7,1,1,0,1,0,2,2,0,"https://fbref.com/en/players/fed17f5a/Carlos-Soler"
"13842","Jesus Vazquez_2023",2023,"Valencia","La Liga","Jesus Vazquez","ESP","DF,MF","19",2003,3.4,13,8,9,1,3,6,11,54.5,5,4,0,4,1,14,8,0,"https://fbref.com/en/players/106c142c/Jesus-Vazquez"
"13843","Álvaro Aceves_2023",2023,"Valladolid","La Liga","Álvaro Aceves","ESP","GK","19",2003,0.1,0,0,0,0,0,0,0,NA,0,0,0,0,0,0,0,0,"https://fbref.com/en/players/be6faae0/Alvaro-Aceves"
"13844","Álvaro Aguado_2023",2023,"Valladolid","La Liga","Álvaro Aguado","ESP","MF","26",1996,21,27,15,13,11,3,15,25,60,10,16,4,12,13,40,15,0,"https://fbref.com/en/players/014aa7bd/Alvaro-Aguado"
"13845","Babatunde Akinsola_2023",2023,"Valladolid","La Liga","Babatunde Akinsola","NGA","FW","19",2003,0.1,1,1,0,0,1,0,0,NA,0,0,0,0,0,1,0,0,"https://fbref.com/en/players/733aab44/Babatunde-Akinsola"
"13846","Selim Amallah_2023",2023,"Valladolid","La Liga","Selim Amallah","MAR","MF,FW","25",1996,3,15,9,7,8,0,5,8,62.5,3,2,0,2,5,20,2,0,"https://fbref.com/en/players/00eba9c9/Selim-Amallah"
"13847","Anuar_2023",2023,"Valladolid","La Liga","Anuar","MAR","MF,FW","27",1995,2.3,4,4,0,1,3,0,0,NA,0,5,2,3,3,7,3,0,"https://fbref.com/en/players/c93231dc/Anuar"
"13848","Roberto Arroyo_2023",2023,"Valladolid","La Liga","Roberto Arroyo","ESP","MF","18",2003,0.2,1,1,0,1,0,1,1,100,0,0,0,0,0,1,0,0,"https://fbref.com/en/players/6091cf45/Roberto-Arroyo"
"13849","Sergio Asenjo_2023",2023,"Valladolid","La Liga","Sergio Asenjo","ESP","GK","33",1989,10,0,0,0,0,0,0,0,NA,0,0,0,0,0,0,10,2,"https://fbref.com/en/players/9f0ea33f/Sergio-Asenjo"
"13850","Sergio Escudero_2023",2023,"Valladolid","La Liga","Sergio Escudero","ESP","DF","32",1989,16,33,19,21,8,4,15,35,42.9,20,26,6,20,26,59,46,0,"https://fbref.com/en/players/b0616e3d/Sergio-Escudero"
"13851","Zouhair Feddal_2023",2023,"Valladolid","La Liga","Zouhair Feddal","MAR","DF","33",1989,4.2,4,2,1,3,0,3,4,75,1,9,9,0,5,9,27,0,"https://fbref.com/en/players/89151b16/Zouhair-Feddal"
"13852","Joaquín Fernández_2023",2023,"Valladolid","La Liga","Joaquín Fernández","ESP","DF","26",1996,24,35,28,20,11,4,19,30,63.3,11,31,22,9,27,62,98,1,"https://fbref.com/en/players/b86a64b2/Joaquin-Fernandez"
"13853","Iván Fresneda_2023",2023,"Valladolid","La Liga","Iván Fresneda","ESP","DF","17",2004,19.4,48,34,31,13,4,29,47,61.7,18,32,8,24,15,63,60,0,"https://fbref.com/en/players/29d0f2ac/Ivan-Fresneda"
"13854","Sékou Gassama_2023",2023,"Valladolid","La Liga","Sékou Gassama","SEN","FW","27",1995,0.4,0,0,0,0,0,0,0,NA,0,0,0,0,0,0,0,0,"https://fbref.com/en/players/475a738b/Sekou-Gassama"
"13855","Sergi Guardiola_2023",2023,"Valladolid","La Liga","Sergi Guardiola","ESP","FW","31",1991,5.6,12,7,6,5,1,2,4,50,2,6,0,6,2,14,7,0,"https://fbref.com/en/players/32974271/Sergi-Guardiola"
"13856","Martin Hongla_2023",2023,"Valladolid","La Liga","Martin Hongla","CMR","DF,MF","24",1998,14.5,18,13,13,5,0,11,21,52.4,10,15,12,3,8,26,46,1,"https://fbref.com/en/players/b85bf253/Martin-Hongla"
"13857","Kenedy_2023",2023,"Valladolid","La Liga","Kenedy","BRA","FW,DF","26",1996,3.1,6,2,3,3,0,2,4,50,2,2,0,2,1,7,0,0,"https://fbref.com/en/players/5eebbfdf/Kenedy"
"13858","Cyle Larin_2023",2023,"Valladolid","La Liga","Cyle Larin","CAN","FW","27",1995,16.3,9,3,2,4,3,3,7,42.9,4,6,3,3,0,9,15,0,"https://fbref.com/en/players/e7af9060/Cyle-Larin"
"13859","Sergio León_2023",2023,"Valladolid","La Liga","Sergio León","ESP","FW","33",1989,14.8,6,4,0,4,2,3,6,50,3,6,0,6,0,6,4,0,"https://fbref.com/en/players/0a0cc13c/Sergio-Leon"
"13860","Darwin Machís_2023",2023,"Valladolid","La Liga","Darwin Machís","VEN","FW","29",1993,6.7,3,2,0,2,1,1,8,12.5,7,5,0,5,3,6,4,0,"https://fbref.com/en/players/ed6ea4d9/Darwin-Machis"
"13861","Mickael Malsa_2023",2023,"Valladolid","La Liga","Mickael Malsa","MTQ","MF","26",1995,0.8,2,2,1,1,0,1,4,25,3,1,1,0,2,4,3,0,"https://fbref.com/en/players/bbc19252/Mickael-Malsa"
"13862","Jordi Masip_2023",2023,"Valladolid","La Liga","Jordi Masip","ESP","GK","33",1989,27.9,0,0,0,0,0,0,2,0,2,0,0,0,1,1,3,2,"https://fbref.com/en/players/8fae77ea/Jordi-Masip"
"13863","Roque Mesa_2023",2023,"Valladolid","La Liga","Roque Mesa","ESP","MF","33",1989,18,27,15,16,10,1,12,38,31.6,26,16,4,12,13,40,18,0,"https://fbref.com/en/players/7c4243d4/Roque-Mesa"
"13864","Monchu_2023",2023,"Valladolid","La Liga","Monchu","ESP","MF","22",1999,22.6,50,29,20,21,9,19,46,41.3,27,28,11,17,18,68,22,1,"https://fbref.com/en/players/8ac501f5/Monchu"
"13865","Juanjo Narváez_2023",2023,"Valladolid","La Liga","Juanjo Narváez","COL","MF,FW","27",1995,1.6,1,1,1,0,0,1,1,100,0,2,0,2,0,1,0,0,"https://fbref.com/en/players/485e4939/Juanjo-Narvaez"
"13866","Lucas Olaza_2023",2023,"Valladolid","La Liga","Lucas Olaza","URU","DF","28",1994,16.6,24,14,12,10,2,17,26,65.4,9,20,8,12,14,38,34,0,"https://fbref.com/en/players/4cee5954/Lucas-Olaza"
"13867","Lucas Oliveira Rosa_2023",2023,"Valladolid","La Liga","Lucas Oliveira Rosa","BRA","DF","22",2000,10.3,39,18,23,10,6,12,20,60,8,12,2,10,15,54,24,0,"https://fbref.com/en/players/5132b92c/Lucas-Oliveira-Rosa"
"13868","Kike Pérez_2023",2023,"Valladolid","La Liga","Kike Pérez","ESP","MF","25",1997,25.6,67,33,30,32,5,25,68,36.8,43,26,7,19,20,87,28,0,"https://fbref.com/en/players/237a3851/Kike-Perez"
"13869","Luis Pérez_2023",2023,"Valladolid","La Liga","Luis Pérez","ESP","DF","27",1995,13.5,44,24,26,12,6,27,38,71.1,11,13,4,9,16,60,29,0,"https://fbref.com/en/players/b7c04927/Luis-Perez"
"13870","Óscar Plano_2023",2023,"Valladolid","La Liga","Óscar Plano","ESP","FW,MF","31",1991,22.6,40,25,9,17,14,12,37,32.4,25,26,2,24,29,69,23,0,"https://fbref.com/en/players/7c388b20/Oscar-Plano"
"13871","Gonzalo Plata_2023",2023,"Valladolid","La Liga","Gonzalo Plata","ECU","FW","21",2000,25.6,66,35,31,24,11,23,70,32.9,47,40,0,40,12,78,10,1,"https://fbref.com/en/players/54bcdeb0/Gonzalo-Plata"
"13872","Manuel Pozo_2023",2023,"Valladolid","La Liga","Manuel Pozo","ESP","FW","20",2001,0.2,0,0,0,0,0,0,0,NA,0,2,0,2,2,2,0,0,"https://fbref.com/en/players/35440884/Manuel-Pozo"
"13873","Iván Sánchez_2023",2023,"Valladolid","La Liga","Iván Sánchez","ESP","MF,FW","29",1992,12.8,20,14,8,8,4,10,27,37,17,14,1,13,8,28,4,0,"https://fbref.com/en/players/70107d4d/Ivan-Sanchez"
"13874","Javi Sánchez_2023",2023,"Valladolid","La Liga","Javi Sánchez","ESP","DF","25",1997,26.6,43,26,27,15,1,17,26,65.4,9,32,22,10,46,89,116,0,"https://fbref.com/en/players/60359288/Javi-Sanchez"
"13875","David Torres_2023",2023,"Valladolid","La Liga","David Torres","ESP","DF","19",2003,4.3,1,1,0,1,0,1,1,100,0,4,2,2,3,4,8,0,"https://fbref.com/en/players/381dbcfc/David-Torres"
"13876","Toni Villa_2023",2023,"Valladolid","La Liga","Toni Villa","ESP","MF","27",1995,1,6,3,2,3,1,4,9,44.4,5,0,0,0,0,6,0,0,"https://fbref.com/en/players/636eae97/Toni-Villa"
"13877","Shon Weissman_2023",2023,"Valladolid","La Liga","Shon Weissman","ISR","FW","26",1996,8.3,2,1,1,1,0,0,4,0,4,8,0,8,1,3,7,0,"https://fbref.com/en/players/379dc075/Shon-Weissman"
"13878","Jawad El Yamiq_2023",2023,"Valladolid","La Liga","Jawad El Yamiq","MAR","DF","30",1992,17.9,17,11,10,7,0,6,11,54.5,5,27,19,8,37,54,101,0,"https://fbref.com/en/players/f6f6b6e8/Jawad-El-Yamiq"
"13879","Raúl Albiol_2023",2023,"Villarreal","La Liga","Raúl Albiol","ESP","DF","36",1985,23.5,25,17,17,6,2,14,18,77.8,4,17,13,4,14,39,111,0,"https://fbref.com/en/players/4bd414c1/Raul-Albiol"
"13880","Alex Baena_2023",2023,"Villarreal","La Liga","Alex Baena","ESP","MF,FW","21",2001,21.6,30,17,9,15,6,15,45,33.3,30,15,3,12,7,37,16,0,"https://fbref.com/en/players/518f2234/Alex-Baena"
"13881","Étienne Capoue_2023",2023,"Villarreal","La Liga","Étienne Capoue","FRA","MF","34",1988,21.7,21,12,6,13,2,10,18,55.6,8,12,5,7,19,40,20,1,"https://fbref.com/en/players/5acc4a10/Etienne-Capoue"
"13882","Samuel Chukwueze_2023",2023,"Villarreal","La Liga","Samuel Chukwueze","NGA","FW,MF","23",1999,26,14,7,7,2,5,7,23,30.4,16,13,0,13,12,26,16,0,"https://fbref.com/en/players/b8a642fc/Samuel-Chukwueze"
"13883","Diego Collado_2023",2023,"Villarreal","La Liga","Diego Collado","ESP","FW","21",2001,0.1,0,0,0,0,0,0,0,NA,0,0,0,0,0,0,0,0,"https://fbref.com/en/players/b3f62bfc/Diego-Collado"
"13884","Francis Coquelin_2023",2023,"Villarreal","La Liga","Francis Coquelin","FRA","MF","31",1991,8.3,18,13,7,9,2,7,7,100,0,8,2,6,9,27,7,0,"https://fbref.com/en/players/a6951bf8/Francis-Coquelin"
"13885","Jorge Cuenca_2023",2023,"Villarreal","La Liga","Jorge Cuenca","ESP","DF","22",1999,5.6,9,7,7,2,0,4,7,57.1,3,10,8,2,6,15,44,0,"https://fbref.com/en/players/0abc51f2/Jorge-Cuenca"
"13886","Arnaut Danjuma_2023",2023,"Villarreal","La Liga","Arnaut Danjuma","NED","FW","25",1997,5.3,3,3,1,0,2,1,2,50,1,0,0,0,0,3,1,1,"https://fbref.com/en/players/f08490a6/Arnaut-Danjuma"
"13887","Alberto Del Moral_2023",2023,"Villarreal","La Liga","Alberto Del Moral","ESP","MF","22",2000,0.1,0,0,0,0,0,0,0,NA,0,0,0,0,0,0,0,0,"https://fbref.com/en/players/84a85b48/Alberto-Del-Moral"
"13888","Mamadou Fall_2023",2023,"Villarreal","La Liga","Mamadou Fall","SEN","DF","19",2002,0.3,0,0,0,0,0,0,0,NA,0,1,0,1,0,0,1,0,"https://fbref.com/en/players/805a2a11/Mamadou-Fall"
"13889","Kiko Femenía_2023",2023,"Villarreal","La Liga","Kiko Femenía","ESP","DF","31",1991,12.6,18,9,14,3,1,13,18,72.2,5,15,6,9,20,38,22,0,"https://fbref.com/en/players/e5d01ecf/Kiko-Femenia"
"13890","Juan Foyth_2023",2023,"Villarreal","La Liga","Juan Foyth","ARG","DF","24",1998,21.8,73,48,49,22,2,41,57,71.9,16,32,11,21,20,93,68,0,"https://fbref.com/en/players/6c7762c3/Juan-Foyth"
"13891","Haissem Hassan_2023",2023,"Villarreal","La Liga","Haissem Hassan","FRA","FW,MF","20",2002,0.6,0,0,0,0,0,0,2,0,2,0,0,0,1,1,0,0,"https://fbref.com/en/players/e0979e74/Haissem-Hassan"
"13892","Nicolas Jackson_2023",2023,"Villarreal","La Liga","Nicolas Jackson","SEN","FW","21",2001,17.8,14,11,2,10,2,2,8,25,6,18,2,16,2,16,4,0,"https://fbref.com/en/players/9c36ed83/Nicolas-Jackson"
"13893","Filip Jørgensen_2023",2023,"Villarreal","La Liga","Filip Jørgensen","DEN","GK","20",2002,2,0,0,0,0,0,0,1,0,1,0,0,0,0,0,0,0,"https://fbref.com/en/players/0107757e/Filip-Jorgensen"
"13894","Giovani Lo Celso_2023",2023,"Villarreal","La Liga","Giovani Lo Celso","ARG","MF,FW","26",1996,12.5,32,28,7,15,10,12,21,57.1,9,14,2,12,6,38,5,0,"https://fbref.com/en/players/d7553721/Giovani-Lo-Celso"
"13895","José Luis Morales_2023",2023,"Villarreal","La Liga","José Luis Morales","ESP","FW,MF","35",1987,13.5,7,6,1,2,4,5,17,29.4,12,12,1,11,2,9,2,0,"https://fbref.com/en/players/4a478107/Jose-Luis-Morales"
"13896","Aïssa Mandi_2023",2023,"Villarreal","La Liga","Aïssa Mandi","ALG","DF","30",1991,16.2,18,10,14,3,1,6,12,50,6,19,14,5,21,39,58,0,"https://fbref.com/en/players/fbd6378b/Aissa-Mandi"
"13897","Johan Mojica_2023",2023,"Villarreal","La Liga","Johan Mojica","COL","DF","29",1992,7.1,13,9,9,3,1,5,9,55.6,4,8,3,5,4,17,14,1,"https://fbref.com/en/players/608f2092/Johan-Mojica"
"13898","Alberto Moreno_2023",2023,"Villarreal","La Liga","Alberto Moreno","ESP","DF","30",1992,14.4,23,12,10,10,3,11,24,45.8,13,12,1,11,23,46,26,0,"https://fbref.com/en/players/11b9265b/Alberto-Moreno"
"13899","Gerard Moreno_2023",2023,"Villarreal","La Liga","Gerard Moreno","ESP","FW","30",1992,13.7,11,6,0,6,5,3,6,50,3,6,2,4,5,16,10,0,"https://fbref.com/en/players/81f0781e/Gerard-Moreno"
"13900","Manu Morlanes_2023",2023,"Villarreal","La Liga","Manu Morlanes","ESP","MF","23",1999,1.8,3,2,2,1,0,3,3,100,0,3,2,1,1,4,2,0,"https://fbref.com/en/players/a0255c67/Manu-Morlanes"
"13901","Fernando Niño_2023",2023,"Villarreal","La Liga","Fernando Niño","ESP","MF,FW","21",2000,0.2,0,0,0,0,0,0,0,NA,0,0,0,0,0,0,0,0,"https://fbref.com/en/players/81d5c497/Fernando-Nino"
"13902","Daniel Parejo_2023",2023,"Villarreal","La Liga","Daniel Parejo","ESP","MF","33",1989,36.5,71,40,32,23,16,30,75,40,45,40,12,28,29,100,31,2,"https://fbref.com/en/players/7460ca0d/Daniel-Parejo"
"13903","Pascu_2023",2023,"Villarreal","La Liga","Pascu","ESP","DF,FW","19",2003,0.1,0,0,0,0,0,0,0,NA,0,0,0,0,0,0,0,0,"https://fbref.com/en/players/a2d9cf74/Pascu"
"13904","Alfonso Pedraza_2023",2023,"Villarreal","La Liga","Alfonso Pedraza","ESP","DF","26",1996,18.1,35,26,20,10,5,19,29,65.5,10,19,1,18,18,53,31,0,"https://fbref.com/en/players/63f04c6c/Alfonso-Pedraza"
"13905","Yeremi Pino_2023",2023,"Villarreal","La Liga","Yeremi Pino","ESP","FW,MF","19",2002,27.2,62,38,25,20,17,21,56,37.5,35,41,4,37,15,77,36,0,"https://fbref.com/en/players/540ec57b/Yeremi-Pino"
"13906","Pepe Reina_2023",2023,"Villarreal","La Liga","Pepe Reina","ESP","GK","39",1982,22,0,0,0,0,0,0,1,0,1,0,0,0,1,1,4,4,"https://fbref.com/en/players/e358587b/Pepe-Reina"
"13907","Gerónimo Rulli_2023",2023,"Villarreal","La Liga","Gerónimo Rulli","ARG","GK","30",1992,14,0,0,0,0,0,0,0,NA,0,1,0,1,1,1,6,2,"https://fbref.com/en/players/625c144a/Geronimo-Rulli"
"13908","Ramón Terrats_2023",2023,"Villarreal","La Liga","Ramón Terrats","ESP","MF","21",2000,9.1,15,10,3,8,4,9,17,52.9,8,11,4,7,8,23,6,2,"https://fbref.com/en/players/f36016a5/Ramon-Terrats"
"13909","Pau Torres_2023",2023,"Villarreal","La Liga","Pau Torres","ESP","DF","25",1997,33.9,43,25,25,13,5,23,36,63.9,13,36,27,9,13,56,146,3,"https://fbref.com/en/players/532e1e4f/Pau-Torres"
"13910","Manu Trigueros_2023",2023,"Villarreal","La Liga","Manu Trigueros","ESP","MF","30",1991,9.2,20,14,9,5,6,9,22,40.9,13,9,2,7,5,25,4,0,"https://fbref.com/en/players/963829d0/Manu-Trigueros"
"13911","Felix Agu_2023",2023,"Werder Bremen","Bundesliga","Felix Agu","GER","DF,FW","22",1999,0.5,1,0,0,1,0,0,0,NA,0,1,1,0,0,1,0,0,"https://fbref.com/en/players/cb6d81b3/Felix-Agu"
"13912","Leonardo Bittencourt_2023",2023,"Werder Bremen","Bundesliga","Leonardo Bittencourt","GER","MF,DF","28",1993,18.1,53,28,20,25,8,25,62,40.3,37,13,0,13,10,63,15,0,"https://fbref.com/en/players/dc62fbee/Leonardo-Bittencourt"
"13913","Lee Buchanan_2023",2023,"Werder Bremen","Bundesliga","Lee Buchanan","ENG","DF,FW","21",2001,5.2,14,10,2,11,1,6,12,50,6,5,0,5,12,26,21,0,"https://fbref.com/en/players/45e95f21/Lee-Buchanan"
"13914","Oliver Burke_2023",2023,"Werder Bremen","Bundesliga","Oliver Burke","SCO","FW,MF","25",1997,3,1,0,0,0,1,0,0,NA,0,2,0,2,0,1,0,0,"https://fbref.com/en/players/f631c17f/Oliver-Burke"
"13915","Fabio Chiarodia_2023",2023,"Werder Bremen","Bundesliga","Fabio Chiarodia","ITA","DF","17",2005,0.7,0,0,0,0,0,0,0,NA,0,1,0,1,2,2,4,0,"https://fbref.com/en/players/48780156/Fabio-Chiarodia"
"13916","Eren Dinkçi_2023",2023,"Werder Bremen","Bundesliga","Eren Dinkçi","GER","FW,MF","20",2001,2.6,5,5,2,1,2,2,6,33.3,4,2,0,2,0,5,2,0,"https://fbref.com/en/players/4ccd8957/Eren-Dinkci"
"13917","Marvin Ducksch_2023",2023,"Werder Bremen","Bundesliga","Marvin Ducksch","GER","FW","28",1994,31.7,8,3,2,4,2,3,16,18.8,13,13,2,11,9,17,41,1,"https://fbref.com/en/players/638a4d71/Marvin-Ducksch"
"13918","Marco Friedl_2023",2023,"Werder Bremen","Bundesliga","Marco Friedl","AUT","DF","24",1998,28.8,62,46,40,22,0,41,68,60.3,27,46,17,29,58,120,127,1,"https://fbref.com/en/players/f86ad3f5/Marco-Friedl"
"13919","Niclas Füllkrug_2023",2023,"Werder Bremen","Bundesliga","Niclas Füllkrug","GER","FW","29",1993,27.5,9,4,0,6,3,3,13,23.1,10,13,4,9,1,10,24,0,"https://fbref.com/en/players/4f16405e/Niclas-Fullkrug"
"13920","Christian Groß_2023",2023,"Werder Bremen","Bundesliga","Christian Groß","GER","MF","33",1989,21,56,25,20,34,2,29,60,48.3,31,20,5,15,23,79,38,1,"https://fbref.com/en/players/14a7af33/Christian-Gross"
"13921","Ilia Gruev_2023",2023,"Werder Bremen","Bundesliga","Ilia Gruev","BUL","MF","22",2000,17.6,44,27,16,25,3,18,31,58.1,13,23,6,17,22,66,21,1,"https://fbref.com/en/players/1fc4f3d1/Ilia-Gruev"
"13922","Anthony Jung_2023",2023,"Werder Bremen","Bundesliga","Anthony Jung","GER","DF,FW","30",1991,29.1,46,27,19,20,7,31,58,53.4,27,30,6,24,22,68,63,0,"https://fbref.com/en/players/de838f86/Anthony-Jung"
"13923","Jean-Manuel Mbom_2023",2023,"Werder Bremen","Bundesliga","Jean-Manuel Mbom","GER","MF","22",2000,0.1,0,0,0,0,0,0,1,0,1,0,0,0,0,0,0,0,"https://fbref.com/en/players/1a5d7cb9/Jean-Manuel-Mbom"
"13924","Jiří Pavlenka_2023",2023,"Werder Bremen","Bundesliga","Jiří Pavlenka","CZE","GK","30",1992,32.3,1,0,1,0,0,1,5,20,4,1,0,1,3,4,21,1,"https://fbref.com/en/players/0a1cb833/Jiri-Pavlenka"
"13925","Maximilian Philipp_2023",2023,"Werder Bremen","Bundesliga","Maximilian Philipp","GER","FW,MF","28",1994,4.9,6,5,3,2,1,1,9,11.1,8,7,1,6,3,9,4,0,"https://fbref.com/en/players/061e8e23/Maximilian-Philipp"
"13926","Amos Pieper_2023",2023,"Werder Bremen","Bundesliga","Amos Pieper","GER","DF","24",1998,21.7,46,28,25,19,2,24,40,60,16,23,11,12,30,76,94,1,"https://fbref.com/en/players/526ea7cc/Amos-Pieper"
"13927","Nicolai Rapp_2023",2023,"Werder Bremen","Bundesliga","Nicolai Rapp","GER","MF,DF","25",1996,0.8,3,1,3,0,0,0,3,0,3,0,0,0,0,3,1,0,"https://fbref.com/en/players/c8b3a472/Nicolai-Rapp"
"13928","Dikeni Salifou_2023",2023,"Werder Bremen","Bundesliga","Dikeni Salifou","TOG","MF","19",2003,0,0,0,0,0,0,0,0,NA,0,0,0,0,0,0,0,0,"https://fbref.com/en/players/e1830c52/Dikeni-Salifou"
"13929","Romano Schmid_2023",2023,"Werder Bremen","Bundesliga","Romano Schmid","AUT","MF,FW","22",2000,16.9,24,15,5,13,6,10,22,45.5,12,21,3,18,7,31,12,0,"https://fbref.com/en/players/220ace7e/Romano-Schmid"
"13930","Niklas Schmidt_2023",2023,"Werder Bremen","Bundesliga","Niklas Schmidt","GER","MF","24",1998,12.1,25,10,12,11,2,13,28,46.4,15,10,0,10,5,30,12,0,"https://fbref.com/en/players/b9ae8560/Niklas-Schmidt"
"13931","Jens Stage_2023",2023,"Werder Bremen","Bundesliga","Jens Stage","DEN","MF","25",1996,20.6,34,17,15,18,1,10,37,27,27,34,11,23,16,50,37,0,"https://fbref.com/en/players/1fffae99/Jens-Stage"
"13932","Niklas Stark_2023",2023,"Werder Bremen","Bundesliga","Niklas Stark","GER","DF","27",1995,23.1,56,36,29,24,3,27,42,64.3,15,24,13,11,37,93,110,0,"https://fbref.com/en/players/aad48be9/Niklas-Stark"
"13933","Miloš Veljković_2023",2023,"Werder Bremen","Bundesliga","Miloš Veljković","SRB","DF","26",1995,25.2,30,19,17,13,0,18,29,62.1,11,32,16,16,33,63,103,0,"https://fbref.com/en/players/a5ae8f8e/Milos-Veljkovic"
"13934","Mitchell Weiser_2023",2023,"Werder Bremen","Bundesliga","Mitchell Weiser","GER","DF,FW","28",1994,28,71,43,38,24,9,38,75,50.7,37,50,7,43,28,99,38,1,"https://fbref.com/en/players/30c220c3/Mitchell-Weiser"
"13935","Michael Zetterer_2023",2023,"Werder Bremen","Bundesliga","Michael Zetterer","GER","GK","27",1995,1.7,0,0,0,0,0,0,0,NA,0,0,0,0,0,0,1,0,"https://fbref.com/en/players/9b688ae1/Michael-Zetterer"
"13936","Nayef Aguerd_2023",2023,"West Ham","Premier League","Nayef Aguerd","MAR","DF","26",1996,17.7,27,18,18,8,1,13,20,65,7,26,24,2,18,45,79,2,"https://fbref.com/en/players/288e1e13/Nayef-Aguerd"
"13937","Michail Antonio_2023",2023,"West Ham","Premier League","Michail Antonio","JAM","FW","32",1990,20.3,14,7,1,8,5,3,12,25,9,13,5,8,5,19,9,0,"https://fbref.com/en/players/ac05f970/Michail-Antonio"
"13938","Alphonse Areola_2023",2023,"West Ham","Premier League","Alphonse Areola","FRA","GK","29",1993,3.4,0,0,0,0,0,0,0,NA,0,0,0,0,0,0,0,0,"https://fbref.com/en/players/2f965a72/Alphonse-Areola"
"13939","Saïd Benrahma_2023",2023,"West Ham","Premier League","Saïd Benrahma","ALG","FW,MF","26",1995,23,25,15,11,7,7,11,27,40.7,16,23,1,22,9,34,13,0,"https://fbref.com/en/players/5a04fd92/Said-Benrahma"
"13940","Jarrod Bowen_2023",2023,"West Ham","Premier League","Jarrod Bowen","ENG","FW,MF","25",1996,35.9,39,16,14,11,14,16,57,28.1,41,47,9,38,36,75,25,0,"https://fbref.com/en/players/79c84d1c/Jarrod-Bowen"
"13941","Maxwel Cornet_2023",2023,"West Ham","Premier League","Maxwel Cornet","CIV","FW","25",1996,2.7,7,3,5,0,2,4,6,66.7,2,6,0,6,2,9,3,0,"https://fbref.com/en/players/beb391dd/Maxwel-Cornet"
"13942","Vladimír Coufal_2023",2023,"West Ham","Premier League","Vladimír Coufal","CZE","DF","29",1992,23.7,58,31,37,15,6,36,51,70.6,15,24,6,18,38,96,70,0,"https://fbref.com/en/players/fdf3cb77/Vladimir-Coufal"
"13943","Conor Coventry_2023",2023,"West Ham","Premier League","Conor Coventry","IRL","MF,FW","22",2000,0,0,0,0,0,0,0,0,NA,0,0,0,0,0,0,0,0,"https://fbref.com/en/players/a5ca9127/Conor-Coventry"
"13944","Aaron Cresswell_2023",2023,"West Ham","Premier League","Aaron Cresswell","ENG","DF","32",1989,24.8,21,11,12,7,2,12,31,38.7,19,21,11,10,27,48,56,0,"https://fbref.com/en/players/4f974391/Aaron-Cresswell"
"13945","Craig Dawson_2023",2023,"West Ham","Premier League","Craig Dawson","ENG","DF","32",1990,8,10,6,8,2,0,4,6,66.7,2,9,6,3,6,16,26,0,"https://fbref.com/en/players/3e9e06cb/Craig-Dawson"
"13946","Flynn Downes_2023",2023,"West Ham","Premier League","Flynn Downes","ENG","MF","23",1999,8.5,16,9,4,10,2,6,12,50,6,15,2,13,7,23,6,0,"https://fbref.com/en/players/69fdb896/Flynn-Downes"
"13947","Łukasz Fabiański_2023",2023,"West Ham","Premier League","Łukasz Fabiański","POL","GK","37",1985,34.6,2,0,2,0,0,1,2,50,1,1,0,1,0,2,10,1,"https://fbref.com/en/players/9328b835/Lukasz-Fabianski"
"13948","Pablo Fornals_2023",2023,"West Ham","Premier League","Pablo Fornals","ESP","FW,MF","26",1996,16.7,30,15,9,12,9,13,34,38.2,21,16,2,14,14,44,9,0,"https://fbref.com/en/players/82927de4/Pablo-Fornals"
"13949","Danny Ings_2023",2023,"West Ham","Premier League","Danny Ings","ENG","FW","30",1992,8.6,9,8,0,4,5,5,14,35.7,9,8,2,6,3,12,5,0,"https://fbref.com/en/players/07802f7f/Danny-Ings"
"13950","Ben Johnson_2023",2023,"West Ham","Premier League","Ben Johnson","ENG","DF","22",2000,9.6,20,14,12,4,4,12,18,66.7,6,12,4,8,9,29,28,1,"https://fbref.com/en/players/9319781b/Ben-Johnson"
"13951","Thilo Kehrer_2023",2023,"West Ham","Premier League","Thilo Kehrer","GER","DF","25",1996,24.8,43,24,25,14,4,21,44,47.7,23,16,6,10,34,77,76,1,"https://fbref.com/en/players/51dbeea9/Thilo-Kehrer"
"13952","Manuel Lanzini_2023",2023,"West Ham","Premier League","Manuel Lanzini","ARG","MF,FW","29",1993,2.8,2,2,1,1,0,2,6,33.3,4,2,0,2,2,4,0,0,"https://fbref.com/en/players/26f6dca8/Manuel-Lanzini"
"13953","Divin Mubama_2023",2023,"West Ham","Premier League","Divin Mubama","ENG","FW","17",2004,0.4,1,1,1,0,0,0,0,NA,0,0,0,0,0,1,0,0,"https://fbref.com/en/players/92868cb5/Divin-Mubama"
"13954","Angelo Ogbonna_2023",2023,"West Ham","Premier League","Angelo Ogbonna","ITA","DF","34",1988,13.7,11,4,7,4,0,5,10,50,5,11,7,4,17,28,74,1,"https://fbref.com/en/players/74b2cd7e/Angelo-Ogbonna"
"13955","Emerson Palmieri_2023",2023,"West Ham","Premier League","Emerson Palmieri","ITA","DF","27",1994,14.7,26,14,9,15,2,12,24,50,12,17,4,13,15,41,36,0,"https://fbref.com/en/players/e0bc6fdc/Emerson-Palmieri"
"13956","Lucas Paquetá_2023",2023,"West Ham","Premier League","Lucas Paquetá","BRA","MF","24",1997,23.9,71,53,23,36,12,27,66,40.9,39,41,4,37,16,87,31,0,"https://fbref.com/en/players/9b6f7fd5/Lucas-Paqueta"
"13957","Declan Rice_2023",2023,"West Ham","Premier League","Declan Rice","ENG","MF","23",1999,36.4,79,38,44,31,4,31,50,62,19,45,15,30,63,142,58,0,"https://fbref.com/en/players/1c7012b8/Declan-Rice"
"13958","Gianluca Scamacca_2023",2023,"West Ham","Premier League","Gianluca Scamacca","ITA","FW","23",1999,10.3,10,5,1,3,6,2,2,100,0,3,0,3,4,14,5,0,"https://fbref.com/en/players/8790f988/Gianluca-Scamacca"
"13959","Tomáš Souček_2023",2023,"West Ham","Premier League","Tomáš Souček","CZE","MF","27",1995,31.3,77,37,41,29,7,28,58,48.3,30,42,17,25,53,130,71,3,"https://fbref.com/en/players/6613c819/Tomas-Soucek"
"13960","Kurt Zouma_2023",2023,"West Ham","Premier League","Kurt Zouma","FRA","DF","27",1994,22.1,9,4,4,5,0,5,8,62.5,3,17,14,3,30,39,120,1,"https://fbref.com/en/players/ce4246f5/Kurt-Zouma"
"13961","Lukáš Ambros_2023",2023,"Wolfsburg","Bundesliga","Lukáš Ambros","CZE","MF","18",2004,0.2,1,0,1,0,0,1,4,25,3,1,0,1,0,1,2,1,"https://fbref.com/en/players/cd682b6b/Lukas-Ambros"
"13962","Maximilian Arnold_2023",2023,"Wolfsburg","Bundesliga","Maximilian Arnold","GER","MF","28",1994,30.7,62,31,25,28,9,28,54,51.9,26,34,11,23,26,88,65,2,"https://fbref.com/en/players/86e119e0/Maximilian-Arnold"
"13963","Ridle Baku_2023",2023,"Wolfsburg","Bundesliga","Ridle Baku","GER","DF,FW","24",1998,28.7,50,26,29,17,4,32,58,55.2,26,44,6,38,21,71,59,0,"https://fbref.com/en/players/442b56fa/Ridle-Baku"
"13964","Sebastiaan Bornauw_2023",2023,"Wolfsburg","Bundesliga","Sebastiaan Bornauw","BEL","DF","23",1999,21.4,29,17,17,10,2,16,22,72.7,6,27,12,15,31,60,83,1,"https://fbref.com/en/players/01834aa0/Sebastiaan-Bornauw"
"13965","Josip Brekalo_2023",2023,"Wolfsburg","Bundesliga","Josip Brekalo","CRO","MF,FW","24",1998,3,2,1,2,0,0,0,4,0,4,0,0,0,2,4,2,0,"https://fbref.com/en/players/d4a2533d/Josip-Brekalo"
"13966","Koen Casteels_2023",2023,"Wolfsburg","Bundesliga","Koen Casteels","BEL","GK","30",1992,34,0,0,0,0,0,0,0,NA,0,0,0,0,1,1,10,1,"https://fbref.com/en/players/db401046/Koen-Casteels"
"13967","Nicolas Cozza_2023",2023,"Wolfsburg","Bundesliga","Nicolas Cozza","FRA","DF","23",1999,1.1,3,3,1,2,0,2,3,66.7,1,3,1,2,0,3,0,0,"https://fbref.com/en/players/8f325097/Nicolas-Cozza"
"13968","Kilian Fischer_2023",2023,"Wolfsburg","Bundesliga","Kilian Fischer","GER","DF,FW","21",2000,5.6,9,6,3,4,2,6,11,54.5,5,6,0,6,5,14,18,0,"https://fbref.com/en/players/79f7302a/Kilian-Fischer"
"13969","Bartol Franjić_2023",2023,"Wolfsburg","Bundesliga","Bartol Franjić","CRO","MF","22",2000,2.5,4,2,2,2,0,0,2,0,2,4,1,3,5,9,4,0,"https://fbref.com/en/players/697dc00a/Bartol-Franjic"
"13970","Yannick Gerhardt_2023",2023,"Wolfsburg","Bundesliga","Yannick Gerhardt","GER","MF","28",1994,20.7,29,15,10,11,8,12,30,40,18,26,5,21,7,36,24,0,"https://fbref.com/en/players/62ab9184/Yannick-Gerhardt"
"13971","Josuha Guilavogui_2023",2023,"Wolfsburg","Bundesliga","Josuha Guilavogui","FRA","DF,MF","31",1990,13.1,18,11,7,10,1,6,17,35.3,11,19,13,6,23,41,52,0,"https://fbref.com/en/players/e6c43eec/Josuha-Guilavogui"
"13972","Jakub Kamiński_2023",2023,"Wolfsburg","Bundesliga","Jakub Kamiński","POL","FW,DF","20",2002,22.9,36,25,15,13,8,20,40,50,20,37,2,35,8,44,15,0,"https://fbref.com/en/players/202b3b68/Jakub-Kaminski"
"13973","Max Kruse_2023",2023,"Wolfsburg","Bundesliga","Max Kruse","GER","MF,FW","34",1988,3,1,1,0,1,0,0,1,0,1,2,1,1,0,1,1,0,"https://fbref.com/en/players/f9446dcd/Max-Kruse"
"13974","Maxence Lacroix_2023",2023,"Wolfsburg","Bundesliga","Maxence Lacroix","FRA","DF","22",2000,18.1,22,13,15,7,0,8,16,50,8,22,11,11,26,48,85,0,"https://fbref.com/en/players/277c49ed/Maxence-Lacroix"
"13975","Omar Marmoush_2023",2023,"Wolfsburg","Bundesliga","Omar Marmoush","EGY","FW","23",1999,16.4,16,10,8,2,6,4,16,25,12,21,1,20,7,23,4,0,"https://fbref.com/en/players/0e0102eb/Omar-Marmoush"
"13976","Felix Nmecha_2023",2023,"Wolfsburg","Bundesliga","Felix Nmecha","GER","MF","21",2000,20.4,41,24,11,23,7,16,34,47.1,18,26,10,16,25,66,31,0,"https://fbref.com/en/players/091c86e2/Felix-Nmecha"
"13977","Lukas Nmecha_2023",2023,"Wolfsburg","Bundesliga","Lukas Nmecha","GER","FW","23",1998,10,5,3,0,2,3,3,3,100,0,5,1,4,3,8,4,0,"https://fbref.com/en/players/0cc5f4a5/Lukas-Nmecha"
"13978","Paulo Otávio_2023",2023,"Wolfsburg","Bundesliga","Paulo Otávio","BRA","DF","27",1994,22.7,72,46,46,17,9,44,66,66.7,22,42,6,36,30,102,70,1,"https://fbref.com/en/players/1cbe4984/Paulo-Otavio"
"13979","Kevin Paredes_2023",2023,"Wolfsburg","Bundesliga","Kevin Paredes","USA","FW,MF","19",2003,5.9,13,9,6,3,4,9,12,75,3,7,0,7,6,19,8,0,"https://fbref.com/en/players/5c50fdbc/Kevin-Paredes"
"13980","Dženan Pejčinović_2023",2023,"Wolfsburg","Bundesliga","Dženan Pejčinović","GER","FW","17",2005,0.1,0,0,0,0,0,0,0,NA,0,0,0,0,0,0,0,0,"https://fbref.com/en/players/80f252f6/Dzenan-Pejcinovic"
"13981","Maximilian Philipp_2023",2023,"Wolfsburg","Bundesliga","Maximilian Philipp","GER","FW","28",1994,1.3,2,1,1,1,0,1,1,100,0,1,0,1,0,2,0,0,"https://fbref.com/en/players/061e8e23/Maximilian-Philipp"
"13982","Jérôme Roussillon_2023",2023,"Wolfsburg","Bundesliga","Jérôme Roussillon","FRA","MF,DF","29",1993,0.2,0,0,0,0,0,0,0,NA,0,0,0,0,0,0,0,0,"https://fbref.com/en/players/13203c45/Jerome-Roussillon"
"13983","Mattias Svanberg_2023",2023,"Wolfsburg","Bundesliga","Mattias Svanberg","SWE","MF,FW","23",1999,20.4,25,16,8,16,1,10,30,33.3,20,27,5,22,21,46,25,1,"https://fbref.com/en/players/92d83c27/Mattias-Svanberg"
"13984","Micky van de Ven_2023",2023,"Wolfsburg","Bundesliga","Micky van de Ven","NED","DF","21",2001,33,45,30,26,18,1,28,39,71.8,11,42,24,18,26,71,108,2,"https://fbref.com/en/players/8fe2a392/Micky-van-de-Ven"
"13985","Aster Vranckx_2023",2023,"Wolfsburg","Bundesliga","Aster Vranckx","BEL","MF","19",2002,0.1,0,0,0,0,0,0,0,NA,0,0,0,0,0,0,1,0,"https://fbref.com/en/players/f86cd5df/Aster-Vranckx"
"13986","Luca Waldschmidt_2023",2023,"Wolfsburg","Bundesliga","Luca Waldschmidt","GER","FW,MF","26",1996,5.8,5,2,2,1,2,2,10,20,8,6,0,6,3,8,5,0,"https://fbref.com/en/players/e5a35ae9/Luca-Waldschmidt"
"13987","Patrick Wimmer_2023",2023,"Wolfsburg","Bundesliga","Patrick Wimmer","AUT","FW,MF","21",2001,18.3,39,26,18,11,10,12,38,31.6,26,27,2,25,15,54,15,0,"https://fbref.com/en/players/cb11b429/Patrick-Wimmer"
"13988","Jonas Wind_2023",2023,"Wolfsburg","Bundesliga","Jonas Wind","DEN","FW","23",1999,14.3,14,6,2,7,5,5,10,50,5,14,4,10,1,15,10,0,"https://fbref.com/en/players/2077ae86/Jonas-Wind"
"13989","Rayan Aït Nouri_2023",2023,"Wolves","Premier League","Rayan Aït Nouri","ALG","DF","21",2001,12,33,20,25,7,1,9,15,60,6,3,0,3,9,42,28,0,"https://fbref.com/en/players/9b398aea/Rayan-Ait-Nouri"
"13990","Daniel Bentley_2023",2023,"Wolves","Premier League","Daniel Bentley","ENG","GK","29",1993,2,1,1,1,0,0,1,1,100,0,0,0,0,0,1,0,0,"https://fbref.com/en/players/68db6358/Daniel-Bentley"
"13991","Hugo Bueno_2023",2023,"Wolves","Premier League","Hugo Bueno","ESP","DF","19",2002,14.6,33,16,23,6,4,17,33,51.5,16,14,1,13,10,43,36,0,"https://fbref.com/en/players/bfc3b3a0/Hugo-Bueno"
"13992","Chem Campbell_2023",2023,"Wolves","Premier League","Chem Campbell","WAL","FW,MF","19",2002,0.8,2,1,1,1,0,0,1,0,1,2,0,2,1,3,0,0,"https://fbref.com/en/players/6f711f67/Chem-Campbell"
"13993","Jonny Castro_2023",2023,"Wolves","Premier League","Jonny Castro","ESP","DF","28",1994,14,34,15,23,10,1,18,37,48.6,19,26,5,21,14,48,28,2,"https://fbref.com/en/players/e28868f3/Jonny-Castro"
"13994","Nathan Collins_2023",2023,"Wolves","Premier League","Nathan Collins","IRL","DF","21",2001,20.2,27,15,19,8,0,15,24,62.5,9,35,28,7,21,48,84,0,"https://fbref.com/en/players/a8c19eb8/Nathan-Collins"
"13995","Diego Costa_2023",2023,"Wolves","Premier League","Diego Costa","ESP","FW","33",1988,13.8,3,1,3,0,0,2,9,22.2,7,6,1,5,2,5,17,0,"https://fbref.com/en/players/a190d597/Diego-Costa"
"13996","Matheus Cunha_2023",2023,"Wolves","Premier League","Matheus Cunha","BRA","FW","23",1999,10.7,7,4,0,5,2,2,10,20,8,15,3,12,9,16,11,0,"https://fbref.com/en/players/dc62b55d/Matheus-Cunha"
"13997","Craig Dawson_2023",2023,"Wolves","Premier League","Craig Dawson","ENG","DF","32",1990,15.7,9,6,6,3,0,4,7,57.1,3,31,23,8,12,21,74,2,"https://fbref.com/en/players/3e9e06cb/Craig-Dawson"
"13998","Leander Dendoncker_2023",2023,"Wolves","Premier League","Leander Dendoncker","BEL","MF","27",1995,2.4,4,2,0,3,1,2,3,66.7,1,2,0,2,9,13,4,0,"https://fbref.com/en/players/5a7301ae/Leander-Dendoncker"
"13999","Morgan Gibbs-White_2023",2023,"Wolves","Premier League","Morgan Gibbs-White","ENG","FW,MF","22",2000,2,3,1,3,0,0,2,3,66.7,1,2,0,2,1,4,3,0,"https://fbref.com/en/players/32f60ed8/Morgan-Gibbs-White"
"14000","João Gomes_2023",2023,"Wolves","Premier League","João Gomes","BRA","MF","21",2001,7.3,29,13,14,14,1,13,23,56.5,10,12,3,9,4,33,11,0,"https://fbref.com/en/players/8b57ad2c/Joao-Gomes"
"14001","Toti Gomes_2023",2023,"Wolves","Premier League","Toti Gomes","POR","DF","23",1999,10.9,15,9,11,4,0,9,13,69.2,4,16,8,8,11,26,51,0,"https://fbref.com/en/players/f0caab96/Toti-Gomes"
"14002","Gonçalo Guedes_2023",2023,"Wolves","Premier League","Gonçalo Guedes","POR","FW,MF","25",1996,7.9,8,6,4,3,1,5,8,62.5,3,4,0,4,1,9,2,0,"https://fbref.com/en/players/e6bc67d7/Goncalo-Guedes"
"14003","Hwang Hee-chan_2023",2023,"Wolves","Premier League","Hwang Hee-chan","KOR","FW,MF","26",1996,12.6,20,9,7,8,5,6,19,31.6,13,18,2,16,5,25,5,0,"https://fbref.com/en/players/169fd162/Hwang-Hee-chan"
"14004","Joseph Hodge_2023",2023,"Wolves","Premier League","Joseph Hodge","IRL","MF","19",2002,1.9,5,2,1,3,1,3,4,75,1,5,0,5,0,5,2,1,"https://fbref.com/en/players/bd8a5d95/Joseph-Hodge"
"14005","Raúl Jiménez_2023",2023,"Wolves","Premier League","Raúl Jiménez","MEX","FW","31",1991,9.4,9,6,3,5,1,3,6,50,3,9,0,9,0,9,8,0,"https://fbref.com/en/players/b561db50/Raul-Jimenez"
"14006","Sasa Kalajdzic_2023",2023,"Wolves","Premier League","Sasa Kalajdzic","AUT","FW","25",1997,0.5,0,0,0,0,0,0,0,NA,0,0,0,0,1,1,0,0,"https://fbref.com/en/players/15f24fe7/Sasa-Kalajdzic"
"14007","Max Kilman_2023",2023,"Wolves","Premier League","Max Kilman","ENG","DF","25",1997,36.7,36,20,26,9,1,16,30,53.3,14,70,42,28,19,55,164,1,"https://fbref.com/en/players/d0f72bf1/Max-Kilman"
"14008","Dexter Lembikisa_2023",2023,"Wolves","Premier League","Dexter Lembikisa","JAM","DF","18",2003,0.3,0,0,0,0,0,0,0,NA,0,0,0,0,0,0,0,0,"https://fbref.com/en/players/0bdda685/Dexter-Lembikisa"
"14009","Mario Lemina_2023",2023,"Wolves","Premier League","Mario Lemina","GAB","MF","28",1993,14.4,38,24,22,13,3,20,38,52.6,18,26,8,18,14,52,24,1,"https://fbref.com/en/players/2b471f99/Mario-Lemina"
"14010","João Moutinho_2023",2023,"Wolves","Premier League","João Moutinho","POR","MF","35",1986,19.8,51,30,24,21,6,19,46,41.3,27,22,6,16,18,69,20,0,"https://fbref.com/en/players/f5a00fa4/Joao-Moutinho"
"14011","Pedro Neto_2023",2023,"Wolves","Premier League","Pedro Neto","POR","FW,MF","22",2000,10.7,11,6,4,2,5,7,17,41.2,10,5,1,4,4,15,4,0,"https://fbref.com/en/players/7ba2eaa9/Pedro-Neto"
"14012","Rúben Neves_2023",2023,"Wolves","Premier League","Rúben Neves","POR","MF","25",1997,33.5,79,43,31,33,15,32,74,43.2,42,59,22,37,50,129,85,1,"https://fbref.com/en/players/44bfb6c5/Ruben-Neves"
"14013","Matheus Nunes_2023",2023,"Wolves","Premier League","Matheus Nunes","POR","MF","23",1998,27.4,67,43,36,22,9,28,61,45.9,33,35,4,31,16,83,35,2,"https://fbref.com/en/players/e6af02e0/Matheus-Nunes"
"14014","Daniel Podence_2023",2023,"Wolves","Premier League","Daniel Podence","POR","FW,MF","26",1995,19.7,27,17,13,9,5,6,31,19.4,25,19,0,19,7,34,6,0,"https://fbref.com/en/players/7fcc71d8/Daniel-Podence"
"14015","Connor Ronan_2023",2023,"Wolves","Premier League","Connor Ronan","IRL","MF","24",1998,0,0,0,0,0,0,0,0,NA,0,0,0,0,0,0,0,0,"https://fbref.com/en/players/1b804500/Connor-Ronan"
"14016","José Sá_2023",2023,"Wolves","Premier League","José Sá","POR","GK","29",1993,36,1,0,1,0,0,1,1,100,0,0,0,0,0,1,10,6,"https://fbref.com/en/players/903b6e8b/Jose-Sa"
"14017","Pablo Sarabia_2023",2023,"Wolves","Premier League","Pablo Sarabia","ESP","FW,MF","30",1992,8.5,12,6,4,5,3,6,15,40,9,7,0,7,2,14,4,0,"https://fbref.com/en/players/9744ff80/Pablo-Sarabia"
"14018","Nélson Semedo_2023",2023,"Wolves","Premier League","Nélson Semedo","POR","DF","28",1993,29.2,71,42,48,19,4,33,64,51.6,31,42,15,27,29,100,83,2,"https://fbref.com/en/players/d04b94db/Nelson-Semedo"
"14019","Adama Traoré_2023",2023,"Wolves","Premier League","Adama Traoré","ESP","FW,MF","26",1996,16.6,14,7,7,4,3,4,9,44.4,5,8,1,7,3,17,17,0,"https://fbref.com/en/players/9a28eba4/Adama-Traore"
"14020","Boubacar Traoré_2023",2023,"Wolves","Premier League","Boubacar Traoré","MLI","MF","20",2001,4.6,12,5,4,5,3,3,7,42.9,4,4,2,2,7,19,1,0,"https://fbref.com/en/players/999ceb5f/Boubacar-Traore"
